"date","geography","geography code","NS-SeC: All categories: NS-SeC; measures: Value","NS-SeC: 1. Higher managerial, administrative and professional occupations; measures: Value","NS-SeC: 1.1 Large employers and higher managerial and administrative occupations; measures: Value","NS-SeC: 1.2 Higher professional occupations; measures: Value","NS-SeC: 2. Lower managerial, administrative and professional occupations; measures: Value","NS-SeC: 3. Intermediate occupations; measures: Value","NS-SeC: 4. Small employers and own account workers; measures: Value","NS-SeC: 5. Lower supervisory and technical occupations; measures: Value","NS-SeC: 6. Semi-routine occupations; measures: Value","NS-SeC: 7. Routine occupations; measures: Value","NS-SeC: 8. Never worked and long-term unemployed; measures: Value","NS-SeC: L14.1 Never worked; measures: Value","NS-SeC: L14.2 Long-term unemployed; measures: Value","NS-SeC: L15 Full-time students; measures: Value"
"2011","Darlington 001B","E01012334",1742,269,82,187,512,261,246,81,157,98,37,20,17,81
"2011","Darlington 001C","E01012335",1009,154,42,112,279,148,105,63,117,72,16,12,4,55
"2011","Darlington 001D","E01012366",1554,197,59,138,390,201,245,106,165,115,36,17,19,99
"2011","Darlington 001E","E01033481",1020,144,37,107,326,156,70,71,101,69,35,18,17,48
"2011","Darlington 001F","E01033482",1196,145,29,116,370,180,87,98,130,89,23,14,9,74
"2011","Darlington 002C","E01012323",1149,58,21,37,187,196,86,116,218,151,47,20,27,90
"2011","Darlington 002D","E01012324",1045,51,11,40,211,160,91,94,194,165,21,14,7,58
"2011","Darlington 002E","E01032545",939,51,21,30,183,152,59,85,169,154,42,24,18,44
"2011","Darlington 002F","E01032546",1329,138,40,98,276,250,120,101,197,124,40,24,16,83
"2011","Darlington 003A","E01012328",1160,66,24,42,225,175,75,101,212,189,59,41,18,58
"2011","Darlington 003B","E01012329",1377,136,43,93,355,267,107,97,204,126,28,16,12,57
"2011","Darlington 003C","E01012330",869,97,27,70,212,150,50,75,118,90,16,6,10,61
"2011","Darlington 003D","E01012331",936,67,17,50,170,155,55,74,186,126,39,18,21,64
"2011","Darlington 004A","E01012349",1097,13,2,11,106,137,62,80,246,247,146,82,64,60
"2011","Darlington 004B","E01012350",1140,44,15,29,172,161,70,112,225,211,78,39,39,67
"2011","Darlington 004C","E01012351",1094,92,32,60,209,168,66,90,192,144,44,27,17,89
"2011","Darlington 004D","E01012352",1142,43,10,33,147,144,68,86,242,238,120,72,48,54
"2011","Darlington 005A","E01012325",1104,83,24,59,236,164,83,90,185,160,51,34,17,52
"2011","Darlington 005B","E01012326",798,42,15,27,132,107,58,76,167,126,48,35,13,42
"2011","Darlington 005C","E01012332",969,36,9,27,128,110,45,103,225,208,62,44,18,52
"2011","Darlington 005D","E01012333",1041,60,14,46,194,175,57,88,198,151,54,38,16,64
"2011","Darlington 006A","E01012309",1380,103,25,78,325,261,82,134,218,154,24,18,6,79
"2011","Darlington 006B","E01012310",1444,70,18,52,276,235,108,142,278,194,59,39,20,82
"2011","Darlington 006C","E01012311",1106,72,21,51,167,153,79,99,210,154,70,40,30,102
"2011","Darlington 006D","E01012312",890,23,4,19,79,98,44,84,200,193,128,87,41,41
"2011","Darlington 006E","E01012313",941,44,10,34,131,123,59,72,233,172,55,32,23,52
"2011","Darlington 006F","E01012314",954,22,3,19,119,116,60,61,208,218,96,55,41,54
"2011","Darlington 007A","E01012362",1049,64,12,52,165,140,51,75,222,196,82,43,39,54
"2011","Darlington 007B","E01012363",1043,62,7,55,211,204,55,93,155,156,48,23,25,59
"2011","Darlington 007C","E01012364",1166,88,15,73,251,200,65,85,206,129,80,55,25,62
"2011","Darlington 007D","E01012365",931,94,25,69,220,155,61,70,150,96,27,14,13,58
"2011","Darlington 008B","E01012353",1241,59,13,46,200,181,86,96,234,200,117,73,44,68
"2011","Darlington 008C","E01012354",1206,50,7,43,154,123,81,109,204,223,180,119,61,82
"2011","Darlington 008D","E01012355",1104,142,17,125,201,125,93,63,191,144,91,60,31,54
"2011","Darlington 008E","E01033483",812,36,8,28,82,86,36,52,163,157,149,106,43,51
"2011","Darlington 008F","E01033484",919,76,14,62,165,107,73,50,161,138,88,60,28,61
"2011","Darlington 009A","E01012307",1392,56,15,41,176,211,92,109,294,278,107,77,30,69
"2011","Darlington 009B","E01012327",1027,22,1,21,86,87,43,82,251,223,153,101,52,80
"2011","Darlington 009C","E01012342",1222,56,13,43,150,136,77,112,274,247,93,70,23,77
"2011","Darlington 009D","E01012343",1456,64,16,48,230,242,119,137,294,228,67,48,19,75
"2011","Darlington 010A","E01012315",1149,175,39,136,405,182,88,45,101,42,24,14,10,87
"2011","Darlington 010B","E01012316",1821,394,81,313,595,206,144,81,156,80,46,26,20,119
"2011","Darlington 010C","E01012360",1143,233,48,185,373,140,130,38,87,52,28,12,16,62
"2011","Darlington 011A","E01012336",1199,230,69,161,364,195,93,55,101,51,33,27,6,77
"2011","Darlington 011B","E01012337",1220,202,52,150,382,227,81,57,115,41,23,18,5,92
"2011","Darlington 011C","E01012347",1231,150,35,115,334,252,111,70,127,80,30,17,13,77
"2011","Darlington 011D","E01012348",1324,150,40,110,339,288,96,87,163,109,29,13,16,63
"2011","Darlington 011E","E01012361",1353,232,59,173,451,198,130,54,115,63,22,11,11,88
"2011","Darlington 012A","E01012304",890,17,4,13,112,116,78,70,168,170,100,67,33,59
"2011","Darlington 012B","E01012305",944,38,10,28,162,124,64,89,203,150,65,36,29,49
"2011","Darlington 012C","E01012306",1119,61,20,41,188,153,121,96,191,155,94,80,14,60
"2011","Darlington 012D","E01012340",1743,85,26,59,303,263,113,146,334,285,109,78,31,105
"2011","Darlington 012E","E01012341",1243,19,4,15,148,119,64,99,284,269,157,108,49,84
"2011","Darlington 013A","E01012317",1008,49,12,37,133,157,92,99,219,177,37,27,10,45
"2011","Darlington 013B","E01012318",1636,55,15,40,210,180,90,131,337,355,185,119,66,93
"2011","Darlington 013C","E01012319",1967,79,19,60,293,256,131,171,433,349,137,100,37,118
"2011","Darlington 014A","E01012356",1187,145,33,112,230,137,76,77,188,151,91,50,41,92
"2011","Darlington 014B","E01012357",1083,45,10,35,163,139,60,104,206,188,89,63,26,89
"2011","Darlington 014C","E01012358",1208,109,21,88,204,165,79,96,222,171,90,62,28,72
"2011","Darlington 014D","E01012359",1034,23,5,18,66,67,63,87,212,255,180,106,74,81
"2011","Darlington 015A","E01012338",1421,170,44,126,334,207,177,110,169,132,52,35,17,70
"2011","Darlington 015B","E01012339",1286,160,38,122,375,207,131,85,130,91,28,19,9,79
"2011","Darlington 015C","E01012344",1009,133,27,106,256,125,84,72,138,97,37,31,6,67
"2011","Darlington 015D","E01012345",1069,170,51,119,285,140,121,56,112,76,62,53,9,47
"2011","Darlington 015E","E01012346",1355,176,41,135,394,207,108,86,156,96,44,28,16,88
"2011","County Durham 002A","E01020613",1060,105,39,66,258,198,85,88,151,76,26,15,11,73
"2011","County Durham 002B","E01020614",1028,68,16,52,186,175,75,92,221,126,34,22,12,51
"2011","County Durham 002C","E01020622",1338,122,30,92,322,232,104,121,210,120,26,13,13,81
"2011","County Durham 002D","E01020623",1205,123,32,91,294,262,80,102,155,78,29,13,16,82
"2011","County Durham 005A","E01020606",1135,58,14,44,162,127,83,95,216,246,94,51,43,54
"2011","County Durham 005B","E01020615",1238,51,12,39,152,137,70,115,255,278,87,58,29,93
"2011","County Durham 005C","E01020616",1265,62,23,39,220,139,76,111,258,230,89,60,29,80
"2011","County Durham 005D","E01020617",1444,97,28,69,288,252,97,139,249,195,56,43,13,71
"2011","County Durham 007A","E01020596",1186,50,10,40,163,162,61,111,248,248,75,35,40,68
"2011","County Durham 007B","E01020597",1159,101,35,66,281,211,74,105,173,125,26,20,6,63
"2011","County Durham 007C","E01020598",1296,150,37,113,368,224,99,100,152,104,30,15,15,69
"2011","County Durham 007D","E01020611",1009,145,48,97,282,173,87,71,110,71,14,9,5,56
"2011","County Durham 007E","E01020612",1198,181,52,129,358,217,108,62,109,77,20,18,2,66
"2011","County Durham 011A","E01020592",1067,29,6,23,117,98,75,79,229,215,118,77,41,107
"2011","County Durham 011B","E01020593",955,64,15,49,164,122,45,85,189,170,61,33,28,55
"2011","County Durham 011C","E01020599",1211,41,12,29,183,180,75,119,245,231,64,38,26,73
"2011","County Durham 011D","E01020601",1171,119,36,83,274,180,80,80,169,138,24,17,7,107
"2011","County Durham 011E","E01020602",1244,43,10,33,181,164,75,112,271,242,80,46,34,76
"2011","County Durham 011F","E01020618",1174,57,19,38,175,149,108,109,209,198,88,58,30,81
"2011","County Durham 013A","E01020594",1272,109,24,85,287,224,91,91,185,179,34,21,13,72
"2011","County Durham 013B","E01020595",1273,183,42,141,392,193,82,73,142,99,38,26,12,71
"2011","County Durham 013C","E01020600",1132,146,44,102,287,224,80,86,143,79,17,10,7,70
"2011","County Durham 013D","E01020603",1390,242,72,170,379,253,96,74,123,64,26,15,11,133
"2011","County Durham 013E","E01020605",1370,195,70,125,390,274,76,101,146,87,22,14,8,79
"2011","County Durham 015A","E01020590",1042,93,28,65,219,162,71,77,149,123,44,33,11,104
"2011","County Durham 015B","E01020591",1069,66,20,46,167,150,82,101,219,156,62,38,24,66
"2011","County Durham 015C","E01020608",1266,130,22,108,292,211,95,75,183,153,57,42,15,70
"2011","County Durham 015D","E01020609",1038,93,19,74,225,172,58,95,156,136,42,29,13,61
"2011","County Durham 015E","E01020610",1139,148,37,111,328,181,89,77,117,97,24,14,10,78
"2011","County Durham 019A","E01020604",1086,113,30,83,229,127,99,79,172,140,61,43,18,66
"2011","County Durham 019B","E01020607",1257,81,20,61,232,152,84,107,214,246,84,59,25,57
"2011","County Durham 019C","E01020619",1153,82,19,63,242,182,70,105,191,193,25,15,10,63
"2011","County Durham 019D","E01020620",1175,76,20,56,210,164,85,111,207,160,70,49,21,92
"2011","County Durham 019E","E01020621",1436,85,24,61,231,175,82,112,287,284,115,76,39,65
"2011","County Durham 001A","E01020634",1182,143,32,111,327,190,104,84,146,94,27,17,10,67
"2011","County Durham 001B","E01020635",1091,148,35,113,340,170,90,76,114,68,22,17,5,63
"2011","County Durham 001C","E01020636",1240,68,16,52,219,188,87,111,237,191,71,41,30,68
"2011","County Durham 001D","E01020654",1315,104,43,61,322,183,113,120,194,174,39,27,12,66
"2011","County Durham 001E","E01020676",1199,90,21,69,229,181,104,105,204,168,46,29,17,72
"2011","County Durham 003A","E01020627",1181,113,43,70,308,172,97,108,159,118,42,24,18,64
"2011","County Durham 003B","E01020628",1207,182,47,135,375,151,126,70,136,81,28,21,7,58
"2011","County Durham 003C","E01020629",1083,102,26,76,262,131,76,83,177,119,48,33,15,85
"2011","County Durham 003D","E01020655",1483,239,62,177,367,195,154,85,177,127,47,31,16,92
"2011","County Durham 003E","E01020656",1055,78,18,60,224,128,116,85,190,129,52,37,15,53
"2011","County Durham 003F","E01020657",1209,114,39,75,305,154,106,82,187,105,75,58,17,81
"2011","County Durham 004A","E01020661",1337,112,25,87,245,176,89,111,228,210,88,66,22,78
"2011","County Durham 004B","E01020662",1331,86,22,64,217,191,92,107,230,231,73,47,26,104
"2011","County Durham 004C","E01020663",1404,109,32,77,321,214,130,118,211,163,53,28,25,85
"2011","County Durham 004D","E01020674",1147,49,15,34,194,167,64,93,253,198,89,62,27,40
"2011","County Durham 004E","E01020678",1041,63,20,43,183,126,73,82,233,163,44,32,12,74
"2011","County Durham 006A","E01020626",1111,36,10,26,117,111,73,130,242,270,87,62,25,45
"2011","County Durham 006B","E01020638",1196,65,26,39,193,156,88,127,213,218,68,43,25,68
"2011","County Durham 006C","E01020639",1072,49,16,33,140,103,61,92,238,220,114,83,31,55
"2011","County Durham 006D","E01020653",1130,59,17,42,208,135,87,96,194,186,89,62,27,76
"2011","County Durham 006E","E01020677",1136,55,18,37,172,139,74,118,233,199,61,40,21,85
"2011","County Durham 008A","E01020647",1524,74,28,46,183,149,74,125,326,322,189,132,57,82
"2011","County Durham 008B","E01020648",1330,44,11,33,142,142,78,126,270,301,141,88,53,86
"2011","County Durham 008C","E01020649",1154,40,20,20,162,111,94,113,221,253,103,58,45,57
"2011","County Durham 008D","E01020673",1210,33,13,20,125,104,67,100,290,307,131,98,33,53
"2011","County Durham 008E","E01020675",1219,47,18,29,137,115,77,127,281,244,110,81,29,81
"2011","County Durham 009A","E01020624",1204,42,16,26,150,132,101,118,254,238,97,64,33,72
"2011","County Durham 009B","E01020625",1176,68,12,56,191,127,107,127,228,203,56,41,15,69
"2011","County Durham 009C","E01020670",1136,42,18,24,146,150,66,115,242,237,77,54,23,61
"2011","County Durham 009D","E01020671",988,13,8,5,101,77,55,99,230,223,116,74,42,74
"2011","County Durham 009E","E01020672",1307,53,19,34,193,141,111,112,261,263,105,63,42,68
"2011","County Durham 010A","E01020632",1377,95,28,67,342,201,80,119,214,182,46,29,17,98
"2011","County Durham 010B","E01020640",1786,120,35,85,367,229,105,163,327,296,67,49,18,112
"2011","County Durham 010C","E01020641",1558,98,30,68,289,188,106,127,346,204,94,71,23,106
"2011","County Durham 010D","E01020642",1024,72,31,41,245,156,59,85,174,140,28,17,11,65
"2011","County Durham 010E","E01020643",1632,103,39,64,325,196,107,151,329,275,60,43,17,86
"2011","County Durham 010F","E01020667",1189,65,29,36,207,109,90,118,273,214,64,46,18,49
"2011","County Durham 012A","E01020650",1630,99,37,62,297,179,122,152,336,291,73,53,20,81
"2011","County Durham 012B","E01020651",1243,79,28,51,233,171,104,121,228,194,49,34,15,64
"2011","County Durham 012C","E01020652",1373,85,28,57,210,145,74,122,280,262,80,52,28,115
"2011","County Durham 012D","E01020668",1097,44,11,33,167,110,85,101,222,230,85,58,27,53
"2011","County Durham 012E","E01020669",1094,64,18,46,198,137,79,100,219,162,69,48,21,66
"2011","County Durham 014A","E01020630",1007,63,15,48,195,126,61,82,217,153,51,39,12,59
"2011","County Durham 014B","E01020631",1162,60,23,37,186,147,87,111,222,213,69,51,18,67
"2011","County Durham 014C","E01020637",1246,98,32,66,319,171,146,88,177,141,33,23,10,73
"2011","County Durham 014D","E01020644",1862,100,25,75,364,210,137,142,352,317,122,94,28,118
"2011","County Durham 014E","E01020645",1040,36,19,17,112,79,74,105,248,220,80,61,19,86
"2011","County Durham 020A","E01020633",1206,73,22,51,217,123,116,110,230,207,79,53,26,51
"2011","County Durham 020B","E01020664",1059,180,46,134,334,129,152,49,81,70,15,11,4,49
"2011","County Durham 020C","E01020665",989,92,24,68,258,131,70,68,152,117,48,37,11,53
"2011","County Durham 020D","E01020666",1085,145,33,112,340,159,89,62,121,96,20,14,6,53
"2011","County Durham 024A","E01020646",1174,104,29,75,204,138,159,62,202,190,57,40,17,58
"2011","County Durham 024B","E01020658",1255,58,14,44,197,157,87,105,268,260,70,42,28,53
"2011","County Durham 024C","E01020659",1198,122,42,80,301,159,86,106,165,131,39,22,17,89
"2011","County Durham 024D","E01020660",1201,106,23,83,272,147,120,81,178,153,43,31,12,101
"2011","County Durham 022A","E01020709",2168,175,54,121,352,240,175,150,262,477,226,203,23,111
"2011","County Durham 022B","E01020717",1246,175,39,136,390,241,62,73,140,64,32,16,16,69
"2011","County Durham 022C","E01020718",997,122,31,91,294,192,40,74,115,83,24,19,5,53
"2011","County Durham 022D","E01020719",983,131,41,90,343,193,44,51,93,47,19,7,12,62
"2011","County Durham 022E","E01020721",957,141,30,111,268,175,63,59,105,58,21,12,9,67
"2011","County Durham 023A","E01020708",847,143,29,114,267,135,44,38,64,53,21,12,9,82
"2011","County Durham 023B","E01020710",1224,162,28,134,311,182,64,80,151,130,45,33,12,99
"2011","County Durham 023C","E01020711",1210,89,18,71,230,157,71,86,214,196,72,50,22,95
"2011","County Durham 023D","E01020720",1007,88,22,66,224,189,50,83,171,122,23,13,10,57
"2011","County Durham 026A","E01020679",1186,62,18,44,184,117,91,112,191,241,119,88,31,69
"2011","County Durham 026B","E01020680",1259,156,37,119,376,160,110,90,123,124,48,37,11,72
"2011","County Durham 026C","E01020681",1116,62,15,47,195,159,62,94,223,197,54,37,17,70
"2011","County Durham 026D","E01020714",1267,160,33,127,333,180,113,85,166,135,36,24,12,59
"2011","County Durham 026E","E01020716",1218,41,5,36,134,112,68,105,267,268,131,84,47,92
"2011","County Durham 027A","E01020725",1126,143,31,112,305,164,107,79,138,109,24,15,9,57
"2011","County Durham 027B","E01020726",946,108,23,85,248,131,107,41,119,105,37,24,13,50
"2011","County Durham 027C","E01020727",804,45,15,30,115,79,58,71,160,172,69,44,25,35
"2011","County Durham 027D","E01020729",1580,119,34,85,315,170,118,138,281,283,77,46,31,79
"2011","County Durham 027E","E01020730",1203,62,12,50,197,138,77,108,250,279,40,27,13,52
"2011","County Durham 027F","E01020731",1120,121,22,99,310,174,64,72,158,126,38,17,21,57
"2011","County Durham 028A","E01020682",1425,183,50,133,446,246,96,78,195,87,24,16,8,70
"2011","County Durham 028B","E01020683",1216,175,46,129,386,206,70,71,134,72,33,20,13,69
"2011","County Durham 028C","E01020690",962,95,20,75,257,165,65,80,145,86,13,11,2,56
"2011","County Durham 028D","E01020691",978,55,14,41,186,147,61,90,196,145,29,14,15,69
"2011","County Durham 028E","E01020692",1121,171,41,130,312,195,62,72,122,94,27,15,12,66
"2011","County Durham 029A","E01020693",1063,105,8,97,180,105,61,68,198,161,43,27,16,142
"2011","County Durham 029B","E01020722",1559,104,13,91,179,132,60,101,255,262,93,67,26,373
"2011","County Durham 029C","E01020723",1425,165,14,151,218,97,55,62,136,135,69,49,20,488
"2011","County Durham 029D","E01020724",1168,53,7,46,97,71,47,67,262,272,145,108,37,154
"2011","County Durham 030A","E01020703",1890,141,15,126,112,41,47,25,46,31,26,18,8,1421
"2011","County Durham 030D","E01033164",2149,129,9,120,102,44,20,24,41,23,15,8,7,1751
"2011","County Durham 030E","E01033195",1242,154,22,132,155,36,33,17,41,11,9,5,4,786
"2011","County Durham 030F","E01033197",1848,66,11,55,94,42,67,63,74,176,199,179,20,1067
"2011","County Durham 030G","E01033221",4347,122,10,112,96,38,32,23,42,28,24,17,7,3942
"2011","County Durham 033A","E01020684",1779,209,33,176,405,233,148,137,212,201,58,42,16,176
"2011","County Durham 033B","E01020702",1752,464,52,412,426,130,90,33,46,41,51,39,12,471
"2011","County Durham 033C","E01020704",1597,231,22,209,234,51,55,15,27,24,22,16,6,938
"2011","County Durham 033D","E01020712",1255,272,33,239,352,112,72,35,63,51,21,14,7,277
"2011","County Durham 033E","E01020713",1501,420,80,340,410,142,86,41,62,40,26,20,6,274
"2011","County Durham 031A","E01020705",1075,59,15,44,136,126,65,102,217,240,84,49,35,46
"2011","County Durham 031B","E01020706",1420,119,29,90,293,184,137,116,248,218,48,34,14,57
"2011","County Durham 031C","E01020715",1830,132,31,101,321,243,134,164,313,305,118,65,53,100
"2011","County Durham 038A","E01020685",1231,144,31,113,294,191,110,92,160,153,37,17,20,50
"2011","County Durham 038B","E01020686",1173,39,11,28,122,122,81,113,246,295,94,65,29,61
"2011","County Durham 038C","E01020687",1114,92,27,65,237,185,65,107,180,148,32,17,15,68
"2011","County Durham 038D","E01020688",1153,81,19,62,189,158,63,107,229,197,68,50,18,61
"2011","County Durham 038E","E01020689",1042,37,8,29,147,82,71,106,205,245,82,51,31,67
"2011","County Durham 041A","E01020694",1087,72,20,52,158,113,52,105,190,259,66,43,23,72
"2011","County Durham 041B","E01020696",996,100,18,82,200,120,93,76,150,175,34,19,15,48
"2011","County Durham 041C","E01020697",1186,121,24,97,232,171,65,102,163,179,65,44,21,88
"2011","County Durham 041D","E01020732",1277,316,47,269,406,163,87,33,68,49,44,32,12,111
"2011","County Durham 044A","E01020695",1358,116,34,82,275,158,85,156,202,224,55,36,19,87
"2011","County Durham 044B","E01020698",1210,129,26,103,309,159,100,109,169,130,30,19,11,75
"2011","County Durham 044C","E01020699",850,20,6,14,102,86,46,110,173,200,52,29,23,61
"2011","County Durham 044D","E01020700",1160,39,10,29,163,106,81,114,191,318,78,57,21,70
"2011","County Durham 044E","E01020701",993,117,35,82,250,124,69,86,131,130,30,21,9,56
"2011","County Durham 016A","E01020750",974,63,15,48,228,178,60,96,150,103,16,9,7,80
"2011","County Durham 016B","E01020781",785,38,12,26,138,121,41,75,137,148,46,35,11,41
"2011","County Durham 016D","E01020786",1260,107,27,80,324,214,99,119,154,132,24,16,8,87
"2011","County Durham 016E","E01020787",1346,31,14,17,175,179,61,124,286,314,97,67,30,79
"2011","County Durham 016F","E01033163",1441,212,58,154,462,237,102,98,144,100,10,9,1,76
"2011","County Durham 016G","E01033202",840,39,13,26,134,122,48,77,171,159,40,24,16,50
"2011","County Durham 017A","E01020740",1092,61,17,44,187,148,83,119,181,184,59,46,13,70
"2011","County Durham 017B","E01020741",968,29,6,23,121,113,56,83,214,193,92,65,27,67
"2011","County Durham 017C","E01020742",1248,45,13,32,176,161,50,142,261,243,86,62,24,84
"2011","County Durham 017D","E01020782",896,66,22,44,168,135,61,89,141,124,52,35,17,60
"2011","County Durham 017E","E01020783",1001,41,15,26,149,153,44,78,219,196,55,32,23,66
"2011","County Durham 017F","E01020784",1054,48,14,34,153,103,59,97,219,207,112,80,32,56
"2011","County Durham 018A","E01020743",962,38,10,28,108,100,44,90,189,201,122,86,36,70
"2011","County Durham 018B","E01020747",877,14,8,6,61,53,31,81,187,213,161,116,45,76
"2011","County Durham 018C","E01020748",942,33,7,26,91,103,40,80,210,220,91,66,25,74
"2011","County Durham 018D","E01020749",993,28,8,20,97,95,54,114,212,288,74,54,20,31
"2011","County Durham 018E","E01020773",1088,41,13,28,168,126,44,118,202,249,78,66,12,62
"2011","County Durham 018F","E01020775",1217,28,11,17,126,131,29,114,268,297,139,104,35,85
"2011","County Durham 021C","E01020776",1395,69,18,51,231,195,85,173,276,207,80,59,21,79
"2011","County Durham 021D","E01033161",1120,76,23,53,220,163,83,109,171,173,54,34,20,71
"2011","County Durham 021E","E01033198",1196,43,8,35,143,132,37,107,200,178,80,53,27,276
"2011","County Durham 021F","E01033205",1138,67,26,41,165,190,76,130,167,208,70,48,22,65
"2011","County Durham 021G","E01033206",1108,62,18,44,146,156,75,104,195,243,67,44,23,60
"2011","County Durham 025A","E01020751",1402,41,16,25,169,162,84,147,272,321,113,76,37,93
"2011","County Durham 025B","E01020752",873,19,6,13,90,79,68,83,190,181,127,91,36,36
"2011","County Durham 025C","E01020754",966,83,24,59,200,124,103,87,107,165,51,38,13,46
"2011","County Durham 025D","E01020756",1046,102,38,64,284,146,104,85,131,124,18,11,7,52
"2011","County Durham 032A","E01020745",970,22,6,16,93,123,32,86,214,236,96,71,25,68
"2011","County Durham 032B","E01020753",1332,58,23,35,158,187,61,130,266,301,92,68,24,79
"2011","County Durham 032C","E01020757",816,16,7,9,97,99,28,73,176,160,124,96,28,43
"2011","County Durham 032D","E01020758",1019,17,3,14,99,92,47,77,244,243,116,84,32,84
"2011","County Durham 032E","E01020759",786,10,2,8,60,74,41,61,161,190,116,83,33,73
"2011","County Durham 032F","E01020765",1272,33,11,22,128,145,80,113,259,281,136,95,41,97
"2011","County Durham 034A","E01020760",1232,57,21,36,195,161,97,139,202,249,64,50,14,68
"2011","County Durham 034B","E01020761",951,30,10,20,105,105,56,85,193,241,76,60,16,60
"2011","County Durham 034C","E01020762",974,18,6,12,97,102,55,96,211,238,94,66,28,63
"2011","County Durham 034D","E01020763",1373,70,22,48,204,158,152,114,231,266,103,79,24,75
"2011","County Durham 036A","E01020764",1029,23,5,18,84,83,35,81,229,308,137,88,49,49
"2011","County Durham 036B","E01020766",1047,38,15,23,154,136,59,95,216,257,43,31,12,49
"2011","County Durham 036C","E01020767",1424,28,6,22,130,146,78,115,277,373,197,151,46,80
"2011","County Durham 036D","E01020768",1173,27,10,17,154,151,70,121,246,298,44,31,13,62
"2011","County Durham 035A","E01020733",929,34,12,22,113,121,46,96,207,167,77,56,21,68
"2011","County Durham 035B","E01020734",886,21,6,15,97,116,44,85,215,176,70,47,23,62
"2011","County Durham 035C","E01020735",1009,42,13,29,170,159,68,93,185,196,33,21,12,63
"2011","County Durham 035D","E01020770",912,45,17,28,125,140,48,83,183,167,56,36,20,65
"2011","County Durham 035E","E01020771",765,24,7,17,89,104,38,72,169,162,53,28,25,54
"2011","County Durham 035F","E01020780",833,41,10,31,103,121,45,79,153,174,61,45,16,56
"2011","County Durham 037A","E01020746",880,50,24,26,165,124,50,111,138,155,37,30,7,50
"2011","County Durham 037B","E01020769",916,58,19,39,170,119,55,80,176,142,45,28,17,71
"2011","County Durham 037C","E01020777",1087,43,13,30,140,141,38,104,209,242,88,60,28,82
"2011","County Durham 037D","E01020778",963,82,30,52,242,133,70,96,145,118,26,16,10,51
"2011","County Durham 037E","E01020779",1331,161,57,104,371,218,87,99,134,124,25,14,11,112
"2011","County Durham 039A","E01020736",903,28,14,14,121,97,66,88,164,215,72,55,17,52
"2011","County Durham 039B","E01020737",1023,51,19,32,145,140,67,116,182,218,42,27,15,62
"2011","County Durham 039C","E01020738",775,32,12,20,124,96,45,95,162,149,44,31,13,28
"2011","County Durham 039D","E01020739",951,22,5,17,103,114,46,102,205,236,84,54,30,39
"2011","County Durham 039E","E01020744",754,42,12,30,126,79,51,81,144,154,33,26,7,44
"2011","County Durham 040A","E01020788",1146,37,13,24,159,136,111,101,206,260,76,58,18,60
"2011","County Durham 040B","E01020789",1058,52,14,38,174,136,75,93,174,238,63,41,22,53
"2011","County Durham 040C","E01020790",956,21,9,12,97,103,72,79,185,241,97,71,26,61
"2011","County Durham 040D","E01020791",964,54,13,41,126,113,48,91,177,221,91,60,31,43
"2011","County Durham 040E","E01020792",1075,54,19,35,158,122,82,99,178,198,115,77,38,69
"2011","County Durham 043A","E01020772",1513,171,39,132,364,177,165,100,195,190,64,47,17,87
"2011","County Durham 043B","E01020793",1264,36,20,16,131,120,82,118,281,337,92,62,30,67
"2011","County Durham 043C","E01020794",1331,92,25,67,261,201,90,145,192,227,43,29,14,80
"2011","County Durham 043D","E01020795",1311,73,24,49,211,173,145,95,214,246,91,74,17,63
"2011","County Durham 047A","E01020817",1062,88,29,59,244,165,58,94,202,143,13,9,4,55
"2011","County Durham 047B","E01020818",1073,80,30,50,188,144,85,95,196,193,51,34,17,41
"2011","County Durham 047C","E01020819",752,19,6,13,72,57,32,66,198,198,63,42,21,47
"2011","County Durham 047D","E01020837",1357,96,29,67,316,235,89,128,209,194,34,11,23,56
"2011","County Durham 047E","E01020843",1223,122,39,83,312,154,122,84,160,174,26,19,7,69
"2011","County Durham 048A","E01020809",1069,24,6,18,124,101,63,91,250,275,78,55,23,63
"2011","County Durham 048B","E01020810",997,66,27,39,221,138,68,80,159,139,51,26,25,75
"2011","County Durham 048C","E01020811",923,36,11,25,152,118,53,82,186,178,61,50,11,57
"2011","County Durham 048D","E01020812",1140,57,17,40,214,141,95,98,217,205,45,33,12,68
"2011","County Durham 048E","E01020827",1368,63,21,42,234,153,113,127,234,258,99,78,21,87
"2011","County Durham 049A","E01020806",1039,40,17,23,156,110,63,84,237,230,64,46,18,55
"2011","County Durham 049B","E01020807",1019,19,3,16,114,83,47,102,216,243,136,78,58,59
"2011","County Durham 049C","E01020820",1041,46,12,34,114,108,56,91,239,245,84,60,24,58
"2011","County Durham 049D","E01020842",1491,44,14,30,155,159,79,143,347,345,129,90,39,90
"2011","County Durham 050A","E01020797",1875,84,21,63,258,206,140,170,360,438,136,100,36,83
"2011","County Durham 050B","E01020798",1048,28,6,22,136,131,45,96,250,248,63,51,12,51
"2011","County Durham 050C","E01020799",1112,44,17,27,149,125,55,121,255,235,61,37,24,67
"2011","County Durham 050D","E01020808",1061,60,18,42,171,128,78,108,193,205,56,43,13,62
"2011","County Durham 052A","E01020821",1392,131,42,89,306,162,138,102,233,183,57,33,24,80
"2011","County Durham 052B","E01020822",1432,129,37,92,344,201,134,119,222,164,42,30,12,77
"2011","County Durham 052C","E01020823",1257,44,12,32,129,117,79,104,294,304,104,57,47,82
"2011","County Durham 052D","E01020835",1245,63,17,46,194,126,70,135,283,244,57,45,12,73
"2011","County Durham 052E","E01020836",1431,72,20,52,267,161,93,133,273,267,100,73,27,65
"2011","County Durham 053B","E01020803",1512,79,32,47,244,204,111,157,288,245,77,46,31,107
"2011","County Durham 053D","E01020805",1382,38,17,21,160,131,82,117,326,342,120,83,37,66
"2011","County Durham 053E","E01033203",2121,103,33,70,306,235,173,218,436,432,128,81,47,90
"2011","County Durham 054A","E01020796",980,115,32,83,286,121,85,82,105,100,28,17,11,58
"2011","County Durham 054B","E01020828",1233,179,59,120,373,143,181,71,129,69,24,13,11,64
"2011","County Durham 054C","E01020829",1786,326,75,251,560,255,148,104,153,111,36,22,14,93
"2011","County Durham 054D","E01020830",1105,121,33,88,277,156,97,74,135,144,29,24,5,72
"2011","County Durham 059A","E01020801",1157,46,8,38,177,135,74,136,259,210,67,47,20,53
"2011","County Durham 059B","E01020802",1463,73,27,46,222,153,106,133,284,300,133,101,32,59
"2011","County Durham 059C","E01020838",1305,46,22,24,182,139,107,122,280,277,87,51,36,65
"2011","County Durham 059D","E01020839",1194,33,13,20,139,108,66,108,304,274,101,76,25,61
"2011","County Durham 059E","E01020840",1142,38,17,21,131,101,80,116,235,265,115,75,40,61
"2011","County Durham 059F","E01020841",1257,24,14,10,98,82,66,103,314,331,152,85,67,87
"2011","County Durham 060A","E01020813",977,115,40,75,224,169,67,89,150,94,14,9,5,55
"2011","County Durham 060B","E01020814",1102,82,29,53,263,160,60,112,175,151,38,29,9,61
"2011","County Durham 060C","E01020815",945,99,42,57,223,137,67,69,139,106,36,27,9,69
"2011","County Durham 060D","E01020848",828,63,17,46,189,130,47,69,144,108,30,17,13,48
"2011","County Durham 060E","E01020850",1468,235,73,162,397,231,96,93,154,111,49,32,17,102
"2011","County Durham 060F","E01020851",1096,118,52,66,318,169,79,95,141,105,26,20,6,45
"2011","County Durham 061A","E01020816",1005,27,10,17,114,80,51,97,244,216,100,75,25,76
"2011","County Durham 061B","E01020844",1080,28,7,21,99,108,46,113,276,239,101,69,32,70
"2011","County Durham 061C","E01020847",1081,32,13,19,121,97,36,104,279,218,101,73,28,93
"2011","County Durham 061D","E01020849",920,18,5,13,112,84,44,100,218,188,91,71,20,65
"2011","County Durham 062A","E01020825",1151,45,7,38,159,126,66,125,291,218,46,30,16,75
"2011","County Durham 062B","E01020831",983,37,10,27,145,127,58,91,241,185,52,31,21,47
"2011","County Durham 062C","E01020833",894,38,14,24,159,129,55,89,182,141,44,35,9,57
"2011","County Durham 062D","E01020834",909,40,11,29,123,122,51,91,212,174,48,26,22,48
"2011","County Durham 063A","E01020824",1092,42,17,25,170,118,57,140,247,222,51,36,15,45
"2011","County Durham 063B","E01020826",1112,94,32,62,215,134,89,97,180,168,58,31,27,77
"2011","County Durham 063C","E01020832",1009,59,17,42,168,129,75,105,213,180,33,19,14,47
"2011","County Durham 063D","E01020845",996,31,12,19,129,101,35,109,247,218,67,42,25,59
"2011","County Durham 063E","E01020846",956,87,22,65,201,123,75,77,145,126,60,41,19,62
"2011","County Durham 064A","E01020856",1152,69,15,54,164,97,133,112,225,219,71,49,22,62
"2011","County Durham 064B","E01020858",788,53,18,35,159,100,80,79,109,127,41,25,16,40
"2011","County Durham 064C","E01020859",922,63,19,44,201,119,135,79,121,110,31,17,14,63
"2011","County Durham 064D","E01020860",777,21,8,13,87,68,71,92,155,185,62,42,20,36
"2011","County Durham 064E","E01020861",894,55,16,39,117,91,115,83,190,173,37,29,8,33
"2011","County Durham 064F","E01020862",1778,229,57,172,455,211,269,111,206,160,47,24,23,90
"2011","County Durham 064G","E01020864",1574,176,61,115,335,180,289,128,191,189,36,26,10,50
"2011","County Durham 064H","E01020867",1598,136,43,93,359,161,244,123,232,186,61,43,18,96
"2011","County Durham 065A","E01020857",1081,139,46,93,260,110,224,77,109,89,15,9,6,58
"2011","County Durham 065B","E01020863",1104,141,36,105,282,127,248,66,101,69,22,18,4,48
"2011","County Durham 065C","E01020865",995,114,24,90,194,112,219,85,116,96,13,10,3,46
"2011","County Durham 065D","E01020866",789,63,22,41,141,76,166,64,130,97,19,16,3,33
"2011","County Durham 066A","E01020852",1184,82,23,59,223,119,101,120,182,176,64,50,14,117
"2011","County Durham 066B","E01020853",1055,78,23,55,217,118,82,124,162,148,53,43,10,73
"2011","County Durham 066C","E01020854",2095,188,62,126,381,214,207,159,280,263,300,284,16,103
"2011","County Durham 066D","E01020855",859,90,29,61,216,94,84,94,124,76,21,12,9,60
"2011","County Durham 042A","E01020889",1138,119,36,83,223,122,200,112,169,113,42,27,15,38
"2011","County Durham 042B","E01020890",1308,101,20,81,261,145,162,108,227,178,65,42,23,61
"2011","County Durham 042C","E01020891",1275,130,32,98,262,105,218,107,172,155,61,35,26,65
"2011","County Durham 042D","E01020905",1114,115,29,86,241,162,113,87,143,160,34,22,12,59
"2011","County Durham 042E","E01020906",1247,187,46,141,315,136,180,85,133,111,36,22,14,64
"2011","County Durham 045A","E01020876",1278,74,22,52,206,174,98,122,265,215,68,44,24,56
"2011","County Durham 045B","E01020878",1231,46,19,27,157,127,92,89,260,251,136,83,53,73
"2011","County Durham 045C","E01020887",1420,95,20,75,268,188,150,102,251,207,96,65,31,63
"2011","County Durham 045D","E01020892",805,35,8,27,103,66,89,64,182,149,55,38,17,62
"2011","County Durham 045E","E01020894",863,41,8,33,134,81,81,55,173,169,84,52,32,45
"2011","County Durham 045F","E01020898",1056,24,6,18,93,72,82,70,260,260,137,87,50,58
"2011","County Durham 046A","E01020877",1206,71,22,49,183,159,110,107,228,227,74,47,27,47
"2011","County Durham 046B","E01020879",1612,115,35,80,372,265,132,143,275,180,46,31,15,84
"2011","County Durham 046C","E01020893",1270,65,23,42,238,140,103,123,243,217,71,45,26,70
"2011","County Durham 046D","E01020899",999,48,17,31,150,147,105,97,169,185,58,30,28,40
"2011","County Durham 046E","E01020903",878,75,23,52,196,112,90,64,144,108,41,29,12,48
"2011","County Durham 046F","E01020904",1310,100,33,67,285,180,125,103,226,172,52,26,26,67
"2011","County Durham 051A","E01020873",1054,21,4,17,93,65,70,69,273,278,131,92,39,54
"2011","County Durham 051B","E01020875",1014,55,11,44,187,104,111,81,180,180,40,24,16,76
"2011","County Durham 051C","E01020900",1046,64,20,44,216,134,85,80,187,126,77,54,23,77
"2011","County Durham 051D","E01020901",982,21,10,11,117,82,55,101,185,214,151,112,39,56
"2011","County Durham 051E","E01020902",1053,20,9,11,90,78,66,95,294,232,113,85,28,65
"2011","County Durham 055A","E01020868",1358,129,32,97,284,189,120,98,220,163,91,67,24,64
"2011","County Durham 055B","E01020869",1052,56,18,38,169,113,84,97,211,174,76,60,16,72
"2011","County Durham 055C","E01020874",1097,40,15,25,122,93,88,97,242,250,100,72,28,65
"2011","County Durham 055D","E01020880",1194,48,19,29,126,91,84,85,219,215,129,90,39,197
"2011","County Durham 055E","E01020881",980,76,37,39,190,129,87,80,180,145,47,26,21,46
"2011","County Durham 056A","E01020870",988,104,33,71,281,153,94,79,120,83,21,10,11,53
"2011","County Durham 056B","E01020871",1020,73,25,48,209,150,67,83,199,139,45,31,14,55
"2011","County Durham 056C","E01020872",1251,96,23,73,259,185,103,91,210,179,77,57,20,51
"2011","County Durham 056D","E01020883",1318,133,42,91,299,223,105,103,204,145,19,9,10,87
"2011","County Durham 056E","E01020886",917,54,14,40,162,95,58,95,193,159,51,32,19,50
"2011","County Durham 057A","E01020882",1128,72,27,45,244,116,121,95,202,162,54,34,20,62
"2011","County Durham 057B","E01020888",1486,142,41,101,329,195,181,107,230,179,57,25,32,66
"2011","County Durham 057C","E01020895",1104,37,9,28,162,79,71,97,233,274,109,76,33,42
"2011","County Durham 057D","E01020896",1012,61,24,37,159,116,85,113,210,193,36,23,13,39
"2011","County Durham 057E","E01020897",1800,88,30,58,305,189,136,163,371,345,115,85,30,88
"2011","County Durham 058A","E01020884",1026,53,19,34,161,133,80,81,222,186,63,38,25,47
"2011","County Durham 058B","E01020885",836,38,13,25,125,78,58,67,182,180,63,47,16,45
"2011","County Durham 058C","E01020907",1168,29,10,19,117,91,83,114,271,292,104,72,32,67
"2011","County Durham 058D","E01020908",1057,39,14,25,143,106,76,84,234,200,104,74,30,71
"2011","County Durham 058E","E01020909",1129,15,5,10,51,59,42,87,262,297,229,180,49,87
"2011","Hartlepool 001A","E01011954",1545,49,15,34,212,184,67,143,317,339,127,75,52,107
"2011","Hartlepool 001B","E01011969",1028,58,18,40,210,158,52,111,200,155,33,19,14,51
"2011","Hartlepool 001C","E01011970",917,65,24,41,218,148,57,93,129,125,21,13,8,61
"2011","Hartlepool 001D","E01011971",1024,102,29,73,253,158,76,93,134,130,17,8,9,61
"2011","Hartlepool 001F","E01033465",1352,174,53,121,397,189,91,108,134,135,32,19,13,92
"2011","Hartlepool 001G","E01033467",755,54,14,40,155,81,46,56,144,126,50,37,13,43
"2011","Hartlepool 002A","E01011952",1106,23,4,19,98,115,53,89,250,267,134,85,49,77
"2011","Hartlepool 002B","E01011953",1321,20,6,14,111,124,34,107,293,304,222,131,91,106
"2011","Hartlepool 002C","E01011991",1387,70,19,51,219,153,128,129,231,247,120,81,39,90
"2011","Hartlepool 002D","E01011992",1171,33,8,25,140,118,68,104,220,251,155,109,46,82
"2011","Hartlepool 002E","E01011993",1274,25,6,19,153,130,98,110,251,267,147,86,61,93
"2011","Hartlepool 002F","E01011994",1079,17,6,11,108,93,53,91,253,225,175,130,45,64
"2011","Hartlepool 003A","E01011955",1001,29,6,23,90,110,53,96,195,225,128,90,38,75
"2011","Hartlepool 003C","E01011957",984,23,7,16,120,107,72,87,206,190,112,75,37,67
"2011","Hartlepool 003G","E01032540",752,39,12,27,149,82,51,68,121,135,54,39,15,53
"2011","Hartlepool 003H","E01032541",1525,43,11,32,203,190,99,137,300,327,126,83,43,100
"2011","Hartlepool 003I","E01033466",1412,15,0,15,115,123,51,120,315,308,255,180,75,110
"2011","Hartlepool 005A","E01011973",977,18,3,15,72,69,45,78,195,192,244,171,73,64
"2011","Hartlepool 005B","E01011974",1384,96,19,77,228,207,77,125,198,206,155,106,49,92
"2011","Hartlepool 005C","E01011975",1016,30,11,19,168,129,55,98,214,182,94,51,43,46
"2011","Hartlepool 005D","E01011976",754,17,7,10,79,78,41,66,157,137,113,78,35,66
"2011","Hartlepool 006A","E01011965",1175,150,37,113,347,166,117,85,106,62,41,30,11,101
"2011","Hartlepool 006B","E01011966",1068,93,25,68,265,136,69,92,155,133,54,28,26,71
"2011","Hartlepool 006C","E01011983",1247,173,59,114,358,168,128,81,123,70,46,33,13,100
"2011","Hartlepool 006D","E01012002",1010,57,22,35,225,127,73,106,144,148,59,39,20,71
"2011","Hartlepool 007A","E01011951",1021,41,7,34,125,141,57,86,220,148,136,80,56,67
"2011","Hartlepool 007B","E01011964",1035,74,21,53,202,100,88,81,124,121,140,104,36,105
"2011","Hartlepool 007C","E01011967",1076,50,10,40,245,152,63,92,184,126,56,34,22,108
"2011","Hartlepool 007D","E01011999",1480,57,7,50,166,133,83,113,291,251,252,161,91,134
"2011","Hartlepool 007E","E01012000",1027,23,3,20,100,76,50,69,193,246,204,139,65,66
"2011","Hartlepool 008A","E01011950",1159,27,7,20,129,124,50,86,242,228,198,120,78,75
"2011","Hartlepool 008B","E01011986",948,50,14,36,137,133,60,90,189,149,66,38,28,74
"2011","Hartlepool 008C","E01011987",1062,47,16,31,165,119,64,90,220,221,78,42,36,58
"2011","Hartlepool 008D","E01012001",1441,58,16,42,164,131,69,114,280,324,203,149,54,98
"2011","Hartlepool 009A","E01011949",1383,26,6,20,159,138,72,147,299,279,145,80,65,118
"2011","Hartlepool 009B","E01011980",1168,19,5,14,125,130,56,105,289,252,124,67,57,68
"2011","Hartlepool 009C","E01011981",1102,24,7,17,89,100,59,112,267,228,124,81,43,99
"2011","Hartlepool 009D","E01011984",861,51,17,34,183,143,53,84,158,122,21,16,5,46
"2011","Hartlepool 010A","E01011985",876,59,24,35,159,106,59,95,172,133,49,31,18,44
"2011","Hartlepool 010B","E01011988",1358,48,15,33,231,181,88,130,294,236,75,47,28,75
"2011","Hartlepool 010C","E01011989",1309,22,4,18,146,123,86,116,252,283,189,136,53,92
"2011","Hartlepool 010D","E01011990",1269,55,18,37,196,164,85,130,242,230,89,52,37,78
"2011","Hartlepool 011A","E01011995",1047,73,25,48,237,146,76,104,178,133,27,14,13,73
"2011","Hartlepool 011B","E01011996",1113,98,30,68,212,153,93,124,194,125,46,24,22,68
"2011","Hartlepool 011C","E01011997",1531,109,41,68,391,247,113,156,223,154,47,28,19,91
"2011","Hartlepool 011D","E01011998",1072,94,27,67,225,148,69,113,179,140,29,16,13,75
"2011","Hartlepool 012A","E01011961",1034,29,10,19,140,109,62,115,206,209,97,52,45,67
"2011","Hartlepool 012B","E01011962",1004,30,8,22,128,112,43,99,233,171,106,65,41,82
"2011","Hartlepool 012C","E01011977",1266,21,8,13,107,96,62,99,300,300,171,110,61,110
"2011","Hartlepool 012D","E01011978",1041,15,6,9,100,70,57,80,225,259,161,102,59,74
"2011","Hartlepool 012E","E01011979",1080,28,14,14,104,89,39,92,223,256,157,106,51,92
"2011","Hartlepool 014A","E01011959",1528,205,51,154,433,209,221,94,124,107,33,19,14,102
"2011","Hartlepool 014B","E01011960",1052,67,23,44,244,155,74,126,163,125,28,22,6,70
"2011","Hartlepool 014C","E01011963",1056,72,20,52,210,157,72,119,198,138,26,11,15,64
"2011","Hartlepool 014D","E01011968",1557,107,41,66,310,232,140,149,231,230,47,34,13,111
"2011","Hartlepool 014E","E01011982",939,164,49,115,317,125,84,55,63,45,23,18,5,63
"2011","Hartlepool 014F","E01012003",1161,130,29,101,303,170,91,98,156,82,37,22,15,94
"2011","Hartlepool 014G","E01012005",1484,186,54,132,398,234,126,120,184,95,21,14,7,120
"2011","Middlesbrough 001A","E01012068",2017,26,4,22,89,69,77,54,156,177,276,202,74,1093
"2011","Middlesbrough 001D","E01012092",1766,22,4,18,82,46,70,47,139,140,290,231,59,930
"2011","Middlesbrough 001E","E01012093",1410,33,5,28,72,78,115,62,167,151,313,251,62,419
"2011","Middlesbrough 001F","E01012094",1925,74,9,65,164,154,130,110,275,241,345,281,64,432
"2011","Middlesbrough 001G","E01033468",1956,45,4,41,125,82,141,115,296,332,453,338,115,367
"2011","Middlesbrough 002A","E01012058",1244,16,5,11,109,101,46,99,254,266,263,175,88,90
"2011","Middlesbrough 002B","E01012059",1088,27,6,21,105,81,46,82,233,237,185,139,46,92
"2011","Middlesbrough 002C","E01012060",1138,18,5,13,89,87,35,88,257,306,201,150,51,57
"2011","Middlesbrough 002D","E01012061",980,19,8,11,76,62,36,85,239,248,146,107,39,69
"2011","Middlesbrough 003A","E01012036",1195,31,7,24,71,58,86,66,165,154,187,134,53,377
"2011","Middlesbrough 003B","E01012037",1147,20,4,16,93,77,36,68,229,196,237,181,56,191
"2011","Middlesbrough 003C","E01012038",1125,24,3,21,123,114,56,80,187,201,154,108,46,186
"2011","Middlesbrough 003D","E01012039",1268,25,5,20,77,69,50,64,154,132,198,151,47,499
"2011","Middlesbrough 003E","E01012040",1102,24,3,21,84,74,48,54,174,169,206,149,57,269
"2011","Middlesbrough 003F","E01012041",805,12,0,12,73,67,36,46,133,203,172,124,48,63
"2011","Middlesbrough 004A","E01012074",1036,30,4,26,105,97,50,102,243,219,118,86,32,72
"2011","Middlesbrough 004B","E01012075",1025,17,6,11,84,70,26,77,260,241,164,115,49,86
"2011","Middlesbrough 004C","E01012076",983,10,5,5,56,64,29,75,221,272,173,114,59,83
"2011","Middlesbrough 004D","E01012077",974,17,3,14,85,78,42,91,247,243,110,75,35,61
"2011","Middlesbrough 004E","E01012088",895,14,4,10,49,55,40,69,201,217,161,119,42,89
"2011","Middlesbrough 005A","E01012078",1122,44,10,34,167,118,64,71,164,132,178,113,65,184
"2011","Middlesbrough 005B","E01012079",1004,62,14,48,183,111,82,93,155,137,102,70,32,79
"2011","Middlesbrough 005C","E01012080",938,42,9,33,145,101,58,86,183,181,67,50,17,75
"2011","Middlesbrough 005D","E01012081",1261,85,11,74,247,129,102,94,187,145,145,97,48,127
"2011","Middlesbrough 006A","E01012026",1173,25,8,17,180,147,72,125,228,200,111,83,28,85
"2011","Middlesbrough 006B","E01012027",1284,25,8,17,148,155,57,91,260,259,205,142,63,84
"2011","Middlesbrough 006E","E01033469",1421,74,15,59,193,129,59,91,283,267,205,145,60,120
"2011","Middlesbrough 007A","E01012015",1107,15,6,9,94,113,30,99,240,296,140,101,39,80
"2011","Middlesbrough 007B","E01012016",1208,24,12,12,114,102,55,104,256,285,179,107,72,89
"2011","Middlesbrough 007C","E01012017",1146,33,12,21,156,122,70,124,252,247,76,52,24,66
"2011","Middlesbrough 007D","E01012089",1060,17,9,8,67,69,32,70,250,263,201,137,64,91
"2011","Middlesbrough 007E","E01012090",1151,9,4,5,71,65,41,71,268,314,237,160,77,75
"2011","Middlesbrough 007F","E01012091",1119,17,6,11,71,79,34,87,263,266,213,153,60,89
"2011","Middlesbrough 008A","E01012011",1341,23,7,16,109,119,49,89,358,297,178,141,37,119
"2011","Middlesbrough 008B","E01012012",1281,55,12,43,229,157,99,110,235,179,93,69,24,124
"2011","Middlesbrough 008C","E01012013",956,29,6,23,97,99,54,78,219,214,95,58,37,71
"2011","Middlesbrough 008D","E01012014",1099,27,4,23,122,131,57,89,258,200,126,91,35,89
"2011","Middlesbrough 009A","E01012053",1214,122,26,96,287,167,118,90,140,91,74,59,15,125
"2011","Middlesbrough 009B","E01012054",1241,86,15,71,273,178,105,84,154,108,115,91,24,138
"2011","Middlesbrough 009C","E01012055",1423,154,30,124,341,183,113,101,164,117,125,105,20,125
"2011","Middlesbrough 009D","E01012056",1721,80,13,67,370,262,92,105,251,206,111,81,30,244
"2011","Middlesbrough 009E","E01012057",1423,109,15,94,292,181,97,106,215,155,112,93,19,156
"2011","Middlesbrough 010A","E01012082",1095,19,4,15,97,93,50,94,276,234,141,91,50,91
"2011","Middlesbrough 010B","E01012083",1043,13,3,10,98,109,43,87,240,227,150,103,47,76
"2011","Middlesbrough 010C","E01012084",1116,8,0,8,69,89,33,83,300,262,173,112,61,99
"2011","Middlesbrough 010D","E01012085",1018,20,6,14,72,74,34,82,245,282,144,110,34,65
"2011","Middlesbrough 011A","E01012018",1279,131,7,124,150,134,51,75,215,184,218,190,28,121
"2011","Middlesbrough 011B","E01012019",861,18,8,10,60,59,30,50,188,200,176,128,48,80
"2011","Middlesbrough 011C","E01012020",1066,27,8,19,152,93,51,77,222,203,149,103,46,92
"2011","Middlesbrough 011D","E01012021",925,11,1,10,81,81,26,72,209,201,151,99,52,93
"2011","Middlesbrough 012A","E01012007",1064,77,9,68,228,177,56,99,193,126,48,33,15,60
"2011","Middlesbrough 012B","E01012008",1035,97,23,74,233,161,92,79,134,87,41,28,13,111
"2011","Middlesbrough 012C","E01012009",1292,108,26,82,326,202,83,102,194,128,50,36,14,99
"2011","Middlesbrough 012D","E01012010",1003,87,22,65,263,144,86,89,119,77,34,27,7,104
"2011","Middlesbrough 013A","E01012046",1251,103,29,74,305,201,94,108,168,135,60,47,13,77
"2011","Middlesbrough 013B","E01012047",1108,87,24,63,238,178,98,93,162,103,53,44,9,96
"2011","Middlesbrough 013C","E01012048",1265,83,25,58,271,230,83,116,201,139,43,29,14,99
"2011","Middlesbrough 014A","E01012049",1076,65,18,47,239,160,80,108,181,139,42,25,17,62
"2011","Middlesbrough 014B","E01012050",983,23,4,19,129,88,43,82,208,222,118,89,29,70
"2011","Middlesbrough 014C","E01012051",919,26,11,15,120,86,49,66,197,187,109,70,39,79
"2011","Middlesbrough 014D","E01012052",998,74,21,53,185,165,64,89,170,115,61,43,18,75
"2011","Middlesbrough 015A","E01012022",1204,69,20,49,229,195,81,111,227,169,35,18,17,88
"2011","Middlesbrough 015B","E01012023",972,83,23,60,225,177,61,95,137,108,31,28,3,55
"2011","Middlesbrough 015C","E01012024",1155,59,17,42,241,217,58,109,215,146,49,33,16,61
"2011","Middlesbrough 015D","E01012025",999,66,18,48,179,152,70,114,193,126,30,22,8,69
"2011","Middlesbrough 017A","E01012065",1177,177,58,119,338,190,91,81,133,87,22,17,5,58
"2011","Middlesbrough 017B","E01012066",1508,217,56,161,457,243,92,100,147,93,32,26,6,127
"2011","Middlesbrough 017C","E01012067",1132,121,29,92,290,189,97,96,126,109,41,27,14,63
"2011","Middlesbrough 018A","E01012042",1106,42,15,27,178,131,65,97,237,186,100,59,41,70
"2011","Middlesbrough 018B","E01012043",1104,45,8,37,186,150,60,128,235,168,53,38,15,79
"2011","Middlesbrough 018C","E01012044",1073,29,10,19,124,100,43,86,244,214,144,89,55,89
"2011","Middlesbrough 018D","E01012045",1005,20,7,13,81,75,60,86,242,212,157,97,60,72
"2011","Middlesbrough 018G","E01032552",1198,68,18,50,203,168,57,111,212,196,90,51,39,93
"2011","Middlesbrough 018H","E01032553",932,111,26,85,229,131,92,64,103,92,78,58,20,32
"2011","Middlesbrough 019A","E01012030",1112,95,26,69,259,180,67,106,154,127,35,21,14,89
"2011","Middlesbrough 019B","E01012031",1196,62,12,50,210,155,55,122,238,188,86,53,33,80
"2011","Middlesbrough 019C","E01012032",1315,135,37,98,373,224,76,131,156,79,37,23,14,104
"2011","Middlesbrough 019D","E01012033",961,45,9,36,122,133,44,76,184,166,132,103,29,59
"2011","Middlesbrough 019E","E01012034",1144,73,26,47,258,170,70,87,182,124,56,35,21,124
"2011","Middlesbrough 019F","E01012035",968,41,7,34,150,149,48,90,196,155,72,44,28,67
"2011","Middlesbrough 020A","E01012062",1104,98,25,73,261,189,83,101,158,115,21,12,9,78
"2011","Middlesbrough 020B","E01012063",1016,105,23,82,262,190,52,97,145,90,15,12,3,60
"2011","Middlesbrough 020C","E01012064",1375,180,49,131,345,191,106,136,159,122,48,33,15,88
"2011","Middlesbrough 020D","E01012071",1119,205,55,150,314,205,69,80,87,47,26,16,10,86
"2011","Middlesbrough 020E","E01012073",1076,136,21,115,297,205,69,79,115,77,37,26,11,61
"2011","Middlesbrough 020F","E01032593",1431,220,50,170,424,188,141,87,112,73,45,27,18,141
"2011","Northumberland 004A","E01027356",1288,185,42,143,327,155,211,90,140,84,31,15,16,65
"2011","Northumberland 004B","E01027357",930,123,36,87,273,147,104,58,86,64,25,17,8,50
"2011","Northumberland 004C","E01027366",1152,123,43,80,282,140,185,94,146,96,29,17,12,57
"2011","Northumberland 004D","E01027367",1424,230,126,104,429,222,128,87,147,82,36,16,20,63
"2011","Northumberland 005A","E01027358",1503,78,18,60,274,181,161,160,280,238,66,44,22,65
"2011","Northumberland 005B","E01027359",1597,65,23,42,217,155,126,164,352,298,112,74,38,108
"2011","Northumberland 005D","E01033715",770,66,11,55,170,82,77,67,137,111,25,9,16,35
"2011","Northumberland 005E","E01033717",1046,138,37,101,286,122,99,61,152,98,25,12,13,65
"2011","Northumberland 006A","E01027361",1609,82,21,61,262,195,190,136,319,258,85,57,28,82
"2011","Northumberland 006B","E01027362",916,69,24,45,170,105,73,96,170,144,53,36,17,36
"2011","Northumberland 006C","E01027363",797,21,8,13,91,59,60,80,199,170,78,48,30,39
"2011","Northumberland 006D","E01027364",1562,107,33,74,359,244,137,132,235,209,52,30,22,87
"2011","Northumberland 006E","E01027370",1432,208,52,156,421,187,209,74,133,97,24,13,11,79
"2011","Northumberland 006F","E01027371",1318,130,47,83,246,153,157,102,252,167,43,28,15,68
"2011","Northumberland 006G","E01027372",1618,239,73,166,453,211,248,97,149,104,47,29,18,70
"2011","Northumberland 007A","E01027365",1627,247,65,182,430,149,315,92,175,104,28,17,11,87
"2011","Northumberland 007B","E01027368",1303,157,41,116,273,149,238,89,185,107,40,20,20,65
"2011","Northumberland 007C","E01027369",1090,149,33,116,317,112,169,71,133,80,20,11,9,39
"2011","Northumberland 007D","E01027373",1537,189,39,150,348,154,320,97,212,110,42,31,11,65
"2011","Northumberland 001A","E01027376",1226,41,13,28,163,110,75,124,372,246,47,22,25,48
"2011","Northumberland 001B","E01027377",1259,100,19,81,269,112,181,107,249,154,41,21,20,46
"2011","Northumberland 001C","E01027385",897,21,5,16,78,45,49,84,306,209,50,36,14,55
"2011","Northumberland 001D","E01027387",1299,55,7,48,230,145,127,121,329,195,47,25,22,50
"2011","Northumberland 001E","E01027388",1048,46,19,27,122,103,77,103,275,209,47,19,28,66
"2011","Northumberland 001F","E01027389",1195,47,12,35,187,112,122,132,266,214,57,39,18,58
"2011","Northumberland 002A","E01027378",721,84,23,61,190,87,109,54,93,53,15,4,11,36
"2011","Northumberland 002B","E01027379",1017,73,17,56,237,146,103,86,171,123,21,12,9,57
"2011","Northumberland 002C","E01027380",1084,85,24,61,203,103,231,83,188,114,30,17,13,47
"2011","Northumberland 002D","E01027382",1266,134,35,99,283,121,230,114,185,113,34,22,12,52
"2011","Northumberland 002E","E01027386",997,47,20,27,181,96,107,99,212,174,34,21,13,47
"2011","Northumberland 003A","E01027374",1538,122,40,82,313,143,274,149,228,208,46,28,18,55
"2011","Northumberland 003B","E01027375",1380,119,28,91,325,115,273,112,221,133,26,19,7,56
"2011","Northumberland 003C","E01027381",1414,96,23,73,302,148,287,104,238,152,41,23,18,46
"2011","Northumberland 003D","E01027383",982,58,22,36,182,76,190,101,172,156,24,19,5,23
"2011","Northumberland 003E","E01027384",1097,103,25,78,229,107,236,79,175,99,26,12,14,43
"2011","Northumberland 003F","E01027390",1421,83,19,64,286,142,216,119,262,207,54,33,21,52
"2011","Northumberland 022A","E01027392",1182,23,5,18,104,97,74,101,281,283,146,107,39,73
"2011","Northumberland 022B","E01027393",1027,19,3,16,105,89,67,85,230,247,123,85,38,62
"2011","Northumberland 022C","E01027416",1084,14,4,10,112,105,47,90,217,244,195,126,69,60
"2011","Northumberland 022D","E01027424",1437,31,13,18,138,147,79,123,284,364,164,107,57,107
"2011","Northumberland 023A","E01027414",1136,67,14,53,213,161,113,91,177,156,94,66,28,64
"2011","Northumberland 023B","E01027415",1192,40,14,26,136,128,74,95,260,260,139,94,45,60
"2011","Northumberland 023C","E01027431",1314,48,12,36,212,207,85,119,236,237,119,78,41,51
"2011","Northumberland 023D","E01027441",1480,113,31,82,310,255,95,136,247,183,63,36,27,78
"2011","Northumberland 023E","E01027442",1191,69,21,48,250,200,97,95,180,174,69,45,24,57
"2011","Northumberland 024A","E01027391",1035,41,16,25,149,142,55,105,213,208,52,28,24,70
"2011","Northumberland 024B","E01027422",1319,33,14,19,156,166,65,115,312,319,101,70,31,52
"2011","Northumberland 024C","E01027423",1103,14,6,8,136,123,52,118,281,260,63,40,23,56
"2011","Northumberland 024D","E01027429",1283,42,8,34,156,184,69,119,260,267,124,84,40,62
"2011","Northumberland 024E","E01027430",1167,47,16,31,159,155,59,92,247,228,91,53,38,89
"2011","Northumberland 025A","E01027425",1757,138,44,94,389,295,129,165,299,159,65,42,23,118
"2011","Northumberland 025B","E01027426",1023,25,11,14,104,96,55,89,194,229,135,84,51,96
"2011","Northumberland 025C","E01027427",1198,42,12,30,184,158,77,105,210,259,107,58,49,56
"2011","Northumberland 025D","E01027428",1224,74,24,50,251,229,84,135,213,151,24,13,11,63
"2011","Northumberland 026A","E01027437",1408,115,34,81,342,289,80,136,209,136,27,18,9,74
"2011","Northumberland 026B","E01027438",1151,79,19,60,243,231,67,110,206,119,21,13,8,75
"2011","Northumberland 026C","E01027439",1497,192,57,135,426,299,102,117,168,89,18,9,9,86
"2011","Northumberland 026D","E01027440",1111,123,37,86,258,218,76,93,170,99,21,15,6,53
"2011","Northumberland 027A","E01027400",964,147,30,117,294,204,49,63,83,41,6,4,2,77
"2011","Northumberland 027B","E01027401",1108,182,49,133,347,210,69,72,107,41,9,2,7,71
"2011","Northumberland 027C","E01027402",1037,152,44,108,300,192,45,71,115,47,17,5,12,98
"2011","Northumberland 027D","E01027403",932,123,34,89,265,189,58,70,102,48,16,12,4,61
"2011","Northumberland 029A","E01027398",1670,86,27,59,257,204,102,122,327,310,138,99,39,124
"2011","Northumberland 029B","E01027409",1132,84,22,62,223,206,71,117,200,129,37,24,13,65
"2011","Northumberland 029C","E01027411",927,41,11,30,167,152,46,88,173,153,59,32,27,48
"2011","Northumberland 029D","E01027412",1114,28,6,22,121,110,60,99,229,239,156,107,49,72
"2011","Northumberland 029E","E01027413",1448,64,12,52,233,260,80,116,290,247,72,37,35,86
"2011","Northumberland 028A","E01027395",1082,62,15,47,189,172,54,80,210,188,66,43,23,61
"2011","Northumberland 028B","E01027396",1019,53,15,38,185,152,54,91,198,161,59,40,19,66
"2011","Northumberland 028C","E01027397",985,21,7,14,117,127,66,84,231,207,77,47,30,55
"2011","Northumberland 028D","E01027399",1195,99,22,77,301,253,86,106,151,104,26,18,8,69
"2011","Northumberland 028E","E01027404",1213,89,19,70,275,241,63,119,192,124,34,29,5,76
"2011","Northumberland 028F","E01027405",1186,100,25,75,279,245,71,119,178,104,13,6,7,77
"2011","Northumberland 030A","E01027417",1077,116,27,89,283,187,95,79,142,93,28,20,8,54
"2011","Northumberland 030B","E01027418",1404,135,34,101,310,250,121,111,213,142,45,27,18,77
"2011","Northumberland 030C","E01027419",1154,76,24,52,250,179,105,93,196,138,53,23,30,64
"2011","Northumberland 030D","E01027420",1086,107,28,79,269,195,88,82,162,110,21,12,9,52
"2011","Northumberland 030E","E01027421",1074,69,17,52,224,176,64,110,192,149,40,22,18,50
"2011","Northumberland 031A","E01027394",933,65,18,47,184,179,63,80,144,147,21,11,10,50
"2011","Northumberland 031B","E01027406",1038,94,20,74,243,228,66,89,160,93,23,15,8,42
"2011","Northumberland 031C","E01027407",1068,81,30,51,229,239,58,115,178,102,16,7,9,50
"2011","Northumberland 031D","E01027408",980,51,18,33,195,183,50,87,180,155,37,19,18,42
"2011","Northumberland 031E","E01027410",1249,150,43,107,336,246,100,87,150,86,19,12,7,75
"2011","Northumberland 032A","E01027432",1182,73,19,54,236,194,110,98,196,179,43,18,25,53
"2011","Northumberland 032B","E01027433",1249,89,24,65,257,165,84,115,217,186,67,48,19,69
"2011","Northumberland 032C","E01027434",1086,62,10,52,223,187,80,96,195,152,39,20,19,52
"2011","Northumberland 032D","E01027435",1091,74,20,54,239,166,87,96,180,148,48,23,25,53
"2011","Northumberland 032E","E01027436",1179,79,18,61,260,202,70,102,194,147,52,27,25,73
"2011","Northumberland 008A","E01027443",1077,36,8,28,149,128,66,101,228,214,104,50,54,51
"2011","Northumberland 008B","E01027444",2129,72,22,50,245,181,207,225,340,477,310,254,56,72
"2011","Northumberland 008C","E01027445",1246,105,24,81,277,187,100,92,197,158,56,43,13,74
"2011","Northumberland 008D","E01027446",1093,97,31,66,267,189,82,106,158,103,20,13,7,71
"2011","Northumberland 008E","E01027451",1296,51,22,29,150,153,77,135,258,270,132,86,46,70
"2011","Northumberland 008F","E01027474",1406,101,26,75,252,170,92,145,270,216,81,41,40,79
"2011","Northumberland 008G","E01027475",1088,140,40,100,308,154,103,84,128,87,30,20,10,54
"2011","Northumberland 011A","E01027457",1144,195,40,155,301,130,99,32,89,61,179,172,7,58
"2011","Northumberland 011B","E01027462",1354,53,11,42,217,180,92,134,263,255,99,67,32,61
"2011","Northumberland 011C","E01027463",1305,149,32,117,365,186,119,116,162,130,26,14,12,52
"2011","Northumberland 015A","E01027447",1359,194,58,136,356,139,314,69,131,61,21,13,8,74
"2011","Northumberland 015B","E01027448",1407,319,79,240,408,153,218,44,91,51,25,13,12,98
"2011","Northumberland 015C","E01027450",1222,210,52,158,388,137,185,49,97,56,22,10,12,78
"2011","Northumberland 015D","E01027473",1272,205,49,156,376,124,205,74,125,74,20,11,9,69
"2011","Northumberland 016A","E01027452",1054,131,37,94,300,141,65,72,130,93,40,26,14,82
"2011","Northumberland 016B","E01027453",954,122,25,97,254,133,94,64,127,95,28,22,6,37
"2011","Northumberland 016E","E01027461",933,46,14,32,166,93,54,71,168,192,85,56,29,58
"2011","Northumberland 016F","E01033718",1439,137,25,112,295,163,123,111,235,226,59,29,30,90
"2011","Northumberland 018A","E01027455",1094,178,46,132,351,192,91,65,88,44,18,8,10,67
"2011","Northumberland 018B","E01027456",1008,198,44,154,381,148,62,32,71,34,17,12,5,65
"2011","Northumberland 018C","E01027458",1153,225,55,170,414,150,91,46,86,40,19,12,7,82
"2011","Northumberland 018D","E01027460",1203,162,44,118,381,203,92,72,133,67,28,17,11,65
"2011","Northumberland 033A","E01027464",947,200,34,166,272,148,87,44,76,32,24,14,10,64
"2011","Northumberland 033B","E01027465",1060,161,31,130,286,150,153,45,121,51,11,7,4,82
"2011","Northumberland 033C","E01027466",811,54,12,42,158,103,97,66,110,122,32,24,8,69
"2011","Northumberland 033F","E01033714",1751,382,98,284,475,235,227,51,99,56,78,66,12,148
"2011","Northumberland 034A","E01027449",1127,169,33,136,327,156,139,60,125,59,28,16,12,64
"2011","Northumberland 034B","E01027468",922,218,60,158,279,134,89,30,63,28,15,11,4,66
"2011","Northumberland 034C","E01027469",1008,256,67,189,308,109,105,27,65,26,25,15,10,87
"2011","Northumberland 034D","E01027471",1213,286,68,218,370,166,152,42,67,37,25,18,7,68
"2011","Northumberland 034E","E01027472",1315,224,72,152,353,202,196,69,112,64,18,14,4,77
"2011","Northumberland 019A","E01027479",1699,164,42,122,368,171,353,141,237,139,43,27,16,83
"2011","Northumberland 019B","E01027480",950,131,30,101,236,83,204,58,101,62,17,11,6,58
"2011","Northumberland 019C","E01027503",1388,108,22,86,321,155,282,124,194,124,26,15,11,54
"2011","Northumberland 019D","E01027511",860,71,18,53,195,84,215,63,121,63,15,10,5,33
"2011","Northumberland 037A","E01027484",1704,164,40,124,386,164,343,144,206,157,56,40,16,84
"2011","Northumberland 037B","E01027485",1068,51,15,36,166,99,96,115,253,199,50,33,17,39
"2011","Northumberland 037C","E01027486",845,48,11,37,122,92,75,106,182,158,26,13,13,36
"2011","Northumberland 037D","E01027487",851,69,20,49,152,89,109,84,146,144,23,11,12,35
"2011","Northumberland 037E","E01027512",834,83,20,63,172,75,174,68,117,77,22,19,3,46
"2011","Northumberland 036A","E01027483",977,182,40,142,293,122,126,54,84,59,12,6,6,45
"2011","Northumberland 036B","E01027496",889,136,27,109,236,107,85,73,96,75,25,11,14,56
"2011","Northumberland 036C","E01027508",836,106,25,81,231,108,98,58,107,65,18,8,10,45
"2011","Northumberland 036D","E01027513",1367,331,55,276,444,144,123,59,99,56,25,15,10,86
"2011","Northumberland 035A","E01027476",1753,169,43,126,402,203,201,130,283,216,61,36,25,88
"2011","Northumberland 035B","E01027489",1198,182,37,145,307,138,119,65,164,81,37,20,17,105
"2011","Northumberland 035C","E01027490",1274,139,23,116,285,131,112,100,227,147,47,30,17,86
"2011","Northumberland 035D","E01027491",1140,209,51,158,343,144,124,50,124,39,15,11,4,92
"2011","Northumberland 035E","E01027492",1311,234,46,188,397,137,133,68,148,67,29,17,12,98
"2011","Northumberland 035F","E01027493",1048,36,6,30,142,102,73,96,242,220,77,45,32,60
"2011","Northumberland 035G","E01027494",1633,264,59,205,513,163,146,107,201,110,47,33,14,82
"2011","Northumberland 038A","E01027497",1976,206,41,165,465,294,159,161,301,200,63,36,27,127
"2011","Northumberland 038B","E01027498",1893,109,33,76,338,221,107,183,414,320,109,61,48,92
"2011","Northumberland 038C","E01027499",1130,101,26,75,271,171,99,120,169,100,30,22,8,69
"2011","Northumberland 038D","E01027500",1201,73,16,57,227,143,95,111,248,191,54,32,22,59
"2011","Northumberland 038E","E01027501",863,60,13,47,211,135,70,71,133,101,28,18,10,54
"2011","Northumberland 038F","E01027502",993,88,23,65,245,146,78,85,164,78,37,27,10,72
"2011","Northumberland 039A","E01027481",1150,226,47,179,302,126,153,62,127,76,22,11,11,56
"2011","Northumberland 039B","E01027482",1133,187,55,132,276,115,126,81,146,98,26,16,10,78
"2011","Northumberland 039C","E01027504",1444,304,61,243,412,151,203,55,102,51,65,56,9,101
"2011","Northumberland 039D","E01027506",877,159,43,116,243,87,160,47,70,45,17,12,5,49
"2011","Northumberland 039E","E01027507",1046,254,53,201,332,93,149,42,66,31,19,14,5,60
"2011","Northumberland 039F","E01027509",976,166,33,133,295,132,93,64,88,65,28,24,4,45
"2011","Northumberland 040A","E01027477",965,146,27,119,245,89,215,41,93,54,24,14,10,58
"2011","Northumberland 040B","E01027478",785,82,24,58,190,82,124,51,116,67,24,17,7,49
"2011","Northumberland 040C","E01027488",1612,160,36,124,313,178,275,131,250,177,48,23,25,80
"2011","Northumberland 040D","E01027495",777,110,33,77,194,76,140,52,83,54,18,11,7,50
"2011","Northumberland 040E","E01027505",1071,185,39,146,295,93,240,50,74,56,13,8,5,65
"2011","Northumberland 040F","E01027510",876,142,31,111,219,80,125,69,107,74,27,11,16,33
"2011","Northumberland 009A","E01027541",1363,56,16,40,240,151,156,141,244,195,116,75,41,64
"2011","Northumberland 009B","E01027542",1220,40,11,29,163,115,86,105,222,258,167,121,46,64
"2011","Northumberland 009C","E01027543",935,19,5,14,91,96,68,78,208,209,111,62,49,55
"2011","Northumberland 009D","E01027544",1040,47,10,37,192,133,70,102,202,172,74,44,30,48
"2011","Northumberland 010A","E01027528",980,24,4,20,122,118,54,102,197,224,83,50,33,56
"2011","Northumberland 010B","E01027529",880,44,12,32,162,144,46,79,178,117,48,30,18,62
"2011","Northumberland 010C","E01027539",1252,31,3,28,143,128,62,121,266,273,171,107,64,57
"2011","Northumberland 010D","E01027545",1459,30,8,22,151,168,70,142,339,280,208,131,77,71
"2011","Northumberland 010E","E01027546",1274,36,15,21,147,150,46,118,287,263,148,77,71,79
"2011","Northumberland 013A","E01027533",1212,27,4,23,125,126,53,106,262,302,164,102,62,47
"2011","Northumberland 013B","E01027540",1375,49,8,41,189,134,83,119,250,266,192,136,56,93
"2011","Northumberland 013E","E01027549",1217,110,43,67,318,213,75,101,161,132,34,24,10,73
"2011","Northumberland 013F","E01033716",1763,80,34,46,255,219,79,159,348,349,177,121,56,97
"2011","Northumberland 012A","E01027524",1045,56,8,48,211,141,74,105,190,148,43,23,20,77
"2011","Northumberland 012B","E01027525",1209,93,30,63,255,183,90,124,202,152,56,39,17,54
"2011","Northumberland 012C","E01027526",1005,111,40,71,255,169,75,82,151,77,14,8,6,71
"2011","Northumberland 012D","E01027527",941,28,15,13,97,110,52,64,197,223,109,79,30,61
"2011","Northumberland 012E","E01027536",1157,70,27,43,280,161,55,122,197,148,43,29,14,81
"2011","Northumberland 014A","E01027532",1499,79,32,47,312,244,83,140,260,225,62,42,20,94
"2011","Northumberland 014B","E01027537",1004,32,11,21,177,123,59,86,185,219,73,49,24,50
"2011","Northumberland 014C","E01027538",1378,130,36,94,344,252,79,139,211,119,20,11,9,84
"2011","Northumberland 017A","E01027530",1018,39,8,31,196,131,61,94,186,175,84,47,37,52
"2011","Northumberland 017B","E01027531",1269,77,24,53,239,174,97,111,218,197,97,63,34,59
"2011","Northumberland 017C","E01027534",1309,59,14,45,177,164,82,130,274,255,97,51,46,71
"2011","Northumberland 017D","E01027535",1092,71,19,52,279,209,86,130,138,114,17,11,6,48
"2011","Northumberland 017E","E01027553",1259,84,24,60,250,177,96,108,210,223,55,36,19,56
"2011","Northumberland 017F","E01027554",992,64,19,45,217,173,91,101,163,118,22,15,7,43
"2011","Northumberland 020A","E01027515",1083,60,11,49,204,176,72,102,172,193,57,36,21,47
"2011","Northumberland 020B","E01027517",1495,81,26,55,306,252,80,168,249,215,68,41,27,76
"2011","Northumberland 020C","E01027518",1020,23,7,16,99,121,73,88,204,235,105,73,32,72
"2011","Northumberland 020D","E01027519",1015,27,11,16,124,94,68,103,215,218,112,70,42,54
"2011","Northumberland 020E","E01027550",927,33,3,30,144,137,69,81,179,181,50,26,24,53
"2011","Northumberland 020F","E01027551",1061,27,5,22,139,90,53,114,213,248,110,69,41,67
"2011","Northumberland 020G","E01027552",977,31,15,16,168,123,106,98,184,161,63,34,29,43
"2011","Northumberland 021A","E01027514",1184,125,40,85,294,160,91,95,171,121,66,43,23,61
"2011","Northumberland 021B","E01027516",860,67,17,50,206,143,67,82,112,91,42,32,10,50
"2011","Northumberland 021C","E01027520",1115,130,37,93,316,183,80,91,132,80,20,12,8,83
"2011","Northumberland 021D","E01027521",1235,170,48,122,356,234,107,76,108,66,15,9,6,103
"2011","Northumberland 021E","E01027522",938,45,13,32,165,113,50,81,190,173,64,41,23,57
"2011","Northumberland 021F","E01027523",843,53,20,33,147,109,52,86,150,154,44,27,17,48
"2011","Redcar and Cleveland 001A","E01012100",1272,40,17,23,171,98,75,129,244,213,227,125,102,75
"2011","Redcar and Cleveland 001B","E01012101",1130,62,14,48,188,138,86,92,174,169,133,90,43,88
"2011","Redcar and Cleveland 001C","E01012102",1630,54,10,44,251,192,111,146,336,279,149,78,71,112
"2011","Redcar and Cleveland 001D","E01012184",1061,52,13,39,198,117,94,108,190,167,67,37,30,68
"2011","Redcar and Cleveland 002A","E01012105",981,50,13,37,169,121,66,120,181,155,51,33,18,68
"2011","Redcar and Cleveland 002B","E01012142",1211,46,12,34,176,127,61,126,282,229,90,51,39,74
"2011","Redcar and Cleveland 002C","E01012143",864,7,1,6,77,52,36,71,194,190,152,102,50,85
"2011","Redcar and Cleveland 002D","E01012144",1055,52,16,36,188,130,70,130,206,152,49,33,16,78
"2011","Redcar and Cleveland 003C","E01012106",977,36,8,28,169,108,83,117,200,158,47,32,15,59
"2011","Redcar and Cleveland 003D","E01012107",979,24,2,22,98,90,65,95,232,209,95,63,32,71
"2011","Redcar and Cleveland 003E","E01032560",779,54,18,36,150,114,62,88,125,101,44,31,13,41
"2011","Redcar and Cleveland 003F","E01032561",1121,16,3,13,115,96,48,116,247,234,155,116,39,94
"2011","Redcar and Cleveland 004A","E01012176",1023,79,18,61,216,145,67,123,169,131,36,20,16,57
"2011","Redcar and Cleveland 004B","E01012177",1108,94,24,70,283,187,48,105,168,112,27,15,12,84
"2011","Redcar and Cleveland 004C","E01012178",1055,84,25,59,248,167,75,98,169,101,41,30,11,72
"2011","Redcar and Cleveland 004D","E01012179",1040,88,29,59,259,186,42,107,144,122,30,17,13,62
"2011","Redcar and Cleveland 004E","E01012180",1343,148,38,110,354,201,72,160,169,70,37,23,14,132
"2011","Redcar and Cleveland 004F","E01012185",1052,64,16,48,219,153,74,110,183,128,64,46,18,57
"2011","Redcar and Cleveland 004G","E01012186",1203,100,35,65,291,152,104,108,196,128,51,29,22,73
"2011","Redcar and Cleveland 005A","E01012127",753,13,1,12,59,59,36,51,184,168,127,82,45,56
"2011","Redcar and Cleveland 005B","E01012128",814,21,7,14,86,64,40,72,205,159,97,67,30,70
"2011","Redcar and Cleveland 005C","E01012129",1608,97,33,64,317,254,92,174,279,215,86,55,31,94
"2011","Redcar and Cleveland 005D","E01012130",1016,67,27,40,217,132,71,124,170,126,50,32,18,59
"2011","Redcar and Cleveland 005E","E01012131",927,30,6,24,95,97,47,79,201,191,129,91,38,58
"2011","Redcar and Cleveland 006A","E01012138",1917,216,62,154,513,301,139,219,231,149,37,17,20,112
"2011","Redcar and Cleveland 006B","E01012139",1528,135,41,94,346,228,110,208,223,150,40,22,18,88
"2011","Redcar and Cleveland 006C","E01012140",1011,50,14,36,161,138,53,109,217,169,44,20,24,70
"2011","Redcar and Cleveland 006D","E01012141",836,64,20,44,172,128,53,113,122,85,37,19,18,62
"2011","Redcar and Cleveland 006E","E01012154",958,77,28,49,234,162,59,107,148,98,18,15,3,55
"2011","Redcar and Cleveland 006F","E01012155",1065,54,9,45,187,129,70,125,220,156,70,45,25,54
"2011","Redcar and Cleveland 006G","E01012156",1255,96,20,76,301,222,92,128,172,125,41,27,14,78
"2011","Redcar and Cleveland 006H","E01012157",1171,108,28,80,272,157,76,115,149,155,66,51,15,73
"2011","Redcar and Cleveland 007A","E01012158",1016,165,39,126,299,135,107,70,105,58,21,14,7,56
"2011","Redcar and Cleveland 007B","E01012159",1261,92,15,77,250,113,142,119,192,147,148,75,73,58
"2011","Redcar and Cleveland 007C","E01012160",1037,86,16,70,239,117,102,80,151,115,54,40,14,93
"2011","Redcar and Cleveland 007D","E01012161",1011,108,22,86,279,109,105,70,131,92,57,40,17,60
"2011","Redcar and Cleveland 009A","E01012113",952,11,6,5,63,63,26,72,222,229,187,122,65,79
"2011","Redcar and Cleveland 009B","E01012114",997,17,4,13,67,63,34,75,186,244,251,173,78,60
"2011","Redcar and Cleveland 009E","E01012175",1010,23,7,16,93,82,47,101,209,235,153,99,54,67
"2011","Redcar and Cleveland 009F","E01033471",1547,25,13,12,111,112,41,118,315,386,305,197,108,134
"2011","Redcar and Cleveland 010A","E01012095",1013,59,19,40,205,122,95,140,162,144,32,23,9,54
"2011","Redcar and Cleveland 010B","E01012097",901,41,16,25,132,102,59,141,164,163,61,40,21,38
"2011","Redcar and Cleveland 010C","E01012098",994,53,18,35,148,121,86,137,191,149,41,19,22,68
"2011","Redcar and Cleveland 010D","E01012099",1116,33,8,25,100,89,70,131,252,228,153,98,55,60
"2011","Redcar and Cleveland 011A","E01012108",1061,28,15,13,130,98,36,95,220,264,99,64,35,91
"2011","Redcar and Cleveland 011B","E01012109",1048,64,25,39,194,133,66,128,165,149,84,48,36,65
"2011","Redcar and Cleveland 011C","E01012110",1109,39,10,29,200,151,42,162,213,182,48,28,20,72
"2011","Redcar and Cleveland 011D","E01012111",915,30,11,19,125,107,50,83,202,193,65,46,19,60
"2011","Redcar and Cleveland 011E","E01012171",1039,29,8,21,128,98,38,125,231,245,69,47,22,76
"2011","Redcar and Cleveland 011F","E01012172",1031,56,17,39,147,128,56,141,231,193,38,20,18,41
"2011","Redcar and Cleveland 012A","E01012162",1078,46,18,28,183,122,63,156,215,166,69,42,27,58
"2011","Redcar and Cleveland 012B","E01012163",1644,98,36,62,328,222,131,227,255,193,56,34,22,134
"2011","Redcar and Cleveland 012C","E01012164",1239,91,23,68,232,126,120,148,242,154,63,37,26,63
"2011","Redcar and Cleveland 012D","E01012165",1571,61,14,47,240,148,84,169,321,270,181,122,59,97
"2011","Redcar and Cleveland 013A","E01012096",1161,27,8,19,109,97,78,134,233,277,155,109,46,51
"2011","Redcar and Cleveland 013D","E01012136",1088,49,17,32,161,79,67,119,243,176,120,71,49,74
"2011","Redcar and Cleveland 013E","E01033473",1499,21,12,9,136,101,82,160,344,379,190,120,70,86
"2011","Redcar and Cleveland 015A","E01012112",1080,12,6,6,74,93,40,100,270,280,146,86,60,65
"2011","Redcar and Cleveland 015B","E01012145",1117,61,18,43,174,143,76,123,207,193,69,40,29,71
"2011","Redcar and Cleveland 015C","E01012147",1217,117,39,78,254,199,73,153,182,137,28,14,14,74
"2011","Redcar and Cleveland 015D","E01012149",940,63,25,38,165,157,59,117,170,122,32,22,10,55
"2011","Redcar and Cleveland 016A","E01012132",1516,66,13,53,245,111,173,168,269,264,140,80,60,80
"2011","Redcar and Cleveland 016B","E01012134",1102,42,10,32,176,97,108,139,183,187,113,83,30,57
"2011","Redcar and Cleveland 016C","E01012137",1013,48,17,31,155,101,102,121,178,186,56,40,16,66
"2011","Redcar and Cleveland 016D","E01012181",1231,47,12,35,188,121,106,139,247,229,77,42,35,77
"2011","Redcar and Cleveland 018A","E01012117",1016,58,11,47,178,107,82,94,209,143,94,60,34,51
"2011","Redcar and Cleveland 018B","E01012118",1009,74,18,56,160,130,76,121,183,154,54,30,24,57
"2011","Redcar and Cleveland 018C","E01012119",1512,110,42,68,303,182,107,134,255,205,117,72,45,99
"2011","Redcar and Cleveland 018D","E01012121",956,27,5,22,102,85,65,90,206,208,115,70,45,58
"2011","Redcar and Cleveland 019E","E01032548",1100,150,29,121,358,188,68,72,110,81,13,10,3,60
"2011","Redcar and Cleveland 019F","E01032549",1253,183,44,139,378,196,87,97,121,79,36,26,10,76
"2011","Redcar and Cleveland 019G","E01033472",1870,147,26,121,390,217,132,196,338,244,92,51,41,114
"2011","Redcar and Cleveland 020A","E01012120",987,104,21,83,269,117,73,106,146,86,30,19,11,56
"2011","Redcar and Cleveland 020B","E01012124",1103,186,45,141,334,162,98,79,96,57,23,16,7,68
"2011","Redcar and Cleveland 020C","E01012182",1060,149,41,108,286,156,80,100,131,82,17,11,6,59
"2011","Redcar and Cleveland 020D","E01012183",1193,109,21,88,321,181,76,147,179,95,24,10,14,61
"2011","Redcar and Cleveland 021A","E01012148",1061,27,9,18,111,111,37,101,240,201,138,90,48,95
"2011","Redcar and Cleveland 021B","E01012150",1125,31,9,22,126,125,43,88,237,210,150,96,54,115
"2011","Redcar and Cleveland 021C","E01012151",1090,60,18,42,200,147,62,131,207,172,46,28,18,65
"2011","Redcar and Cleveland 021D","E01012152",1181,75,24,51,242,161,113,145,172,169,28,16,12,76
"2011","Redcar and Cleveland 021E","E01032594",977,92,26,66,274,146,84,70,127,97,37,21,16,50
"2011","Redcar and Cleveland 022A","E01012146",967,80,34,46,209,170,54,122,133,106,35,27,8,58
"2011","Redcar and Cleveland 022B","E01012167",1081,53,14,39,184,129,51,103,227,197,56,39,17,81
"2011","Redcar and Cleveland 022C","E01012168",1386,29,10,19,187,163,58,126,300,302,123,78,45,98
"2011","Redcar and Cleveland 022D","E01012170",924,9,3,6,44,52,32,67,186,241,223,167,56,70
"2011","Redcar and Cleveland 022E","E01012173",865,58,18,40,176,126,61,103,140,101,35,22,13,65
"2011","Redcar and Cleveland 022F","E01012174",816,44,16,28,158,158,48,91,144,94,18,13,5,61
"2011","Redcar and Cleveland 022G","E01033470",1348,39,12,27,126,110,85,129,232,318,213,152,61,96
"2011","Stockton-on-Tees 001A","E01012242",1148,74,20,54,225,202,58,137,207,135,41,22,19,69
"2011","Stockton-on-Tees 001B","E01012243",1234,78,16,62,274,219,68,134,197,150,35,21,14,79
"2011","Stockton-on-Tees 001C","E01012244",1129,92,21,71,255,200,75,114,164,137,27,12,15,65
"2011","Stockton-on-Tees 001D","E01012246",1171,102,31,71,281,189,69,138,173,108,20,13,7,91
"2011","Stockton-on-Tees 001E","E01012296",1035,80,15,65,257,148,78,107,152,120,48,40,8,45
"2011","Stockton-on-Tees 001F","E01012297",2023,228,55,173,569,322,140,178,234,133,45,28,17,174
"2011","Stockton-on-Tees 002A","E01012197",1412,45,13,32,206,172,78,131,302,258,116,67,49,104
"2011","Stockton-on-Tees 002B","E01012256",979,73,30,43,209,162,78,111,151,115,31,21,10,49
"2011","Stockton-on-Tees 002C","E01012257",1028,88,22,66,242,166,58,110,165,125,19,9,10,55
"2011","Stockton-on-Tees 002D","E01012275",1075,40,14,26,154,124,49,112,229,199,97,68,29,71
"2011","Stockton-on-Tees 002E","E01012276",1178,38,5,33,186,155,79,117,224,236,77,41,36,66
"2011","Stockton-on-Tees 002F","E01012277",1153,36,9,27,174,139,80,121,223,193,90,63,27,97
"2011","Stockton-on-Tees 003A","E01012196",1214,31,13,18,176,136,58,116,276,244,88,54,34,89
"2011","Stockton-on-Tees 003B","E01012198",1069,22,4,18,112,78,50,102,191,263,173,126,47,78
"2011","Stockton-on-Tees 003C","E01012214",1143,34,6,28,139,138,53,114,241,258,87,50,37,79
"2011","Stockton-on-Tees 003D","E01012215",862,20,6,14,93,85,36,57,195,201,109,69,40,66
"2011","Stockton-on-Tees 003E","E01012216",943,32,9,23,118,104,55,100,180,197,77,43,34,80
"2011","Stockton-on-Tees 003F","E01012245",1135,31,10,21,104,111,48,111,246,252,149,88,61,83
"2011","Stockton-on-Tees 004A","E01012278",956,38,14,24,136,116,65,103,189,169,81,44,37,59
"2011","Stockton-on-Tees 004B","E01012279",1265,49,17,32,221,195,77,133,245,209,58,32,26,78
"2011","Stockton-on-Tees 004C","E01012280",1126,51,13,38,224,161,82,107,205,158,43,26,17,95
"2011","Stockton-on-Tees 004D","E01012281",893,34,8,26,127,105,68,77,169,176,93,54,39,44
"2011","Stockton-on-Tees 005A","E01012255",1027,86,26,60,236,197,70,112,153,97,10,4,6,66
"2011","Stockton-on-Tees 005B","E01012269",1264,170,46,124,332,198,187,76,109,72,38,28,10,82
"2011","Stockton-on-Tees 005D","E01012294",912,159,36,123,265,150,80,41,81,46,33,25,8,57
"2011","Stockton-on-Tees 005E","E01012295",884,86,24,62,165,113,81,70,162,112,45,19,26,50
"2011","Stockton-on-Tees 005F","E01033476",1246,301,89,212,388,143,162,44,55,38,26,15,11,89
"2011","Stockton-on-Tees 005G","E01033480",1327,177,54,123,414,205,142,95,128,77,23,11,12,66
"2011","Stockton-on-Tees 006A","E01012210",1240,156,38,118,349,183,87,123,138,92,23,16,7,89
"2011","Stockton-on-Tees 006B","E01012211",1354,188,49,139,415,218,108,103,115,88,27,19,8,92
"2011","Stockton-on-Tees 006C","E01012212",1151,121,27,94,280,193,81,124,165,95,31,22,9,61
"2011","Stockton-on-Tees 006D","E01012213",980,40,5,35,198,178,51,96,201,148,28,18,10,40
"2011","Stockton-on-Tees 007A","E01012192",1190,53,15,38,215,164,88,121,190,214,69,41,28,76
"2011","Stockton-on-Tees 007B","E01012193",1116,46,8,38,139,141,68,104,218,198,128,91,37,74
"2011","Stockton-on-Tees 007C","E01012260",1215,118,35,83,305,178,119,95,161,131,43,21,22,65
"2011","Stockton-on-Tees 007D","E01012261",1162,87,15,72,254,182,66,112,191,148,57,34,23,65
"2011","Stockton-on-Tees 008A","E01012247",890,13,3,10,80,108,31,103,190,209,84,51,33,72
"2011","Stockton-on-Tees 008B","E01012249",1069,27,6,21,97,112,60,95,253,256,95,57,38,74
"2011","Stockton-on-Tees 008C","E01012271",1029,28,10,18,105,91,47,85,228,216,148,113,35,81
"2011","Stockton-on-Tees 008D","E01012272",820,43,17,26,148,113,57,99,148,110,37,24,13,65
"2011","Stockton-on-Tees 008E","E01012273",1108,22,8,14,112,102,37,86,264,249,139,93,46,97
"2011","Stockton-on-Tees 008F","E01012274",957,14,2,12,107,103,47,100,189,206,108,75,33,83
"2011","Stockton-on-Tees 009D","E01012248",1023,52,13,39,180,109,70,93,199,179,76,49,27,65
"2011","Stockton-on-Tees 009E","E01012250",1004,18,6,12,111,81,25,92,268,227,126,85,41,56
"2011","Stockton-on-Tees 009F","E01032542",742,25,5,20,85,76,37,60,169,158,85,52,33,47
"2011","Stockton-on-Tees 009G","E01032543",1528,25,5,20,122,111,57,126,388,360,198,130,68,141
"2011","Stockton-on-Tees 009H","E01032544",1462,104,33,71,332,203,61,135,237,191,105,78,27,94
"2011","Stockton-on-Tees 010A","E01012194",1096,57,21,36,184,136,51,90,227,177,107,51,56,67
"2011","Stockton-on-Tees 010B","E01012195",1083,20,3,17,106,94,53,80,216,279,147,96,51,88
"2011","Stockton-on-Tees 010C","E01012258",1664,36,6,30,140,120,119,144,277,463,306,254,52,59
"2011","Stockton-on-Tees 010D","E01012259",1343,66,23,43,258,196,81,135,253,192,80,44,36,82
"2011","Stockton-on-Tees 010E","E01012268",1234,30,3,27,132,130,63,131,234,243,189,121,68,82
"2011","Stockton-on-Tees 011A","E01012187",1082,50,15,35,200,133,79,136,214,164,47,29,18,59
"2011","Stockton-on-Tees 011B","E01012188",951,75,21,54,224,190,53,96,150,87,21,10,11,55
"2011","Stockton-on-Tees 011C","E01012189",1057,77,23,54,217,150,77,103,199,157,33,19,14,44
"2011","Stockton-on-Tees 011D","E01012205",1080,71,17,54,252,180,51,107,159,159,38,26,12,63
"2011","Stockton-on-Tees 012A","E01012219",1348,84,19,65,290,199,107,119,219,173,59,38,21,98
"2011","Stockton-on-Tees 012B","E01012251",1171,43,10,33,139,130,68,111,238,191,150,92,58,101
"2011","Stockton-on-Tees 012C","E01012252",1032,15,2,13,77,72,30,61,234,204,229,149,80,110
"2011","Stockton-on-Tees 012D","E01012253",909,33,14,19,139,111,65,88,181,137,68,46,22,87
"2011","Stockton-on-Tees 012E","E01012254",1041,29,7,22,90,88,52,65,227,215,184,108,76,91
"2011","Stockton-on-Tees 013A","E01012204",986,109,36,73,258,178,65,86,129,94,24,15,9,43
"2011","Stockton-on-Tees 013B","E01012206",1035,76,18,58,196,145,70,83,199,146,61,37,24,59
"2011","Stockton-on-Tees 013C","E01012207",1356,135,32,103,325,195,92,127,170,148,68,53,15,96
"2011","Stockton-on-Tees 013D","E01012208",1227,120,28,92,314,209,93,107,147,95,32,17,15,110
"2011","Stockton-on-Tees 014A","E01012262",1725,45,9,36,145,134,89,103,273,269,236,156,80,431
"2011","Stockton-on-Tees 014C","E01012264",1794,136,29,107,389,239,131,139,298,230,124,87,37,108
"2011","Stockton-on-Tees 014E","E01012266",1722,28,5,23,148,84,66,120,354,370,366,259,107,186
"2011","Stockton-on-Tees 014F","E01012267",1247,24,2,22,86,110,75,86,228,280,219,158,61,139
"2011","Stockton-on-Tees 014G","E01033477",1979,61,9,52,192,116,157,125,284,300,414,296,118,330
"2011","Stockton-on-Tees 015A","E01012190",1154,99,29,70,284,184,69,129,180,115,28,14,14,66
"2011","Stockton-on-Tees 015B","E01012191",1095,75,18,57,222,164,61,107,207,122,49,33,16,88
"2011","Stockton-on-Tees 015C","E01012224",1293,129,25,104,329,241,78,110,180,108,37,20,17,81
"2011","Stockton-on-Tees 015D","E01012225",1157,110,28,82,307,179,88,83,159,111,27,18,9,93
"2011","Stockton-on-Tees 015E","E01012226",1083,93,20,73,280,216,57,105,157,84,26,17,9,65
"2011","Stockton-on-Tees 016A","E01012209",1244,141,30,111,286,193,90,81,175,113,51,32,19,114
"2011","Stockton-on-Tees 016B","E01012217",1152,40,9,31,171,147,79,81,213,190,145,68,77,86
"2011","Stockton-on-Tees 016C","E01012218",1106,141,29,112,257,173,88,74,137,88,54,37,17,94
"2011","Stockton-on-Tees 016D","E01012223",1103,155,42,113,342,165,91,90,89,71,29,22,7,71
"2011","Stockton-on-Tees 017A","E01012286",1096,25,8,17,86,96,41,67,227,225,199,126,73,130
"2011","Stockton-on-Tees 017B","E01012287",1975,97,9,88,157,185,54,94,214,213,132,81,51,829
"2011","Stockton-on-Tees 017C","E01012288",1053,29,3,26,104,124,48,72,195,188,130,91,39,163
"2011","Stockton-on-Tees 017D","E01012289",903,42,12,30,124,89,62,78,167,140,97,63,34,104
"2011","Stockton-on-Tees 018A","E01012238",1103,30,6,24,116,123,48,100,241,222,124,87,37,99
"2011","Stockton-on-Tees 018B","E01012239",1370,74,18,56,212,176,69,111,264,234,128,78,50,102
"2011","Stockton-on-Tees 018C","E01012240",1334,58,19,39,220,183,91,148,260,216,70,51,19,88
"2011","Stockton-on-Tees 018D","E01012241",1183,71,18,53,172,166,58,132,238,194,55,29,26,97
"2011","Stockton-on-Tees 019A","E01012290",1296,87,25,62,250,205,100,114,230,187,51,33,18,72
"2011","Stockton-on-Tees 019B","E01012291",1242,35,12,23,173,136,86,127,250,220,117,76,41,98
"2011","Stockton-on-Tees 019C","E01012292",1724,66,14,52,294,241,110,142,314,294,137,88,49,126
"2011","Stockton-on-Tees 020A","E01012282",946,23,13,10,117,116,48,86,221,174,88,60,28,73
"2011","Stockton-on-Tees 020B","E01012283",936,30,10,20,102,79,35,88,231,201,106,58,48,64
"2011","Stockton-on-Tees 020C","E01012284",1068,25,8,17,99,83,38,115,264,265,108,79,29,71
"2011","Stockton-on-Tees 020D","E01012285",1048,46,15,31,162,152,57,100,223,179,76,43,33,53
"2011","Stockton-on-Tees 021A","E01012199",1129,169,52,117,312,178,79,87,126,79,21,12,9,78
"2011","Stockton-on-Tees 021B","E01012200",1490,213,56,157,397,198,128,94,191,128,42,24,18,99
"2011","Stockton-on-Tees 021C","E01012201",1263,155,43,112,307,218,90,118,173,96,28,19,9,78
"2011","Stockton-on-Tees 021D","E01012202",1054,158,25,133,286,145,85,75,124,83,38,22,16,60
"2011","Stockton-on-Tees 021E","E01012203",1346,171,44,127,367,210,103,89,159,95,44,23,21,108
"2011","Stockton-on-Tees 021F","E01012270",996,129,33,96,242,120,89,67,125,104,42,31,11,78
"2011","Stockton-on-Tees 022A","E01012228",1053,115,26,89,277,167,79,92,124,90,31,18,13,78
"2011","Stockton-on-Tees 022B","E01012230",1189,151,27,124,308,219,95,87,122,69,39,20,19,99
"2011","Stockton-on-Tees 022C","E01012233",1087,191,65,126,329,147,112,71,98,42,20,11,9,77
"2011","Stockton-on-Tees 022D","E01012236",1032,114,30,84,285,173,85,86,103,76,31,22,9,79
"2011","Stockton-on-Tees 022E","E01012237",1064,135,37,98,281,166,81,97,117,59,25,16,9,103
"2011","Stockton-on-Tees 023A","E01012227",1089,134,34,100,296,209,81,91,122,63,27,16,11,66
"2011","Stockton-on-Tees 023C","E01012231",1386,176,50,126,397,245,94,95,146,85,31,18,13,117
"2011","Stockton-on-Tees 023D","E01012232",1061,132,45,87,310,202,62,79,106,81,16,5,11,73
"2011","Stockton-on-Tees 023E","E01012234",1241,140,36,104,379,207,96,96,108,68,33,20,13,114
"2011","Stockton-on-Tees 023F","E01033474",1151,190,41,149,348,223,68,91,97,56,23,9,14,55
"2011","Stockton-on-Tees 023G","E01033475",1229,258,64,194,380,187,76,70,79,53,27,17,10,99
"2011","Stockton-on-Tees 023H","E01033478",1302,201,58,143,412,192,102,82,108,68,23,17,6,114
"2011","Stockton-on-Tees 023I","E01033479",1261,176,58,118,362,201,94,109,128,74,25,16,9,92
"2011","Stockton-on-Tees 024A","E01012235",1118,172,42,130,310,130,118,52,78,135,69,52,17,54
"2011","Stockton-on-Tees 024B","E01012298",1094,252,70,182,373,138,55,41,85,38,30,16,14,82
"2011","Stockton-on-Tees 024C","E01012299",1138,257,44,213,376,128,101,56,99,42,18,8,10,61
"2011","Stockton-on-Tees 024D","E01012300",1083,90,22,68,237,144,71,89,174,152,61,43,18,65
"2011","Stockton-on-Tees 024E","E01012301",1053,180,44,136,323,150,73,68,83,70,23,12,11,83
"2011","Stockton-on-Tees 024F","E01012302",944,140,29,111,313,133,61,62,88,61,14,7,7,72
"2011","Stockton-on-Tees 024G","E01012303",1104,154,36,118,301,165,87,95,128,87,28,15,13,59
"2011","Gateshead 001A","E01008246",1020,75,21,54,197,151,64,78,196,149,47,27,20,63
"2011","Gateshead 001B","E01008247",1172,79,22,57,227,157,74,99,225,184,58,40,18,69
"2011","Gateshead 001C","E01008248",1356,176,40,136,375,190,105,96,203,106,29,20,9,76
"2011","Gateshead 001D","E01008249",1123,140,39,101,299,194,77,81,166,96,21,16,5,49
"2011","Gateshead 001E","E01008250",1088,108,19,89,256,141,70,74,200,128,44,29,15,67
"2011","Gateshead 002A","E01008195",1530,123,33,90,342,222,114,132,268,208,49,30,19,72
"2011","Gateshead 002B","E01008197",1193,92,23,69,286,209,105,88,177,154,32,15,17,50
"2011","Gateshead 002C","E01008198",976,62,13,49,172,142,67,99,151,168,51,36,15,64
"2011","Gateshead 002D","E01008199",1034,82,18,64,250,167,64,102,190,107,18,12,6,54
"2011","Gateshead 002E","E01008200",1037,136,31,105,286,146,99,78,138,62,12,4,8,80
"2011","Gateshead 002F","E01008245",1085,128,37,91,309,155,88,58,155,91,22,16,6,79
"2011","Gateshead 003A","E01008214",1182,45,8,37,106,98,34,67,234,319,186,146,40,93
"2011","Gateshead 003B","E01008215",1243,56,13,43,166,143,51,84,222,268,173,108,65,80
"2011","Gateshead 003C","E01008243",1149,98,19,79,233,211,84,97,172,169,31,23,8,54
"2011","Gateshead 003D","E01008244",1588,108,23,85,307,245,82,138,261,247,100,62,38,100
"2011","Gateshead 004A","E01008178",1247,94,18,76,290,145,69,89,214,169,98,62,36,79
"2011","Gateshead 004B","E01008180",1057,21,7,14,125,109,40,82,266,247,89,47,42,78
"2011","Gateshead 004C","E01008182",1186,75,20,55,198,161,73,92,249,209,68,43,25,61
"2011","Gateshead 004D","E01008277",1071,58,17,41,164,155,66,87,248,174,46,33,13,73
"2011","Gateshead 004E","E01008280",1333,66,10,56,207,188,91,105,275,225,104,69,35,72
"2011","Gateshead 005A","E01008177",1074,74,21,53,211,165,80,91,189,123,78,58,20,63
"2011","Gateshead 005B","E01008179",940,74,13,61,195,132,50,81,200,126,31,20,11,51
"2011","Gateshead 005C","E01008181",1116,127,29,98,269,145,105,85,176,128,26,23,3,55
"2011","Gateshead 005D","E01008276",1072,66,18,48,177,151,72,95,222,185,51,26,25,53
"2011","Gateshead 005E","E01008279",1113,79,26,53,232,187,92,115,185,133,23,14,9,67
"2011","Gateshead 007A","E01008209",1625,111,31,80,273,216,88,162,329,260,84,49,35,102
"2011","Gateshead 007B","E01008210",1038,50,10,40,149,132,53,89,203,209,85,57,28,68
"2011","Gateshead 007C","E01008258",1810,195,23,172,354,198,59,120,262,301,216,158,58,105
"2011","Gateshead 007D","E01008259",1499,61,17,44,192,157,84,123,314,319,177,95,82,72
"2011","Gateshead 008A","E01008167",1260,104,20,84,210,133,82,106,205,205,112,82,30,103
"2011","Gateshead 008B","E01008169",939,73,8,65,190,118,76,48,99,83,112,96,16,140
"2011","Gateshead 008C","E01008170",1564,108,15,93,253,159,84,116,305,266,140,102,38,133
"2011","Gateshead 008D","E01008171",1168,58,8,50,146,86,49,63,149,124,105,68,37,388
"2011","Gateshead 008E","E01008257",1055,28,2,26,101,114,38,102,239,250,125,94,31,58
"2011","Gateshead 009A","E01008262",1387,117,30,87,257,169,91,120,258,197,108,76,32,70
"2011","Gateshead 009B","E01008263",1109,56,13,43,162,120,67,106,246,209,84,55,29,59
"2011","Gateshead 009C","E01008264",1037,133,36,97,297,190,65,74,118,68,22,18,4,70
"2011","Gateshead 009D","E01008265",1076,93,22,71,201,164,63,94,199,128,63,36,27,71
"2011","Gateshead 009E","E01008266",1008,139,26,113,256,204,69,70,130,64,18,9,9,58
"2011","Gateshead 010A","E01008251",1445,138,15,123,291,218,101,110,206,191,98,69,29,92
"2011","Gateshead 010B","E01008252",1234,101,16,85,230,121,82,88,189,151,117,80,37,155
"2011","Gateshead 010C","E01008253",1345,113,8,105,287,154,68,82,207,195,124,77,47,115
"2011","Gateshead 010D","E01008254",1053,59,12,47,181,123,72,88,181,197,92,66,26,60
"2011","Gateshead 010E","E01008255",1256,99,22,77,234,158,91,96,226,196,78,62,16,78
"2011","Gateshead 011A","E01008165",1058,36,14,22,104,128,41,89,242,233,105,72,33,80
"2011","Gateshead 011B","E01008201",1100,21,7,14,101,93,55,100,230,206,178,142,36,116
"2011","Gateshead 011C","E01008202",1371,71,15,56,199,213,85,123,268,230,98,73,25,84
"2011","Gateshead 011D","E01008204",1148,40,9,31,124,124,54,90,241,268,146,98,48,61
"2011","Gateshead 012A","E01008212",1033,39,12,27,140,135,37,102,174,249,105,72,33,52
"2011","Gateshead 012B","E01008213",1072,52,15,37,171,160,53,120,172,217,59,42,17,68
"2011","Gateshead 012C","E01008216",1092,50,15,35,155,125,62,101,215,237,89,66,23,58
"2011","Gateshead 012D","E01008228",879,39,6,33,109,92,42,86,204,189,72,46,26,46
"2011","Gateshead 013A","E01008206",1243,77,15,62,237,190,62,139,244,179,44,25,19,71
"2011","Gateshead 013B","E01008207",1101,100,31,69,235,199,76,102,182,123,27,15,12,57
"2011","Gateshead 013C","E01008208",1209,68,16,52,215,138,61,114,247,223,62,42,20,81
"2011","Gateshead 013D","E01008211",1306,62,15,47,214,193,98,125,265,204,60,34,26,85
"2011","Gateshead 014A","E01008283",1089,89,19,70,256,237,73,88,147,125,18,10,8,56
"2011","Gateshead 014B","E01008284",1099,74,12,62,221,197,69,107,165,152,43,29,14,71
"2011","Gateshead 014C","E01008286",1074,69,16,53,175,170,73,120,176,183,41,25,16,67
"2011","Gateshead 014D","E01008287",1496,179,41,138,337,304,83,135,170,148,35,24,11,105
"2011","Gateshead 015A","E01008231",1129,42,13,29,129,144,52,97,257,244,89,48,41,75
"2011","Gateshead 015B","E01008240",1076,44,9,35,182,158,43,107,215,199,71,55,16,57
"2011","Gateshead 015C","E01008241",1135,72,17,55,184,146,75,113,196,196,76,54,22,77
"2011","Gateshead 015D","E01008242",1147,37,7,30,136,163,49,105,253,256,75,54,21,73
"2011","Gateshead 015E","E01008281",1012,26,12,14,140,137,54,88,228,214,64,41,23,61
"2011","Gateshead 015F","E01008282",1031,27,5,22,124,128,47,95,237,234,70,40,30,69
"2011","Gateshead 016A","E01008219",1266,96,21,75,269,163,80,95,212,187,84,63,21,80
"2011","Gateshead 016B","E01008235",1108,102,28,74,247,206,83,104,161,117,13,7,6,75
"2011","Gateshead 016C","E01008236",1077,116,13,103,286,187,78,71,116,114,47,32,15,62
"2011","Gateshead 016D","E01008237",1120,204,48,156,332,179,87,69,95,50,20,14,6,84
"2011","Gateshead 016E","E01008238",1179,214,34,180,375,176,62,63,126,64,22,17,5,77
"2011","Gateshead 017A","E01008267",988,130,42,88,234,167,73,70,129,84,45,35,10,56
"2011","Gateshead 017B","E01008269",1093,170,52,118,312,212,85,68,125,46,16,7,9,59
"2011","Gateshead 017C","E01008270",966,123,36,87,266,210,79,69,111,48,24,18,6,36
"2011","Gateshead 017D","E01008271",1106,150,33,117,305,203,90,72,135,62,17,10,7,72
"2011","Gateshead 017E","E01008275",1126,154,33,121,307,222,66,77,136,69,20,10,10,75
"2011","Gateshead 018A","E01008229",1010,49,16,33,181,152,61,108,200,162,39,28,11,58
"2011","Gateshead 018B","E01008230",1003,74,19,55,178,129,65,99,172,150,65,43,22,71
"2011","Gateshead 018C","E01008232",958,27,7,20,98,120,55,84,200,228,90,64,26,56
"2011","Gateshead 018D","E01008233",1117,68,23,45,219,204,79,109,197,152,24,14,10,65
"2011","Gateshead 018E","E01008285",1022,21,11,10,111,140,49,96,230,237,67,41,26,71
"2011","Gateshead 019A","E01008256",1354,77,20,57,218,203,78,140,310,200,47,24,23,81
"2011","Gateshead 019B","E01008260",1191,131,45,86,262,218,90,105,165,115,37,25,12,68
"2011","Gateshead 019C","E01008261",1060,32,8,24,133,112,52,102,228,257,79,52,27,65
"2011","Gateshead 019D","E01008268",1074,121,34,87,247,186,90,65,147,116,28,19,9,74
"2011","Gateshead 019E","E01008272",1024,145,36,109,254,184,95,63,135,76,27,17,10,45
"2011","Gateshead 019F","E01008273",1142,93,17,76,303,212,81,83,170,111,28,12,16,61
"2011","Gateshead 019G","E01008274",1085,66,15,51,214,179,61,103,194,134,57,35,22,77
"2011","Gateshead 020A","E01008193",888,125,33,92,259,147,57,48,88,77,29,23,6,58
"2011","Gateshead 020B","E01008194",1049,98,24,74,226,214,72,94,156,108,20,11,9,61
"2011","Gateshead 020C","E01008234",1597,217,52,165,417,246,98,125,213,146,44,23,21,91
"2011","Gateshead 020D","E01008239",1147,176,32,144,341,181,109,60,105,73,27,19,8,75
"2011","Gateshead 021A","E01008218",1165,36,12,24,94,106,51,102,289,326,101,73,28,60
"2011","Gateshead 021B","E01008220",847,16,3,13,69,96,35,68,185,209,104,70,34,65
"2011","Gateshead 021C","E01008221",1230,33,9,24,138,149,61,102,295,247,117,77,40,88
"2011","Gateshead 021D","E01008225",1300,109,32,77,248,199,91,121,203,212,52,34,18,65
"2011","Gateshead 021E","E01008227",1186,6,0,6,81,93,53,81,259,300,212,162,50,101
"2011","Gateshead 022A","E01008184",1039,167,35,132,311,155,109,59,96,65,31,22,9,46
"2011","Gateshead 022B","E01008185",966,45,12,33,129,98,79,80,219,176,66,39,27,74
"2011","Gateshead 022C","E01008188",1044,124,30,94,271,147,73,69,161,100,17,12,5,82
"2011","Gateshead 022D","E01008278",1079,114,30,84,286,156,108,99,162,82,19,8,11,53
"2011","Gateshead 023A","E01008189",1014,27,6,21,108,121,52,102,229,214,92,67,25,69
"2011","Gateshead 023B","E01008190",970,85,21,64,210,163,62,90,171,107,16,10,6,66
"2011","Gateshead 023C","E01008191",1125,33,7,26,140,156,54,100,277,220,75,46,29,70
"2011","Gateshead 023D","E01008192",1071,53,17,36,146,111,74,111,222,194,79,55,24,81
"2011","Gateshead 023E","E01008217",1114,46,15,31,163,152,60,100,236,220,68,40,28,69
"2011","Gateshead 024A","E01008183",1070,76,21,55,226,131,71,91,190,157,67,41,26,61
"2011","Gateshead 024B","E01008186",1511,58,12,46,258,163,108,119,325,270,117,68,49,93
"2011","Gateshead 024C","E01008187",1186,66,17,49,206,144,83,106,252,191,57,37,20,81
"2011","Gateshead 024D","E01008196",1439,114,36,78,303,209,130,114,233,192,59,36,23,85
"2011","Gateshead 025A","E01008222",1100,40,7,33,157,154,81,108,212,225,63,30,33,60
"2011","Gateshead 025B","E01008223",1272,53,9,44,138,152,62,108,301,266,115,80,35,77
"2011","Gateshead 025C","E01008224",1368,127,43,84,273,207,109,111,196,198,47,37,10,100
"2011","Gateshead 025D","E01008226",1140,102,31,71,197,151,97,80,214,162,61,34,27,76
"2011","Gateshead 026A","E01008172",1228,72,21,51,230,190,67,121,221,193,53,33,20,81
"2011","Gateshead 026B","E01008173",1151,40,13,27,148,133,66,97,210,249,114,81,33,94
"2011","Gateshead 026C","E01008174",1475,133,41,92,286,219,107,127,245,190,61,43,18,107
"2011","Gateshead 026D","E01008175",1098,64,12,52,188,159,93,95,212,154,76,45,31,57
"2011","Gateshead 026E","E01008176",1149,72,25,47,214,213,83,117,181,151,37,21,16,81
"2011","Gateshead 027A","E01008162",1967,287,26,261,404,241,72,139,241,219,136,88,48,228
"2011","Gateshead 027B","E01008164",1009,58,15,43,170,92,39,61,173,192,128,96,32,96
"2011","Gateshead 027C","E01008166",1368,187,16,171,220,93,49,77,186,206,178,131,47,172
"2011","Gateshead 027D","E01008168",1981,258,27,231,325,185,51,104,226,220,124,85,39,488
"2011","Gateshead 028A","E01008163",1342,76,17,59,233,142,70,78,209,197,90,64,26,247
"2011","Gateshead 028B","E01008203",1433,81,7,74,247,199,69,91,219,238,141,96,45,148
"2011","Gateshead 028C","E01008205",1099,178,33,145,294,163,71,79,120,96,31,19,12,67
"2011","Newcastle upon Tyne 001A","E01008294",1184,130,23,107,278,224,73,88,166,80,33,22,11,112
"2011","Newcastle upon Tyne 001B","E01008306",1215,116,22,94,230,167,109,79,199,183,58,43,15,74
"2011","Newcastle upon Tyne 001C","E01008307",715,43,10,33,129,98,43,53,138,128,38,28,10,45
"2011","Newcastle upon Tyne 001D","E01008308",1043,109,27,82,206,152,73,66,158,153,64,39,25,62
"2011","Newcastle upon Tyne 001E","E01008311",1297,206,34,172,353,199,78,81,161,79,27,16,11,113
"2011","Newcastle upon Tyne 001F","E01008312",940,101,16,85,229,162,44,62,116,83,46,38,8,97
"2011","Newcastle upon Tyne 001G","E01008313",932,85,14,71,179,148,61,83,154,98,36,23,13,88
"2011","Newcastle upon Tyne 002A","E01008309",1178,291,58,233,385,136,84,37,94,35,21,17,4,95
"2011","Newcastle upon Tyne 002C","E01008352",1054,162,19,143,209,131,70,71,130,94,68,54,14,119
"2011","Newcastle upon Tyne 002D","E01008357",1178,309,43,266,359,130,118,38,69,27,37,25,12,91
"2011","Newcastle upon Tyne 002E","E01008358",1113,191,25,166,281,161,75,58,126,89,51,31,20,81
"2011","Newcastle upon Tyne 002F","E01033550",1380,401,86,315,440,144,136,35,63,31,25,18,7,105
"2011","Newcastle upon Tyne 002G","E01033551",1295,328,67,261,416,166,120,40,68,35,28,20,8,94
"2011","Newcastle upon Tyne 003A","E01008336",994,42,6,36,143,159,70,90,168,167,78,52,26,77
"2011","Newcastle upon Tyne 003B","E01008337",979,39,4,35,134,136,58,78,205,159,90,67,23,80
"2011","Newcastle upon Tyne 003C","E01008338",908,55,14,41,138,120,66,72,162,105,96,81,15,94
"2011","Newcastle upon Tyne 003D","E01008339",1069,37,9,28,159,127,79,73,192,181,115,84,31,106
"2011","Newcastle upon Tyne 003E","E01008340",1034,21,3,18,95,84,50,84,237,192,171,132,39,100
"2011","Newcastle upon Tyne 003F","E01008341",998,62,12,50,137,144,56,96,202,154,77,54,23,70
"2011","Newcastle upon Tyne 003G","E01008342",1020,90,28,62,281,200,68,86,121,91,33,21,12,50
"2011","Newcastle upon Tyne 004A","E01008293",1110,98,22,76,236,201,72,92,174,104,40,26,14,93
"2011","Newcastle upon Tyne 004B","E01008456",1057,26,10,16,149,143,52,81,229,213,94,65,29,70
"2011","Newcastle upon Tyne 004C","E01008457",1144,40,8,32,174,156,73,83,222,216,124,85,39,56
"2011","Newcastle upon Tyne 004D","E01008458",1178,184,41,143,296,160,136,73,131,86,28,23,5,84
"2011","Newcastle upon Tyne 004E","E01008459",1234,25,3,22,109,115,55,88,280,256,194,148,46,112
"2011","Newcastle upon Tyne 004F","E01008460",1056,21,4,17,123,103,63,84,260,228,97,61,36,77
"2011","Newcastle upon Tyne 005A","E01008351",1040,162,21,141,252,149,89,65,125,75,42,38,4,81
"2011","Newcastle upon Tyne 005B","E01008354",1288,308,30,278,297,136,65,48,156,99,37,27,10,142
"2011","Newcastle upon Tyne 005C","E01008418",1461,482,75,407,473,117,104,49,63,24,26,14,12,123
"2011","Newcastle upon Tyne 005D","E01008420",980,365,46,319,278,92,64,4,49,13,14,9,5,101
"2011","Newcastle upon Tyne 005E","E01008422",1292,325,39,286,331,120,60,23,67,32,18,12,6,316
"2011","Newcastle upon Tyne 005F","E01008424",1421,270,25,245,285,155,46,44,83,53,62,44,18,423
"2011","Newcastle upon Tyne 006A","E01008353",1091,107,18,89,197,146,59,81,162,141,67,50,17,131
"2011","Newcastle upon Tyne 006B","E01008355",1136,360,44,316,352,108,60,29,59,39,40,28,12,89
"2011","Newcastle upon Tyne 006C","E01008356",1167,239,41,198,228,131,89,58,127,89,99,84,15,107
"2011","Newcastle upon Tyne 006D","E01008378",1012,257,35,222,235,102,81,48,83,59,40,34,6,107
"2011","Newcastle upon Tyne 006E","E01008419",1138,433,51,382,331,101,61,23,34,18,24,16,8,113
"2011","Newcastle upon Tyne 006F","E01008421",1111,339,37,302,330,103,76,39,70,28,26,16,10,100
"2011","Newcastle upon Tyne 006G","E01008423",955,381,58,323,224,74,89,10,31,29,13,9,4,104
"2011","Newcastle upon Tyne 007A","E01008317",1037,248,31,217,298,134,80,47,70,47,32,24,8,81
"2011","Newcastle upon Tyne 007B","E01008319",1399,303,52,251,371,214,143,79,107,48,31,28,3,103
"2011","Newcastle upon Tyne 007C","E01008320",1071,132,17,115,265,182,72,64,128,98,41,31,10,89
"2011","Newcastle upon Tyne 007D","E01008321",1266,361,42,319,341,167,79,53,84,45,38,29,9,98
"2011","Newcastle upon Tyne 007E","E01008322",1104,193,30,163,285,183,82,50,90,77,41,24,17,103
"2011","Newcastle upon Tyne 007F","E01008323",1359,163,16,147,278,208,65,74,129,103,36,25,11,303
"2011","Newcastle upon Tyne 008A","E01008295",1037,20,3,17,120,110,53,88,238,194,120,86,34,94
"2011","Newcastle upon Tyne 008B","E01008374",1162,154,21,133,284,147,73,84,155,104,59,42,17,102
"2011","Newcastle upon Tyne 008C","E01008375",1104,73,9,64,179,150,67,90,205,176,95,71,24,69
"2011","Newcastle upon Tyne 008D","E01008376",894,171,31,140,244,125,68,62,79,45,33,20,13,67
"2011","Newcastle upon Tyne 008E","E01008377",1534,148,12,136,270,165,86,101,249,212,173,130,43,130
"2011","Newcastle upon Tyne 008F","E01008379",1071,105,16,89,177,129,86,97,166,147,83,53,30,81
"2011","Newcastle upon Tyne 008G","E01008380",1178,33,7,26,99,84,45,73,211,212,288,239,49,133
"2011","Newcastle upon Tyne 011A","E01008296",1093,42,9,33,154,149,65,118,247,210,65,43,22,43
"2011","Newcastle upon Tyne 011B","E01008297",990,30,11,19,105,84,55,72,211,239,131,95,36,63
"2011","Newcastle upon Tyne 011C","E01008298",1028,44,9,35,171,145,69,92,206,174,54,36,18,73
"2011","Newcastle upon Tyne 011D","E01008299",915,21,7,14,86,97,50,77,206,202,90,66,24,86
"2011","Newcastle upon Tyne 012A","E01008314",1232,89,18,71,188,130,47,60,101,80,35,24,11,502
"2011","Newcastle upon Tyne 012B","E01008315",1139,182,31,151,262,136,77,56,149,100,47,28,19,130
"2011","Newcastle upon Tyne 012C","E01008316",1236,174,33,141,327,222,101,74,112,90,29,22,7,107
"2011","Newcastle upon Tyne 012D","E01008318",1038,64,6,58,153,136,72,77,176,165,87,61,26,108
"2011","Newcastle upon Tyne 012E","E01008363",1259,164,31,133,326,213,74,74,138,110,37,27,10,123
"2011","Newcastle upon Tyne 012F","E01008365",1254,273,41,232,379,131,99,40,63,38,36,22,14,195
"2011","Newcastle upon Tyne 013A","E01008366",1934,190,13,177,194,79,40,22,26,33,22,16,6,1328
"2011","Newcastle upon Tyne 013B","E01008369",1837,253,27,226,237,82,60,24,41,34,25,12,13,1081
"2011","Newcastle upon Tyne 013C","E01008371",1004,337,42,295,236,76,99,18,32,8,20,14,6,178
"2011","Newcastle upon Tyne 013D","E01008372",1799,204,16,188,170,79,36,28,57,40,24,21,3,1161
"2011","Newcastle upon Tyne 013E","E01008373",2281,120,11,109,140,79,28,25,39,32,16,12,4,1802
"2011","Newcastle upon Tyne 014A","E01008400",957,38,5,33,119,105,69,81,218,178,99,65,34,50
"2011","Newcastle upon Tyne 014B","E01008401",1051,32,10,22,143,110,75,95,210,242,77,50,27,67
"2011","Newcastle upon Tyne 014C","E01008402",1106,94,14,80,212,150,95,113,196,143,43,31,12,60
"2011","Newcastle upon Tyne 014D","E01008403",1059,96,23,73,232,179,77,92,161,117,36,21,15,69
"2011","Newcastle upon Tyne 014E","E01008404",1290,75,20,55,267,178,95,133,205,196,85,54,31,56
"2011","Newcastle upon Tyne 014F","E01008405",1020,44,17,27,159,127,70,99,210,201,53,29,24,57
"2011","Newcastle upon Tyne 014G","E01008443",1055,125,26,99,252,221,88,86,130,80,16,6,10,57
"2011","Newcastle upon Tyne 015A","E01008324",878,24,6,18,94,97,54,84,207,175,72,45,27,71
"2011","Newcastle upon Tyne 015B","E01008325",969,20,7,13,128,135,44,89,232,192,84,60,24,45
"2011","Newcastle upon Tyne 015C","E01008326",1057,72,17,55,213,216,68,76,191,104,17,11,6,100
"2011","Newcastle upon Tyne 015D","E01008327",868,19,9,10,94,71,46,53,224,200,91,64,27,70
"2011","Newcastle upon Tyne 015E","E01008328",895,84,20,64,208,181,50,84,137,76,21,15,6,54
"2011","Newcastle upon Tyne 015F","E01008329",1084,54,15,39,179,180,91,91,207,139,61,35,26,82
"2011","Newcastle upon Tyne 015G","E01008330",927,32,7,25,131,102,57,93,207,174,75,44,31,56
"2011","Newcastle upon Tyne 016A","E01008300",1140,57,8,49,157,129,79,85,217,210,115,90,25,91
"2011","Newcastle upon Tyne 016B","E01008450",979,38,3,35,108,104,59,67,194,177,112,82,30,120
"2011","Newcastle upon Tyne 016C","E01008451",1358,84,8,76,244,183,68,118,249,192,103,73,30,117
"2011","Newcastle upon Tyne 016D","E01008452",1044,190,20,170,249,101,125,33,71,43,69,60,9,163
"2011","Newcastle upon Tyne 017A","E01008367",2068,305,27,278,276,81,63,31,73,43,51,22,29,1145
"2011","Newcastle upon Tyne 017B","E01008368",1681,198,18,180,149,51,35,13,30,18,19,12,7,1168
"2011","Newcastle upon Tyne 017C","E01008370",1435,315,37,278,265,102,85,29,48,34,32,18,14,525
"2011","Newcastle upon Tyne 017D","E01008409",1502,256,28,228,274,101,47,17,62,42,42,29,13,661
"2011","Newcastle upon Tyne 017E","E01008411",1674,133,13,120,172,58,38,39,90,61,38,24,14,1045
"2011","Newcastle upon Tyne 018A","E01008303",1546,40,3,37,152,160,62,121,232,258,176,127,49,345
"2011","Newcastle upon Tyne 018B","E01008359",1454,129,11,118,243,108,35,44,120,107,62,46,16,606
"2011","Newcastle upon Tyne 018C","E01008360",1520,193,14,179,345,186,48,72,122,73,38,23,15,443
"2011","Newcastle upon Tyne 018D","E01008361",1423,117,8,109,246,165,49,74,152,112,52,30,22,456
"2011","Newcastle upon Tyne 018E","E01008362",1630,101,5,96,228,127,38,57,140,93,71,44,27,775
"2011","Newcastle upon Tyne 018F","E01008364",1498,195,26,169,323,179,50,62,104,68,51,31,20,466
"2011","Newcastle upon Tyne 019A","E01008343",1101,76,19,57,181,163,87,88,182,162,65,43,22,97
"2011","Newcastle upon Tyne 019B","E01008344",1128,50,13,37,168,132,78,103,231,189,68,49,19,109
"2011","Newcastle upon Tyne 019C","E01008345",1151,34,9,25,128,149,85,89,266,238,105,73,32,57
"2011","Newcastle upon Tyne 019D","E01008346",1367,59,9,50,155,90,64,68,158,101,55,41,14,617
"2011","Newcastle upon Tyne 019E","E01008347",1017,93,13,80,172,133,99,71,170,117,68,56,12,94
"2011","Newcastle upon Tyne 019F","E01008348",794,41,4,37,78,75,64,55,133,125,109,90,19,114
"2011","Newcastle upon Tyne 019G","E01008349",1067,60,6,54,129,118,137,57,126,80,156,135,21,204
"2011","Newcastle upon Tyne 019H","E01008350",936,35,9,26,147,126,69,86,161,172,74,52,22,66
"2011","Newcastle upon Tyne 020A","E01008430",1017,52,7,45,127,169,60,82,189,188,67,41,26,83
"2011","Newcastle upon Tyne 020B","E01008431",1052,43,9,34,164,168,61,100,206,197,54,31,23,59
"2011","Newcastle upon Tyne 020C","E01008433",1024,74,17,57,211,186,79,100,146,122,40,28,12,66
"2011","Newcastle upon Tyne 020D","E01008434",1111,81,25,56,227,178,82,97,167,141,35,20,15,103
"2011","Newcastle upon Tyne 020E","E01008435",1051,45,15,30,117,131,47,90,204,215,122,83,39,80
"2011","Newcastle upon Tyne 020F","E01008436",1112,32,9,23,119,115,48,93,231,243,148,107,41,83
"2011","Newcastle upon Tyne 021A","E01008381",1102,74,24,50,261,212,75,119,154,120,19,9,10,68
"2011","Newcastle upon Tyne 021B","E01008382",855,18,4,14,82,81,54,60,186,192,103,80,23,79
"2011","Newcastle upon Tyne 021C","E01008383",1042,35,9,26,141,140,60,89,240,194,70,47,23,73
"2011","Newcastle upon Tyne 021D","E01008384",1026,53,22,31,176,172,89,109,171,134,50,29,21,72
"2011","Newcastle upon Tyne 021E","E01008385",1060,41,7,34,191,143,69,96,193,166,89,52,37,72
"2011","Newcastle upon Tyne 021F","E01008386",988,56,11,45,170,182,76,91,170,137,34,22,12,72
"2011","Newcastle upon Tyne 021G","E01008387",1052,68,17,51,237,175,82,94,170,123,41,29,12,62
"2011","Newcastle upon Tyne 022B","E01008396",2525,68,3,65,115,79,68,76,174,161,220,180,40,1564
"2011","Newcastle upon Tyne 022C","E01008398",1289,41,8,33,120,99,67,75,192,227,259,192,67,209
"2011","Newcastle upon Tyne 022D","E01008449",1436,93,4,89,156,103,80,46,135,116,170,146,24,537
"2011","Newcastle upon Tyne 022E","E01008453",1180,172,17,155,282,112,106,50,118,53,97,85,12,190
"2011","Newcastle upon Tyne 022G","E01008455",1122,58,5,53,142,104,135,50,121,81,193,173,20,238
"2011","Newcastle upon Tyne 022H","E01033556",2137,177,11,166,211,139,93,61,186,147,179,149,30,944
"2011","Newcastle upon Tyne 023A","E01008406",1279,77,10,67,142,107,46,80,164,144,109,79,30,410
"2011","Newcastle upon Tyne 023B","E01008407",2658,79,10,69,129,105,36,43,121,121,79,58,21,1945
"2011","Newcastle upon Tyne 023D","E01008410",1499,140,20,120,196,109,52,53,111,106,45,27,18,687
"2011","Newcastle upon Tyne 023E","E01008412",1479,182,25,157,268,106,51,56,92,83,41,31,10,600
"2011","Newcastle upon Tyne 023F","E01008413",1337,85,11,74,172,83,56,45,103,73,85,67,18,635
"2011","Newcastle upon Tyne 023G","E01033548",977,187,26,161,176,77,46,47,87,102,69,43,26,186
"2011","Newcastle upon Tyne 023H","E01033553",2540,102,13,89,158,73,32,28,78,65,54,44,10,1950
"2011","Newcastle upon Tyne 024A","E01008394",1387,45,1,44,45,20,7,7,20,15,32,19,13,1196
"2011","Newcastle upon Tyne 024B","E01008395",1231,126,8,118,141,75,41,57,117,133,102,74,28,439
"2011","Newcastle upon Tyne 024C","E01008397",1755,76,7,69,109,36,31,30,46,33,48,34,14,1346
"2011","Newcastle upon Tyne 024D","E01008399",1324,39,9,30,139,107,54,74,233,215,241,191,50,222
"2011","Newcastle upon Tyne 024E","E01008439",1301,53,4,49,133,84,67,86,207,211,263,207,56,197
"2011","Newcastle upon Tyne 024G","E01033543",1260,142,12,130,167,69,36,36,39,34,47,29,18,690
"2011","Newcastle upon Tyne 024H","E01033545",1145,176,16,160,217,101,36,34,72,55,50,43,7,404
"2011","Newcastle upon Tyne 024I","E01033554",1192,176,14,162,199,82,53,41,80,61,70,48,22,430
"2011","Newcastle upon Tyne 025B","E01008415",866,23,7,16,115,99,53,69,145,190,111,83,28,61
"2011","Newcastle upon Tyne 025C","E01008416",1298,76,12,64,266,206,91,114,199,184,71,51,20,91
"2011","Newcastle upon Tyne 025E","E01033547",1440,33,12,21,113,113,84,96,309,369,232,175,57,91
"2011","Newcastle upon Tyne 026A","E01008301",1478,169,25,144,287,162,84,92,189,205,126,84,42,164
"2011","Newcastle upon Tyne 026B","E01008302",1215,27,6,21,126,125,57,101,259,280,175,133,42,65
"2011","Newcastle upon Tyne 026C","E01008304",1482,47,9,38,157,117,67,119,277,303,243,189,54,152
"2011","Newcastle upon Tyne 026D","E01008305",1437,72,7,65,144,122,52,102,261,287,248,197,51,149
"2011","Newcastle upon Tyne 026E","E01008391",1047,24,5,19,82,93,42,62,231,259,167,114,53,87
"2011","Newcastle upon Tyne 026F","E01008392",1230,49,7,42,146,140,62,92,261,237,153,105,48,90
"2011","Newcastle upon Tyne 026G","E01008432",1042,46,13,33,141,157,68,73,185,225,71,54,17,76
"2011","Newcastle upon Tyne 027A","E01008288",1002,64,9,55,176,153,83,79,173,152,77,57,20,45
"2011","Newcastle upon Tyne 027B","E01008289",1061,29,4,25,127,107,52,55,231,205,161,127,34,94
"2011","Newcastle upon Tyne 027C","E01008290",930,27,8,19,97,97,46,58,186,213,128,91,37,78
"2011","Newcastle upon Tyne 027D","E01008291",1449,24,6,18,120,97,52,82,269,332,328,245,83,145
"2011","Newcastle upon Tyne 027E","E01008292",998,73,22,51,230,181,87,71,149,107,30,18,12,70
"2011","Newcastle upon Tyne 028A","E01008388",1257,22,4,18,101,132,48,72,292,302,191,135,56,97
"2011","Newcastle upon Tyne 028B","E01008389",1217,12,5,7,96,122,43,89,304,297,158,116,42,96
"2011","Newcastle upon Tyne 028C","E01008426",1111,16,5,11,71,62,71,72,239,291,197,144,53,92
"2011","Newcastle upon Tyne 028D","E01008429",968,17,6,11,85,92,53,73,202,241,137,96,41,68
"2011","Newcastle upon Tyne 029A","E01008331",1297,32,4,28,117,74,77,76,174,124,330,292,38,293
"2011","Newcastle upon Tyne 029B","E01008332",1560,41,5,36,133,90,79,99,239,277,322,254,68,280
"2011","Newcastle upon Tyne 029C","E01008333",1271,63,1,62,152,95,101,82,169,159,289,252,37,161
"2011","Newcastle upon Tyne 029D","E01008334",1489,49,11,38,171,117,106,104,247,218,223,189,34,254
"2011","Newcastle upon Tyne 029E","E01008335",1400,50,10,40,151,147,144,110,179,147,252,221,31,220
"2011","Newcastle upon Tyne 029F","E01008437",870,26,4,22,86,41,44,58,152,190,191,152,39,82
"2011","Newcastle upon Tyne 029G","E01008438",1276,35,7,28,113,84,56,90,224,309,251,177,74,114
"2011","Newcastle upon Tyne 030A","E01008390",1192,30,3,27,117,103,55,80,262,267,198,149,49,80
"2011","Newcastle upon Tyne 030B","E01008425",1354,22,3,19,115,108,57,88,282,315,259,177,82,108
"2011","Newcastle upon Tyne 030C","E01008427",890,12,3,9,54,58,28,49,187,211,220,173,47,71
"2011","Newcastle upon Tyne 030D","E01008428",903,27,5,22,98,98,54,80,178,222,83,58,25,63
"2011","Newcastle upon Tyne 031A","E01008441",1178,56,8,48,148,154,77,119,254,223,56,39,17,91
"2011","Newcastle upon Tyne 031B","E01008442",1010,91,24,67,229,219,80,94,137,81,17,10,7,62
"2011","Newcastle upon Tyne 031C","E01008444",1137,105,26,79,260,211,113,100,174,73,35,22,13,66
"2011","Newcastle upon Tyne 031D","E01008445",1388,80,17,63,248,208,134,121,266,184,58,39,19,89
"2011","Newcastle upon Tyne 031E","E01008446",1055,102,33,69,238,211,70,100,154,101,23,13,10,56
"2011","Newcastle upon Tyne 031F","E01008447",943,84,14,70,194,177,64,83,166,73,26,17,9,76
"2011","Newcastle upon Tyne 031G","E01008448",1197,190,48,142,302,233,95,88,139,62,23,12,11,65
"2011","North Tyneside 001A","E01008547",971,180,40,140,321,176,91,30,72,20,12,3,9,69
"2011","North Tyneside 001B","E01008548",1014,190,50,140,327,188,67,36,83,33,20,15,5,70
"2011","North Tyneside 001C","E01008549",1023,168,42,126,307,183,67,53,118,50,16,9,7,61
"2011","North Tyneside 001D","E01008551",1010,173,41,132,305,182,88,59,88,43,16,10,6,56
"2011","North Tyneside 002A","E01008478",1148,29,13,16,150,147,86,104,232,241,109,62,47,50
"2011","North Tyneside 002B","E01008480",1141,50,13,37,150,154,93,115,229,219,78,50,28,53
"2011","North Tyneside 002C","E01008504",1198,131,53,78,285,253,65,101,175,97,27,19,8,64
"2011","North Tyneside 002D","E01008578",1087,62,12,50,180,172,75,124,201,159,49,30,19,65
"2011","North Tyneside 002E","E01008583",1078,67,20,47,159,175,67,117,192,163,69,39,30,69
"2011","North Tyneside 003A","E01008520",989,169,33,136,297,158,83,41,86,42,29,19,10,84
"2011","North Tyneside 003B","E01008523",941,220,53,167,313,119,80,34,55,32,11,6,5,77
"2011","North Tyneside 003C","E01008546",1024,201,48,153,365,169,70,38,81,23,12,8,4,65
"2011","North Tyneside 003D","E01008550",1188,229,42,187,395,160,101,36,94,57,26,12,14,90
"2011","North Tyneside 004A","E01008577",947,45,7,38,183,176,60,88,195,118,33,13,20,49
"2011","North Tyneside 004B","E01008579",1025,102,19,83,263,209,86,80,143,78,17,8,9,47
"2011","North Tyneside 004C","E01008580",1050,104,22,82,288,200,76,97,141,68,23,19,4,53
"2011","North Tyneside 004D","E01008581",942,86,21,65,260,202,69,71,127,64,22,8,14,41
"2011","North Tyneside 004E","E01008582",983,72,13,59,201,160,80,97,134,132,53,30,23,54
"2011","North Tyneside 005A","E01008517",1103,162,29,133,369,178,75,42,115,56,20,12,8,86
"2011","North Tyneside 005B","E01008519",1023,152,31,121,282,187,56,52,120,66,28,17,11,80
"2011","North Tyneside 005C","E01008521",1084,143,28,115,295,213,70,60,146,73,22,19,3,62
"2011","North Tyneside 005D","E01008522",1166,164,41,123,373,209,98,70,109,47,21,8,13,75
"2011","North Tyneside 006A","E01008584",1229,111,21,90,262,155,118,87,174,99,137,108,29,86
"2011","North Tyneside 006B","E01008585",1159,168,28,140,342,154,101,66,113,83,52,41,11,80
"2011","North Tyneside 006C","E01008587",1060,144,32,112,302,157,101,59,128,72,46,28,18,51
"2011","North Tyneside 006D","E01008588",1238,162,25,137,339,156,97,76,153,105,63,44,19,87
"2011","North Tyneside 006E","E01008589",1075,178,40,138,350,175,80,47,90,52,20,11,9,83
"2011","North Tyneside 007A","E01008518",1143,142,33,109,300,207,84,71,150,97,30,15,15,62
"2011","North Tyneside 007B","E01008564",1088,110,25,85,308,193,107,76,130,75,30,20,10,59
"2011","North Tyneside 007C","E01008565",1501,142,24,118,368,246,129,100,197,168,70,35,35,81
"2011","North Tyneside 007D","E01008567",1024,46,6,40,153,159,66,65,231,156,83,54,29,65
"2011","North Tyneside 008A","E01008475",1293,125,26,99,289,273,79,102,204,135,16,11,5,70
"2011","North Tyneside 008B","E01008476",1229,50,12,38,153,188,80,96,237,261,97,58,39,67
"2011","North Tyneside 008C","E01008477",1139,34,8,26,146,164,59,103,250,221,88,46,42,74
"2011","North Tyneside 008D","E01008479",1096,96,24,72,257,231,64,94,174,125,9,6,3,46
"2011","North Tyneside 009A","E01008552",1217,140,37,103,304,227,76,97,145,108,54,32,22,66
"2011","North Tyneside 009B","E01008553",1308,141,22,119,382,219,78,85,179,79,43,30,13,102
"2011","North Tyneside 009C","E01008554",1223,125,19,106,264,153,114,83,191,124,67,45,22,102
"2011","North Tyneside 009D","E01008555",1109,62,15,47,187,167,90,86,182,179,72,41,31,84
"2011","North Tyneside 009E","E01008586",1078,178,25,153,339,132,97,46,116,73,36,26,10,61
"2011","North Tyneside 010A","E01008495",1245,191,33,158,325,235,92,93,126,79,26,11,15,78
"2011","North Tyneside 010B","E01008496",1148,131,20,111,310,155,89,79,150,122,51,31,20,61
"2011","North Tyneside 010C","E01008497",1030,129,30,99,313,187,67,61,130,65,20,9,11,58
"2011","North Tyneside 010D","E01008498",982,104,21,83,252,180,64,82,148,71,18,8,10,63
"2011","North Tyneside 011B","E01008568",1066,62,19,43,155,192,71,103,219,165,43,27,16,56
"2011","North Tyneside 011C","E01008569",978,47,14,33,141,137,63,91,214,169,64,44,20,52
"2011","North Tyneside 011D","E01008570",1009,98,27,71,230,195,76,71,147,111,29,12,17,52
"2011","North Tyneside 011E","E01032647",1309,270,52,218,381,220,70,64,123,75,31,19,12,75
"2011","North Tyneside 011F","E01032648",1059,103,19,84,188,159,56,79,185,165,71,54,17,53
"2011","North Tyneside 012A","E01008500",1189,110,19,91,281,215,67,98,169,142,39,28,11,68
"2011","North Tyneside 012B","E01008505",1255,172,48,124,321,219,84,83,149,120,42,23,19,65
"2011","North Tyneside 012C","E01008506",1057,52,13,39,168,182,48,91,224,183,49,27,22,60
"2011","North Tyneside 012D","E01008507",1141,124,27,97,280,206,63,101,157,106,28,16,12,76
"2011","North Tyneside 013A","E01008493",1092,128,37,91,293,180,74,74,128,107,25,14,11,83
"2011","North Tyneside 013B","E01008494",1064,77,27,50,229,180,87,90,190,115,37,27,10,59
"2011","North Tyneside 013C","E01008556",1387,158,42,116,391,250,92,107,146,95,49,37,12,99
"2011","North Tyneside 013D","E01008557",1247,179,43,136,343,222,96,80,121,63,27,18,9,116
"2011","North Tyneside 014A","E01008470",1020,86,19,67,213,158,67,70,170,139,54,36,18,63
"2011","North Tyneside 014B","E01008499",1210,73,14,59,245,197,73,82,205,192,62,46,16,81
"2011","North Tyneside 014C","E01008502",1162,62,9,53,199,186,74,90,221,196,58,31,27,76
"2011","North Tyneside 014D","E01008516",918,99,34,65,226,209,63,64,103,85,22,14,8,47
"2011","North Tyneside 015A","E01008488",1052,37,11,26,156,154,69,97,223,184,77,41,36,55
"2011","North Tyneside 015B","E01008489",1145,47,12,35,147,143,69,90,250,195,107,64,43,97
"2011","North Tyneside 015C","E01008490",1182,85,18,67,219,176,74,116,240,149,56,36,20,67
"2011","North Tyneside 015D","E01008491",1130,43,12,31,153,149,78,98,232,206,92,53,39,79
"2011","North Tyneside 016A","E01008558",1170,221,35,186,368,180,93,66,88,70,24,10,14,60
"2011","North Tyneside 016B","E01008560",1287,270,47,223,430,157,120,53,94,70,32,26,6,61
"2011","North Tyneside 016C","E01008561",1237,134,16,118,279,142,98,79,185,189,78,47,31,53
"2011","North Tyneside 016D","E01008562",1059,198,35,163,289,132,94,59,112,65,35,19,16,75
"2011","North Tyneside 017A","E01008525",1103,155,36,119,324,179,99,65,118,74,34,21,13,55
"2011","North Tyneside 017B","E01008527",1163,159,33,126,323,206,80,69,138,93,26,18,8,69
"2011","North Tyneside 017C","E01008559",1185,148,16,132,354,182,71,86,141,111,34,19,15,58
"2011","North Tyneside 017D","E01008563",1010,235,57,178,337,135,85,38,58,25,18,10,8,79
"2011","North Tyneside 018A","E01008469",1096,180,26,154,287,205,66,70,111,81,25,14,11,71
"2011","North Tyneside 018B","E01008472",1062,147,23,124,314,192,87,60,109,65,23,8,15,65
"2011","North Tyneside 018C","E01008473",965,157,25,132,283,146,78,45,62,54,79,69,10,61
"2011","North Tyneside 018D","E01008501",1521,222,51,171,389,280,110,110,150,111,50,35,15,99
"2011","North Tyneside 018E","E01008503",1166,63,12,51,216,198,72,102,196,181,68,34,34,70
"2011","North Tyneside 019A","E01008471",1181,61,9,52,239,202,65,82,210,179,56,36,20,87
"2011","North Tyneside 019B","E01008474",1070,42,4,38,152,165,55,74,194,214,92,62,30,82
"2011","North Tyneside 019C","E01008513",1671,230,20,210,365,265,85,103,240,218,89,62,27,76
"2011","North Tyneside 019D","E01008514",1271,96,18,78,199,194,79,92,225,200,80,53,27,106
"2011","North Tyneside 019F","E01032649",843,114,14,100,201,117,41,62,110,117,44,25,19,37
"2011","North Tyneside 019G","E01032650",837,54,6,48,113,126,28,61,190,155,67,38,29,43
"2011","North Tyneside 020A","E01008486",1024,40,6,34,159,167,54,110,191,180,59,39,20,64
"2011","North Tyneside 020B","E01008487",1047,52,18,34,168,134,71,99,195,192,72,38,34,64
"2011","North Tyneside 020C","E01008526",1137,113,21,92,318,195,79,87,165,82,18,9,9,80
"2011","North Tyneside 020D","E01008530",1169,62,9,53,227,207,60,99,203,191,46,29,17,74
"2011","North Tyneside 021A","E01008461",1069,42,8,34,154,163,46,100,208,196,70,45,25,90
"2011","North Tyneside 021B","E01008466",1109,102,29,73,272,231,77,98,157,87,26,8,18,59
"2011","North Tyneside 021C","E01008467",1109,80,16,64,233,242,55,101,175,123,41,24,17,59
"2011","North Tyneside 021D","E01008468",1081,50,12,38,166,192,61,90,188,172,81,53,28,81
"2011","North Tyneside 022A","E01008483",1250,94,26,68,273,208,90,99,208,157,54,35,19,67
"2011","North Tyneside 022B","E01008524",1342,130,21,109,272,180,103,82,229,163,133,80,53,50
"2011","North Tyneside 022C","E01008528",1101,129,24,105,294,192,66,73,147,98,27,16,11,75
"2011","North Tyneside 022D","E01008529",1186,148,21,127,328,196,102,63,144,105,42,26,16,58
"2011","North Tyneside 023A","E01008481",1057,26,6,20,127,138,53,64,255,238,78,44,34,78
"2011","North Tyneside 023B","E01008482",1190,44,11,33,158,135,71,93,272,226,119,71,48,72
"2011","North Tyneside 023C","E01008484",996,27,7,20,107,104,53,89,233,220,106,60,46,57
"2011","North Tyneside 023D","E01008485",1015,19,2,17,83,100,37,70,225,224,174,125,49,83
"2011","North Tyneside 023E","E01008492",1255,41,10,31,160,163,70,123,276,207,123,83,40,92
"2011","North Tyneside 024A","E01008462",893,37,13,24,128,150,42,80,180,162,52,32,20,62
"2011","North Tyneside 024B","E01008463",1004,35,11,24,163,158,43,96,214,168,64,39,25,63
"2011","North Tyneside 024C","E01008464",1054,51,14,37,190,216,56,104,201,147,31,20,11,58
"2011","North Tyneside 024D","E01008465",1063,69,20,49,192,209,70,114,185,147,22,10,12,55
"2011","North Tyneside 025A","E01008531",1197,98,25,73,235,234,81,99,210,138,23,10,13,79
"2011","North Tyneside 025B","E01008532",1108,44,12,32,170,206,58,121,217,179,48,30,18,65
"2011","North Tyneside 025C","E01008534",1084,86,16,70,234,199,70,98,184,116,24,16,8,73
"2011","North Tyneside 025D","E01008538",1030,61,19,42,191,206,58,99,164,138,22,12,10,91
"2011","North Tyneside 026A","E01008508",1134,36,11,25,105,173,65,110,237,231,95,64,31,82
"2011","North Tyneside 026B","E01008509",1139,42,9,33,148,163,42,110,253,215,96,60,36,70
"2011","North Tyneside 026C","E01008510",1175,61,21,40,193,190,58,101,245,212,74,37,37,41
"2011","North Tyneside 026D","E01008512",1131,28,8,20,129,122,64,104,268,217,131,78,53,68
"2011","North Tyneside 027A","E01008539",1159,137,36,101,322,202,67,88,153,108,37,15,22,45
"2011","North Tyneside 027B","E01008540",1142,37,9,28,124,106,51,100,236,244,172,115,57,72
"2011","North Tyneside 027C","E01008541",1144,49,8,41,161,134,66,96,255,221,95,52,43,67
"2011","North Tyneside 027D","E01008544",1252,64,12,52,190,138,69,105,212,239,173,83,90,62
"2011","North Tyneside 027E","E01008545",936,35,12,23,143,103,45,80,184,186,106,73,33,54
"2011","North Tyneside 028A","E01008511",1243,44,9,35,166,183,66,110,276,228,100,62,38,70
"2011","North Tyneside 028B","E01008542",1059,40,9,31,109,131,41,85,224,219,125,75,50,85
"2011","North Tyneside 028C","E01008543",1590,92,18,74,264,218,93,121,301,234,173,103,70,94
"2011","North Tyneside 028D","E01008571",1273,78,19,59,217,171,68,109,243,205,109,68,41,73
"2011","North Tyneside 029A","E01008572",1311,52,11,41,242,208,76,106,244,184,119,69,50,80
"2011","North Tyneside 029B","E01008573",1272,81,12,69,186,204,65,97,224,202,130,71,59,83
"2011","North Tyneside 029C","E01008574",1181,109,23,86,271,196,72,83,184,124,44,30,14,98
"2011","North Tyneside 029D","E01008576",1510,84,19,65,270,185,108,108,298,225,102,61,41,130
"2011","North Tyneside 030A","E01008533",1045,32,8,24,143,148,76,87,221,187,71,44,27,80
"2011","North Tyneside 030B","E01008535",1133,70,17,53,197,211,81,91,183,156,51,32,19,93
"2011","North Tyneside 030C","E01008536",1130,96,21,75,257,163,67,83,170,151,78,45,33,65
"2011","North Tyneside 030D","E01008537",1002,47,12,35,164,155,45,87,185,152,77,47,30,90
"2011","North Tyneside 030E","E01008575",1040,59,9,50,163,145,65,89,192,179,90,58,32,58
"2011","South Tyneside 001A","E01008595",1231,72,19,53,266,176,76,114,187,177,80,49,31,83
"2011","South Tyneside 001B","E01008596",975,32,7,25,100,92,79,94,154,150,156,125,31,118
"2011","South Tyneside 001C","E01008597",1851,185,42,143,436,285,144,131,229,196,127,83,44,118
"2011","South Tyneside 001D","E01008598",1181,104,23,81,213,154,126,88,173,120,120,91,29,83
"2011","South Tyneside 001E","E01008599",1064,48,7,41,158,111,82,90,205,187,113,83,30,70
"2011","South Tyneside 002A","E01008664",1109,46,9,37,141,112,55,104,201,172,127,90,37,151
"2011","South Tyneside 002B","E01008665",1136,43,7,36,155,124,80,105,233,205,124,76,48,67
"2011","South Tyneside 002C","E01008666",1041,28,12,16,75,85,38,85,202,243,202,149,53,83
"2011","South Tyneside 002D","E01008667",1196,59,8,51,171,135,74,106,216,253,125,77,48,57
"2011","South Tyneside 002E","E01008668",1166,42,11,31,147,136,78,117,222,225,126,95,31,73
"2011","South Tyneside 003A","E01008673",923,95,22,73,254,134,60,76,112,89,14,6,8,89
"2011","South Tyneside 003B","E01008675",1084,77,14,63,261,162,68,81,186,138,45,22,23,66
"2011","South Tyneside 003C","E01008676",919,67,15,52,182,143,66,87,149,100,49,31,18,76
"2011","South Tyneside 003D","E01008677",1090,128,29,99,221,157,76,70,137,98,41,29,12,162
"2011","South Tyneside 003E","E01008678",987,60,15,45,195,122,82,89,131,132,43,19,24,133
"2011","South Tyneside 004A","E01008647",1079,118,30,88,231,190,76,92,134,126,41,29,12,71
"2011","South Tyneside 004B","E01008648",1020,87,22,65,216,165,79,84,135,120,50,33,17,84
"2011","South Tyneside 004C","E01008649",1128,34,8,26,171,162,66,101,214,193,95,65,30,92
"2011","South Tyneside 004D","E01008651",1252,32,10,22,112,107,46,94,290,285,187,116,71,99
"2011","South Tyneside 005A","E01008679",989,61,13,48,208,143,55,78,166,140,62,39,23,76
"2011","South Tyneside 005B","E01008680",1041,107,30,77,255,183,63,90,150,95,23,12,11,75
"2011","South Tyneside 005C","E01008682",825,25,3,22,105,95,56,68,158,134,112,76,36,72
"2011","South Tyneside 005D","E01008683",1125,67,12,55,200,161,67,113,188,162,84,62,22,83
"2011","South Tyneside 006A","E01008635",972,65,17,48,219,145,78,82,170,103,46,23,23,64
"2011","South Tyneside 006B","E01008650",1072,91,19,72,224,192,75,79,149,148,34,20,14,80
"2011","South Tyneside 006C","E01008674",981,112,36,76,280,168,66,76,103,59,26,16,10,91
"2011","South Tyneside 006D","E01008681",1055,158,40,118,276,167,92,75,108,68,30,22,8,81
"2011","South Tyneside 007A","E01008600",1022,29,7,22,108,110,50,113,212,214,128,78,50,58
"2011","South Tyneside 007B","E01008604",1201,52,14,38,169,127,29,94,252,244,152,105,47,82
"2011","South Tyneside 007C","E01008660",1140,86,29,57,250,175,74,87,194,141,59,42,17,74
"2011","South Tyneside 007D","E01008661",873,38,13,25,140,121,46,59,195,159,72,41,31,43
"2011","South Tyneside 008A","E01008633",983,23,7,16,126,122,46,88,209,197,97,68,29,75
"2011","South Tyneside 008B","E01008634",886,20,8,12,103,92,30,74,210,189,102,59,43,66
"2011","South Tyneside 008C","E01008636",1054,41,15,26,149,132,55,104,203,217,77,56,21,76
"2011","South Tyneside 008D","E01008637",1059,56,13,43,146,127,62,96,234,191,66,41,25,81
"2011","South Tyneside 009A","E01008639",1461,74,14,60,237,230,73,117,267,234,133,83,50,96
"2011","South Tyneside 009B","E01008652",840,32,9,23,122,123,45,77,163,160,65,44,21,53
"2011","South Tyneside 009C","E01008653",922,38,12,26,131,118,38,64,193,183,79,47,32,78
"2011","South Tyneside 009D","E01008654",983,44,4,40,178,162,64,92,197,132,55,29,26,59
"2011","South Tyneside 009E","E01008655",1065,42,9,33,142,131,41,81,216,222,105,66,39,85
"2011","South Tyneside 009F","E01008657",1037,96,27,69,269,174,70,88,136,111,23,11,12,70
"2011","South Tyneside 010A","E01008638",1086,83,32,51,254,203,77,109,144,107,37,20,17,72
"2011","South Tyneside 010B","E01008640",1480,125,30,95,307,215,89,119,239,224,63,42,21,99
"2011","South Tyneside 010C","E01008641",1103,60,22,38,148,142,60,96,217,214,104,68,36,62
"2011","South Tyneside 010D","E01008642",1088,94,29,65,227,209,66,97,148,137,40,33,7,70
"2011","South Tyneside 011A","E01008590",1154,42,10,32,147,135,73,123,227,241,100,70,30,66
"2011","South Tyneside 011B","E01008591",1126,39,12,27,176,157,60,106,214,215,92,56,36,67
"2011","South Tyneside 011C","E01008592",1123,63,11,52,191,164,64,107,211,169,94,66,28,60
"2011","South Tyneside 011D","E01008594",1244,65,23,42,199,145,61,112,236,234,99,77,22,93
"2011","South Tyneside 012A","E01008601",1050,31,8,23,124,112,57,86,229,222,118,77,41,71
"2011","South Tyneside 012B","E01008669",1023,28,11,17,116,94,63,84,198,232,138,104,34,70
"2011","South Tyneside 012C","E01008671",977,24,6,18,128,128,39,89,184,204,117,70,47,64
"2011","South Tyneside 012D","E01008672",993,39,10,29,154,128,67,101,194,172,71,49,22,67
"2011","South Tyneside 013A","E01008622",1223,124,33,91,272,188,94,88,150,176,70,37,33,61
"2011","South Tyneside 013C","E01008625",1050,37,13,24,137,119,66,86,221,205,102,48,54,77
"2011","South Tyneside 013E","E01033074",1557,66,24,42,213,203,84,114,298,322,148,105,43,109
"2011","South Tyneside 014A","E01008602",1047,26,4,22,107,116,51,84,268,237,90,51,39,68
"2011","South Tyneside 014B","E01008603",978,22,7,15,120,110,53,84,216,210,103,61,42,60
"2011","South Tyneside 014C","E01008608",757,19,5,14,70,86,41,66,180,180,71,47,24,44
"2011","South Tyneside 014D","E01008670",1095,26,9,17,126,134,47,114,235,257,90,57,33,66
"2011","South Tyneside 015A","E01008643",1070,66,24,42,173,186,58,92,196,178,46,30,16,75
"2011","South Tyneside 015B","E01008644",1049,37,12,25,139,161,49,95,212,222,70,44,26,64
"2011","South Tyneside 015C","E01008645",1025,29,10,19,131,123,55,98,221,208,88,56,32,72
"2011","South Tyneside 015D","E01008646",973,83,24,59,147,179,48,94,165,147,48,36,12,62
"2011","South Tyneside 015E","E01008656",1042,61,20,41,188,159,60,88,170,162,79,54,25,75
"2011","South Tyneside 015F","E01008658",986,27,11,16,104,127,46,92,226,187,91,48,43,86
"2011","South Tyneside 016A","E01008593",912,20,4,16,84,117,53,80,192,181,131,80,51,54
"2011","South Tyneside 016B","E01008605",885,52,9,43,138,119,51,87,179,150,49,33,16,60
"2011","South Tyneside 016C","E01008606",982,27,9,18,89,97,48,89,219,206,136,86,50,71
"2011","South Tyneside 016D","E01008607",918,12,2,10,76,81,24,98,227,220,132,80,52,48
"2011","South Tyneside 016E","E01008609",1006,29,6,23,94,123,42,91,213,223,114,88,26,77
"2011","South Tyneside 017A","E01008631",1106,64,21,43,141,172,53,89,250,182,77,53,24,78
"2011","South Tyneside 017B","E01008632",935,34,15,19,125,139,53,83,202,178,69,43,26,52
"2011","South Tyneside 017C","E01008659",1063,52,15,37,174,147,53,102,199,186,77,40,37,73
"2011","South Tyneside 017D","E01008662",915,31,8,23,118,132,37,95,182,181,71,51,20,68
"2011","South Tyneside 017E","E01008663",944,45,8,37,161,129,50,63,202,158,78,44,34,58
"2011","South Tyneside 018A","E01008624",1019,95,23,72,186,139,65,91,160,144,53,32,21,86
"2011","South Tyneside 018B","E01008684",898,41,18,23,154,119,62,79,169,149,89,63,26,36
"2011","South Tyneside 018C","E01008685",1396,120,31,89,293,204,88,107,233,170,84,53,31,97
"2011","South Tyneside 018D","E01008686",1213,71,17,54,218,177,85,121,222,174,61,39,22,84
"2011","South Tyneside 018E","E01008687",1183,130,31,99,272,163,113,95,180,119,58,42,16,53
"2011","South Tyneside 019A","E01008688",962,30,8,22,122,122,48,80,215,194,90,51,39,61
"2011","South Tyneside 019B","E01008689",1076,24,9,15,107,114,54,122,250,234,108,80,28,63
"2011","South Tyneside 019C","E01008690",1059,27,7,20,142,122,51,85,229,235,77,47,30,91
"2011","South Tyneside 019D","E01008691",1022,74,15,59,226,183,54,98,157,132,30,18,12,68
"2011","South Tyneside 019E","E01008692",1018,39,12,27,119,134,43,96,211,218,85,52,33,73
"2011","South Tyneside 020A","E01008627",1068,76,20,56,269,203,69,109,166,96,28,17,11,52
"2011","South Tyneside 020B","E01008628",1023,33,10,23,110,124,33,85,232,216,119,74,45,71
"2011","South Tyneside 020C","E01008629",1086,86,21,65,216,175,72,105,192,150,35,20,15,55
"2011","South Tyneside 020D","E01008630",1036,37,9,28,131,137,40,74,221,228,100,60,40,68
"2011","South Tyneside 021A","E01008610",930,24,11,13,92,92,49,98,201,205,109,71,38,60
"2011","South Tyneside 021B","E01008611",1172,108,29,79,280,193,87,118,149,123,29,23,6,85
"2011","South Tyneside 021C","E01008612",1177,106,31,75,268,212,104,103,143,126,27,16,11,88
"2011","South Tyneside 021D","E01008613",1177,39,8,31,174,148,75,110,212,243,122,81,41,54
"2011","South Tyneside 022A","E01008616",1150,178,40,138,366,177,84,69,99,67,27,15,12,83
"2011","South Tyneside 022B","E01008618",930,176,47,129,272,138,113,37,71,31,19,13,6,73
"2011","South Tyneside 022C","E01008619",1137,193,49,144,335,171,138,69,97,37,25,14,11,72
"2011","South Tyneside 022D","E01008621",1032,177,33,144,324,164,98,53,78,45,25,9,16,68
"2011","South Tyneside 023A","E01008614",1143,84,24,60,211,150,61,96,215,184,64,38,26,78
"2011","South Tyneside 023B","E01008615",1030,80,19,61,233,174,80,71,153,138,37,14,23,64
"2011","South Tyneside 023C","E01008617",1071,206,44,162,310,154,87,66,86,51,26,12,14,85
"2011","South Tyneside 023D","E01008620",990,145,39,106,304,160,75,61,81,65,24,15,9,75
"2011","Sunderland 001A","E01008713",1223,104,26,78,312,221,94,90,161,96,31,17,14,114
"2011","Sunderland 001B","E01008722",1073,80,23,57,249,220,75,100,165,91,23,13,10,70
"2011","Sunderland 001C","E01008724",881,66,11,55,205,171,48,73,127,95,14,7,7,82
"2011","Sunderland 001D","E01008726",1083,83,26,57,252,207,83,90,142,116,37,24,13,73
"2011","Sunderland 002A","E01008723",959,137,34,103,305,168,70,53,79,53,13,7,6,81
"2011","Sunderland 002B","E01008725",1035,85,16,69,252,215,82,82,151,82,19,13,6,67
"2011","Sunderland 002C","E01008727",1150,79,16,63,258,190,74,88,204,155,23,12,11,79
"2011","Sunderland 002D","E01008728",1114,95,20,75,254,200,77,81,167,117,25,14,11,98
"2011","Sunderland 002E","E01008792",912,104,20,84,305,129,89,59,78,55,40,40,0,53
"2011","Sunderland 003A","E01008698",1052,29,9,20,103,117,45,95,252,235,111,75,36,65
"2011","Sunderland 003B","E01008837",947,20,7,13,101,126,56,71,206,215,97,67,30,55
"2011","Sunderland 003C","E01008838",1157,25,10,15,99,150,49,116,239,299,100,76,24,80
"2011","Sunderland 003D","E01008839",1003,21,7,14,74,101,52,81,233,254,125,88,37,62
"2011","Sunderland 003E","E01008840",1008,31,8,23,107,118,48,93,244,224,80,53,27,63
"2011","Sunderland 003F","E01008841",851,15,4,11,56,70,36,75,186,206,135,97,38,72
"2011","Sunderland 004A","E01008712",1226,34,13,21,135,160,58,102,257,257,151,111,40,72
"2011","Sunderland 004B","E01008817",806,9,2,7,54,80,33,49,183,198,143,112,31,57
"2011","Sunderland 004C","E01008819",1005,30,9,21,104,123,52,113,225,220,76,54,22,62
"2011","Sunderland 004D","E01008821",923,17,5,12,94,79,43,76,213,197,151,100,51,53
"2011","Sunderland 004E","E01008822",1174,27,8,19,104,127,69,95,274,285,116,79,37,77
"2011","Sunderland 004F","E01008842",1109,50,17,33,157,143,68,120,216,215,78,58,20,62
"2011","Sunderland 005A","E01008708",1068,55,10,45,183,161,62,96,178,218,54,41,13,61
"2011","Sunderland 005B","E01008709",1062,20,4,16,98,122,44,77,231,261,143,97,46,66
"2011","Sunderland 005D","E01008711",1089,54,9,45,183,140,75,98,191,211,69,51,18,68
"2011","Sunderland 005F","E01008820",885,26,3,23,115,106,48,71,202,210,66,43,23,41
"2011","Sunderland 005G","E01033075",1500,25,8,17,140,161,85,108,313,387,192,145,47,89
"2011","Sunderland 006A","E01008786",1044,84,18,66,255,167,86,90,143,116,37,20,17,66
"2011","Sunderland 006B","E01008787",1320,57,9,48,206,173,92,114,212,186,68,39,29,212
"2011","Sunderland 006C","E01008788",1137,62,11,51,226,214,74,99,214,139,47,23,24,62
"2011","Sunderland 006D","E01008789",1091,131,40,91,251,141,107,90,148,109,39,28,11,75
"2011","Sunderland 006E","E01008790",1163,78,19,59,212,167,95,89,187,153,58,37,21,124
"2011","Sunderland 006F","E01008791",1438,63,12,51,161,118,90,95,216,276,122,81,41,297
"2011","Sunderland 007A","E01008855",1153,97,22,75,218,170,78,98,191,167,61,38,23,73
"2011","Sunderland 007B","E01008856",1097,80,24,56,225,228,62,104,185,147,17,9,8,49
"2011","Sunderland 007C","E01008876",1177,148,56,92,285,189,115,80,130,94,50,35,15,86
"2011","Sunderland 007D","E01008877",1080,109,27,82,271,182,72,97,153,118,27,16,11,51
"2011","Sunderland 008A","E01008693",951,30,13,17,115,117,62,84,197,220,74,51,23,52
"2011","Sunderland 008B","E01008694",1001,22,6,16,108,147,52,90,235,222,62,37,25,63
"2011","Sunderland 008C","E01008695",1089,26,10,16,105,127,59,92,229,266,124,90,34,61
"2011","Sunderland 008D","E01008696",998,63,30,33,187,131,84,101,161,151,42,27,15,78
"2011","Sunderland 008E","E01008697",923,25,8,17,95,128,46,93,205,227,57,38,19,47
"2011","Sunderland 008F","E01008699",1039,12,3,9,93,117,36,93,246,263,108,73,35,71
"2011","Sunderland 009A","E01008853",992,27,10,17,129,119,48,89,197,227,103,68,35,53
"2011","Sunderland 009B","E01008854",1174,46,17,29,122,144,64,109,239,234,137,70,67,79
"2011","Sunderland 009C","E01008857",977,37,16,21,115,117,53,84,223,212,73,36,37,63
"2011","Sunderland 009D","E01008858",951,15,5,10,58,108,46,85,234,239,101,58,43,65
"2011","Sunderland 009E","E01008859",963,33,10,23,103,121,30,81,206,220,90,56,34,79
"2011","Sunderland 009F","E01008860",1038,19,11,8,108,111,60,89,238,279,78,42,36,56
"2011","Sunderland 009G","E01008878",1114,60,21,39,143,176,79,103,203,213,56,43,13,81
"2011","Sunderland 010A","E01008873",1030,100,29,71,258,162,77,76,159,126,22,9,13,50
"2011","Sunderland 010B","E01008874",1285,44,14,30,196,168,60,112,269,234,89,62,27,113
"2011","Sunderland 010C","E01008875",1177,65,18,47,248,189,59,109,222,158,66,43,23,61
"2011","Sunderland 010D","E01008879",1115,47,17,30,174,194,58,102,211,215,53,27,26,61
"2011","Sunderland 010E","E01008880",912,49,15,34,134,164,42,91,176,169,33,12,21,54
"2011","Sunderland 011A","E01008701",1477,19,3,16,159,149,60,82,225,230,106,76,30,447
"2011","Sunderland 011B","E01008704",1155,37,11,26,204,137,58,85,197,186,96,73,23,155
"2011","Sunderland 011C","E01008706",1171,34,3,31,182,116,54,92,212,185,101,66,35,195
"2011","Sunderland 011D","E01008707",1269,37,2,35,160,109,46,82,151,131,86,65,21,467
"2011","Sunderland 012A","E01008756",1085,27,10,17,127,109,54,91,234,239,124,84,40,80
"2011","Sunderland 012B","E01008762",1092,21,6,15,96,121,49,76,203,282,167,120,47,77
"2011","Sunderland 012C","E01008812",1258,39,16,23,136,137,70,86,269,293,149,102,47,79
"2011","Sunderland 012F","E01033076",1138,16,3,13,65,95,64,87,252,311,171,126,45,77
"2011","Sunderland 013A","E01008700",986,22,5,17,111,94,40,67,144,167,79,51,28,262
"2011","Sunderland 013B","E01008703",1943,61,9,52,190,157,61,82,231,257,185,119,66,719
"2011","Sunderland 013C","E01008705",906,32,8,24,112,99,46,52,155,141,81,61,20,188
"2011","Sunderland 013D","E01008831",1901,115,15,100,250,156,86,107,215,179,187,142,45,606
"2011","Sunderland 013E","E01008834",1585,135,24,111,306,192,91,79,184,147,139,84,55,312
"2011","Sunderland 014A","E01008810",1227,40,16,24,144,138,62,101,244,283,139,97,42,76
"2011","Sunderland 014B","E01008811",1224,51,21,30,203,200,99,125,231,185,53,33,20,77
"2011","Sunderland 014C","E01008813",1125,36,12,24,137,121,71,83,215,267,118,76,42,77
"2011","Sunderland 014D","E01008814",1170,52,21,31,215,155,100,119,189,213,54,35,19,73
"2011","Sunderland 015A","E01008757",1109,35,10,25,160,135,58,67,243,222,115,80,35,74
"2011","Sunderland 015B","E01008758",1084,64,16,48,223,149,84,89,195,151,47,36,11,82
"2011","Sunderland 015C","E01008759",1120,83,21,62,220,170,81,94,185,151,49,31,18,87
"2011","Sunderland 015D","E01008761",1004,66,9,57,243,174,79,77,154,116,30,21,9,65
"2011","Sunderland 016A","E01008702",808,8,2,6,53,62,41,50,161,264,115,85,30,54
"2011","Sunderland 016B","E01008735",1485,131,18,113,269,189,91,83,196,196,176,116,60,154
"2011","Sunderland 016C","E01008736",927,8,2,6,91,84,45,61,171,211,179,128,51,77
"2011","Sunderland 016D","E01008737",1042,43,8,35,179,118,58,77,154,156,166,112,54,91
"2011","Sunderland 016E","E01008738",1023,31,7,24,115,131,44,82,175,177,134,95,39,134
"2011","Sunderland 016F","E01008836",1201,28,9,19,90,75,67,93,195,258,262,167,95,133
"2011","Sunderland 017A","E01008845",1134,118,36,82,270,236,69,89,147,118,32,19,13,55
"2011","Sunderland 017B","E01008846",820,27,7,20,96,110,40,59,169,159,95,57,38,65
"2011","Sunderland 017C","E01008847",965,15,4,11,82,112,65,92,215,212,85,57,28,87
"2011","Sunderland 017D","E01008850",1338,125,41,84,326,212,102,103,168,146,44,29,15,112
"2011","Sunderland 017E","E01008851",1202,39,12,27,169,164,70,130,256,248,50,27,23,76
"2011","Sunderland 018A","E01008760",1127,93,24,69,269,174,94,78,150,119,49,34,15,101
"2011","Sunderland 018B","E01008830",1156,50,7,43,199,147,48,96,113,96,91,58,33,316
"2011","Sunderland 018C","E01008832",1117,62,11,51,207,183,69,98,148,136,90,69,21,124
"2011","Sunderland 018D","E01008833",1061,59,17,42,235,160,92,80,135,103,72,59,13,125
"2011","Sunderland 019A","E01008843",1023,95,24,71,222,189,65,90,149,117,20,15,5,76
"2011","Sunderland 019B","E01008844",1072,95,28,67,210,183,75,80,183,148,45,37,8,53
"2011","Sunderland 019C","E01008848",1038,92,25,67,227,193,67,98,158,124,23,14,9,56
"2011","Sunderland 019D","E01008849",882,22,4,18,80,107,40,59,206,199,96,53,43,73
"2011","Sunderland 019E","E01008852",990,55,12,43,230,179,64,100,152,124,21,9,12,65
"2011","Sunderland 020A","E01008867",1277,39,7,32,145,193,56,120,266,250,144,76,68,64
"2011","Sunderland 020B","E01008868",1012,90,25,65,224,218,65,70,153,111,18,11,7,63
"2011","Sunderland 020C","E01008869",1017,53,22,31,189,187,55,96,190,162,30,19,11,55
"2011","Sunderland 020D","E01008870",1127,94,26,68,286,223,74,86,165,108,31,17,14,60
"2011","Sunderland 020E","E01008871",1115,45,19,26,171,186,53,81,225,201,63,32,31,90
"2011","Sunderland 020F","E01008872",1172,72,19,53,271,249,84,95,191,118,25,14,11,67
"2011","Sunderland 021A","E01008729",787,11,3,8,80,101,27,47,168,166,122,90,32,65
"2011","Sunderland 021B","E01008730",1204,18,5,13,109,108,55,85,247,298,190,143,47,94
"2011","Sunderland 021C","E01008731",908,9,2,7,69,81,48,72,206,233,143,103,40,47
"2011","Sunderland 021D","E01008732",1480,82,28,54,213,258,116,118,259,226,95,71,24,113
"2011","Sunderland 021E","E01008733",1224,26,10,16,133,157,64,109,256,296,114,72,42,69
"2011","Sunderland 021F","E01008734",1091,73,25,48,219,195,92,115,158,157,26,20,6,56
"2011","Sunderland 022A","E01008740",1077,146,37,109,250,139,115,66,104,67,89,77,12,101
"2011","Sunderland 022B","E01008781",1155,133,36,97,315,186,89,63,119,62,55,46,9,133
"2011","Sunderland 022C","E01008782",1075,127,41,86,271,195,84,69,110,84,34,22,12,101
"2011","Sunderland 022D","E01008783",1071,132,32,100,328,199,89,52,87,63,32,23,9,89
"2011","Sunderland 022E","E01008784",1140,152,33,119,315,174,86,75,125,84,27,21,6,102
"2011","Sunderland 022F","E01008785",1088,104,25,79,282,193,75,93,145,83,23,13,10,90
"2011","Sunderland 022G","E01008835",1223,162,27,135,295,142,93,67,122,76,83,67,16,183
"2011","Sunderland 023A","E01008823",1059,21,4,17,93,121,53,78,229,256,120,79,41,88
"2011","Sunderland 023B","E01008824",1082,19,5,14,86,130,51,98,240,234,141,88,53,83
"2011","Sunderland 023C","E01008825",1132,31,10,21,110,143,77,93,266,228,107,74,33,77
"2011","Sunderland 023D","E01008826",1068,25,6,19,128,127,69,84,240,213,82,51,31,100
"2011","Sunderland 023E","E01008827",882,14,5,9,81,84,46,82,195,203,112,77,35,65
"2011","Sunderland 023F","E01008828",1120,20,1,19,107,115,59,66,255,266,129,84,45,103
"2011","Sunderland 023G","E01008829",977,22,7,15,84,107,48,81,186,231,141,108,33,77
"2011","Sunderland 024A","E01008739",1153,67,17,50,168,137,66,103,190,194,118,73,45,110
"2011","Sunderland 024B","E01008741",1092,65,25,40,177,199,73,94,172,179,59,36,23,74
"2011","Sunderland 024C","E01008779",1042,47,11,36,196,166,79,84,178,173,56,33,23,63
"2011","Sunderland 024D","E01008780",1430,97,28,69,230,178,91,112,247,230,125,94,31,120
"2011","Sunderland 025A","E01008799",1287,182,39,143,338,212,91,84,132,117,36,25,11,95
"2011","Sunderland 025B","E01008861",1162,106,31,75,255,171,94,105,184,131,51,33,18,65
"2011","Sunderland 025C","E01008862",1191,197,49,148,302,220,80,77,135,86,21,12,9,73
"2011","Sunderland 025D","E01008863",1282,192,64,128,362,214,125,84,114,66,34,24,10,91
"2011","Sunderland 025E","E01008864",1041,171,56,115,298,169,85,59,92,58,36,22,14,73
"2011","Sunderland 025F","E01008865",1021,51,18,33,149,152,68,89,194,213,52,33,19,53
"2011","Sunderland 025G","E01008866",1047,54,18,36,180,157,67,99,216,165,50,33,17,59
"2011","Sunderland 026A","E01008773",1015,18,6,12,111,142,49,82,241,202,101,66,35,69
"2011","Sunderland 026B","E01008776",849,35,7,28,94,111,42,71,175,178,68,39,29,75
"2011","Sunderland 026C","E01008777",971,22,9,13,107,135,52,87,228,222,89,52,37,29
"2011","Sunderland 026D","E01008778",977,55,13,42,147,150,81,71,156,171,74,38,36,72
"2011","Sunderland 026E","E01008809",1187,54,16,38,199,196,85,110,223,195,70,48,22,55
"2011","Sunderland 027A","E01008803",1031,31,12,19,145,157,55,97,223,197,74,48,26,52
"2011","Sunderland 027B","E01008804",1140,40,9,31,169,155,75,93,200,240,84,65,19,84
"2011","Sunderland 027C","E01008805",1064,32,13,19,150,171,66,84,218,185,69,43,26,89
"2011","Sunderland 027F","E01033077",1334,64,22,42,181,219,67,108,264,233,78,57,21,120
"2011","Sunderland 028A","E01008763",1077,43,9,34,174,166,59,97,174,200,79,56,23,85
"2011","Sunderland 028B","E01008764",1140,61,21,40,196,153,83,79,230,194,52,41,11,92
"2011","Sunderland 028C","E01008766",1617,101,27,74,259,230,90,135,273,259,132,95,37,138
"2011","Sunderland 028D","E01008768",1061,85,24,61,221,171,87,89,148,124,55,37,18,81
"2011","Sunderland 028E","E01008769",1264,85,25,60,212,174,80,96,210,191,111,83,28,105
"2011","Sunderland 029A","E01008772",1004,153,41,112,298,164,95,55,92,61,18,13,5,68
"2011","Sunderland 029B","E01008774",932,56,20,36,210,165,65,79,140,101,46,32,14,70
"2011","Sunderland 029C","E01008775",1066,140,41,99,322,173,79,65,118,70,33,24,9,66
"2011","Sunderland 029D","E01008802",1065,84,30,54,206,171,104,94,171,138,28,19,9,69
"2011","Sunderland 029E","E01008808",1203,101,22,79,321,242,87,80,170,91,26,11,15,85
"2011","Sunderland 030A","E01008793",1171,25,7,18,126,130,63,112,246,286,130,91,39,53
"2011","Sunderland 030B","E01008795",1339,118,28,90,264,206,110,132,202,182,42,25,17,83
"2011","Sunderland 030C","E01008797",1442,127,40,87,329,245,113,110,230,158,45,31,14,85
"2011","Sunderland 030D","E01008800",1026,24,9,15,95,119,43,92,218,235,121,86,35,79
"2011","Sunderland 030E","E01008801",1218,102,35,67,269,231,97,107,198,107,35,27,8,72
"2011","Sunderland 031A","E01008765",1175,100,26,74,252,218,86,111,169,129,35,27,8,75
"2011","Sunderland 031B","E01008767",1110,59,19,40,184,173,58,111,212,173,60,41,19,80
"2011","Sunderland 031C","E01008770",1132,100,29,71,261,207,84,102,148,101,44,26,18,85
"2011","Sunderland 031D","E01008771",1140,67,18,49,200,211,58,116,194,170,54,35,19,70
"2011","Sunderland 032A","E01008720",1042,58,13,45,192,148,107,79,189,139,65,38,27,65
"2011","Sunderland 032B","E01008721",1181,118,28,90,254,223,98,103,156,121,29,22,7,79
"2011","Sunderland 032D","E01008796",1181,86,23,63,253,207,83,100,170,141,56,31,25,85
"2011","Sunderland 032F","E01032483",1311,79,25,54,230,191,100,101,239,200,69,45,24,102
"2011","Sunderland 032G","E01032484",1004,71,25,46,180,155,74,84,190,143,58,43,15,49
"2011","Sunderland 033A","E01008750",1426,98,31,67,266,245,112,145,226,190,53,33,20,91
"2011","Sunderland 033B","E01008751",786,27,9,18,102,112,49,74,157,164,45,29,16,56
"2011","Sunderland 033C","E01008752",1136,46,8,38,135,135,73,98,230,250,95,67,28,74
"2011","Sunderland 033D","E01008753",868,33,13,20,100,136,64,73,187,168,58,37,21,49
"2011","Sunderland 033E","E01008755",1014,40,12,28,140,137,61,103,203,205,73,43,30,52
"2011","Sunderland 034A","E01008714",876,29,12,17,114,108,51,61,175,159,106,67,39,73
"2011","Sunderland 034B","E01008715",973,61,17,44,195,145,59,85,162,146,54,40,14,66
"2011","Sunderland 034C","E01008716",1045,99,24,75,259,202,85,88,140,105,19,13,6,48
"2011","Sunderland 034D","E01008717",1196,80,30,50,214,157,85,99,211,191,75,55,20,84
"2011","Sunderland 034E","E01008749",1087,85,23,62,236,239,67,93,161,106,36,24,12,64
"2011","Sunderland 034F","E01008754",1009,37,9,28,158,149,48,84,212,188,85,51,34,48
"2011","Sunderland 035A","E01008718",1058,55,17,38,164,149,73,89,195,206,80,61,19,47
"2011","Sunderland 035B","E01008719",887,26,6,20,137,122,46,86,173,180,77,55,22,40
"2011","Sunderland 035C","E01008742",1269,56,17,39,187,171,128,122,227,210,81,60,21,87
"2011","Sunderland 035D","E01008747",1103,87,22,65,237,188,69,77,160,167,68,50,18,50
"2011","Sunderland 035E","E01008748",1051,69,18,51,157,159,86,84,193,201,47,38,9,55
"2011","Sunderland 036A","E01008743",1179,23,6,17,82,113,55,126,272,304,141,106,35,63
"2011","Sunderland 036B","E01008744",1174,50,13,37,140,137,91,113,248,229,92,68,24,74
"2011","Sunderland 036C","E01008745",1298,82,19,63,254,239,83,138,215,187,39,27,12,61
"2011","Sunderland 036D","E01008746",1173,28,5,23,102,112,69,103,222,287,176,138,38,74
"2011","Blackburn with Darwen 001A","E01012607",1099,72,16,56,166,135,89,101,195,179,78,68,10,84
"2011","Blackburn with Darwen 001B","E01012608",1158,51,9,42,161,133,112,105,212,176,123,90,33,85
"2011","Blackburn with Darwen 001C","E01012633",1144,82,25,57,233,149,113,112,209,125,50,37,13,71
"2011","Blackburn with Darwen 001D","E01012634",1004,88,22,66,234,153,77,89,130,107,49,35,14,77
"2011","Blackburn with Darwen 001E","E01012635",1139,103,17,86,212,169,96,81,157,98,103,81,22,120
"2011","Blackburn with Darwen 001F","E01012636",1068,108,34,74,271,165,107,89,142,95,22,13,9,69
"2011","Blackburn with Darwen 002A","E01012581",870,113,20,93,234,131,79,65,103,55,28,22,6,62
"2011","Blackburn with Darwen 002B","E01012582",1192,194,42,152,273,172,132,48,91,63,91,85,6,128
"2011","Blackburn with Darwen 002C","E01012583",1169,148,32,116,297,178,141,66,132,68,51,44,7,88
"2011","Blackburn with Darwen 002D","E01012587",1343,127,24,103,256,175,138,87,160,124,160,137,23,116
"2011","Blackburn with Darwen 002E","E01012588",1331,69,10,59,176,165,108,66,221,136,224,205,19,166
"2011","Blackburn with Darwen 003A","E01012574",956,28,8,20,74,70,60,69,196,212,152,125,27,95
"2011","Blackburn with Darwen 003B","E01012577",1212,37,8,29,85,108,101,58,153,190,309,276,33,171
"2011","Blackburn with Darwen 003C","E01012578",1326,49,8,41,103,114,96,59,199,188,329,305,24,189
"2011","Blackburn with Darwen 003D","E01012605",1232,37,13,24,99,145,94,63,160,222,252,220,32,160
"2011","Blackburn with Darwen 003E","E01012606",1063,44,9,35,99,116,96,63,162,154,199,174,25,130
"2011","Blackburn with Darwen 004A","E01012579",1127,38,1,37,102,105,80,46,169,167,254,231,23,166
"2011","Blackburn with Darwen 004B","E01012580",1502,53,6,47,108,143,118,56,217,210,400,358,42,197
"2011","Blackburn with Darwen 004C","E01012642",1152,77,19,58,110,99,95,51,151,123,271,243,28,175
"2011","Blackburn with Darwen 004D","E01012645",1267,123,29,94,196,168,114,58,170,126,183,159,24,129
"2011","Blackburn with Darwen 005A","E01012585",1085,90,13,77,157,120,140,47,127,101,177,160,17,126
"2011","Blackburn with Darwen 005B","E01012586",1145,43,8,35,96,111,107,65,179,168,249,216,33,127
"2011","Blackburn with Darwen 005C","E01012656",1158,48,9,39,94,83,106,89,208,207,211,195,16,112
"2011","Blackburn with Darwen 005D","E01012657",1363,33,6,27,88,119,123,85,264,224,285,244,41,142
"2011","Blackburn with Darwen 005E","E01012658",1291,58,12,46,187,159,112,96,265,184,138,104,34,92
"2011","Blackburn with Darwen 006A","E01012629",852,51,9,42,130,102,55,65,159,146,75,55,20,69
"2011","Blackburn with Darwen 006B","E01012631",888,18,6,12,88,68,73,71,162,186,152,123,29,70
"2011","Blackburn with Darwen 006C","E01012643",1111,31,8,23,99,100,90,55,180,194,255,230,25,107
"2011","Blackburn with Darwen 006D","E01012644",1851,79,9,70,162,190,190,85,261,220,420,382,38,244
"2011","Blackburn with Darwen 006E","E01012655",1333,30,3,27,112,92,75,103,254,308,240,171,69,119
"2011","Blackburn with Darwen 007A","E01012571",977,17,1,16,45,92,93,44,150,170,221,192,29,145
"2011","Blackburn with Darwen 007B","E01012572",1042,27,4,23,63,92,62,54,152,184,272,252,20,136
"2011","Blackburn with Darwen 007C","E01012573",1201,46,9,37,77,133,86,51,190,169,285,248,37,164
"2011","Blackburn with Darwen 007D","E01012575",902,26,4,22,94,83,68,52,149,170,190,162,28,70
"2011","Blackburn with Darwen 007E","E01012630",1485,54,8,46,98,125,116,74,245,231,325,283,42,217
"2011","Blackburn with Darwen 008A","E01012576",1120,27,3,24,80,96,69,53,208,187,180,147,33,220
"2011","Blackburn with Darwen 008B","E01012637",1081,20,5,15,97,89,39,81,232,285,156,95,61,82
"2011","Blackburn with Darwen 008C","E01012638",1151,26,8,18,91,103,54,115,241,275,159,109,50,87
"2011","Blackburn with Darwen 008D","E01012639",1229,26,10,16,94,98,76,111,262,291,151,111,40,120
"2011","Blackburn with Darwen 008E","E01012640",1256,41,11,30,139,132,98,135,258,218,151,101,50,84
"2011","Blackburn with Darwen 008F","E01012641",1061,33,5,28,89,92,49,84,192,216,193,152,41,113
"2011","Blackburn with Darwen 009A","E01012595",1361,76,20,56,181,143,95,136,264,244,103,61,42,119
"2011","Blackburn with Darwen 009B","E01012596",1314,73,19,54,183,145,91,125,276,220,110,76,34,91
"2011","Blackburn with Darwen 009C","E01012622",1153,26,2,24,101,97,47,86,231,288,178,133,45,99
"2011","Blackburn with Darwen 009D","E01012623",1099,58,15,43,195,151,76,82,196,190,65,39,26,86
"2011","Blackburn with Darwen 009E","E01012624",1141,36,12,24,155,130,66,123,248,234,75,41,34,74
"2011","Blackburn with Darwen 009F","E01012625",1182,56,15,41,147,147,90,130,263,214,76,39,37,59
"2011","Blackburn with Darwen 010A","E01012584",1052,178,32,146,284,137,159,43,89,29,54,52,2,79
"2011","Blackburn with Darwen 010B","E01012609",1188,117,39,78,304,191,108,119,154,95,19,12,7,81
"2011","Blackburn with Darwen 010C","E01012610",920,101,35,66,211,145,76,87,129,80,17,10,7,74
"2011","Blackburn with Darwen 010D","E01012611",800,116,32,84,216,120,95,46,95,54,15,8,7,43
"2011","Blackburn with Darwen 010E","E01012612",1026,94,24,70,240,184,84,100,153,90,27,23,4,54
"2011","Blackburn with Darwen 010F","E01012613",965,124,39,85,256,156,89,79,106,67,15,7,8,73
"2011","Blackburn with Darwen 011A","E01012600",971,24,10,14,121,92,59,78,223,227,74,50,24,73
"2011","Blackburn with Darwen 011B","E01012601",1062,24,10,14,105,79,50,92,226,251,139,102,37,96
"2011","Blackburn with Darwen 011C","E01012602",1223,157,49,108,295,200,91,107,153,110,37,19,18,73
"2011","Blackburn with Darwen 011D","E01012603",1101,37,15,22,110,99,52,115,229,236,137,88,49,86
"2011","Blackburn with Darwen 011E","E01012604",1149,84,24,60,244,119,62,98,174,204,64,48,16,100
"2011","Blackburn with Darwen 011F","E01012632",1484,195,28,167,207,151,126,96,221,168,152,112,40,168
"2011","Blackburn with Darwen 012A","E01012594",1008,34,6,28,127,123,69,81,216,188,86,55,31,84
"2011","Blackburn with Darwen 012B","E01012618",1074,86,13,73,255,145,69,108,172,128,36,14,22,75
"2011","Blackburn with Darwen 012C","E01012619",934,25,8,17,93,86,50,88,186,205,120,85,35,81
"2011","Blackburn with Darwen 012D","E01012620",1058,72,27,45,194,148,89,130,192,152,32,19,13,49
"2011","Blackburn with Darwen 012E","E01012621",1094,52,20,32,174,135,59,93,222,199,71,46,25,89
"2011","Blackburn with Darwen 013A","E01012593",1331,86,27,59,259,183,102,115,252,200,57,32,25,77
"2011","Blackburn with Darwen 013B","E01012597",1334,132,47,85,272,215,146,139,185,120,18,11,7,107
"2011","Blackburn with Darwen 013C","E01012598",2120,289,81,208,594,339,192,165,220,140,27,16,11,154
"2011","Blackburn with Darwen 013D","E01012599",881,53,12,41,185,148,84,94,137,103,26,14,12,51
"2011","Blackburn with Darwen 014A","E01012589",1027,50,11,39,186,125,76,77,199,170,75,50,25,69
"2011","Blackburn with Darwen 014B","E01012590",943,44,12,32,133,123,90,88,180,164,60,38,22,61
"2011","Blackburn with Darwen 014C","E01012591",1144,69,21,48,170,132,90,110,216,196,86,61,25,75
"2011","Blackburn with Darwen 014D","E01012648",863,39,14,25,114,101,82,86,188,154,55,35,20,44
"2011","Blackburn with Darwen 014E","E01012652",1173,144,59,85,291,190,134,83,127,83,21,10,11,100
"2011","Blackburn with Darwen 015A","E01012617",1062,42,12,30,175,120,81,123,214,173,45,25,20,89
"2011","Blackburn with Darwen 015B","E01012646",1142,57,24,33,124,111,93,113,251,215,100,68,32,78
"2011","Blackburn with Darwen 015C","E01012647",993,45,17,28,115,114,81,82,176,199,121,88,33,60
"2011","Blackburn with Darwen 015D","E01012650",955,33,9,24,99,84,72,100,190,196,114,84,30,67
"2011","Blackburn with Darwen 016A","E01012649",1014,47,16,31,120,109,91,88,174,184,131,92,39,70
"2011","Blackburn with Darwen 016B","E01012651",1198,45,13,32,232,182,92,119,221,167,52,37,15,88
"2011","Blackburn with Darwen 016C","E01012653",967,65,21,44,198,143,93,76,155,111,49,35,14,77
"2011","Blackburn with Darwen 016D","E01012654",1254,84,25,59,196,165,111,112,198,199,104,70,34,85
"2011","Blackburn with Darwen 017A","E01012614",1320,133,38,95,283,199,113,117,193,152,33,23,10,97
"2011","Blackburn with Darwen 017B","E01012615",1106,61,31,30,166,164,98,114,193,189,54,39,15,67
"2011","Blackburn with Darwen 017C","E01012616",1338,125,40,85,266,167,164,128,216,151,39,23,16,82
"2011","Blackburn with Darwen 017D","E01012659",1060,114,25,89,301,169,103,81,115,91,28,19,9,58
"2011","Blackburn with Darwen 017E","E01012660",890,101,38,63,222,132,106,64,112,73,22,12,10,58
"2011","Blackburn with Darwen 017F","E01012661",1129,73,19,54,209,175,91,91,213,157,45,25,20,75
"2011","Blackburn with Darwen 018A","E01012592",1516,201,62,139,365,201,201,120,184,127,21,12,9,96
"2011","Blackburn with Darwen 018D","E01012628",940,164,44,120,285,119,150,32,75,47,14,9,5,54
"2011","Blackburn with Darwen 018E","E01032485",1359,271,73,198,406,173,210,60,91,48,20,14,6,80
"2011","Blackburn with Darwen 018F","E01032486",1063,218,46,172,329,150,112,36,83,52,14,6,8,69
"2011","Blackpool 001A","E01012663",1104,75,18,57,232,149,144,93,187,115,45,23,22,64
"2011","Blackpool 001B","E01012664",1169,66,22,44,229,198,129,105,216,109,33,19,14,84
"2011","Blackpool 001C","E01012665",1128,47,7,40,202,225,136,122,207,121,24,13,11,44
"2011","Blackpool 001D","E01012716",1017,69,21,48,206,171,126,79,163,97,29,14,15,77
"2011","Blackpool 001E","E01012719",964,69,25,44,222,164,119,78,156,93,24,16,8,39
"2011","Blackpool 002A","E01012662",1032,52,11,41,180,212,99,95,182,142,29,21,8,41
"2011","Blackpool 002B","E01012703",1051,65,14,51,179,186,123,99,172,118,45,30,15,64
"2011","Blackpool 002C","E01012704",1491,84,28,56,220,182,120,121,275,248,145,85,60,96
"2011","Blackpool 002D","E01012706",1207,68,17,51,240,233,129,114,194,112,36,12,24,81
"2011","Blackpool 002E","E01012717",1175,114,26,88,286,221,149,88,139,74,24,17,7,80
"2011","Blackpool 003A","E01012666",1055,61,14,47,192,137,151,94,178,125,55,38,17,62
"2011","Blackpool 003B","E01012667",1091,92,22,70,244,190,121,78,148,103,19,7,12,96
"2011","Blackpool 003C","E01012668",1113,69,19,50,201,169,137,100,186,119,43,24,19,89
"2011","Blackpool 003D","E01012669",1318,112,29,83,242,194,178,105,204,155,54,32,22,74
"2011","Blackpool 003E","E01012718",1130,95,24,71,246,173,157,101,160,103,23,11,12,72
"2011","Blackpool 004A","E01012690",1287,80,27,53,262,235,147,94,205,143,37,16,21,84
"2011","Blackpool 004B","E01012691",1329,53,9,44,236,199,136,115,258,181,55,40,15,96
"2011","Blackpool 004C","E01012692",1251,74,23,51,223,190,127,92,193,191,78,48,30,83
"2011","Blackpool 004D","E01012705",1118,50,12,38,173,169,113,108,185,184,62,33,29,74
"2011","Blackpool 004E","E01012723",1083,66,18,48,235,184,142,87,155,113,33,22,11,68
"2011","Blackpool 005A","E01012693",1125,71,19,52,214,190,131,87,191,132,43,20,23,66
"2011","Blackpool 005B","E01012711",1043,37,14,23,176,151,116,89,174,166,59,38,21,75
"2011","Blackpool 005C","E01012747",1088,111,31,80,260,188,163,63,121,78,30,17,13,74
"2011","Blackpool 005D","E01012750",1266,53,18,35,238,204,163,120,192,151,64,39,25,81
"2011","Blackpool 006A","E01012681",1362,25,3,22,148,69,293,97,214,270,189,95,94,57
"2011","Blackpool 006B","E01012683",1124,21,6,15,143,101,100,95,215,207,164,104,60,78
"2011","Blackpool 006C","E01012748",1282,36,10,26,165,132,268,106,226,166,107,70,37,76
"2011","Blackpool 006D","E01012749",1295,75,18,57,198,154,211,111,200,176,100,64,36,70
"2011","Blackpool 007A","E01012707",921,34,8,26,131,123,72,90,193,153,75,41,34,50
"2011","Blackpool 007B","E01012720",1046,10,2,8,83,93,87,73,238,227,150,105,45,85
"2011","Blackpool 007C","E01012721",1201,16,6,10,106,86,74,94,293,283,166,106,60,83
"2011","Blackpool 007D","E01012724",930,19,4,15,118,89,64,75,206,191,113,72,41,55
"2011","Blackpool 008A","E01012678",1077,16,3,13,70,67,69,111,218,276,185,102,83,65
"2011","Blackpool 008B","E01012679",1002,19,7,12,100,80,76,69,199,201,168,112,56,90
"2011","Blackpool 008C","E01012680",1134,28,7,21,149,134,101,96,224,215,102,68,34,85
"2011","Blackpool 008D","E01012682",1060,22,10,12,102,109,92,92,221,220,149,100,49,53
"2011","Blackpool 008E","E01012684",1033,20,5,15,126,121,73,98,215,212,115,69,46,53
"2011","Blackpool 009A","E01012676",1017,59,11,48,201,126,94,90,181,122,57,32,25,87
"2011","Blackpool 009B","E01012677",1012,83,14,69,236,123,121,58,160,97,53,31,22,81
"2011","Blackpool 009C","E01012708",985,49,13,36,192,158,104,79,171,144,25,11,14,63
"2011","Blackpool 009D","E01012709",1141,47,11,36,171,180,90,86,265,155,79,52,27,68
"2011","Blackpool 009E","E01012710",865,86,21,65,201,117,114,70,97,69,48,35,13,63
"2011","Blackpool 009F","E01012722",1020,125,22,103,267,121,124,55,111,58,44,38,6,115
"2011","Blackpool 010A","E01012673",1048,21,3,18,110,53,97,68,191,237,154,100,54,117
"2011","Blackpool 010B","E01012675",1106,17,4,13,152,90,80,85,215,216,161,109,52,90
"2011","Blackpool 010C","E01012735",996,23,5,18,131,101,134,96,176,175,97,56,41,63
"2011","Blackpool 010D","E01012736",1203,21,4,17,113,40,485,68,159,179,78,53,25,60
"2011","Blackpool 010E","E01012737",1171,24,3,21,132,86,132,88,218,246,133,80,53,112
"2011","Blackpool 011A","E01012670",914,22,2,20,100,70,87,79,185,194,110,69,41,67
"2011","Blackpool 011B","E01012733",772,32,9,23,135,95,79,57,154,93,65,46,19,62
"2011","Blackpool 011C","E01012734",1048,67,12,55,210,143,116,92,174,140,43,22,21,63
"2011","Blackpool 011D","E01012738",928,24,8,16,107,104,94,68,187,175,101,57,44,68
"2011","Blackpool 011E","E01012739",999,27,9,18,138,116,101,72,204,158,90,62,28,93
"2011","Blackpool 011F","E01012742",874,55,13,42,142,104,109,74,141,119,53,33,20,77
"2011","Blackpool 012A","E01012712",1249,91,25,66,266,203,149,97,198,122,30,19,11,93
"2011","Blackpool 012B","E01012713",1402,100,18,82,295,213,154,105,238,161,37,23,14,99
"2011","Blackpool 012C","E01012715",1156,70,18,52,281,188,129,83,166,114,46,23,23,79
"2011","Blackpool 012D","E01012740",1092,74,16,58,250,145,156,61,182,105,33,21,12,86
"2011","Blackpool 012E","E01012741",969,48,14,34,186,152,103,94,182,120,29,18,11,55
"2011","Blackpool 013A","E01012671",1145,23,3,20,105,64,292,79,175,239,99,63,36,69
"2011","Blackpool 013B","E01012672",1099,19,8,11,97,58,301,80,170,196,125,74,51,53
"2011","Blackpool 013C","E01012674",1247,26,7,19,155,94,89,131,259,254,150,97,53,89
"2011","Blackpool 013D","E01012751",1214,14,2,12,102,66,280,113,187,237,153,89,64,62
"2011","Blackpool 014A","E01012686",1026,28,6,22,101,75,93,102,227,195,122,86,36,83
"2011","Blackpool 014B","E01012687",1019,18,2,16,97,85,84,79,218,226,138,88,50,74
"2011","Blackpool 014C","E01012688",884,35,8,27,139,128,98,88,176,132,43,34,9,45
"2011","Blackpool 014D","E01012689",949,37,12,25,157,158,111,78,170,149,45,31,14,44
"2011","Blackpool 014E","E01012714",1243,76,18,58,269,212,149,106,194,138,41,33,8,58
"2011","Blackpool 015A","E01012695",991,22,10,12,146,116,81,108,226,152,78,48,30,62
"2011","Blackpool 015B","E01012743",1220,28,8,20,146,120,128,105,247,225,110,81,29,111
"2011","Blackpool 015C","E01012744",1154,39,13,26,144,141,125,97,257,205,76,50,26,70
"2011","Blackpool 015D","E01012745",1230,54,11,43,187,142,155,108,246,186,62,45,17,90
"2011","Blackpool 015E","E01012746",1280,41,5,36,167,149,133,118,274,209,88,58,30,101
"2011","Blackpool 016A","E01012685",1077,47,6,41,189,156,108,111,201,154,43,19,24,68
"2011","Blackpool 016B","E01012694",967,37,10,27,151,112,111,99,186,157,53,24,29,61
"2011","Blackpool 016C","E01012696",1101,43,15,28,176,159,124,84,228,148,69,43,26,70
"2011","Blackpool 016D","E01012697",1025,51,13,38,173,165,103,97,215,143,36,26,10,42
"2011","Blackpool 016E","E01012698",1076,26,7,19,126,100,89,98,269,194,93,64,29,81
"2011","Blackpool 017A","E01012726",1217,92,23,69,261,184,162,82,188,127,57,40,17,64
"2011","Blackpool 017B","E01012728",1088,56,15,41,216,111,117,101,213,153,59,32,27,62
"2011","Blackpool 017C","E01012752",1013,36,7,29,169,90,169,80,198,140,78,48,30,53
"2011","Blackpool 017D","E01012753",859,71,23,48,173,118,119,53,133,86,29,21,8,77
"2011","Blackpool 017E","E01012754",908,42,9,33,122,94,140,58,177,149,72,48,24,54
"2011","Blackpool 017F","E01012755",1087,94,17,77,239,176,134,75,140,102,62,42,20,65
"2011","Blackpool 018A","E01012701",1039,59,14,45,184,179,147,97,158,107,45,23,22,63
"2011","Blackpool 018B","E01012729",1154,64,21,43,237,208,166,88,182,127,39,23,16,43
"2011","Blackpool 018C","E01012730",1262,102,23,79,275,183,217,92,175,94,32,19,13,92
"2011","Blackpool 018D","E01012731",1156,63,20,43,201,170,169,113,203,131,42,26,16,64
"2011","Blackpool 018E","E01012732",1214,81,25,56,205,160,190,96,217,149,52,40,12,64
"2011","Blackpool 019A","E01012699",1276,70,17,53,236,204,139,112,230,161,41,18,23,83
"2011","Blackpool 019B","E01012700",1317,82,19,63,241,198,148,134,228,143,49,25,24,94
"2011","Blackpool 019C","E01012702",1017,39,9,30,152,126,125,87,214,166,61,50,11,47
"2011","Blackpool 019D","E01012725",1032,84,18,66,181,141,157,79,185,96,42,32,10,67
"2011","Blackpool 019E","E01012727",1158,93,28,65,245,175,203,87,163,83,32,24,8,77
"2011","Cheshire East 022A","E01018393",1542,263,84,179,350,166,342,82,130,100,31,24,7,78
"2011","Cheshire East 022B","E01018411",1683,379,95,284,506,215,216,69,109,52,30,20,10,107
"2011","Cheshire East 022C","E01018412",1092,187,34,153,290,123,181,44,102,70,35,18,17,60
"2011","Cheshire East 023A","E01018413",926,191,43,148,286,127,88,40,76,42,16,9,7,60
"2011","Cheshire East 023B","E01018414",1046,215,39,176,304,164,77,50,101,53,15,9,6,67
"2011","Cheshire East 023C","E01018415",1047,146,34,112,275,134,117,71,115,92,34,19,15,63
"2011","Cheshire East 023D","E01018416",1000,212,44,168,307,141,80,41,88,64,9,6,3,58
"2011","Cheshire East 024A","E01018424",1289,180,46,134,314,194,127,103,145,123,31,17,14,72
"2011","Cheshire East 024B","E01018425",1190,105,21,84,282,147,117,119,157,170,50,22,28,43
"2011","Cheshire East 024C","E01018426",1214,96,22,74,196,153,85,121,224,219,48,30,18,72
"2011","Cheshire East 024D","E01018427",994,128,38,90,225,174,71,93,132,85,15,2,13,71
"2011","Cheshire East 025A","E01018419",1056,129,26,103,240,141,94,96,152,109,23,13,10,72
"2011","Cheshire East 025B","E01018420",1343,202,50,152,411,200,110,75,108,111,31,16,15,95
"2011","Cheshire East 025C","E01018421",997,91,23,68,232,159,83,93,141,98,37,21,16,63
"2011","Cheshire East 025D","E01018422",941,97,26,71,194,109,65,83,129,172,20,8,12,72
"2011","Cheshire East 025E","E01018423",1046,71,24,47,140,119,79,109,195,216,64,41,23,53
"2011","Cheshire East 026A","E01018395",1210,117,32,85,254,163,161,108,175,154,34,22,12,44
"2011","Cheshire East 026B","E01018396",1061,99,24,75,197,115,94,83,194,163,42,26,16,74
"2011","Cheshire East 026C","E01018400",1536,63,17,46,206,130,134,142,342,315,121,75,46,83
"2011","Cheshire East 026D","E01018401",1126,123,24,99,194,100,108,84,180,197,58,30,28,82
"2011","Cheshire East 027A","E01018398",1053,61,18,43,202,103,96,100,201,181,48,29,19,61
"2011","Cheshire East 027B","E01018399",1110,157,32,125,245,129,112,78,178,115,25,20,5,71
"2011","Cheshire East 027C","E01018402",1487,144,27,117,284,170,140,110,273,211,82,54,28,73
"2011","Cheshire East 027D","E01018403",1472,211,46,165,354,203,142,117,176,150,43,25,18,76
"2011","Cheshire East 028A","E01018397",1311,259,50,209,354,158,147,87,138,70,24,14,10,74
"2011","Cheshire East 028B","E01018408",1338,176,29,147,328,197,126,101,175,128,31,16,15,76
"2011","Cheshire East 028C","E01018409",1276,147,53,94,274,175,121,101,183,153,56,36,20,66
"2011","Cheshire East 028D","E01018410",1138,198,44,154,284,182,95,80,135,56,36,25,11,72
"2011","Cheshire East 029A","E01018404",1064,187,44,143,312,138,116,56,100,71,17,9,8,67
"2011","Cheshire East 029B","E01018405",1095,185,48,137,300,156,101,82,118,86,23,15,8,44
"2011","Cheshire East 029C","E01018406",1048,241,52,189,288,147,128,43,78,52,12,6,6,59
"2011","Cheshire East 029D","E01018407",1083,184,48,136,301,165,128,48,109,84,11,5,6,53
"2011","Cheshire East 030A","E01018436",1052,136,34,102,260,154,79,86,144,98,16,8,8,79
"2011","Cheshire East 030B","E01018437",1175,141,27,114,293,129,90,103,158,140,54,32,22,67
"2011","Cheshire East 030C","E01018438",1077,145,39,106,256,177,83,99,146,101,15,6,9,55
"2011","Cheshire East 030D","E01018439",944,190,34,156,288,136,86,35,82,44,20,10,10,63
"2011","Cheshire East 031A","E01018440",1323,190,48,142,330,171,103,95,162,118,44,28,16,110
"2011","Cheshire East 031B","E01018441",1222,176,36,140,349,168,73,97,135,102,26,14,12,96
"2011","Cheshire East 031C","E01018442",1324,178,41,137,349,191,110,96,155,114,32,16,16,99
"2011","Cheshire East 031D","E01018443",1149,125,31,94,266,154,112,99,160,139,24,12,12,70
"2011","Cheshire East 032A","E01018432",1113,154,36,118,251,151,89,82,149,121,41,20,21,75
"2011","Cheshire East 032B","E01018433",956,92,23,69,222,140,85,80,145,114,30,23,7,48
"2011","Cheshire East 032C","E01018434",1019,146,40,106,244,145,92,74,151,88,35,22,13,44
"2011","Cheshire East 032D","E01018435",974,77,24,53,172,108,87,88,155,164,53,28,25,70
"2011","Cheshire East 033A","E01018394",1559,238,59,179,434,164,270,82,134,109,37,25,12,91
"2011","Cheshire East 033B","E01018417",1213,150,43,107,279,178,152,97,173,97,23,16,7,64
"2011","Cheshire East 033C","E01018418",1150,126,33,93,269,155,193,89,117,109,31,18,13,61
"2011","Cheshire East 033D","E01018428",1067,102,18,84,246,130,139,78,171,112,24,12,12,65
"2011","Cheshire East 033E","E01018429",1132,112,32,80,248,133,156,87,157,138,31,12,19,70
"2011","Cheshire East 033F","E01018430",1081,96,27,69,258,166,104,102,155,95,27,14,13,78
"2011","Cheshire East 033G","E01018431",930,139,39,100,255,114,133,54,113,55,13,8,5,54
"2011","Cheshire East 040A","E01018387",1264,226,50,176,370,204,105,62,115,57,14,4,10,111
"2011","Cheshire East 040B","E01018388",1146,85,16,69,189,116,87,101,218,192,68,37,31,90
"2011","Cheshire East 040C","E01018389",1112,173,46,127,302,156,101,73,118,86,20,10,10,83
"2011","Cheshire East 040D","E01018390",1203,127,29,98,315,178,106,100,154,133,26,18,8,64
"2011","Cheshire East 042A","E01018386",999,151,31,120,248,137,91,57,100,78,25,13,12,112
"2011","Cheshire East 042B","E01018391",1346,187,43,144,360,197,106,100,162,119,36,13,23,79
"2011","Cheshire East 042C","E01018392",1453,254,57,197,449,193,116,84,147,71,23,14,9,116
"2011","Cheshire East 034A","E01018472",1091,64,10,54,179,149,71,130,226,179,27,10,17,66
"2011","Cheshire East 034B","E01018473",1249,122,40,82,255,191,75,136,237,145,21,9,12,67
"2011","Cheshire East 034C","E01018474",1396,160,45,115,315,192,107,152,196,120,23,15,8,131
"2011","Cheshire East 034D","E01018475",1351,144,33,111,320,232,93,132,178,123,19,8,11,110
"2011","Cheshire East 035A","E01018463",1082,31,7,24,155,102,61,104,265,225,72,42,30,67
"2011","Cheshire East 035B","E01018476",904,24,7,17,95,80,40,85,196,202,108,71,37,74
"2011","Cheshire East 035C","E01018477",1013,39,8,31,111,93,64,117,212,240,75,48,27,62
"2011","Cheshire East 035D","E01018478",1026,23,9,14,112,82,51,96,225,249,100,74,26,88
"2011","Cheshire East 035E","E01018479",1183,70,18,52,212,147,109,133,215,179,49,32,17,69
"2011","Cheshire East 036A","E01018459",912,19,5,14,92,62,49,89,200,229,99,61,38,73
"2011","Cheshire East 036B","E01018460",1009,40,9,31,140,128,60,141,213,200,41,19,22,46
"2011","Cheshire East 036C","E01018461",1015,42,14,28,129,119,54,117,266,183,52,27,25,53
"2011","Cheshire East 036D","E01018466",1703,70,13,57,158,150,89,193,355,421,181,104,77,86
"2011","Cheshire East 036E","E01018467",1686,74,14,60,211,146,69,159,391,355,143,88,55,138
"2011","Cheshire East 037A","E01018482",1038,62,17,45,157,107,66,113,208,194,70,38,32,61
"2011","Cheshire East 037B","E01018483",1040,51,10,41,179,128,65,116,222,191,38,23,15,50
"2011","Cheshire East 037C","E01018484",1530,80,18,62,203,141,75,125,295,361,165,120,45,85
"2011","Cheshire East 037D","E01018485",1090,29,9,20,92,82,43,113,269,260,110,70,40,92
"2011","Cheshire East 038A","E01018499",1160,93,25,68,208,183,75,157,200,144,21,15,6,79
"2011","Cheshire East 038B","E01018500",980,62,25,37,169,151,62,130,188,147,17,11,6,54
"2011","Cheshire East 038C","E01018501",1179,62,13,49,194,132,58,146,214,157,42,24,18,174
"2011","Cheshire East 038D","E01018502",1765,86,32,54,199,121,56,106,145,103,13,11,2,936
"2011","Cheshire East 039A","E01018462",1089,60,5,55,112,108,40,114,217,247,95,54,41,96
"2011","Cheshire East 039B","E01018464",1086,50,11,39,149,122,68,118,223,202,69,37,32,85
"2011","Cheshire East 039C","E01018496",1225,100,25,75,226,142,73,126,219,174,53,32,21,112
"2011","Cheshire East 039D","E01018497",909,42,9,33,150,88,35,93,202,185,47,21,26,67
"2011","Cheshire East 039E","E01018498",1127,57,14,43,155,117,57,94,236,229,88,64,24,94
"2011","Cheshire East 041A","E01018465",2121,335,89,246,569,264,287,136,210,162,34,19,15,124
"2011","Cheshire East 041B","E01018468",1231,182,43,139,309,187,72,82,167,108,24,14,10,100
"2011","Cheshire East 041C","E01018469",1130,139,38,101,279,139,124,104,141,103,30,25,5,71
"2011","Cheshire East 041D","E01018470",1128,176,39,137,312,162,103,78,108,78,12,11,1,99
"2011","Cheshire East 041E","E01018471",1148,132,42,90,279,166,99,99,184,98,19,6,13,72
"2011","Cheshire East 043A","E01018486",1168,52,12,40,141,90,65,108,202,259,77,37,40,174
"2011","Cheshire East 043B","E01018487",1225,54,10,44,153,101,65,123,233,275,73,49,24,148
"2011","Cheshire East 043C","E01018488",1121,99,22,77,233,145,52,127,190,139,22,14,8,114
"2011","Cheshire East 043D","E01018489",1046,66,12,54,157,79,53,96,155,208,70,46,24,162
"2011","Cheshire East 044A","E01018510",1218,120,31,89,270,183,66,116,207,128,32,16,16,96
"2011","Cheshire East 044B","E01018511",1025,59,18,41,178,116,58,103,194,181,58,40,18,78
"2011","Cheshire East 044C","E01018512",1161,54,15,39,161,135,91,128,222,217,58,30,28,95
"2011","Cheshire East 044D","E01018513",1174,109,32,77,251,180,90,131,199,128,28,18,10,58
"2011","Cheshire East 045A","E01018445",1416,56,10,46,161,129,76,137,292,310,154,104,50,101
"2011","Cheshire East 045B","E01018446",979,78,15,63,182,114,49,103,159,149,55,32,23,90
"2011","Cheshire East 045C","E01018447",1319,70,13,57,171,135,58,155,238,266,69,37,32,157
"2011","Cheshire East 045D","E01018448",1255,107,19,88,271,166,86,107,213,155,41,24,17,109
"2011","Cheshire East 046A","E01018490",1044,161,34,127,298,175,87,78,118,53,15,9,6,59
"2011","Cheshire East 046B","E01018491",1064,162,45,117,302,155,105,72,112,73,18,9,9,65
"2011","Cheshire East 046C","E01018492",777,67,15,52,155,134,60,97,128,77,13,8,5,46
"2011","Cheshire East 046D","E01018505",817,133,33,100,258,110,95,36,72,38,12,9,3,63
"2011","Cheshire East 046E","E01018506",1108,191,63,128,319,163,70,78,110,72,21,14,7,84
"2011","Cheshire East 046F","E01018507",1088,179,51,128,307,168,70,94,125,54,16,11,5,75
"2011","Cheshire East 047A","E01018451",912,82,14,68,180,88,81,66,181,139,39,19,20,56
"2011","Cheshire East 047B","E01018454",1177,78,20,58,181,110,102,120,225,204,67,40,27,90
"2011","Cheshire East 047C","E01018455",945,115,26,89,240,133,85,83,144,82,18,9,9,45
"2011","Cheshire East 047D","E01018456",873,173,41,132,218,134,76,51,93,58,20,13,7,50
"2011","Cheshire East 047E","E01018457",1074,149,40,109,294,137,91,77,150,88,23,12,11,65
"2011","Cheshire East 049A","E01018444",1605,261,64,197,364,197,307,81,137,110,38,25,13,110
"2011","Cheshire East 049B","E01018480",1710,229,76,153,379,153,304,74,125,105,39,26,13,302
"2011","Cheshire East 049C","E01018515",1723,296,84,212,523,189,270,82,142,82,31,18,13,108
"2011","Cheshire East 049D","E01018516",1046,176,52,124,286,124,125,72,112,81,14,8,6,56
"2011","Cheshire East 049F","E01033375",889,188,38,150,267,121,76,47,83,26,11,8,3,70
"2011","Cheshire East 049G","E01033376",825,191,46,145,278,113,63,42,57,22,11,7,4,48
"2011","Cheshire East 049H","E01033378",1014,212,55,157,285,111,140,40,67,42,20,12,8,97
"2011","Cheshire East 048A","E01018493",905,70,19,51,192,136,69,103,166,112,15,10,5,42
"2011","Cheshire East 048B","E01018494",1002,124,33,91,220,172,88,80,137,99,28,17,11,54
"2011","Cheshire East 048C","E01018495",964,81,22,59,191,119,112,106,184,101,15,8,7,55
"2011","Cheshire East 048D","E01018508",877,130,30,100,245,125,88,50,101,60,12,7,5,66
"2011","Cheshire East 048E","E01018509",801,78,16,62,209,130,91,67,102,64,16,11,5,44
"2011","Cheshire East 050A","E01018452",782,41,8,33,118,91,75,86,161,127,34,26,8,49
"2011","Cheshire East 050C","E01018503",1149,178,39,139,314,154,106,74,177,60,18,12,6,68
"2011","Cheshire East 050D","E01018504",1256,166,36,130,272,135,114,99,209,160,45,27,18,56
"2011","Cheshire East 050E","E01033372",985,181,36,145,320,101,85,73,93,54,17,9,8,61
"2011","Cheshire East 050F","E01033373",899,117,24,93,191,93,99,56,148,93,44,29,15,58
"2011","Cheshire East 051A","E01018449",1250,191,44,147,327,112,223,75,136,94,24,17,7,68
"2011","Cheshire East 051B","E01018450",1611,224,59,165,398,162,309,97,180,89,52,36,16,100
"2011","Cheshire East 051C","E01018458",1565,279,74,205,411,164,220,92,150,101,39,25,14,109
"2011","Cheshire East 051D","E01018481",1477,217,58,159,316,146,341,85,146,99,32,25,7,95
"2011","Cheshire East 051E","E01018514",1473,207,63,144,338,156,280,91,159,126,27,19,8,89
"2011","Cheshire East 001A","E01018585",1041,186,45,141,267,152,104,59,107,63,24,14,10,79
"2011","Cheshire East 001B","E01018586",1181,153,35,118,309,138,159,67,174,88,30,22,8,63
"2011","Cheshire East 001C","E01018587",1121,197,46,151,341,157,143,48,98,58,14,7,7,65
"2011","Cheshire East 001D","E01018661",946,148,37,111,281,113,130,51,83,51,14,9,5,75
"2011","Cheshire East 002A","E01018657",749,79,21,58,144,117,78,65,112,82,24,12,12,48
"2011","Cheshire East 002B","E01018662",889,150,33,117,264,140,83,54,84,41,13,8,5,60
"2011","Cheshire East 002C","E01018663",1018,175,42,133,312,161,104,49,104,39,14,7,7,60
"2011","Cheshire East 002D","E01018664",1098,211,42,169,335,169,83,49,109,42,20,11,9,80
"2011","Cheshire East 002E","E01018665",821,118,27,91,246,139,77,56,72,35,16,6,10,62
"2011","Cheshire East 003A","E01018655",1045,174,40,134,314,157,126,49,107,55,20,10,10,43
"2011","Cheshire East 003B","E01018656",1026,149,41,108,297,166,110,58,110,51,13,6,7,72
"2011","Cheshire East 003C","E01018658",979,167,40,127,259,176,73,51,107,53,23,14,9,70
"2011","Cheshire East 003D","E01018659",932,193,42,151,275,127,108,35,107,31,10,1,9,46
"2011","Cheshire East 003E","E01018660",749,116,24,92,220,115,79,46,81,30,13,6,7,49
"2011","Cheshire East 004A","E01018582",1339,240,38,202,386,177,128,55,143,72,45,21,24,93
"2011","Cheshire East 004B","E01018592",1181,162,36,126,319,175,126,76,168,56,32,27,5,67
"2011","Cheshire East 004C","E01018593",1237,211,39,172,359,182,126,59,137,65,35,18,17,63
"2011","Cheshire East 004D","E01018594",1213,71,16,55,206,166,113,110,254,158,58,43,15,77
"2011","Cheshire East 004E","E01018595",1129,182,29,153,272,161,104,61,160,79,26,15,11,84
"2011","Cheshire East 004F","E01018596",1411,124,27,97,248,171,100,99,288,209,98,54,44,74
"2011","Cheshire East 005A","E01018583",1380,333,68,265,426,194,115,48,98,49,29,19,10,88
"2011","Cheshire East 005B","E01018584",1397,335,80,255,441,186,143,41,77,31,41,17,24,102
"2011","Cheshire East 005C","E01018612",871,139,37,102,186,115,95,40,113,81,38,22,16,64
"2011","Cheshire East 005D","E01018613",1094,125,28,97,214,138,102,95,188,137,48,28,20,47
"2011","Cheshire East 006A","E01018600",1139,264,67,197,342,140,146,32,62,28,28,24,4,97
"2011","Cheshire East 006B","E01018601",1187,299,50,249,370,123,112,38,95,55,36,22,14,59
"2011","Cheshire East 006C","E01018602",1192,368,83,285,347,121,106,40,70,38,36,17,19,66
"2011","Cheshire East 006D","E01018652",1116,354,83,271,328,115,113,19,62,23,11,6,5,91
"2011","Cheshire East 007A","E01018598",1201,224,56,168,326,137,254,49,76,45,32,20,12,58
"2011","Cheshire East 007B","E01018599",859,185,53,132,261,109,100,35,72,37,24,15,9,36
"2011","Cheshire East 007C","E01018648",1586,254,76,178,387,183,326,78,132,99,55,42,13,72
"2011","Cheshire East 007D","E01018649",953,173,43,130,239,127,169,46,96,55,9,8,1,39
"2011","Cheshire East 007E","E01018650",1226,220,67,153,366,161,155,55,123,66,22,16,6,58
"2011","Cheshire East 007F","E01018651",1199,172,42,130,252,103,169,58,115,92,171,155,16,67
"2011","Cheshire East 007G","E01018654",1707,304,87,217,406,158,294,73,108,80,126,115,11,158
"2011","Cheshire East 008A","E01018588",1084,247,51,196,304,143,128,43,78,32,21,14,7,88
"2011","Cheshire East 008B","E01018589",1084,306,67,239,334,145,91,28,72,32,11,6,5,65
"2011","Cheshire East 008C","E01018590",1289,317,75,242,392,157,115,46,107,55,26,13,13,74
"2011","Cheshire East 008D","E01018653",1358,281,52,229,396,172,165,50,114,68,22,16,6,90
"2011","Cheshire East 009A","E01018605",756,177,46,131,240,106,79,27,55,25,12,6,6,35
"2011","Cheshire East 009B","E01018609",1164,196,38,158,341,150,87,61,153,70,36,24,12,70
"2011","Cheshire East 009C","E01018610",1414,232,41,191,364,162,124,90,188,130,46,34,12,78
"2011","Cheshire East 009D","E01018611",1207,90,18,72,206,108,105,105,225,234,63,38,25,71
"2011","Cheshire East 011A","E01018666",1256,363,122,241,395,126,146,18,53,25,30,25,5,100
"2011","Cheshire East 011B","E01018667",1074,236,71,165,308,117,180,40,71,39,18,11,7,65
"2011","Cheshire East 011C","E01018668",1180,253,73,180,346,146,209,33,66,28,24,17,7,75
"2011","Cheshire East 010A","E01018603",903,238,59,179,284,115,80,29,50,24,22,12,10,61
"2011","Cheshire East 010B","E01018604",947,190,40,150,263,96,104,40,113,59,35,28,7,47
"2011","Cheshire East 010C","E01018606",1001,202,55,147,325,109,104,47,102,58,22,10,12,32
"2011","Cheshire East 010D","E01018607",901,240,66,174,294,129,72,22,50,25,9,6,3,60
"2011","Cheshire East 010E","E01018608",970,299,64,235,286,116,90,27,40,17,18,15,3,77
"2011","Cheshire East 012A","E01018572",1139,302,70,232,353,111,137,34,77,28,21,17,4,76
"2011","Cheshire East 012B","E01018573",1085,273,59,214,317,130,146,34,61,35,18,10,8,71
"2011","Cheshire East 012C","E01018574",1411,295,69,226,445,136,156,71,126,72,24,18,6,86
"2011","Cheshire East 012D","E01018580",1096,241,66,175,284,121,199,27,79,51,46,34,12,48
"2011","Cheshire East 012E","E01018581",838,178,42,136,233,105,98,46,91,34,6,4,2,47
"2011","Cheshire East 013A","E01018575",808,133,30,103,218,101,94,60,78,70,13,5,8,41
"2011","Cheshire East 013B","E01018576",1345,244,37,207,461,164,137,73,110,67,16,6,10,73
"2011","Cheshire East 013C","E01018577",1812,293,62,231,456,242,187,136,228,158,36,15,21,76
"2011","Cheshire East 013D","E01018578",895,148,38,110,254,114,102,63,102,46,15,10,5,51
"2011","Cheshire East 013E","E01018579",778,69,14,55,148,84,92,60,120,126,31,27,4,48
"2011","Cheshire East 014A","E01018641",946,169,40,129,259,135,70,71,92,65,16,14,2,69
"2011","Cheshire East 014B","E01018642",1007,247,61,186,290,163,79,32,73,30,16,13,3,77
"2011","Cheshire East 014C","E01018643",1386,342,95,247,426,155,142,50,93,45,27,13,14,106
"2011","Cheshire East 014D","E01018644",999,187,38,149,303,145,92,48,94,57,28,19,9,45
"2011","Cheshire East 015A","E01018614",1420,338,60,278,409,183,114,61,137,49,42,29,13,87
"2011","Cheshire East 015B","E01018618",1036,107,13,94,186,110,73,89,169,137,69,42,27,96
"2011","Cheshire East 015C","E01018619",1046,182,32,150,277,159,107,63,101,63,23,12,11,71
"2011","Cheshire East 015D","E01018620",997,146,33,113,227,137,67,62,145,92,55,28,27,66
"2011","Cheshire East 015E","E01018621",1004,139,26,113,277,142,84,77,124,76,7,5,2,78
"2011","Cheshire East 016A","E01018626",1651,188,32,156,416,204,158,131,242,170,56,31,25,86
"2011","Cheshire East 016B","E01018628",1188,217,50,167,325,132,134,72,118,88,22,16,6,80
"2011","Cheshire East 016C","E01018629",1296,135,30,105,239,135,109,134,212,203,72,51,21,57
"2011","Cheshire East 016D","E01018630",952,94,19,75,215,122,82,103,143,119,24,13,11,50
"2011","Cheshire East 016E","E01018631",1018,56,11,45,127,102,86,98,213,210,71,36,35,55
"2011","Cheshire East 017A","E01018615",911,133,23,110,236,115,100,65,122,70,27,17,10,43
"2011","Cheshire East 017B","E01018616",950,211,51,160,252,142,83,51,87,31,38,22,16,55
"2011","Cheshire East 017C","E01018617",1083,110,27,83,233,167,95,99,159,119,36,23,13,65
"2011","Cheshire East 017D","E01018632",1190,228,46,182,321,145,112,80,121,99,24,16,8,60
"2011","Cheshire East 017E","E01018633",1113,199,37,162,315,174,87,76,112,57,26,17,9,67
"2011","Cheshire East 018A","E01018622",998,125,19,106,240,130,81,75,143,100,47,21,26,57
"2011","Cheshire East 018B","E01018623",1145,138,31,107,264,167,133,103,153,103,38,25,13,46
"2011","Cheshire East 018C","E01018624",1522,175,26,149,394,211,150,110,203,161,53,28,25,65
"2011","Cheshire East 018D","E01018625",1063,116,23,93,272,129,82,101,157,124,27,12,15,55
"2011","Cheshire East 018E","E01018627",1275,189,31,158,287,168,129,74,194,121,50,35,15,63
"2011","Cheshire East 018F","E01018635",932,128,24,104,222,114,86,80,118,95,43,29,14,46
"2011","Cheshire East 018G","E01018636",1031,136,31,105,256,146,89,66,126,111,18,12,6,83
"2011","Cheshire East 019A","E01018634",1410,176,44,132,366,208,116,104,190,132,24,16,8,94
"2011","Cheshire East 019B","E01018645",1258,43,13,30,179,135,119,137,238,242,90,59,31,75
"2011","Cheshire East 019C","E01018646",1245,87,26,61,201,152,156,99,241,141,89,63,26,79
"2011","Cheshire East 019D","E01018647",1148,97,19,78,212,153,105,76,197,170,49,31,18,89
"2011","Cheshire East 020A","E01018591",1716,284,65,219,435,182,322,91,168,106,29,21,8,99
"2011","Cheshire East 020B","E01018597",1775,323,86,237,452,204,366,71,151,73,35,29,6,100
"2011","Cheshire East 020C","E01018669",1938,433,92,341,581,199,305,80,114,91,24,14,10,111
"2011","Cheshire East 020D","E01018670",1682,328,82,246,419,186,312,76,155,64,63,48,15,79
"2011","Cheshire East 021A","E01018637",1245,71,14,57,200,141,104,100,244,212,79,49,30,94
"2011","Cheshire East 021B","E01018638",1120,75,21,54,185,136,130,95,186,182,64,48,16,67
"2011","Cheshire East 021C","E01018639",1117,128,15,113,249,136,103,73,164,126,55,38,17,83
"2011","Cheshire East 021D","E01018640",946,59,11,48,134,101,86,76,201,161,85,43,42,43
"2011","Cheshire West and Chester 022A","E01018308",1357,221,52,169,359,143,186,70,141,108,43,23,20,86
"2011","Cheshire West and Chester 022B","E01018336",981,81,23,58,225,130,62,105,184,105,28,18,10,61
"2011","Cheshire West and Chester 022C","E01018337",1039,91,33,58,252,123,133,102,150,109,38,31,7,41
"2011","Cheshire West and Chester 022D","E01018338",1346,123,27,96,306,180,100,154,215,151,41,27,14,76
"2011","Cheshire West and Chester 022E","E01018358",879,167,46,121,241,112,103,57,71,46,17,10,7,65
"2011","Cheshire West and Chester 022F","E01018359",802,149,33,116,255,109,71,47,69,38,10,8,2,54
"2011","Cheshire West and Chester 025A","E01018360",1447,252,88,164,408,194,174,71,138,68,50,34,16,92
"2011","Cheshire West and Chester 025B","E01018366",1155,151,40,111,306,155,135,87,159,75,22,14,8,65
"2011","Cheshire West and Chester 025C","E01018367",1413,178,39,139,348,168,190,111,173,115,30,18,12,100
"2011","Cheshire West and Chester 027A","E01018364",1083,72,10,62,161,101,52,109,235,189,89,58,31,75
"2011","Cheshire West and Chester 027B","E01018365",1327,221,49,172,351,194,92,86,165,105,21,11,10,92
"2011","Cheshire West and Chester 027C","E01018378",846,55,12,43,139,73,57,87,193,134,43,29,14,65
"2011","Cheshire West and Chester 027D","E01018379",950,140,34,106,237,164,69,72,116,72,18,16,2,62
"2011","Cheshire West and Chester 027E","E01018380",822,107,28,79,177,123,58,69,127,81,23,14,9,57
"2011","Cheshire West and Chester 028A","E01018362",1108,184,39,145,297,160,90,77,113,78,28,16,12,81
"2011","Cheshire West and Chester 028B","E01018363",735,110,21,89,182,116,54,58,86,60,24,15,9,45
"2011","Cheshire West and Chester 028C","E01018374",1376,267,44,223,435,162,82,73,116,58,24,20,4,159
"2011","Cheshire West and Chester 028D","E01018375",1519,251,41,210,379,148,100,80,137,62,50,44,6,312
"2011","Cheshire West and Chester 028E","E01018376",1050,178,41,137,284,157,85,65,120,65,24,15,9,72
"2011","Cheshire West and Chester 028F","E01018377",1151,250,66,184,360,138,78,68,106,58,40,27,13,53
"2011","Cheshire West and Chester 029A","E01018309",1224,46,15,31,180,172,97,131,242,181,75,48,27,100
"2011","Cheshire West and Chester 029B","E01018310",1096,42,10,32,116,104,49,114,258,234,89,63,26,90
"2011","Cheshire West and Chester 029C","E01018311",989,37,7,30,125,98,67,111,202,197,95,58,37,57
"2011","Cheshire West and Chester 029D","E01018312",1091,23,2,21,142,109,73,135,248,190,81,57,24,90
"2011","Cheshire West and Chester 031A","E01018313",1036,56,11,45,181,134,76,113,231,156,29,18,11,60
"2011","Cheshire West and Chester 031B","E01018314",1177,29,8,21,139,140,73,127,303,212,76,52,24,78
"2011","Cheshire West and Chester 031C","E01018315",834,52,12,40,158,100,69,79,166,118,46,30,16,46
"2011","Cheshire West and Chester 031D","E01018316",981,28,8,20,123,79,65,99,222,195,90,58,32,80
"2011","Cheshire West and Chester 031E","E01018317",1069,18,3,15,138,94,65,104,248,244,94,58,36,64
"2011","Cheshire West and Chester 030A","E01018349",1183,232,44,188,303,151,136,68,126,75,21,11,10,71
"2011","Cheshire West and Chester 030B","E01018350",1370,281,73,208,405,160,158,80,119,55,32,20,12,80
"2011","Cheshire West and Chester 030C","E01018368",973,137,26,111,248,124,114,80,109,78,24,16,8,59
"2011","Cheshire West and Chester 030D","E01018370",967,176,42,134,299,136,107,47,76,52,15,9,6,59
"2011","Cheshire West and Chester 032A","E01018345",942,150,35,115,242,111,65,72,146,82,21,13,8,53
"2011","Cheshire West and Chester 032B","E01018346",964,187,35,152,300,120,76,55,92,50,27,12,15,57
"2011","Cheshire West and Chester 032C","E01018347",993,75,11,64,186,102,68,104,191,166,41,31,10,60
"2011","Cheshire West and Chester 032D","E01018383",1073,126,17,109,278,155,91,90,148,89,15,9,6,81
"2011","Cheshire West and Chester 032E","E01018384",1050,157,33,124,288,178,92,69,119,77,14,7,7,56
"2011","Cheshire West and Chester 033B","E01018327",1681,172,25,147,321,182,103,148,275,191,103,65,38,186
"2011","Cheshire West and Chester 033C","E01018343",1321,200,25,175,311,170,74,102,159,122,45,30,15,138
"2011","Cheshire West and Chester 033D","E01018361",1158,190,29,161,301,124,85,64,143,77,55,30,25,119
"2011","Cheshire West and Chester 033E","E01032930",1541,240,31,209,332,184,109,125,203,140,93,55,38,115
"2011","Cheshire West and Chester 033F","E01032931",960,183,31,152,249,85,90,59,109,66,25,17,8,94
"2011","Cheshire West and Chester 034A","E01018326",1669,234,61,173,410,177,146,112,189,129,44,24,20,228
"2011","Cheshire West and Chester 034B","E01018328",1684,94,16,78,130,63,58,31,73,67,20,14,6,1148
"2011","Cheshire West and Chester 034C","E01018329",1933,177,17,160,310,160,81,83,141,112,69,45,24,800
"2011","Cheshire West and Chester 034D","E01018330",1062,65,16,49,177,78,62,67,113,49,18,9,9,433
"2011","Cheshire West and Chester 034E","E01018331",1501,117,11,106,292,119,57,99,125,93,35,17,18,564
"2011","Cheshire West and Chester 036A","E01018319",1607,214,35,179,434,178,138,113,226,127,66,31,35,111
"2011","Cheshire West and Chester 036B","E01018344",1551,304,59,245,495,179,88,97,168,80,31,11,20,109
"2011","Cheshire West and Chester 036C","E01018381",866,128,12,116,267,112,70,66,92,50,18,6,12,63
"2011","Cheshire West and Chester 036D","E01018382",1078,114,27,87,262,124,93,97,145,115,32,15,17,96
"2011","Cheshire West and Chester 039A","E01018323",955,173,42,131,264,111,104,52,96,57,21,14,7,77
"2011","Cheshire West and Chester 039B","E01018324",957,197,54,143,246,122,105,45,85,45,13,7,6,99
"2011","Cheshire West and Chester 039C","E01018325",1094,205,47,158,349,146,114,56,67,52,25,17,8,80
"2011","Cheshire West and Chester 039D","E01018385",1470,288,83,205,433,221,144,69,110,65,30,22,8,110
"2011","Cheshire West and Chester 041A","E01018320",991,126,27,99,265,141,75,81,114,76,16,8,8,97
"2011","Cheshire West and Chester 041B","E01018321",883,177,31,146,271,112,79,45,96,48,9,7,2,46
"2011","Cheshire West and Chester 041C","E01018322",803,166,35,131,213,116,50,56,84,33,15,7,8,70
"2011","Cheshire West and Chester 041D","E01018348",1582,252,50,202,445,223,152,116,186,91,32,18,14,85
"2011","Cheshire West and Chester 043A","E01018332",742,177,31,146,230,89,55,29,69,35,18,12,6,40
"2011","Cheshire West and Chester 043B","E01018333",1089,296,72,224,328,151,100,42,60,24,21,9,12,67
"2011","Cheshire West and Chester 043C","E01018334",1095,218,48,170,297,179,83,60,107,52,32,22,10,67
"2011","Cheshire West and Chester 043D","E01018340",1017,185,37,148,270,105,74,64,129,110,25,18,7,55
"2011","Cheshire West and Chester 043E","E01018341",793,185,43,142,226,92,65,47,74,47,24,14,10,33
"2011","Cheshire West and Chester 043F","E01018342",1209,254,36,218,368,143,84,75,119,74,33,18,15,59
"2011","Cheshire West and Chester 044A","E01018351",1073,29,4,25,97,72,66,118,216,275,127,95,32,73
"2011","Cheshire West and Chester 044B","E01018352",1392,139,25,114,348,211,74,124,240,160,32,19,13,64
"2011","Cheshire West and Chester 044C","E01018353",1173,150,35,115,262,157,103,89,164,111,36,19,17,101
"2011","Cheshire West and Chester 044D","E01018354",1146,95,25,70,226,131,67,97,202,151,93,71,22,84
"2011","Cheshire West and Chester 046A","E01018335",1522,287,63,224,360,178,200,87,178,94,38,21,17,100
"2011","Cheshire West and Chester 046B","E01018369",1169,185,56,129,252,129,242,68,104,79,27,21,6,83
"2011","Cheshire West and Chester 046C","E01018371",1308,172,43,129,313,146,165,80,178,142,29,18,11,83
"2011","Cheshire West and Chester 046D","E01018372",1408,249,70,179,384,173,234,86,136,76,20,12,8,50
"2011","Cheshire West and Chester 047A","E01018339",1426,256,68,188,395,191,177,80,149,75,30,16,14,73
"2011","Cheshire West and Chester 047B","E01018355",804,100,22,78,171,71,114,66,122,101,28,18,10,31
"2011","Cheshire West and Chester 047C","E01018356",1120,144,41,103,230,124,205,63,156,105,27,15,12,66
"2011","Cheshire West and Chester 047D","E01018357",971,122,27,95,226,111,221,54,89,68,25,18,7,55
"2011","Cheshire West and Chester 047E","E01018373",1503,263,70,193,378,144,285,86,141,72,33,24,9,101
"2011","Cheshire West and Chester 001A","E01018534",1842,174,38,136,344,173,144,156,365,226,98,62,36,162
"2011","Cheshire West and Chester 001B","E01018535",1088,114,22,92,200,114,110,96,180,141,42,22,20,91
"2011","Cheshire West and Chester 001C","E01018536",1227,232,55,177,366,180,105,70,115,57,22,15,7,80
"2011","Cheshire West and Chester 001D","E01018537",1405,327,82,245,423,174,143,57,119,55,31,19,12,76
"2011","Cheshire West and Chester 004A","E01018518",1161,235,63,172,352,157,166,53,74,43,16,11,5,65
"2011","Cheshire West and Chester 004B","E01018569",922,215,52,163,268,131,86,38,66,36,20,13,7,62
"2011","Cheshire West and Chester 004C","E01018570",901,159,41,118,223,115,125,61,88,41,24,18,6,65
"2011","Cheshire West and Chester 004D","E01018571",973,199,49,150,289,124,89,47,109,40,18,11,7,58
"2011","Cheshire West and Chester 005A","E01018546",1072,46,7,39,150,117,70,131,223,186,80,66,14,69
"2011","Cheshire West and Chester 005B","E01018547",1042,67,17,50,225,145,69,127,191,134,24,18,6,60
"2011","Cheshire West and Chester 005C","E01018548",1186,81,18,63,179,152,64,131,239,210,62,42,20,68
"2011","Cheshire West and Chester 005D","E01018549",1067,102,24,78,225,146,72,135,162,122,39,29,10,64
"2011","Cheshire West and Chester 006A","E01018532",1326,122,28,94,277,134,127,127,213,170,54,34,20,102
"2011","Cheshire West and Chester 006B","E01018533",1097,135,23,112,301,173,90,88,119,93,21,16,5,77
"2011","Cheshire West and Chester 006C","E01018544",1173,156,42,114,323,188,87,91,128,72,29,19,10,99
"2011","Cheshire West and Chester 006D","E01018545",1483,179,41,138,368,208,120,140,195,114,23,19,4,136
"2011","Cheshire West and Chester 007A","E01018519",1080,27,10,17,142,136,47,121,265,206,79,46,33,57
"2011","Cheshire West and Chester 007B","E01018520",781,25,8,17,110,76,53,85,194,144,56,29,27,38
"2011","Cheshire West and Chester 007C","E01018525",886,20,6,14,102,77,45,79,241,174,75,43,32,73
"2011","Cheshire West and Chester 007D","E01018563",1517,85,19,66,224,145,83,143,312,274,168,105,63,83
"2011","Cheshire West and Chester 007E","E01018564",1695,86,25,61,254,170,116,179,379,281,138,78,60,92
"2011","Cheshire West and Chester 008A","E01018523",921,29,8,21,115,119,45,106,207,174,65,38,27,61
"2011","Cheshire West and Chester 008B","E01018524",941,24,3,21,98,59,46,105,241,194,94,67,27,80
"2011","Cheshire West and Chester 008C","E01018541",988,61,19,42,176,140,75,107,193,131,43,32,11,62
"2011","Cheshire West and Chester 008D","E01018542",842,22,3,19,100,81,41,96,200,138,77,45,32,87
"2011","Cheshire West and Chester 008E","E01018543",949,39,7,32,160,126,53,89,224,158,42,24,18,58
"2011","Cheshire West and Chester 009A","E01018528",912,71,14,57,212,150,58,105,143,96,11,7,4,66
"2011","Cheshire West and Chester 009B","E01018529",1140,95,28,67,243,178,65,163,202,116,19,12,7,59
"2011","Cheshire West and Chester 009C","E01018530",1118,233,54,179,301,184,100,82,84,51,11,3,8,72
"2011","Cheshire West and Chester 009D","E01018531",1166,137,31,106,289,193,92,120,156,83,22,11,11,74
"2011","Cheshire West and Chester 009E","E01018560",918,106,37,69,207,142,59,94,148,91,16,7,9,55
"2011","Cheshire West and Chester 009F","E01018561",956,156,56,100,249,140,66,105,101,64,9,4,5,66
"2011","Cheshire West and Chester 009G","E01018562",1068,137,38,99,302,180,55,99,129,51,17,11,6,98
"2011","Cheshire West and Chester 010A","E01018522",978,44,14,30,137,104,71,122,193,167,75,42,33,65
"2011","Cheshire West and Chester 010B","E01018538",816,30,11,19,114,67,55,80,200,151,47,27,20,72
"2011","Cheshire West and Chester 010C","E01018539",788,27,3,24,109,72,38,78,177,166,61,44,17,60
"2011","Cheshire West and Chester 010D","E01018540",1038,68,18,50,206,125,73,121,219,131,30,19,11,65
"2011","Cheshire West and Chester 011A","E01018521",873,35,9,26,93,66,45,106,224,183,65,46,19,56
"2011","Cheshire West and Chester 011B","E01018550",796,20,6,14,76,68,41,114,177,163,84,47,37,53
"2011","Cheshire West and Chester 011C","E01018551",1140,26,8,18,138,89,62,122,272,259,111,59,52,61
"2011","Cheshire West and Chester 011D","E01018552",1118,47,14,33,150,127,89,120,233,200,78,49,29,74
"2011","Cheshire West and Chester 011E","E01018553",1063,39,14,25,171,86,80,115,211,205,83,60,23,73
"2011","Cheshire West and Chester 013A","E01018556",1047,72,22,50,193,177,63,132,183,145,33,13,20,49
"2011","Cheshire West and Chester 013B","E01018557",1038,47,8,39,139,114,55,132,244,166,59,36,23,82
"2011","Cheshire West and Chester 013C","E01018558",1017,65,13,52,240,154,61,134,173,112,21,17,4,57
"2011","Cheshire West and Chester 013D","E01018559",910,68,16,52,202,129,41,124,178,91,16,9,7,61
"2011","Cheshire West and Chester 014A","E01018565",1095,111,30,81,254,161,77,118,177,97,27,22,5,73
"2011","Cheshire West and Chester 014B","E01018566",993,69,19,50,193,153,43,148,213,107,24,12,12,43
"2011","Cheshire West and Chester 014C","E01018567",1086,77,17,60,248,126,75,125,202,132,29,23,6,72
"2011","Cheshire West and Chester 014D","E01018568",1150,182,50,132,303,182,100,113,120,70,20,12,8,60
"2011","Cheshire West and Chester 016A","E01018526",1206,99,30,69,256,209,82,161,184,114,20,12,8,81
"2011","Cheshire West and Chester 016B","E01018527",1280,100,26,74,257,212,70,175,201,148,34,21,13,83
"2011","Cheshire West and Chester 016C","E01018554",1791,212,54,158,453,265,95,212,290,121,29,19,10,114
"2011","Cheshire West and Chester 016D","E01018555",926,72,18,54,185,139,52,137,164,109,19,12,7,49
"2011","Cheshire West and Chester 002A","E01018685",843,50,10,40,116,76,78,74,171,156,69,54,15,53
"2011","Cheshire West and Chester 002B","E01018686",1047,150,23,127,282,134,76,86,137,93,42,29,13,47
"2011","Cheshire West and Chester 002C","E01018687",979,198,40,158,293,119,76,54,105,61,21,14,7,52
"2011","Cheshire West and Chester 002D","E01018688",1175,201,45,156,360,143,94,86,120,85,26,12,14,60
"2011","Cheshire West and Chester 002E","E01018689",981,127,34,93,213,128,82,76,153,121,39,30,9,42
"2011","Cheshire West and Chester 002F","E01018690",1514,324,70,254,487,182,144,73,130,68,28,13,15,78
"2011","Cheshire West and Chester 003A","E01018675",1587,316,85,231,403,222,206,82,144,97,29,19,10,88
"2011","Cheshire West and Chester 003B","E01018708",1602,236,72,164,442,182,285,89,145,103,31,15,16,89
"2011","Cheshire West and Chester 003C","E01018721",1700,309,85,224,430,184,312,77,136,115,42,28,14,95
"2011","Cheshire West and Chester 012A","E01018671",961,125,24,101,213,181,62,98,131,94,16,9,7,41
"2011","Cheshire West and Chester 012B","E01018672",1122,71,22,49,182,121,79,125,232,171,69,45,24,72
"2011","Cheshire West and Chester 012C","E01018673",906,75,18,57,188,157,66,93,156,110,19,13,6,42
"2011","Cheshire West and Chester 012D","E01018674",1153,88,13,75,241,162,103,105,189,135,38,24,14,92
"2011","Cheshire West and Chester 015A","E01018684",1659,360,99,261,513,172,227,69,120,80,21,11,10,97
"2011","Cheshire West and Chester 015B","E01018695",1268,164,35,129,326,187,99,140,159,107,17,9,8,69
"2011","Cheshire West and Chester 015C","E01018696",1068,173,43,130,309,135,96,68,116,70,20,8,12,81
"2011","Cheshire West and Chester 015D","E01018697",1250,170,38,132,313,155,116,102,155,116,24,13,11,99
"2011","Cheshire West and Chester 015E","E01018698",1460,295,78,217,409,186,178,85,132,60,27,14,13,88
"2011","Cheshire West and Chester 017A","E01018704",867,77,23,54,153,112,86,77,167,133,15,8,7,47
"2011","Cheshire West and Chester 017B","E01018705",1154,169,40,129,294,169,121,75,134,85,28,11,17,79
"2011","Cheshire West and Chester 017C","E01018706",971,80,19,61,171,112,92,114,150,143,52,32,20,57
"2011","Cheshire West and Chester 017D","E01018718",1275,127,32,95,269,162,115,140,198,160,40,23,17,64
"2011","Cheshire West and Chester 017E","E01018722",1658,254,75,179,378,207,336,103,156,106,30,21,9,88
"2011","Cheshire West and Chester 018A","E01018713",1995,181,41,140,457,272,174,184,301,233,73,38,35,120
"2011","Cheshire West and Chester 018B","E01018714",1303,81,17,64,221,138,93,116,252,232,115,63,52,55
"2011","Cheshire West and Chester 018C","E01018715",1315,65,18,47,223,142,108,143,264,230,76,37,39,64
"2011","Cheshire West and Chester 019A","E01018726",1054,50,10,40,184,119,98,109,224,174,46,28,18,50
"2011","Cheshire West and Chester 019B","E01018727",1259,203,55,148,317,186,139,77,149,96,30,13,17,62
"2011","Cheshire West and Chester 019C","E01018728",1123,87,23,64,199,131,78,127,203,181,46,25,21,71
"2011","Cheshire West and Chester 019D","E01018729",1162,55,13,42,183,123,74,121,217,254,61,33,28,74
"2011","Cheshire West and Chester 020A","E01018709",1136,65,21,44,205,149,96,112,235,160,59,40,19,55
"2011","Cheshire West and Chester 020B","E01018710",1085,60,18,42,159,115,68,117,220,193,73,50,23,80
"2011","Cheshire West and Chester 020C","E01018711",1207,163,39,124,295,182,111,88,151,123,39,23,16,55
"2011","Cheshire West and Chester 020D","E01018712",1220,118,30,88,234,152,112,118,211,165,44,27,17,66
"2011","Cheshire West and Chester 021A","E01018699",1176,154,37,117,304,136,100,94,169,113,32,18,14,74
"2011","Cheshire West and Chester 021B","E01018701",1039,46,11,35,121,87,63,119,223,254,64,42,22,62
"2011","Cheshire West and Chester 021C","E01018716",1139,47,16,31,135,91,57,126,251,257,92,59,33,83
"2011","Cheshire West and Chester 021D","E01018717",1314,106,27,79,252,161,94,133,246,201,66,32,34,55
"2011","Cheshire West and Chester 021E","E01018719",1130,67,12,55,192,150,97,115,193,181,61,44,17,74
"2011","Cheshire West and Chester 021F","E01018720",1113,50,12,38,129,102,94,138,266,203,59,39,20,72
"2011","Cheshire West and Chester 023A","E01018691",1080,210,46,164,304,141,84,72,94,64,24,14,10,87
"2011","Cheshire West and Chester 023B","E01018693",1175,255,65,190,334,172,99,58,107,48,17,9,8,85
"2011","Cheshire West and Chester 023C","E01018694",1122,248,66,182,362,180,88,42,68,44,9,2,7,81
"2011","Cheshire West and Chester 023D","E01018700",1445,324,75,249,432,223,110,57,102,55,25,12,13,117
"2011","Cheshire West and Chester 023E","E01018702",922,192,52,140,307,124,68,41,76,41,15,9,6,58
"2011","Cheshire West and Chester 023F","E01018703",1422,234,56,178,444,230,82,93,151,86,40,22,18,62
"2011","Cheshire West and Chester 024A","E01018676",1049,196,43,153,333,147,114,49,80,44,21,16,5,65
"2011","Cheshire West and Chester 024B","E01018677",1110,232,60,172,319,143,148,53,94,55,15,6,9,51
"2011","Cheshire West and Chester 024C","E01018678",889,188,51,137,289,126,70,25,66,35,17,13,4,73
"2011","Cheshire West and Chester 024D","E01018679",1222,153,44,109,267,160,121,111,176,125,42,24,18,67
"2011","Cheshire West and Chester 024E","E01018692",1462,333,88,245,443,169,193,66,82,58,24,17,7,94
"2011","Cheshire West and Chester 026A","E01018680",1239,223,67,156,355,175,145,68,112,67,13,8,5,81
"2011","Cheshire West and Chester 026B","E01018681",1073,102,32,70,266,157,90,103,168,125,23,10,13,39
"2011","Cheshire West and Chester 026C","E01018682",754,80,17,63,186,102,60,62,117,93,13,8,5,41
"2011","Cheshire West and Chester 026D","E01018683",1049,184,46,138,325,144,125,47,91,73,9,4,5,51
"2011","Cheshire West and Chester 035A","E01018733",1085,49,18,31,165,136,96,118,199,211,56,46,10,55
"2011","Cheshire West and Chester 035B","E01018734",933,44,19,25,125,94,41,106,194,215,63,40,23,51
"2011","Cheshire West and Chester 035C","E01018748",916,20,8,12,62,76,33,95,210,240,106,66,40,74
"2011","Cheshire West and Chester 035D","E01018749",1816,163,46,117,395,260,137,162,292,222,67,41,26,118
"2011","Cheshire West and Chester 037A","E01018736",1234,117,35,82,224,164,107,118,202,169,47,27,20,86
"2011","Cheshire West and Chester 037B","E01018737",1029,136,37,99,278,139,100,73,114,94,23,12,11,72
"2011","Cheshire West and Chester 037C","E01018743",1142,101,28,73,212,174,105,94,212,146,26,15,11,72
"2011","Cheshire West and Chester 037D","E01018744",1248,111,37,74,229,153,71,112,235,182,58,37,21,97
"2011","Cheshire West and Chester 038A","E01018732",1019,42,20,22,175,149,73,105,193,164,66,53,13,52
"2011","Cheshire West and Chester 038B","E01018745",1128,23,6,17,117,100,69,137,243,267,100,55,45,72
"2011","Cheshire West and Chester 038C","E01018746",1246,70,20,50,202,144,85,120,239,228,66,38,28,92
"2011","Cheshire West and Chester 038D","E01018747",1147,62,18,44,188,162,86,106,212,217,48,28,20,66
"2011","Cheshire West and Chester 040A","E01018730",1052,48,6,42,152,120,72,105,212,223,50,40,10,70
"2011","Cheshire West and Chester 040B","E01018738",894,16,1,15,57,76,47,76,194,227,117,79,38,84
"2011","Cheshire West and Chester 040C","E01018739",1012,62,20,42,146,104,70,79,187,223,85,57,28,56
"2011","Cheshire West and Chester 040D","E01018741",961,88,21,67,196,154,75,91,147,118,44,31,13,48
"2011","Cheshire West and Chester 042A","E01018731",1163,51,19,32,187,133,103,131,233,202,70,44,26,53
"2011","Cheshire West and Chester 042B","E01018735",1015,77,29,48,188,177,84,101,165,127,45,34,11,51
"2011","Cheshire West and Chester 042C","E01018740",1090,57,13,44,149,111,72,96,209,199,104,74,30,93
"2011","Cheshire West and Chester 042D","E01018742",1200,120,39,81,258,174,117,114,179,112,51,37,14,75
"2011","Cheshire West and Chester 045A","E01018707",1312,220,50,170,346,147,203,75,116,100,26,18,8,79
"2011","Cheshire West and Chester 045B","E01018723",768,112,28,84,184,82,95,66,109,65,12,6,6,43
"2011","Cheshire West and Chester 045C","E01018724",1103,258,73,185,312,132,121,40,102,60,11,9,2,67
"2011","Cheshire West and Chester 045D","E01018725",962,143,50,93,256,105,197,49,83,60,23,19,4,46
"2011","Halton 001A","E01012392",1754,222,61,161,412,288,138,171,209,141,26,13,13,147
"2011","Halton 001B","E01012393",1499,205,58,147,462,232,148,104,142,92,25,22,3,89
"2011","Halton 001C","E01012395",1092,116,28,88,268,195,96,90,143,83,29,14,15,72
"2011","Halton 001D","E01012411",995,58,15,43,183,150,74,123,165,128,44,30,14,70
"2011","Halton 002A","E01012374",2004,341,79,262,580,347,155,121,193,98,36,21,15,133
"2011","Halton 002B","E01012375",1212,198,66,132,352,186,110,82,98,46,23,17,6,117
"2011","Halton 002C","E01012376",1916,305,90,215,551,331,156,133,185,94,22,12,10,139
"2011","Halton 002D","E01012421",1077,107,28,79,276,189,77,97,144,87,23,12,11,77
"2011","Halton 002E","E01012423",1105,94,33,61,251,180,88,112,163,117,33,20,13,67
"2011","Halton 003A","E01012368",1348,65,17,48,212,194,98,149,267,214,66,46,20,83
"2011","Halton 003B","E01012410",1014,78,17,61,204,196,72,122,165,98,22,14,8,57
"2011","Halton 003C","E01012412",1086,33,10,23,121,151,66,106,242,196,106,78,28,65
"2011","Halton 003D","E01012413",1031,35,14,21,110,134,60,116,254,176,75,51,24,71
"2011","Halton 003E","E01012414",966,54,18,36,176,154,51,111,203,133,32,13,19,52
"2011","Halton 004A","E01012377",1360,41,11,30,171,176,73,154,288,277,105,72,33,75
"2011","Halton 004B","E01012390",1084,46,8,38,178,125,80,102,217,174,99,66,33,63
"2011","Halton 004C","E01012419",845,24,9,15,88,99,52,81,207,171,64,42,22,59
"2011","Halton 004D","E01012420",1070,30,9,21,127,131,65,92,244,211,91,61,30,79
"2011","Halton 004E","E01012422",1013,29,12,17,108,143,50,77,235,208,93,70,23,70
"2011","Halton 005A","E01012369",1115,51,16,35,187,142,87,84,202,200,88,59,29,74
"2011","Halton 005B","E01012394",1058,64,16,48,184,143,85,101,208,147,58,39,19,68
"2011","Halton 005C","E01012425",1198,28,9,19,152,118,90,121,260,242,95,64,31,92
"2011","Halton 005D","E01012426",1009,89,25,64,228,153,105,99,126,104,29,16,13,76
"2011","Halton 005E","E01012427",1296,70,23,47,207,158,76,106,285,209,73,48,25,112
"2011","Halton 006A","E01012378",1156,75,24,51,194,206,81,129,225,151,20,10,10,75
"2011","Halton 006B","E01012379",1146,45,19,26,177,161,75,120,217,178,94,66,28,79
"2011","Halton 006C","E01012380",951,27,9,18,85,107,61,98,214,191,98,70,28,70
"2011","Halton 006D","E01012388",1267,33,7,26,156,154,66,120,297,252,104,73,31,85
"2011","Halton 006E","E01012442",1094,32,10,22,103,104,54,81,277,244,96,64,32,103
"2011","Halton 007A","E01012367",1154,35,8,27,142,113,85,105,249,229,119,80,39,77
"2011","Halton 007B","E01012370",1323,52,10,42,154,206,68,126,305,222,112,72,40,78
"2011","Halton 007C","E01012424",1334,28,7,21,114,112,72,131,253,328,184,125,59,112
"2011","Halton 007D","E01012441",1698,53,12,41,203,156,119,153,365,352,200,119,81,97
"2011","Halton 008A","E01012389",1365,109,26,83,304,216,72,167,228,149,31,20,11,89
"2011","Halton 008B","E01012391",1611,74,20,54,269,210,139,147,283,290,113,68,45,86
"2011","Halton 008C","E01012401",1410,141,40,101,337,221,152,116,177,141,33,18,15,92
"2011","Halton 008D","E01012443",1218,56,18,38,215,186,93,100,228,172,73,50,23,95
"2011","Halton 009A","E01012385",1096,193,57,136,331,159,121,67,88,54,16,9,7,67
"2011","Halton 009B","E01012386",1428,264,75,189,401,237,123,81,112,81,24,13,11,105
"2011","Halton 009C","E01012387",814,122,32,90,215,125,94,53,69,74,16,9,7,46
"2011","Halton 009D","E01012434",1196,137,36,101,288,206,78,108,150,118,36,26,10,75
"2011","Halton 009E","E01012435",1608,225,79,146,428,285,114,136,169,97,37,27,10,117
"2011","Halton 010A","E01012381",996,25,8,17,98,85,34,80,235,221,161,106,55,57
"2011","Halton 010B","E01012382",1087,17,6,11,92,120,48,112,251,264,119,79,40,64
"2011","Halton 010C","E01012384",1208,68,17,51,212,180,77,96,208,205,93,69,24,69
"2011","Halton 010D","E01012444",795,18,4,14,67,75,25,69,178,161,110,80,30,92
"2011","Halton 010E","E01012445",950,20,4,16,87,100,43,95,204,219,110,84,26,72
"2011","Halton 011A","E01012398",876,48,11,37,164,142,53,112,150,121,35,24,11,51
"2011","Halton 011B","E01012400",888,60,19,41,166,154,65,90,160,105,38,21,17,50
"2011","Halton 011C","E01012402",1125,44,14,30,129,126,60,108,242,223,95,68,27,98
"2011","Halton 011D","E01012404",1020,63,22,41,177,148,67,125,171,170,48,29,19,51
"2011","Halton 011E","E01012405",1482,76,26,50,264,200,81,189,254,232,87,65,22,99
"2011","Halton 012A","E01012416",1281,135,42,93,255,190,95,140,188,156,54,33,21,68
"2011","Halton 012B","E01012417",956,47,12,35,157,120,57,113,177,152,65,32,33,68
"2011","Halton 012C","E01012428",1662,127,30,97,335,241,95,197,292,208,62,45,17,105
"2011","Halton 012D","E01012429",981,50,19,31,144,135,56,107,174,172,60,36,24,83
"2011","Halton 012E","E01012430",1323,46,9,37,179,144,70,119,288,259,133,80,53,85
"2011","Halton 012F","E01012431",1615,94,25,69,296,232,104,153,290,249,118,68,50,79
"2011","Halton 013A","E01012383",1265,74,20,54,187,188,77,132,213,221,94,63,31,79
"2011","Halton 013B","E01012396",1076,18,4,14,116,116,45,110,237,226,126,76,50,82
"2011","Halton 013C","E01012397",1062,25,4,21,116,109,43,94,248,233,121,94,27,73
"2011","Halton 013D","E01012399",995,26,6,20,114,120,44,109,214,217,80,50,30,71
"2011","Halton 013E","E01012403",1129,26,12,14,109,129,54,104,245,252,129,85,44,81
"2011","Halton 013F","E01012408",1354,29,10,19,131,142,71,122,287,267,171,121,50,134
"2011","Halton 014A","E01012432",1094,69,13,56,185,143,66,128,212,175,47,32,15,69
"2011","Halton 014B","E01012433",1148,51,11,40,163,131,52,99,253,248,92,60,32,59
"2011","Halton 014C","E01012436",873,23,7,16,92,102,31,70,180,176,120,81,39,79
"2011","Halton 014D","E01012438",825,21,6,15,83,98,29,89,159,183,101,72,29,62
"2011","Halton 014E","E01012440",1080,66,16,50,198,172,46,131,194,168,47,31,16,58
"2011","Halton 015A","E01012406",1186,54,14,40,172,142,73,131,249,190,88,58,30,87
"2011","Halton 015B","E01012407",1197,25,8,17,128,153,52,91,272,264,126,82,44,86
"2011","Halton 015C","E01012409",1037,32,6,26,130,138,51,102,216,217,88,58,30,63
"2011","Halton 015D","E01012437",956,30,10,20,86,118,32,90,250,208,74,41,33,68
"2011","Halton 015E","E01012439",1105,33,14,19,124,126,52,103,250,242,96,56,40,79
"2011","Halton 016A","E01012371",996,93,16,77,219,168,61,97,153,129,21,14,7,55
"2011","Halton 016B","E01012372",934,94,36,58,209,174,72,91,152,79,20,15,5,43
"2011","Halton 016C","E01012373",1040,106,39,67,242,207,49,127,134,108,24,15,9,43
"2011","Halton 016D","E01012415",1069,107,27,80,223,197,81,107,170,107,25,15,10,52
"2011","Halton 016E","E01012418",1026,124,41,83,266,186,66,114,123,70,21,12,9,56
"2011","Warrington 001A","E01012471",1937,179,39,140,296,176,198,150,217,359,258,212,46,104
"2011","Warrington 001B","E01012472",1306,239,56,183,390,177,149,57,112,71,29,17,12,82
"2011","Warrington 001C","E01012476",1198,142,36,106,290,167,151,67,134,118,42,24,18,87
"2011","Warrington 001D","E01012477",1110,234,69,165,355,137,113,46,64,35,33,26,7,93
"2011","Warrington 002A","E01012473",1022,224,59,165,311,150,89,40,88,54,18,13,5,48
"2011","Warrington 002B","E01012474",1003,101,22,79,221,152,66,69,168,110,38,33,5,78
"2011","Warrington 002C","E01012475",1090,115,33,82,258,168,99,64,167,102,33,15,18,84
"2011","Warrington 002D","E01012554",1514,201,48,153,379,226,184,105,160,127,42,21,21,90
"2011","Warrington 003A","E01012467",964,75,21,54,217,151,59,109,167,126,13,8,5,47
"2011","Warrington 003B","E01012468",1717,305,80,225,475,197,168,86,172,113,112,85,27,89
"2011","Warrington 003C","E01012469",1172,99,34,65,235,186,139,92,149,142,65,57,8,65
"2011","Warrington 003D","E01012470",824,32,8,24,147,106,55,86,170,131,41,20,21,56
"2011","Warrington 004A","E01012460",1077,95,18,77,215,171,59,92,147,167,57,31,26,74
"2011","Warrington 004B","E01012462",972,151,26,125,254,166,58,69,115,91,22,12,10,46
"2011","Warrington 004C","E01012463",896,157,34,123,279,136,82,49,79,44,13,7,6,57
"2011","Warrington 004D","E01012464",1081,101,15,86,224,171,75,72,179,121,55,40,15,83
"2011","Warrington 005A","E01012459",1042,60,14,46,181,162,51,73,181,198,68,37,31,68
"2011","Warrington 005B","E01012461",1025,174,47,127,276,191,63,58,124,59,16,9,7,64
"2011","Warrington 005C","E01012465",1024,95,17,78,232,192,80,68,144,114,43,20,23,56
"2011","Warrington 005D","E01012466",1108,76,14,62,169,171,55,85,205,208,76,40,36,63
"2011","Warrington 006A","E01012526",1146,23,7,16,99,99,52,86,268,300,132,91,41,87
"2011","Warrington 006B","E01012534",1079,33,6,27,114,116,63,70,263,231,98,66,32,91
"2011","Warrington 006C","E01012535",1151,25,7,18,125,154,49,104,261,271,81,45,36,81
"2011","Warrington 006D","E01012537",1030,29,7,22,103,129,51,101,204,254,80,47,33,79
"2011","Warrington 006E","E01012539",1108,51,15,36,183,142,86,106,203,188,80,43,37,69
"2011","Warrington 007A","E01012538",1170,163,35,128,288,225,90,75,145,97,25,17,8,62
"2011","Warrington 007B","E01012540",1018,124,32,92,239,177,86,77,137,103,16,8,8,59
"2011","Warrington 007C","E01012541",1006,115,29,86,244,172,44,58,137,104,30,16,14,102
"2011","Warrington 007D","E01012542",1050,101,27,74,230,176,71,63,152,142,38,15,23,77
"2011","Warrington 007E","E01012543",1370,104,31,73,245,188,77,82,147,117,23,12,11,387
"2011","Warrington 007F","E01012544",1094,99,21,78,224,167,75,90,186,159,42,23,19,52
"2011","Warrington 008A","E01012521",1167,54,13,41,186,177,63,97,254,205,60,42,18,71
"2011","Warrington 008B","E01012522",1016,40,11,29,143,127,60,96,219,225,44,27,17,62
"2011","Warrington 008C","E01012533",950,19,3,16,86,87,50,85,206,253,104,74,30,60
"2011","Warrington 008D","E01012536",1003,34,7,27,144,117,71,102,196,208,75,39,36,56
"2011","Warrington 008E","E01012545",1143,58,12,46,128,122,55,96,243,226,125,81,44,90
"2011","Warrington 008F","E01012546",1096,44,11,33,140,131,62,82,243,212,95,56,39,87
"2011","Warrington 009A","E01012561",1191,141,37,104,321,186,71,103,156,128,26,19,7,59
"2011","Warrington 009B","E01012562",1313,260,61,199,380,180,95,76,122,65,24,18,6,111
"2011","Warrington 009C","E01012567",1404,274,69,205,428,202,87,80,130,60,17,8,9,126
"2011","Warrington 009D","E01012568",1844,373,68,305,564,296,101,105,159,102,27,14,13,117
"2011","Warrington 010A","E01012563",1331,229,44,185,365,212,91,76,147,79,27,15,12,105
"2011","Warrington 010B","E01012564",1068,126,25,101,271,176,63,85,132,88,49,34,15,78
"2011","Warrington 010C","E01012565",1778,328,70,258,492,253,105,110,202,117,45,31,14,126
"2011","Warrington 010D","E01012566",1520,318,68,250,407,216,109,85,138,69,55,46,9,123
"2011","Warrington 010E","E01012569",1443,281,73,208,398,208,90,90,157,70,35,23,12,114
"2011","Warrington 010F","E01012570",924,94,21,73,167,145,75,59,167,112,59,34,25,46
"2011","Warrington 011A","E01012481",1176,69,18,51,197,192,85,108,198,194,45,29,16,88
"2011","Warrington 011B","E01012482",1107,38,7,31,161,162,59,90,251,231,63,38,25,52
"2011","Warrington 011C","E01012520",1080,33,5,28,96,128,56,89,223,248,143,93,50,64
"2011","Warrington 011D","E01012523",1071,56,11,45,203,150,76,88,198,189,49,25,24,62
"2011","Warrington 011E","E01012524",1153,64,16,48,197,190,102,117,220,163,25,15,10,75
"2011","Warrington 011F","E01012525",1095,54,9,45,166,142,83,99,233,191,56,38,18,71
"2011","Warrington 012A","E01012478",1031,60,7,53,190,156,84,71,194,162,39,20,19,75
"2011","Warrington 012B","E01012547",1264,106,30,76,280,220,104,100,171,149,47,27,20,87
"2011","Warrington 012C","E01012548",1358,172,28,144,300,210,82,110,192,146,42,28,14,104
"2011","Warrington 012D","E01012549",1007,77,18,59,214,170,79,79,162,163,18,12,6,45
"2011","Warrington 012E","E01012550",1154,79,26,53,252,218,89,110,182,142,18,9,9,64
"2011","Warrington 013A","E01012453",1175,25,3,22,115,117,46,95,244,307,126,88,38,100
"2011","Warrington 013B","E01012454",1503,98,28,70,274,189,79,129,277,293,79,50,29,85
"2011","Warrington 013C","E01012455",1347,36,8,28,136,122,73,137,288,324,148,86,62,83
"2011","Warrington 013D","E01012457",1258,74,9,65,207,150,74,102,246,246,84,50,34,75
"2011","Warrington 014A","E01012551",1202,148,59,89,298,186,117,100,140,98,25,17,8,90
"2011","Warrington 014B","E01012552",1009,79,12,67,171,171,75,99,176,143,38,21,17,57
"2011","Warrington 014C","E01012553",1083,131,42,89,310,171,82,88,121,80,19,9,10,81
"2011","Warrington 014D","E01012555",1024,98,33,65,198,182,89,92,148,135,18,12,6,64
"2011","Warrington 014E","E01012556",1159,93,28,65,235,197,85,112,187,166,28,17,11,56
"2011","Warrington 015A","E01012491",1048,70,19,51,236,176,71,104,174,138,20,13,7,59
"2011","Warrington 015B","E01012492",1062,124,33,91,278,208,75,97,121,80,16,9,7,63
"2011","Warrington 015C","E01012493",1301,153,31,122,340,235,85,122,168,102,20,11,9,76
"2011","Warrington 015D","E01012494",1270,195,45,150,365,225,71,102,136,81,18,7,11,77
"2011","Warrington 015E","E01012500",1074,130,29,101,271,214,90,74,147,75,19,13,6,54
"2011","Warrington 016A","E01012495",1294,168,33,135,322,236,93,109,149,103,23,10,13,91
"2011","Warrington 016B","E01012496",1046,107,29,78,245,186,73,81,173,108,18,10,8,55
"2011","Warrington 016C","E01012497",952,52,10,42,163,131,69,87,203,135,51,36,15,61
"2011","Warrington 016D","E01012498",1095,76,18,58,192,173,58,99,202,170,50,30,20,75
"2011","Warrington 016E","E01012499",1427,147,28,119,330,254,89,117,242,146,27,14,13,75
"2011","Warrington 016F","E01012501",1092,78,23,55,229,179,75,96,191,139,31,17,14,74
"2011","Warrington 017A","E01012479",1222,50,11,39,200,167,74,92,229,248,98,60,38,64
"2011","Warrington 017B","E01012480",1504,119,21,98,239,206,74,117,268,284,119,76,43,78
"2011","Warrington 017D","E01012510",1379,108,24,84,243,180,96,117,256,212,82,48,34,85
"2011","Warrington 017E","E01012511",1322,83,14,69,223,189,80,132,280,208,49,29,20,78
"2011","Warrington 017F","E01033299",1569,141,14,127,336,272,64,146,215,250,63,41,22,82
"2011","Warrington 017G","E01033303",926,42,9,33,128,138,63,79,190,177,59,38,21,50
"2011","Warrington 018B","E01012458",1745,154,44,110,350,255,103,158,269,279,86,59,27,91
"2011","Warrington 018C","E01012483",1206,47,10,37,119,153,63,111,258,269,118,79,39,68
"2011","Warrington 018D","E01012509",1356,132,34,98,289,205,104,132,203,171,44,34,10,76
"2011","Warrington 018E","E01012512",1183,99,20,79,216,189,106,108,209,171,32,19,13,53
"2011","Warrington 018F","E01033300",929,97,10,87,155,103,61,76,146,164,80,56,24,47
"2011","Warrington 018G","E01033302",1220,104,14,90,184,159,71,111,217,213,99,61,38,62
"2011","Warrington 019A","E01012527",1131,90,22,68,261,178,80,110,186,134,29,14,15,63
"2011","Warrington 019B","E01012528",942,114,38,76,210,163,72,74,140,94,26,20,6,49
"2011","Warrington 019C","E01012529",1089,85,21,64,254,205,83,100,167,100,27,16,11,68
"2011","Warrington 019D","E01012530",1055,121,37,84,274,171,98,84,127,87,19,8,11,74
"2011","Warrington 019E","E01012531",1060,114,26,88,249,196,55,102,154,111,23,13,10,56
"2011","Warrington 019F","E01012532",973,97,30,67,230,159,78,80,125,111,24,12,12,69
"2011","Warrington 020A","E01012504",1308,98,19,79,236,165,83,108,239,214,75,43,32,90
"2011","Warrington 020B","E01012505",1048,66,13,53,166,144,66,96,205,177,63,40,23,65
"2011","Warrington 020C","E01012506",1124,38,8,30,146,130,52,123,217,257,88,38,50,73
"2011","Warrington 020D","E01012507",1408,97,20,77,272,203,118,117,245,218,64,36,28,74
"2011","Warrington 020E","E01012508",1127,31,10,21,129,132,66,112,243,270,94,57,37,50
"2011","Warrington 021A","E01012513",1386,318,68,250,417,160,142,58,112,60,25,17,8,94
"2011","Warrington 021B","E01012514",1330,352,76,276,379,163,123,48,93,47,27,19,8,98
"2011","Warrington 021C","E01012515",1080,203,35,168,301,121,112,66,104,80,30,17,13,63
"2011","Warrington 021D","E01012516",968,227,50,177,280,96,113,40,91,52,17,12,5,52
"2011","Warrington 021E","E01012517",1611,387,85,302,487,215,144,73,124,56,23,11,12,102
"2011","Warrington 021F","E01012518",1443,290,61,229,397,188,179,72,98,82,29,13,16,108
"2011","Warrington 021G","E01012519",1061,190,37,153,283,124,88,64,116,106,25,14,11,65
"2011","Warrington 022A","E01012485",1146,153,36,117,292,192,83,79,147,105,26,8,18,69
"2011","Warrington 022B","E01012486",1068,178,31,147,302,171,84,76,121,61,16,12,4,59
"2011","Warrington 022C","E01012487",1104,179,40,139,301,188,82,69,132,75,15,7,8,63
"2011","Warrington 022D","E01012489",1240,287,76,211,382,158,134,54,77,48,17,11,6,83
"2011","Warrington 022E","E01012490",1026,131,42,89,250,171,93,64,139,99,17,12,5,62
"2011","Warrington 023A","E01012450",941,177,34,143,231,153,96,53,81,72,15,11,4,63
"2011","Warrington 023B","E01012451",1066,111,26,85,226,136,77,72,181,127,47,30,17,89
"2011","Warrington 023C","E01012557",1194,215,49,166,367,150,107,84,123,78,23,12,11,47
"2011","Warrington 023D","E01012558",1278,293,81,212,395,155,141,61,86,57,17,10,7,73
"2011","Warrington 023E","E01012559",1081,213,61,152,349,138,104,71,81,57,15,8,7,53
"2011","Warrington 023F","E01012560",1033,177,39,138,286,156,72,66,97,75,29,17,12,75
"2011","Warrington 024A","E01012448",1293,211,65,146,327,149,121,72,111,112,117,106,11,73
"2011","Warrington 024B","E01012488",1231,259,53,206,368,150,148,58,97,53,22,14,8,76
"2011","Warrington 024C","E01012502",1157,253,36,217,349,134,141,40,75,51,28,22,6,86
"2011","Warrington 024D","E01012503",1085,252,74,178,319,150,115,42,64,41,15,8,7,87
"2011","Warrington 025A","E01012446",1089,258,60,198,333,153,90,39,67,38,21,11,10,90
"2011","Warrington 025B","E01012447",1070,325,80,245,331,134,82,26,32,17,16,10,6,107
"2011","Warrington 025C","E01012449",1013,218,64,154,330,183,71,36,65,27,15,9,6,68
"2011","Warrington 025D","E01012452",1229,313,100,213,342,163,154,42,84,29,18,9,9,84
"2011","Allerdale 001A","E01019126",1197,56,20,36,160,92,135,121,278,223,66,37,29,66
"2011","Allerdale 001B","E01019127",1128,75,19,56,215,121,189,90,219,157,24,17,7,38
"2011","Allerdale 001C","E01019132",1387,105,35,70,282,161,312,103,214,116,25,19,6,69
"2011","Allerdale 001D","E01019134",1110,57,15,42,191,131,111,114,239,168,37,28,9,62
"2011","Allerdale 001E","E01019135",1160,48,13,35,144,106,82,133,282,226,73,49,24,66
"2011","Allerdale 001F","E01019136",1176,86,29,57,205,131,114,113,236,174,43,33,10,74
"2011","Allerdale 001G","E01019137",753,46,13,33,126,77,70,66,186,105,35,23,12,42
"2011","Allerdale 002A","E01019083",1393,143,37,106,360,119,342,95,151,106,25,14,11,52
"2011","Allerdale 002B","E01019107",1195,110,22,88,268,139,258,72,160,101,18,10,8,69
"2011","Allerdale 002C","E01019130",1247,128,30,98,310,137,212,78,188,117,21,10,11,56
"2011","Allerdale 002D","E01019131",1420,187,44,143,312,140,344,79,166,93,19,15,4,80
"2011","Allerdale 003A","E01019081",1366,64,19,45,205,127,135,121,315,267,72,56,16,60
"2011","Allerdale 003B","E01019082",1123,55,16,39,170,113,106,120,239,219,42,27,15,59
"2011","Allerdale 003C","E01019102",1294,79,26,53,218,138,293,102,210,133,43,25,18,78
"2011","Allerdale 003D","E01019128",1231,114,33,81,228,110,221,113,180,167,33,22,11,65
"2011","Allerdale 003E","E01019133",1163,141,40,101,263,118,216,73,152,110,26,14,12,64
"2011","Allerdale 004A","E01019093",1179,75,22,53,206,145,104,132,225,203,41,25,16,48
"2011","Allerdale 004B","E01019094",1239,95,22,73,237,114,143,120,199,213,56,40,16,62
"2011","Allerdale 004C","E01019096",1721,102,39,63,297,201,122,228,362,280,53,29,24,76
"2011","Allerdale 004D","E01019114",1097,70,17,53,173,113,123,128,232,158,37,20,17,63
"2011","Allerdale 004E","E01019115",1210,58,9,49,166,108,112,132,244,256,73,45,28,61
"2011","Allerdale 005A","E01019095",1120,22,7,15,89,84,61,96,288,304,109,70,39,67
"2011","Allerdale 005B","E01019097",1233,18,8,10,97,54,57,128,313,333,166,114,52,67
"2011","Allerdale 005C","E01019098",1224,48,14,34,141,109,81,134,302,297,49,30,19,63
"2011","Allerdale 005D","E01019099",1278,38,11,27,168,111,98,144,285,277,89,61,28,68
"2011","Allerdale 006A","E01019084",1095,104,21,83,252,112,109,87,211,147,31,22,9,42
"2011","Allerdale 006B","E01019085",1176,176,40,136,325,124,128,92,140,113,16,11,5,62
"2011","Allerdale 006C","E01019086",831,172,41,131,212,94,142,28,69,42,16,12,4,56
"2011","Allerdale 006D","E01019088",1218,160,32,128,342,118,112,122,171,113,27,20,7,53
"2011","Allerdale 006E","E01019091",1380,251,63,188,391,154,190,85,126,75,18,10,8,90
"2011","Allerdale 007A","E01019078",1106,155,36,119,329,136,93,87,143,94,19,9,10,50
"2011","Allerdale 007B","E01019079",1057,135,38,97,275,106,80,74,170,133,31,18,13,53
"2011","Allerdale 007C","E01019080",1335,109,37,72,250,123,133,137,211,227,77,44,33,68
"2011","Allerdale 007D","E01019087",1176,201,63,138,326,129,91,107,136,92,23,13,10,71
"2011","Allerdale 007E","E01019090",1187,202,37,165,330,102,261,67,98,66,13,10,3,48
"2011","Allerdale 008A","E01019116",946,62,22,40,163,116,75,96,180,141,60,39,21,53
"2011","Allerdale 008B","E01019118",1040,67,15,52,180,129,64,126,219,163,41,24,17,51
"2011","Allerdale 008C","E01019122",1015,32,12,20,112,76,60,116,234,257,83,49,34,45
"2011","Allerdale 008D","E01019123",1158,59,17,42,163,118,88,156,234,239,51,29,22,50
"2011","Allerdale 008E","E01019124",1564,142,51,91,368,224,97,194,254,159,27,15,12,99
"2011","Allerdale 008F","E01019125",1143,108,26,82,237,166,86,148,184,128,35,27,8,51
"2011","Allerdale 009A","E01019111",1118,23,9,14,116,87,64,114,261,310,98,74,24,45
"2011","Allerdale 009B","E01019112",1222,17,5,12,108,87,67,135,284,336,123,87,36,65
"2011","Allerdale 009C","E01019113",1192,17,5,12,120,89,59,113,301,291,134,88,46,68
"2011","Allerdale 009D","E01019120",1370,61,17,44,213,159,75,179,326,253,53,35,18,51
"2011","Allerdale 009E","E01019121",1509,47,9,38,186,149,66,196,366,318,109,75,34,72
"2011","Allerdale 010A","E01019108",1067,34,10,24,128,83,51,97,282,256,69,49,20,67
"2011","Allerdale 010B","E01019109",1304,51,14,37,126,142,64,148,318,303,79,59,20,73
"2011","Allerdale 010C","E01019110",1224,42,20,22,132,130,49,118,282,278,117,81,36,76
"2011","Allerdale 010D","E01019117",1005,88,25,63,185,147,62,133,206,129,18,12,6,37
"2011","Allerdale 010E","E01019119",1088,103,35,68,237,163,65,134,172,137,21,15,6,56
"2011","Allerdale 011A","E01019089",1211,68,26,42,215,118,127,118,233,234,50,27,23,48
"2011","Allerdale 011B","E01019100",1227,103,27,76,269,175,96,154,176,151,36,21,15,67
"2011","Allerdale 011C","E01019101",1108,109,28,81,290,156,104,143,149,91,26,17,9,40
"2011","Allerdale 011D","E01019129",1287,145,54,91,310,166,121,139,216,112,31,23,8,47
"2011","Allerdale 012A","E01019092",1211,147,36,111,287,97,254,110,128,118,17,10,7,53
"2011","Allerdale 012B","E01019103",893,63,7,56,156,63,141,100,181,129,16,9,7,44
"2011","Allerdale 012C","E01019104",932,93,31,62,203,61,161,81,170,85,27,13,14,51
"2011","Allerdale 012D","E01019105",894,69,21,48,187,57,206,98,136,81,12,9,3,48
"2011","Allerdale 012E","E01019106",1045,108,21,87,237,93,238,76,134,95,18,16,2,46
"2011","Barrow-in-Furness 001A","E01019144",1071,79,22,57,195,91,125,129,185,175,31,23,8,61
"2011","Barrow-in-Furness 001B","E01019145",1487,120,35,85,290,186,106,169,258,250,33,18,15,75
"2011","Barrow-in-Furness 001C","E01019146",1018,105,28,77,250,106,119,124,135,114,23,16,7,42
"2011","Barrow-in-Furness 001D","E01019147",1153,67,12,55,232,147,98,117,207,186,27,17,10,72
"2011","Barrow-in-Furness 002A","E01019148",1097,86,24,62,270,140,98,116,181,129,20,9,11,57
"2011","Barrow-in-Furness 002B","E01019149",1148,88,20,68,243,143,104,128,208,129,39,26,13,66
"2011","Barrow-in-Furness 002C","E01019150",1153,70,16,54,180,132,97,124,216,234,35,21,14,65
"2011","Barrow-in-Furness 002D","E01019151",1029,59,18,41,172,101,88,111,224,191,38,24,14,45
"2011","Barrow-in-Furness 003A","E01019152",885,135,30,105,217,118,68,71,91,59,70,68,2,56
"2011","Barrow-in-Furness 003B","E01019153",780,87,26,61,198,124,56,75,91,96,12,9,3,41
"2011","Barrow-in-Furness 003C","E01019154",866,105,22,83,203,139,90,87,114,78,13,8,5,37
"2011","Barrow-in-Furness 003D","E01019155",924,106,24,82,224,165,70,83,142,80,25,17,8,29
"2011","Barrow-in-Furness 003E","E01019162",1078,113,33,80,251,172,74,130,149,102,28,19,9,59
"2011","Barrow-in-Furness 003F","E01019163",953,151,32,119,265,151,84,68,102,55,23,20,3,54
"2011","Barrow-in-Furness 004A","E01019156",1048,34,7,27,102,77,62,111,217,257,124,87,37,64
"2011","Barrow-in-Furness 004B","E01019159",802,39,15,24,113,90,45,92,178,164,39,26,13,42
"2011","Barrow-in-Furness 004C","E01019164",1024,28,3,25,78,68,71,91,226,230,154,101,53,78
"2011","Barrow-in-Furness 004D","E01019165",1090,49,15,34,143,131,87,114,229,196,93,62,31,48
"2011","Barrow-in-Furness 004E","E01019166",1039,34,9,25,140,111,72,89,224,258,54,38,16,57
"2011","Barrow-in-Furness 005A","E01019167",1150,88,19,69,255,162,64,128,205,164,29,15,14,55
"2011","Barrow-in-Furness 005B","E01019168",1044,125,30,95,246,143,69,89,165,105,36,25,11,66
"2011","Barrow-in-Furness 005C","E01019169",950,114,24,90,208,170,78,83,115,94,29,20,9,59
"2011","Barrow-in-Furness 005D","E01019170",951,86,16,70,221,122,63,89,154,117,30,17,13,69
"2011","Barrow-in-Furness 005E","E01019171",1002,53,9,44,179,119,50,111,229,169,45,21,24,47
"2011","Barrow-in-Furness 006A","E01019161",1231,111,26,85,230,147,78,124,219,177,74,59,15,71
"2011","Barrow-in-Furness 006B","E01019176",1276,132,43,89,328,214,91,130,192,117,12,4,8,60
"2011","Barrow-in-Furness 006C","E01019177",1017,84,24,60,186,133,79,75,165,167,62,46,16,66
"2011","Barrow-in-Furness 006D","E01019178",1164,143,37,106,286,166,113,122,154,119,17,9,8,44
"2011","Barrow-in-Furness 006E","E01019179",960,126,30,96,250,151,65,99,131,80,15,11,4,43
"2011","Barrow-in-Furness 007A","E01019140",760,22,4,18,74,65,49,73,171,156,106,85,21,44
"2011","Barrow-in-Furness 007B","E01019160",1000,38,7,31,115,88,51,106,220,239,81,59,22,62
"2011","Barrow-in-Furness 007C","E01019172",1061,48,8,40,169,132,61,139,210,176,76,45,31,50
"2011","Barrow-in-Furness 007D","E01019173",935,48,8,40,139,106,63,78,219,185,52,36,16,45
"2011","Barrow-in-Furness 007E","E01019174",857,22,8,14,113,84,59,71,192,161,85,63,22,70
"2011","Barrow-in-Furness 007F","E01019175",1044,31,11,20,125,107,86,114,249,192,72,50,22,68
"2011","Barrow-in-Furness 008A","E01019141",909,32,8,24,96,78,63,90,174,223,108,72,36,45
"2011","Barrow-in-Furness 008B","E01019142",1041,33,4,29,108,98,75,112,239,232,94,65,29,50
"2011","Barrow-in-Furness 008C","E01019143",1159,41,8,33,134,78,91,119,213,240,150,107,43,93
"2011","Barrow-in-Furness 008D","E01019157",1075,48,12,36,134,87,86,99,214,251,104,68,36,52
"2011","Barrow-in-Furness 008E","E01019158",880,35,7,28,108,90,41,90,208,181,85,59,26,42
"2011","Barrow-in-Furness 009A","E01019180",1408,111,27,84,261,213,90,168,261,214,45,33,12,45
"2011","Barrow-in-Furness 009C","E01019182",1021,81,12,69,216,146,79,106,179,141,24,12,12,49
"2011","Barrow-in-Furness 009E","E01019184",1004,66,17,49,176,140,61,95,182,191,36,25,11,57
"2011","Barrow-in-Furness 009F","E01033160",1484,57,16,41,178,153,78,188,328,307,94,76,18,101
"2011","Barrow-in-Furness 010A","E01019138",976,31,6,25,115,127,54,113,204,247,43,20,23,42
"2011","Barrow-in-Furness 010B","E01019139",1107,33,7,26,97,81,72,119,235,303,128,78,50,39
"2011","Barrow-in-Furness 010C","E01019185",1056,103,29,74,224,152,63,111,172,156,25,13,12,50
"2011","Barrow-in-Furness 010D","E01019186",965,86,18,68,191,131,61,105,172,146,35,21,14,38
"2011","Barrow-in-Furness 010E","E01019187",971,66,25,41,195,130,66,89,163,163,39,25,14,60
"2011","Carlisle 001A","E01019226",905,87,28,59,158,102,179,76,128,96,20,18,2,59
"2011","Carlisle 001B","E01019227",1057,38,11,27,120,84,104,111,256,261,59,35,24,24
"2011","Carlisle 001C","E01019228",1193,62,16,46,193,121,274,101,193,164,36,25,11,49
"2011","Carlisle 001D","E01019229",1462,134,26,108,267,134,440,71,190,125,34,18,16,67
"2011","Carlisle 002A","E01019200",1121,161,51,110,301,141,154,66,127,94,21,11,10,56
"2011","Carlisle 002B","E01019201",959,69,17,52,185,117,110,94,166,126,38,23,15,54
"2011","Carlisle 002C","E01019202",1151,69,23,46,180,123,122,105,246,204,52,31,21,50
"2011","Carlisle 002D","E01019225",1518,177,55,122,321,145,372,90,169,135,31,18,13,78
"2011","Carlisle 003A","E01019188",1071,60,15,45,182,155,90,108,220,158,38,26,12,60
"2011","Carlisle 003B","E01019189",1131,79,16,63,215,143,77,98,221,183,45,33,12,70
"2011","Carlisle 003C","E01019190",1135,136,33,103,309,210,77,85,156,84,20,12,8,58
"2011","Carlisle 003D","E01019191",1144,141,29,112,278,184,100,76,180,110,22,16,6,53
"2011","Carlisle 003E","E01019244",1037,97,24,73,255,162,63,88,164,120,12,7,5,76
"2011","Carlisle 004A","E01019196",1332,88,22,66,262,202,90,122,277,184,52,31,21,55
"2011","Carlisle 004B","E01019238",957,86,26,60,238,168,102,86,142,73,11,9,2,51
"2011","Carlisle 004C","E01019240",1264,133,46,87,337,189,191,81,149,97,29,23,6,58
"2011","Carlisle 004D","E01019241",1139,178,42,136,287,185,100,68,140,92,24,18,6,65
"2011","Carlisle 004E","E01019243",1117,132,39,93,306,161,77,59,137,80,22,12,10,143
"2011","Carlisle 004F","E01019251",1248,152,61,91,349,183,145,94,144,90,18,11,7,73
"2011","Carlisle 005A","E01019192",1078,69,21,48,191,187,87,107,205,144,34,26,8,54
"2011","Carlisle 005B","E01019195",1029,90,23,67,220,172,68,114,176,115,23,14,9,51
"2011","Carlisle 005C","E01019203",1607,150,45,105,402,223,298,105,181,143,25,11,14,80
"2011","Carlisle 005D","E01019254",1043,61,19,42,193,158,78,119,218,150,17,9,8,49
"2011","Carlisle 005E","E01019255",1080,60,13,47,203,186,66,120,223,152,15,6,9,55
"2011","Carlisle 006A","E01019204",1094,64,19,45,169,72,63,82,169,128,59,33,26,288
"2011","Carlisle 006B","E01019206",1249,114,19,95,248,114,98,98,182,158,55,33,22,182
"2011","Carlisle 006C","E01019234",1256,61,14,47,180,114,59,93,257,218,59,36,23,215
"2011","Carlisle 006D","E01019235",1143,79,19,60,223,159,83,97,212,153,29,17,12,108
"2011","Carlisle 006E","E01019237",1171,70,21,49,205,141,88,77,180,133,38,26,12,239
"2011","Carlisle 006F","E01019242",965,96,20,76,206,106,87,65,122,88,17,9,8,178
"2011","Carlisle 007A","E01019219",1620,229,50,179,460,179,294,104,166,99,19,13,6,70
"2011","Carlisle 007B","E01019224",1543,162,39,123,377,195,229,139,200,127,28,12,16,86
"2011","Carlisle 007C","E01019239",1166,126,30,96,275,135,263,72,124,88,20,13,7,63
"2011","Carlisle 007D","E01019249",1065,159,43,116,323,160,154,45,90,58,10,6,4,66
"2011","Carlisle 007E","E01019250",1036,137,38,99,270,123,177,77,124,65,14,11,3,49
"2011","Carlisle 008A","E01019205",1253,86,11,75,159,143,57,129,254,249,83,56,27,93
"2011","Carlisle 008B","E01019207",1054,58,8,50,135,97,58,98,252,220,71,48,23,65
"2011","Carlisle 008C","E01019215",1131,93,21,72,224,118,66,96,229,175,46,21,25,84
"2011","Carlisle 008D","E01019218",1109,55,16,39,141,124,58,109,303,186,68,39,29,65
"2011","Carlisle 008E","E01019233",911,36,12,24,128,135,61,98,225,155,23,14,9,50
"2011","Carlisle 009A","E01019193",1050,19,5,14,108,99,50,81,254,259,124,79,45,56
"2011","Carlisle 009B","E01019194",1529,80,16,64,248,198,77,142,308,289,109,85,24,78
"2011","Carlisle 009C","E01019230",1078,23,7,16,124,123,67,84,323,232,61,28,33,41
"2011","Carlisle 009D","E01019231",1041,17,9,8,108,102,63,115,272,246,85,48,37,33
"2011","Carlisle 009E","E01019232",1117,50,16,34,171,158,97,129,243,173,38,30,8,58
"2011","Carlisle 009F","E01019252",1055,27,8,19,131,143,81,109,280,201,37,22,15,46
"2011","Carlisle 010A","E01019209",1065,30,10,20,178,130,68,123,243,188,45,26,19,60
"2011","Carlisle 010B","E01019211",1424,61,12,49,210,151,112,164,323,246,51,32,19,106
"2011","Carlisle 010C","E01019216",1287,64,8,56,224,130,57,135,332,205,37,22,15,103
"2011","Carlisle 010D","E01019217",1391,119,25,94,258,163,88,152,285,202,46,26,20,78
"2011","Carlisle 010E","E01019220",1187,61,14,47,214,141,99,118,262,189,39,24,15,64
"2011","Carlisle 010F","E01019236",1307,52,13,39,193,120,63,133,261,209,69,41,28,207
"2011","Carlisle 011A","E01019197",1382,50,17,33,152,105,67,116,355,329,122,74,48,86
"2011","Carlisle 011B","E01019198",951,25,5,20,140,96,53,103,261,199,37,25,12,37
"2011","Carlisle 011C","E01019199",746,13,3,10,77,66,34,76,213,189,53,34,19,25
"2011","Carlisle 011D","E01019221",1403,67,17,50,217,141,71,133,349,266,75,44,31,84
"2011","Carlisle 011E","E01019222",1133,41,16,25,143,121,48,120,322,225,58,35,23,55
"2011","Carlisle 011F","E01019245",1098,22,11,11,90,59,66,93,323,250,125,81,44,70
"2011","Carlisle 012A","E01019208",1083,29,9,20,150,109,56,115,252,243,64,38,26,65
"2011","Carlisle 012B","E01019210",1010,37,11,26,128,90,66,108,254,189,74,50,24,64
"2011","Carlisle 012C","E01019246",862,20,5,15,98,104,56,102,220,186,46,32,14,30
"2011","Carlisle 012D","E01019247",1092,50,21,29,173,127,88,102,270,185,49,34,15,48
"2011","Carlisle 012E","E01019248",791,15,8,7,75,73,35,78,229,170,75,51,24,41
"2011","Carlisle 013A","E01019212",1120,160,43,117,265,126,208,51,114,69,17,11,6,110
"2011","Carlisle 013B","E01019213",2044,204,59,145,508,295,259,170,315,160,41,32,9,92
"2011","Carlisle 013C","E01019214",1279,118,28,90,253,180,190,103,206,141,26,19,7,62
"2011","Carlisle 013D","E01019223",1151,73,14,59,225,179,84,119,228,140,42,28,14,61
"2011","Carlisle 013E","E01019253",1311,107,27,80,290,195,113,107,258,169,25,14,11,47
"2011","Copeland 001A","E01019268",864,61,21,40,178,93,97,99,142,117,44,35,9,33
"2011","Copeland 001B","E01019269",1156,45,17,28,137,83,64,111,282,258,113,85,28,63
"2011","Copeland 001C","E01019270",1026,57,21,36,143,95,63,122,246,214,48,29,19,38
"2011","Copeland 001D","E01019297",1039,139,40,99,241,119,69,100,162,108,31,22,9,70
"2011","Copeland 002A","E01019260",1149,73,14,59,222,109,70,135,253,180,52,38,14,55
"2011","Copeland 002B","E01019280",1208,77,18,59,185,107,101,129,196,249,139,87,52,25
"2011","Copeland 002C","E01019281",913,100,15,85,183,124,62,97,141,120,46,27,19,40
"2011","Copeland 002D","E01019282",988,100,20,80,201,129,54,120,176,117,38,25,13,53
"2011","Copeland 003A","E01019261",1332,184,56,128,363,193,77,166,157,100,22,15,7,70
"2011","Copeland 003B","E01019262",1329,210,58,152,329,195,63,147,181,120,35,32,3,49
"2011","Copeland 003C","E01019284",870,35,9,26,136,91,36,126,201,164,42,29,13,39
"2011","Copeland 003D","E01019285",1123,96,12,84,188,109,63,132,221,195,75,53,22,44
"2011","Copeland 003E","E01019286",965,101,30,71,182,121,49,125,182,125,41,28,13,39
"2011","Copeland 003F","E01019287",913,107,26,81,224,129,34,126,152,97,7,1,6,37
"2011","Copeland 003G","E01019288",1101,118,35,83,268,177,59,145,167,99,14,11,3,54
"2011","Copeland 004A","E01019256",1191,133,33,100,254,150,118,155,156,140,27,14,13,58
"2011","Copeland 004B","E01019263",860,35,10,25,108,87,33,104,182,186,74,50,24,51
"2011","Copeland 004C","E01019264",1269,110,32,78,237,152,62,181,225,189,44,25,19,69
"2011","Copeland 004D","E01019265",999,74,24,50,159,115,55,121,196,181,57,39,18,41
"2011","Copeland 004E","E01019266",1153,95,17,78,218,130,76,136,203,186,54,36,18,55
"2011","Copeland 004F","E01019267",920,42,10,32,92,93,51,114,208,193,84,60,24,43
"2011","Copeland 004G","E01019276",805,144,45,99,219,68,124,61,72,59,20,15,5,38
"2011","Copeland 004H","E01019277",884,39,9,30,90,69,49,102,224,204,61,40,21,46
"2011","Copeland 004I","E01019278",1035,123,37,86,221,132,84,112,153,133,24,17,7,53
"2011","Copeland 005A","E01019291",969,43,8,35,142,89,43,140,200,212,48,32,16,52
"2011","Copeland 005B","E01019292",862,44,16,28,165,93,61,110,180,139,30,16,14,40
"2011","Copeland 005C","E01019294",1064,29,7,22,130,111,45,133,265,233,66,36,30,52
"2011","Copeland 005D","E01019295",1056,22,4,18,89,81,53,111,254,270,115,78,37,61
"2011","Copeland 005E","E01019296",1032,48,18,30,142,103,59,130,236,222,54,42,12,38
"2011","Copeland 005F","E01019301",1037,11,3,8,87,64,33,120,238,271,166,123,43,47
"2011","Copeland 005G","E01019302",803,58,17,41,135,78,59,102,142,158,30,17,13,41
"2011","Copeland 006A","E01019271",968,73,18,55,138,106,58,117,180,180,66,54,12,50
"2011","Copeland 006B","E01019272",1074,35,6,29,152,122,50,113,268,212,85,55,30,37
"2011","Copeland 006C","E01019273",1246,114,41,73,256,154,95,153,224,160,29,16,13,61
"2011","Copeland 006D","E01019274",1153,106,29,77,203,130,65,143,216,209,49,27,22,32
"2011","Copeland 006E","E01019275",1614,138,44,94,297,208,98,221,278,217,75,47,28,82
"2011","Copeland 007A","E01019257",1110,93,27,66,219,116,91,127,203,160,56,44,12,45
"2011","Copeland 007B","E01019258",1174,204,54,150,307,149,149,101,111,66,27,14,13,60
"2011","Copeland 007C","E01019279",1054,171,38,133,268,110,201,86,110,64,15,11,4,29
"2011","Copeland 007D","E01019300",1369,256,58,198,401,132,125,108,121,84,25,15,10,117
"2011","Copeland 007E","E01019303",1082,158,44,114,272,122,84,125,133,91,29,22,7,68
"2011","Copeland 007F","E01019304",978,158,34,124,238,94,168,90,113,60,25,11,14,32
"2011","Copeland 008A","E01019259",973,90,18,72,214,83,190,87,134,110,27,17,10,38
"2011","Copeland 008B","E01019283",1548,84,26,58,217,154,186,189,211,305,155,141,14,47
"2011","Copeland 008C","E01019289",1009,81,31,50,182,115,63,111,190,171,47,23,24,49
"2011","Copeland 008D","E01019290",819,48,22,26,125,100,92,90,139,129,38,25,13,58
"2011","Copeland 008E","E01019293",1059,129,37,92,267,98,249,70,90,84,35,32,3,37
"2011","Copeland 008F","E01019298",1113,80,30,50,177,134,98,144,195,188,48,31,17,49
"2011","Copeland 008G","E01019299",1444,70,22,48,186,138,105,183,276,325,94,68,26,67
"2011","Eden 001A","E01019305",1620,133,22,111,353,125,332,135,226,189,45,33,12,82
"2011","Eden 001B","E01019314",955,125,30,95,212,103,208,61,107,79,22,11,11,38
"2011","Eden 001C","E01019320",1104,138,34,104,276,106,245,74,144,65,12,8,4,44
"2011","Eden 001D","E01019321",1163,127,31,96,271,125,222,69,152,113,16,13,3,68
"2011","Eden 002A","E01019315",1273,116,21,95,305,163,265,77,139,122,32,22,10,54
"2011","Eden 002B","E01019316",1150,90,22,68,218,104,198,56,132,92,7,6,1,253
"2011","Eden 002C","E01019322",1028,139,33,106,243,114,171,74,128,89,12,10,2,58
"2011","Eden 002D","E01019338",1144,135,23,112,268,105,300,63,120,70,16,10,6,67
"2011","Eden 003A","E01019327",963,51,19,32,154,101,112,96,185,186,20,18,2,58
"2011","Eden 003B","E01019332",952,38,11,27,126,95,86,109,223,213,35,28,7,27
"2011","Eden 003C","E01019333",801,20,6,14,109,61,92,86,192,161,29,21,8,51
"2011","Eden 003D","E01019335",1125,56,19,37,198,115,109,122,206,199,32,16,16,88
"2011","Eden 003E","E01019336",1344,62,17,45,231,138,114,134,286,232,35,23,12,112
"2011","Eden 004A","E01019312",1055,109,32,77,259,124,171,75,142,99,26,20,6,50
"2011","Eden 004B","E01019326",1130,83,19,64,229,172,126,106,201,137,18,12,6,58
"2011","Eden 004C","E01019328",932,61,17,44,189,130,114,70,141,153,23,18,5,51
"2011","Eden 004D","E01019329",804,101,25,76,190,104,117,57,112,66,17,8,9,40
"2011","Eden 004E","E01019330",1067,103,14,89,234,115,122,86,195,124,28,19,9,60
"2011","Eden 004F","E01019331",1126,72,14,58,198,121,100,112,230,203,27,18,9,63
"2011","Eden 004G","E01019334",946,39,10,29,166,128,125,102,180,153,16,13,3,37
"2011","Eden 005A","E01019308",1063,112,29,83,262,99,224,80,127,90,19,10,9,50
"2011","Eden 005B","E01019311",1047,117,30,87,255,120,210,62,125,95,13,9,4,50
"2011","Eden 005C","E01019313",1033,119,36,83,248,90,238,61,125,90,14,8,6,48
"2011","Eden 005D","E01019339",1065,117,27,90,264,83,261,100,119,68,11,5,6,42
"2011","Eden 006A","E01019306",908,35,5,30,161,85,130,91,178,159,29,15,14,40
"2011","Eden 006B","E01019307",1242,94,22,72,223,149,171,138,217,161,21,10,11,68
"2011","Eden 006C","E01019310",1046,115,16,99,234,82,295,49,103,99,17,10,7,52
"2011","Eden 006D","E01019319",1150,112,28,84,214,111,174,116,196,133,28,19,9,66
"2011","Eden 006E","E01019323",902,82,14,68,200,91,201,82,119,89,16,11,5,22
"2011","Eden 006F","E01019324",971,126,28,98,219,88,234,61,98,97,9,5,4,39
"2011","Eden 006G","E01019337",1027,72,24,48,170,71,179,114,195,165,17,9,8,44
"2011","Eden 007A","E01019309",1727,153,31,122,334,154,435,108,265,176,30,20,10,72
"2011","Eden 007B","E01019317",941,91,17,74,211,97,233,47,134,85,3,2,1,40
"2011","Eden 007C","E01019318",899,62,17,45,138,55,149,73,205,149,38,19,19,30
"2011","Eden 007D","E01019325",1028,81,20,61,213,103,202,72,159,129,26,19,7,43
"2011","Eden 007E","E01019340",1004,105,28,77,199,88,274,65,143,77,18,11,7,35
"2011","South Lakeland 001A","E01019374",1124,71,14,57,256,77,196,108,177,127,15,6,9,97
"2011","South Lakeland 001B","E01019375",1081,102,25,77,269,72,214,115,127,110,17,11,6,55
"2011","South Lakeland 001C","E01019376",1139,86,27,59,247,78,272,146,163,91,7,3,4,49
"2011","South Lakeland 001D","E01019395",1453,157,37,120,306,128,299,112,185,115,42,33,9,109
"2011","South Lakeland 002A","E01019387",1522,177,43,134,355,145,316,130,169,138,20,9,11,72
"2011","South Lakeland 002B","E01019396",1458,157,37,120,315,134,291,128,207,134,21,7,14,71
"2011","South Lakeland 002C","E01019397",1536,169,45,124,347,117,309,157,202,119,29,12,17,87
"2011","South Lakeland 002D","E01019398",871,45,12,33,124,75,126,125,178,133,18,11,7,47
"2011","South Lakeland 002E","E01019399",766,45,8,37,128,74,108,94,158,89,17,12,5,53
"2011","South Lakeland 003A","E01019346",1460,142,43,99,331,150,217,108,260,180,23,18,5,49
"2011","South Lakeland 003B","E01019359",1491,73,32,41,250,169,126,144,326,291,51,39,12,61
"2011","South Lakeland 003C","E01019365",1718,167,35,132,371,186,182,155,290,223,40,22,18,104
"2011","South Lakeland 003D","E01019370",1628,200,43,157,420,208,146,155,225,186,23,13,10,65
"2011","South Lakeland 004A","E01019360",1624,213,37,176,416,152,184,120,270,153,28,18,10,88
"2011","South Lakeland 004B","E01019363",1398,155,31,124,367,121,116,102,270,158,26,15,11,83
"2011","South Lakeland 004C","E01019364",1352,58,14,44,199,128,135,124,325,264,41,22,19,78
"2011","South Lakeland 004D","E01019371",1578,120,29,91,293,148,155,152,289,277,44,21,23,100
"2011","South Lakeland 005A","E01019358",1311,107,24,83,304,168,151,110,231,151,28,20,8,61
"2011","South Lakeland 005B","E01019362",1420,129,30,99,324,238,132,116,236,171,9,7,2,65
"2011","South Lakeland 005C","E01019366",1308,120,32,88,274,173,145,130,233,161,21,14,7,51
"2011","South Lakeland 005D","E01019394",1738,227,54,173,440,156,409,103,167,122,23,12,11,91
"2011","South Lakeland 006A","E01019361",1364,114,26,88,334,184,130,127,220,137,28,17,11,90
"2011","South Lakeland 006B","E01019367",1810,189,49,140,409,229,174,147,320,227,35,21,14,80
"2011","South Lakeland 006C","E01019368",1566,137,32,105,330,258,140,134,280,168,23,14,9,96
"2011","South Lakeland 006D","E01019369",1308,134,29,105,369,172,124,108,192,114,22,14,8,73
"2011","South Lakeland 007A","E01019356",1093,136,39,97,251,91,281,77,141,63,18,9,9,35
"2011","South Lakeland 007B","E01019381",1612,203,46,157,399,149,398,104,165,103,19,13,6,72
"2011","South Lakeland 007C","E01019386",1293,184,39,145,315,108,288,94,151,87,25,10,15,41
"2011","South Lakeland 008A","E01019344",797,119,32,87,184,99,148,59,80,62,16,8,8,30
"2011","South Lakeland 008B","E01019345",884,123,37,86,230,78,147,62,114,75,16,10,6,39
"2011","South Lakeland 008C","E01019350",1268,143,31,112,284,107,301,119,157,104,12,10,2,41
"2011","South Lakeland 008D","E01019351",1374,208,53,155,371,143,273,64,133,86,22,14,8,74
"2011","South Lakeland 009A","E01019372",710,94,28,66,194,61,125,53,96,53,3,1,2,31
"2011","South Lakeland 009B","E01019373",1016,142,37,105,274,72,159,44,99,51,14,6,8,161
"2011","South Lakeland 009C","E01019384",1850,192,48,144,419,147,405,88,167,135,19,8,11,278
"2011","South Lakeland 009D","E01019385",831,60,18,42,201,82,113,68,128,131,11,9,2,37
"2011","South Lakeland 010A","E01019348",861,117,18,99,254,103,140,56,94,48,9,4,5,40
"2011","South Lakeland 010B","E01019352",1703,200,47,153,427,189,324,115,208,120,16,9,7,104
"2011","South Lakeland 010C","E01019377",1248,182,42,140,336,153,221,70,159,73,13,3,10,41
"2011","South Lakeland 010D","E01019383",1453,239,53,186,425,193,238,71,124,80,14,11,3,69
"2011","South Lakeland 011A","E01019341",1110,181,43,138,351,143,144,68,104,67,10,3,7,42
"2011","South Lakeland 011B","E01019342",680,102,16,86,207,67,96,47,66,51,9,8,1,35
"2011","South Lakeland 011C","E01019343",1082,171,35,136,306,130,173,51,109,73,10,4,6,59
"2011","South Lakeland 011D","E01019347",1301,138,41,97,295,176,194,119,165,128,22,12,10,64
"2011","South Lakeland 011E","E01019382",1535,101,20,81,282,155,202,126,300,217,25,14,11,127
"2011","South Lakeland 012A","E01019388",1329,121,27,94,283,129,120,142,237,173,52,33,19,72
"2011","South Lakeland 012B","E01019389",1724,118,42,76,330,149,168,210,286,285,79,52,27,99
"2011","South Lakeland 012C","E01019390",1469,234,41,193,387,144,137,121,206,151,39,24,15,50
"2011","South Lakeland 012D","E01019392",1352,149,31,118,316,116,151,134,219,164,40,17,23,63
"2011","South Lakeland 013A","E01019349",1326,165,40,125,346,125,247,100,152,97,25,11,14,69
"2011","South Lakeland 013B","E01019353",1073,136,41,95,247,115,161,85,148,118,14,8,6,49
"2011","South Lakeland 013C","E01019354",823,105,34,71,206,75,123,66,114,78,15,7,8,41
"2011","South Lakeland 013D","E01019355",856,154,37,117,268,97,127,51,83,38,12,11,1,26
"2011","South Lakeland 013E","E01019357",1371,87,36,51,253,124,224,167,246,176,22,17,5,72
"2011","South Lakeland 014A","E01019378",1183,116,36,80,304,150,107,112,178,122,22,9,13,72
"2011","South Lakeland 014B","E01019379",1047,153,45,108,268,151,152,66,107,84,29,20,9,37
"2011","South Lakeland 014C","E01019380",841,129,43,86,222,100,113,77,96,66,13,5,8,25
"2011","South Lakeland 014D","E01019391",1270,99,30,69,266,147,128,134,225,170,28,18,10,73
"2011","South Lakeland 014E","E01019393",1442,246,71,175,432,173,125,113,163,105,19,12,7,66
"2011","Bolton 001A","E01004768",1173,186,52,134,348,198,132,54,102,51,21,15,6,81
"2011","Bolton 001B","E01004803",1223,220,59,161,391,177,139,48,107,59,13,5,8,69
"2011","Bolton 001C","E01004804",1129,187,52,135,334,178,111,69,108,61,16,10,6,65
"2011","Bolton 001D","E01004807",1113,144,36,108,338,180,103,53,108,72,16,7,9,99
"2011","Bolton 001E","E01004808",1253,232,67,165,346,198,152,60,110,60,17,9,8,78
"2011","Bolton 002A","E01004788",1010,175,50,125,297,174,96,47,104,53,14,7,7,50
"2011","Bolton 002B","E01004790",1037,145,37,108,283,163,106,60,116,79,25,14,11,60
"2011","Bolton 002C","E01004805",1223,184,52,132,365,188,113,58,119,73,28,13,15,95
"2011","Bolton 002D","E01004806",1060,157,43,114,316,143,105,61,117,62,21,14,7,78
"2011","Bolton 002E","E01004810",1187,159,39,120,385,182,98,67,117,64,22,17,5,93
"2011","Bolton 003A","E01004769",1161,162,42,120,355,182,112,67,133,68,20,15,5,62
"2011","Bolton 003B","E01004770",1024,97,22,75,236,189,120,56,133,97,32,22,10,64
"2011","Bolton 003C","E01004771",1159,156,25,131,316,195,154,56,129,63,18,11,7,72
"2011","Bolton 003D","E01004773",1448,120,34,86,313,245,131,113,169,133,84,58,26,140
"2011","Bolton 003E","E01004809",1305,156,40,116,318,189,118,100,186,127,33,18,15,78
"2011","Bolton 004A","E01004777",1110,79,20,59,250,151,80,95,200,135,54,33,21,66
"2011","Bolton 004B","E01004881",961,84,16,68,142,145,87,90,167,161,54,40,14,31
"2011","Bolton 004C","E01004888",1012,84,20,64,228,155,86,85,149,129,28,12,16,68
"2011","Bolton 004D","E01004889",1026,63,10,53,189,140,80,86,201,154,50,34,16,63
"2011","Bolton 004E","E01004890",1052,96,11,85,233,144,102,98,169,132,26,14,12,52
"2011","Bolton 005A","E01004766",1147,60,12,48,226,152,113,81,234,148,51,30,21,82
"2011","Bolton 005B","E01004767",1254,91,21,70,261,202,114,89,216,135,49,36,13,97
"2011","Bolton 005C","E01004772",1220,92,21,71,205,142,90,85,196,207,94,62,32,109
"2011","Bolton 005D","E01004774",1251,84,20,64,215,165,90,83,229,185,87,59,28,113
"2011","Bolton 005E","E01004824",1186,39,6,33,91,138,123,28,204,157,258,233,25,148
"2011","Bolton 006A","E01004784",970,140,32,108,266,164,103,55,111,73,17,14,3,41
"2011","Bolton 006B","E01004785",1037,103,22,81,225,156,95,63,181,124,32,22,10,58
"2011","Bolton 006C","E01004786",1049,89,21,68,268,166,111,72,155,92,25,13,12,71
"2011","Bolton 006D","E01004789",1055,139,40,99,331,156,138,59,101,57,14,8,6,60
"2011","Bolton 006E","E01004791",876,94,22,72,240,136,97,51,141,64,11,5,6,42
"2011","Bolton 006F","E01004792",1070,112,30,82,338,167,133,60,124,62,16,8,8,58
"2011","Bolton 007A","E01004779",1159,129,40,89,246,165,102,83,187,127,39,22,17,81
"2011","Bolton 007B","E01004781",1385,175,33,142,353,217,97,99,207,123,35,22,13,79
"2011","Bolton 007C","E01004882",996,111,24,87,236,146,65,83,152,126,14,5,9,63
"2011","Bolton 007D","E01004883",1120,120,24,96,265,173,80,95,167,118,34,11,23,68
"2011","Bolton 007E","E01004884",1128,205,48,157,368,149,145,56,89,52,15,8,7,49
"2011","Bolton 008A","E01004864",1171,85,18,67,225,168,119,89,211,156,43,26,17,75
"2011","Bolton 008B","E01004867",1085,46,10,36,155,138,99,100,199,183,97,67,30,68
"2011","Bolton 008C","E01004921",1145,90,15,75,250,185,89,81,186,154,38,23,15,72
"2011","Bolton 008D","E01004924",1157,193,46,147,352,158,137,47,99,67,15,11,4,89
"2011","Bolton 008E","E01004925",1108,91,24,67,237,179,113,83,184,102,26,19,7,93
"2011","Bolton 009A","E01004778",881,85,24,61,229,136,97,51,123,97,19,12,7,44
"2011","Bolton 009B","E01004780",1489,195,46,149,440,235,125,114,155,109,22,11,11,94
"2011","Bolton 009C","E01004782",810,63,15,48,147,99,51,76,157,142,31,18,13,44
"2011","Bolton 009D","E01004783",1146,112,39,73,291,195,87,82,164,115,25,12,13,75
"2011","Bolton 010A","E01004802",1233,44,9,35,132,108,71,88,265,264,139,89,50,122
"2011","Bolton 010B","E01004926",901,26,5,21,71,89,61,68,193,190,99,74,25,104
"2011","Bolton 010C","E01004927",1531,76,17,59,202,182,86,125,291,299,169,116,53,101
"2011","Bolton 010D","E01004929",1427,71,14,57,242,190,109,105,273,220,118,85,33,99
"2011","Bolton 011A","E01004820",1108,40,8,32,93,99,63,67,213,224,198,166,32,111
"2011","Bolton 011B","E01004825",1155,33,1,32,109,110,103,47,217,205,235,204,31,96
"2011","Bolton 011C","E01004826",1077,37,7,30,93,116,75,66,242,212,144,115,29,92
"2011","Bolton 011D","E01004865",974,49,12,37,164,107,80,80,180,173,90,66,24,51
"2011","Bolton 011E","E01004866",1189,35,6,29,109,105,80,78,250,222,204,164,40,106
"2011","Bolton 012A","E01004840",1191,181,45,136,311,153,133,77,129,87,41,29,12,79
"2011","Bolton 012B","E01004841",1129,31,6,25,124,115,85,78,230,217,151,107,44,98
"2011","Bolton 012C","E01004842",1145,210,53,157,333,163,114,53,96,73,21,11,10,82
"2011","Bolton 012D","E01004919",1089,122,24,98,286,164,106,65,142,103,23,13,10,78
"2011","Bolton 012E","E01004920",1084,108,31,77,222,156,88,58,176,123,73,41,32,80
"2011","Bolton 013A","E01004787",1127,38,14,24,116,115,77,90,236,247,130,86,44,78
"2011","Bolton 013B","E01004793",1103,36,6,30,115,100,72,120,214,236,122,75,47,88
"2011","Bolton 013C","E01004794",1180,33,8,25,128,110,74,86,241,249,165,111,54,94
"2011","Bolton 013D","E01004795",1069,45,10,35,177,139,93,75,190,199,91,54,37,60
"2011","Bolton 013E","E01004797",913,25,7,18,96,106,45,88,192,173,86,56,30,102
"2011","Bolton 014A","E01004775",1101,176,46,130,276,145,164,73,108,72,19,16,3,68
"2011","Bolton 014B","E01004885",1013,248,62,186,303,127,111,40,68,38,15,12,3,63
"2011","Bolton 014C","E01004886",1011,63,16,47,168,134,71,88,195,164,55,32,23,73
"2011","Bolton 014D","E01004887",1069,78,18,60,219,135,78,83,197,146,54,27,27,79
"2011","Bolton 015A","E01004868",1255,53,9,44,178,143,105,91,229,183,133,98,35,140
"2011","Bolton 015B","E01004869",1214,40,6,34,129,129,85,90,276,234,140,105,35,91
"2011","Bolton 015C","E01004870",1373,68,9,59,147,167,120,75,199,192,215,157,58,190
"2011","Bolton 015D","E01004871",1114,35,4,31,89,97,150,61,185,147,191,165,26,159
"2011","Bolton 015E","E01004922",1269,60,17,43,184,183,104,95,245,197,96,62,34,105
"2011","Bolton 016B","E01004822",1132,38,4,34,82,111,98,56,173,199,250,211,39,125
"2011","Bolton 016C","E01004823",1268,40,4,36,90,110,83,84,256,249,235,198,37,121
"2011","Bolton 016D","E01004848",1246,35,3,32,100,83,69,74,192,235,148,118,30,310
"2011","Bolton 016E","E01033217",831,39,6,33,131,83,54,66,126,149,71,58,13,112
"2011","Bolton 016F","E01033220",1004,34,11,23,157,87,57,56,168,161,188,144,44,96
"2011","Bolton 017A","E01004818",1170,47,12,35,138,93,99,99,212,190,142,98,44,150
"2011","Bolton 017B","E01004819",1153,59,13,46,159,143,104,66,145,121,93,60,33,263
"2011","Bolton 017C","E01004928",1032,35,13,22,147,141,83,92,211,177,87,55,32,59
"2011","Bolton 017D","E01004930",1148,68,19,49,222,171,110,91,202,157,49,28,21,78
"2011","Bolton 017E","E01004931",1141,51,21,30,156,167,92,86,231,216,75,42,33,67
"2011","Bolton 017F","E01004932",1189,54,13,41,193,165,102,119,222,191,70,42,28,73
"2011","Bolton 018A","E01004834",1097,54,16,38,153,113,105,71,184,144,120,94,26,153
"2011","Bolton 018B","E01004838",1130,57,12,45,160,122,99,83,186,164,131,95,36,128
"2011","Bolton 018C","E01004843",1082,225,42,183,318,123,92,48,89,69,34,22,12,84
"2011","Bolton 018D","E01004845",1258,277,56,221,312,152,124,61,109,71,34,31,3,118
"2011","Bolton 018E","E01004923",1197,124,32,92,263,172,98,82,178,89,79,51,28,112
"2011","Bolton 019A","E01004796",1133,49,11,38,209,156,104,103,217,173,54,37,17,68
"2011","Bolton 019B","E01004798",1193,67,21,46,146,154,89,102,240,229,68,44,24,98
"2011","Bolton 019C","E01004799",1017,86,18,68,210,163,94,84,175,132,23,14,9,50
"2011","Bolton 019D","E01004800",1061,81,24,57,243,184,92,84,169,117,28,17,11,63
"2011","Bolton 019E","E01004801",1150,31,6,25,120,105,62,91,243,264,138,87,51,96
"2011","Bolton 019F","E01004917",1540,117,34,83,320,244,122,125,240,200,82,45,37,90
"2011","Bolton 020A","E01004835",1103,157,28,129,257,172,125,62,115,82,49,37,12,84
"2011","Bolton 020B","E01004836",1052,163,44,119,229,162,113,59,121,87,53,41,12,65
"2011","Bolton 020C","E01004837",1193,274,60,214,327,146,143,38,75,47,40,32,8,103
"2011","Bolton 020D","E01004844",1192,281,60,221,369,157,133,30,72,36,18,15,3,96
"2011","Bolton 020E","E01004897",842,141,31,110,249,128,83,41,85,51,23,16,7,41
"2011","Bolton 021A","E01004827",1079,32,4,28,94,77,80,89,223,198,169,135,34,117
"2011","Bolton 021B","E01004849",1193,33,0,33,104,109,86,58,168,191,261,233,28,183
"2011","Bolton 021C","E01004850",1276,29,4,25,94,99,88,65,245,281,212,141,71,163
"2011","Bolton 021D","E01004851",1111,39,6,33,97,80,83,44,215,201,207,182,25,145
"2011","Bolton 021E","E01004853",1049,31,2,29,86,100,80,38,167,172,238,213,25,137
"2011","Bolton 022A","E01004811",1062,35,3,32,111,91,96,56,198,191,181,139,42,103
"2011","Bolton 022B","E01004812",1284,55,10,45,121,120,119,62,186,185,237,188,49,199
"2011","Bolton 022C","E01004813",974,64,5,59,119,124,99,57,139,158,121,100,21,93
"2011","Bolton 022D","E01004815",1068,66,11,55,121,138,92,61,189,170,145,110,35,86
"2011","Bolton 022E","E01004817",1208,67,3,64,211,145,83,75,188,178,149,104,45,112
"2011","Bolton 023A","E01004828",1165,35,3,32,101,95,90,79,250,178,212,180,32,125
"2011","Bolton 023B","E01004829",971,41,6,35,80,90,83,62,159,147,167,144,23,142
"2011","Bolton 023C","E01004832",1111,54,10,44,186,200,67,98,220,151,67,45,22,68
"2011","Bolton 023D","E01004854",1063,50,6,44,69,113,94,34,160,174,212,190,22,157
"2011","Bolton 023E","E01004878",1066,46,12,34,135,119,87,76,186,217,90,69,21,110
"2011","Bolton 024A","E01004911",1170,56,20,36,170,176,100,110,221,193,87,46,41,57
"2011","Bolton 024B","E01004912",1155,75,19,56,211,210,113,97,205,150,37,28,9,57
"2011","Bolton 024C","E01004913",1390,94,21,73,255,214,125,143,233,177,43,29,14,106
"2011","Bolton 024D","E01004914",904,64,25,39,161,164,93,94,139,119,25,17,8,45
"2011","Bolton 024E","E01004915",1056,91,28,63,194,204,90,98,172,118,31,21,10,58
"2011","Bolton 024F","E01004916",1044,57,21,36,178,148,85,80,176,200,64,37,27,56
"2011","Bolton 024G","E01004918",989,64,18,46,201,174,86,90,178,101,23,13,10,72
"2011","Bolton 025A","E01004846",871,21,7,14,99,92,65,64,165,159,135,116,19,71
"2011","Bolton 025B","E01004847",1272,38,7,31,97,122,92,81,191,202,270,223,47,179
"2011","Bolton 025C","E01004852",1095,48,8,40,98,101,108,43,181,166,216,198,18,134
"2011","Bolton 025D","E01004877",1158,11,0,11,98,79,80,74,224,260,193,158,35,139
"2011","Bolton 025E","E01004879",938,23,7,16,103,90,97,59,163,166,124,98,26,113
"2011","Bolton 026A","E01004830",1118,55,16,39,142,141,101,81,235,201,93,69,24,69
"2011","Bolton 026B","E01004831",1205,77,27,50,185,183,141,87,214,160,64,48,16,94
"2011","Bolton 026C","E01004833",1138,77,28,49,229,164,158,101,157,138,50,35,15,64
"2011","Bolton 026D","E01004839",1382,65,14,51,177,133,99,95,286,277,131,81,50,119
"2011","Bolton 027A","E01004814",1029,56,15,41,158,131,112,85,136,126,119,92,27,106
"2011","Bolton 027B","E01004855",1095,49,14,35,160,150,100,80,211,175,86,54,32,84
"2011","Bolton 027C","E01004856",1005,25,15,10,111,114,94,80,170,191,158,119,39,62
"2011","Bolton 027D","E01004857",1103,42,14,28,137,112,99,78,181,217,140,110,30,97
"2011","Bolton 028A","E01004891",1180,125,37,88,228,221,112,111,181,118,26,13,13,58
"2011","Bolton 028B","E01004893",1180,171,40,131,318,199,125,69,142,74,18,12,6,64
"2011","Bolton 028C","E01004894",1380,135,23,112,260,244,106,100,206,192,43,24,19,94
"2011","Bolton 028E","E01004901",1447,193,46,147,398,260,133,99,143,89,19,8,11,113
"2011","Bolton 028F","E01033218",1167,224,60,164,346,155,101,66,117,74,26,20,6,58
"2011","Bolton 028G","E01033219",1126,170,44,126,302,176,130,59,126,77,15,8,7,71
"2011","Bolton 029A","E01004816",1049,35,8,27,117,128,116,70,184,162,130,107,23,107
"2011","Bolton 029B","E01004872",1125,47,12,35,148,150,113,89,221,179,58,39,19,120
"2011","Bolton 029C","E01004873",1208,34,11,23,186,142,82,80,244,199,117,93,24,124
"2011","Bolton 029D","E01004875",1129,65,21,44,226,168,104,86,174,173,52,31,21,81
"2011","Bolton 029E","E01004880",998,81,14,67,191,174,105,64,151,97,44,36,8,91
"2011","Bolton 030A","E01004892",1096,125,21,104,299,171,153,60,117,86,25,20,5,60
"2011","Bolton 030B","E01004896",980,153,38,115,261,162,126,53,93,65,10,6,4,57
"2011","Bolton 030C","E01004899",1131,133,26,107,218,179,123,61,146,133,56,37,19,82
"2011","Bolton 030D","E01004900",1178,200,39,161,285,149,129,61,138,83,45,33,12,88
"2011","Bolton 031A","E01004776",1354,137,39,98,264,191,135,123,205,175,51,33,18,73
"2011","Bolton 031B","E01004895",981,52,14,38,167,132,87,82,165,167,63,49,14,66
"2011","Bolton 031C","E01004936",1601,143,26,117,368,231,148,135,260,183,45,25,20,88
"2011","Bolton 031D","E01004938",1029,36,10,26,114,107,63,109,222,221,93,63,30,64
"2011","Bolton 031E","E01004939",1149,76,20,56,200,161,118,94,219,154,62,43,19,65
"2011","Bolton 032A","E01004858",1187,76,18,58,189,158,75,101,227,220,76,53,23,65
"2011","Bolton 032B","E01004859",1002,38,13,25,118,135,89,82,192,213,84,52,32,51
"2011","Bolton 032C","E01004860",1114,41,12,29,166,153,105,106,211,211,62,40,22,59
"2011","Bolton 032D","E01004902",1250,58,15,43,201,177,96,128,219,223,74,46,28,74
"2011","Bolton 032E","E01004906",1225,58,21,37,178,150,105,104,245,212,94,64,30,79
"2011","Bolton 033A","E01004861",1140,31,10,21,128,117,60,77,247,239,142,101,41,99
"2011","Bolton 033B","E01004862",928,21,7,14,106,109,44,80,187,189,114,66,48,78
"2011","Bolton 033C","E01004863",1124,25,3,22,113,156,81,96,217,219,129,79,50,88
"2011","Bolton 033D","E01004874",1225,51,17,34,195,178,78,93,244,196,85,52,33,105
"2011","Bolton 033E","E01004876",1340,53,17,36,183,183,78,101,243,291,106,66,40,102
"2011","Bolton 034A","E01004903",1093,104,26,78,257,192,96,83,143,124,27,19,8,67
"2011","Bolton 034B","E01004904",1196,100,26,74,292,209,108,86,160,126,43,24,19,72
"2011","Bolton 034C","E01004905",1181,70,18,52,164,162,92,108,216,200,80,59,21,89
"2011","Bolton 034D","E01004907",930,42,15,27,112,121,61,71,202,173,70,48,22,78
"2011","Bolton 034E","E01004908",970,72,22,50,160,191,90,88,150,114,39,28,11,66
"2011","Bolton 034F","E01004909",992,55,18,37,132,152,78,109,184,170,51,31,20,61
"2011","Bolton 034G","E01004910",1664,165,46,119,359,256,149,147,244,187,56,32,24,101
"2011","Bolton 035A","E01004933",1039,104,34,70,252,168,103,62,153,112,19,7,12,66
"2011","Bolton 035B","E01004934",1110,114,35,79,263,148,111,78,163,90,49,34,15,94
"2011","Bolton 035C","E01004935",1294,146,37,109,331,205,114,93,156,128,30,19,11,91
"2011","Bolton 035D","E01004937",1170,138,36,102,335,178,102,78,113,94,30,21,9,102
"2011","Bolton 035E","E01004940",1105,101,23,78,253,172,80,112,150,142,32,17,15,63
"2011","Bury 001A","E01005014",1160,159,42,117,315,169,105,69,142,101,37,20,17,63
"2011","Bury 001B","E01005015",1116,111,25,86,236,123,119,91,161,147,65,44,21,63
"2011","Bury 001C","E01005016",1173,170,34,136,331,171,96,75,136,127,26,20,6,41
"2011","Bury 001D","E01005017",1243,174,45,129,362,153,125,81,137,108,27,10,17,76
"2011","Bury 001E","E01005018",1136,112,29,83,296,157,92,90,174,110,39,25,14,66
"2011","Bury 001F","E01005021",907,135,36,99,212,130,86,37,59,52,6,4,2,190
"2011","Bury 002A","E01005019",1065,157,41,116,313,159,102,57,126,61,25,17,8,65
"2011","Bury 002B","E01005023",920,125,34,91,222,138,85,55,112,109,16,8,8,58
"2011","Bury 002C","E01005046",1002,184,53,131,282,166,101,44,100,60,19,15,4,46
"2011","Bury 002D","E01005048",1293,249,72,177,430,204,132,47,84,49,22,10,12,76
"2011","Bury 003A","E01005020",1100,178,55,123,346,181,84,42,95,49,23,9,14,102
"2011","Bury 003B","E01005022",1220,231,49,182,421,148,112,63,100,41,23,16,7,81
"2011","Bury 003C","E01005047",1067,187,49,138,348,134,151,38,81,48,27,19,8,53
"2011","Bury 003D","E01005049",1259,174,50,124,342,194,138,74,130,108,24,18,6,75
"2011","Bury 003E","E01005051",1117,143,35,108,292,188,108,66,132,93,29,17,12,66
"2011","Bury 004A","E01004976",1109,62,13,49,152,152,77,93,178,179,117,91,26,99
"2011","Bury 004B","E01004977",1193,91,30,61,236,202,116,102,191,147,50,32,18,58
"2011","Bury 004C","E01004978",1212,109,21,88,218,177,101,99,168,150,102,77,25,88
"2011","Bury 004D","E01004981",1065,126,37,89,256,136,137,74,126,108,39,27,12,63
"2011","Bury 004E","E01004982",1088,146,48,98,270,178,115,79,127,87,28,24,4,58
"2011","Bury 005A","E01004961",1121,96,30,66,264,166,77,55,186,144,56,41,15,77
"2011","Bury 005B","E01004965",935,154,41,113,272,161,90,37,104,46,25,17,8,46
"2011","Bury 005C","E01004966",1253,89,21,68,246,162,86,87,215,171,83,57,26,114
"2011","Bury 005D","E01004967",980,165,49,116,261,163,108,51,95,39,30,23,7,68
"2011","Bury 006A","E01004963",1119,102,37,65,235,206,106,97,149,119,37,25,12,68
"2011","Bury 006B","E01004968",1166,136,33,103,304,194,123,77,161,88,22,15,7,61
"2011","Bury 006C","E01005050",1457,176,46,130,361,220,148,106,201,123,31,20,11,91
"2011","Bury 006D","E01005052",1121,120,38,82,298,210,84,87,132,89,29,18,11,72
"2011","Bury 006E","E01005053",1168,113,23,90,278,169,119,77,158,134,46,32,14,74
"2011","Bury 007A","E01004954",1084,120,26,94,232,159,107,69,172,126,53,41,12,46
"2011","Bury 007B","E01004955",956,56,16,40,169,117,76,90,173,152,64,41,23,59
"2011","Bury 007C","E01004956",1083,53,16,37,163,132,86,92,203,198,86,61,25,70
"2011","Bury 007D","E01004957",1273,52,14,38,138,116,85,94,258,264,172,117,55,94
"2011","Bury 007E","E01004960",1009,21,9,12,75,84,53,66,190,234,191,126,65,95
"2011","Bury 008A","E01004958",1074,28,3,25,135,135,78,105,202,207,106,76,30,78
"2011","Bury 008B","E01004959",1221,53,15,38,146,118,96,115,225,259,128,96,32,81
"2011","Bury 008C","E01004979",1127,44,8,36,120,99,94,63,207,221,186,145,41,93
"2011","Bury 008D","E01004980",981,42,6,36,139,131,78,79,181,174,98,70,28,59
"2011","Bury 008E","E01005024",938,28,9,19,93,82,89,59,150,151,196,176,20,90
"2011","Bury 008F","E01005026",1132,38,5,33,156,114,112,60,187,168,199,178,21,98
"2011","Bury 009A","E01004947",1075,66,11,55,226,162,73,78,185,152,63,36,27,70
"2011","Bury 009B","E01004948",1365,88,27,61,245,172,105,107,213,196,153,124,29,86
"2011","Bury 009C","E01004962",1240,94,21,73,263,184,109,93,215,167,36,23,13,79
"2011","Bury 009D","E01004964",1361,99,26,73,306,230,90,100,206,187,56,33,23,87
"2011","Bury 010A","E01004949",1068,132,41,91,292,179,103,88,114,71,12,11,1,77
"2011","Bury 010B","E01004950",1126,182,44,138,344,177,118,59,85,63,20,15,5,78
"2011","Bury 010C","E01004951",1144,129,36,93,294,191,119,82,150,93,32,19,13,54
"2011","Bury 010D","E01004952",1064,129,37,92,321,209,86,67,111,65,16,10,6,60
"2011","Bury 010E","E01004953",1091,140,31,109,285,196,99,70,117,84,22,17,5,78
"2011","Bury 011A","E01005025",1156,76,21,55,236,213,93,81,175,142,64,40,24,76
"2011","Bury 011B","E01005027",1321,70,17,53,191,170,138,95,202,174,138,118,20,143
"2011","Bury 011C","E01005028",1314,45,5,40,147,157,88,99,237,253,154,115,39,134
"2011","Bury 011D","E01005029",1244,68,14,54,204,146,122,79,202,163,154,135,19,106
"2011","Bury 012A","E01005000",1144,114,33,81,309,194,95,86,130,108,21,15,6,87
"2011","Bury 012B","E01005001",1044,123,37,86,278,183,107,75,129,57,19,10,9,73
"2011","Bury 012C","E01005005",1025,89,40,49,271,190,125,69,134,78,23,16,7,46
"2011","Bury 012D","E01005006",1118,127,37,90,282,163,123,66,148,108,31,19,12,70
"2011","Bury 013A","E01005030",1151,45,9,36,161,146,111,101,210,205,95,66,29,77
"2011","Bury 013B","E01005054",1182,118,31,87,292,212,114,79,139,110,38,29,9,80
"2011","Bury 013C","E01005059",1262,125,35,90,256,178,122,83,174,127,83,63,20,114
"2011","Bury 013D","E01005060",1214,127,31,96,264,204,139,82,150,118,59,42,17,71
"2011","Bury 014A","E01004997",1106,75,18,57,206,184,75,88,205,139,49,33,16,85
"2011","Bury 014B","E01004998",1069,69,18,51,203,183,89,107,193,155,26,20,6,44
"2011","Bury 014C","E01004999",1094,86,26,60,220,190,105,112,175,109,29,13,16,68
"2011","Bury 014D","E01005002",1211,78,21,57,224,219,91,115,229,138,46,35,11,71
"2011","Bury 014E","E01005003",1067,53,12,41,159,154,96,91,226,174,60,33,27,54
"2011","Bury 015A","E01004991",1037,64,15,49,165,176,85,100,177,139,47,33,14,84
"2011","Bury 015B","E01004992",1090,60,8,52,178,166,85,88,206,182,71,52,19,54
"2011","Bury 015C","E01004993",1008,71,10,61,200,151,69,73,165,120,78,52,26,81
"2011","Bury 015D","E01004994",969,47,16,31,138,149,71,78,166,160,98,71,27,62
"2011","Bury 016A","E01004990",1113,59,21,38,172,155,74,126,225,175,50,32,18,77
"2011","Bury 016B","E01004996",1062,33,9,24,143,151,75,84,221,185,109,71,38,61
"2011","Bury 016C","E01005004",1060,38,11,27,111,97,77,104,261,208,115,79,36,49
"2011","Bury 016D","E01005008",1389,51,15,36,217,192,93,128,278,221,127,86,41,82
"2011","Bury 016E","E01005009",1134,57,16,41,185,163,77,98,216,165,102,70,32,71
"2011","Bury 017A","E01004945",1114,108,21,87,271,198,119,78,147,83,47,33,14,63
"2011","Bury 017B","E01005055",1077,123,28,95,260,164,128,60,154,83,28,17,11,77
"2011","Bury 017C","E01005056",951,124,28,96,238,167,107,49,127,68,26,24,2,45
"2011","Bury 017D","E01005057",1111,140,40,100,279,182,114,65,129,87,41,23,18,74
"2011","Bury 017E","E01005058",972,131,21,110,244,165,113,45,104,68,24,18,6,78
"2011","Bury 018A","E01004995",1191,86,25,61,228,204,121,90,219,150,28,15,13,65
"2011","Bury 018B","E01005010",1207,128,29,99,276,165,146,70,169,133,48,28,20,72
"2011","Bury 018C","E01005012",1253,101,24,77,227,174,102,91,203,165,89,58,31,101
"2011","Bury 018D","E01005013",1669,147,31,116,297,194,132,122,286,225,137,81,56,129
"2011","Bury 019A","E01004984",928,150,32,118,265,133,145,33,88,30,26,17,9,58
"2011","Bury 019B","E01004985",1071,217,46,171,295,154,170,24,81,34,26,22,4,70
"2011","Bury 019C","E01004989",1040,200,43,157,316,118,141,39,75,47,30,24,6,74
"2011","Bury 019D","E01005007",1062,130,31,99,255,200,117,70,125,73,35,25,10,57
"2011","Bury 019E","E01005011",1005,156,36,120,293,150,105,62,105,55,18,9,9,61
"2011","Bury 020A","E01004983",1015,92,13,79,239,163,92,56,143,94,43,28,15,93
"2011","Bury 020B","E01004986",1211,137,31,106,303,158,111,67,163,125,71,38,33,76
"2011","Bury 020C","E01004987",839,43,10,33,114,91,79,62,184,150,65,44,21,51
"2011","Bury 020D","E01004988",1074,103,31,72,243,167,96,81,168,102,41,27,14,73
"2011","Bury 021A","E01004941",1288,59,16,43,228,182,95,105,244,208,79,46,33,88
"2011","Bury 021B","E01004942",1017,24,4,20,107,124,85,82,213,185,106,63,43,91
"2011","Bury 021C","E01004943",1178,77,12,65,221,161,102,120,187,132,68,43,25,110
"2011","Bury 021D","E01004944",1207,124,35,89,301,196,98,96,151,95,47,32,15,99
"2011","Bury 021E","E01004946",1144,42,9,33,121,146,77,89,255,228,107,71,36,79
"2011","Bury 022A","E01004969",1150,99,20,79,257,151,114,76,140,126,124,99,25,63
"2011","Bury 022B","E01004970",1163,98,14,84,264,197,127,93,152,85,45,38,7,102
"2011","Bury 022C","E01004971",1116,105,25,80,286,197,115,69,140,90,40,29,11,74
"2011","Bury 022D","E01005034",1077,159,43,116,331,156,110,50,99,60,40,32,8,72
"2011","Bury 023A","E01004972",1040,64,12,52,150,138,75,77,181,151,83,63,20,121
"2011","Bury 023B","E01004973",1168,113,25,88,293,172,109,73,151,102,51,37,14,104
"2011","Bury 023C","E01004975",1147,110,18,92,330,165,88,84,139,112,50,35,15,69
"2011","Bury 023D","E01005039",1066,91,20,71,217,137,88,80,168,144,76,47,29,65
"2011","Bury 023E","E01005045",1171,132,23,109,288,169,96,59,156,91,80,56,24,100
"2011","Bury 024A","E01004974",1082,135,22,113,277,163,117,47,125,91,41,24,17,86
"2011","Bury 024B","E01005033",1059,164,30,134,270,149,126,50,92,61,70,54,16,77
"2011","Bury 024C","E01005036",1410,199,43,156,371,184,108,88,165,131,90,42,48,74
"2011","Bury 024D","E01005037",1093,123,23,100,305,179,103,69,97,93,41,24,17,83
"2011","Bury 025A","E01005031",1060,84,10,74,204,151,94,67,189,138,59,36,23,74
"2011","Bury 025B","E01005032",802,52,6,46,143,101,82,50,139,118,66,48,18,51
"2011","Bury 025C","E01005035",1053,160,29,131,301,134,80,78,103,88,44,26,18,65
"2011","Bury 025D","E01005038",1011,160,28,132,274,151,97,51,96,62,33,23,10,87
"2011","Bury 026A","E01005040",1323,135,32,103,293,200,129,72,141,124,93,71,22,136
"2011","Bury 026B","E01005041",1096,160,22,138,256,147,136,37,111,43,75,65,10,131
"2011","Bury 026C","E01005042",1189,183,38,145,306,163,115,51,102,68,77,55,22,124
"2011","Bury 026D","E01005043",1062,170,17,153,252,172,117,37,113,40,68,57,11,93
"2011","Bury 026E","E01005044",964,92,19,73,216,154,98,47,104,85,76,63,13,92
"2011","Manchester 001A","E01005098",1115,28,7,21,135,151,63,92,231,205,120,84,36,90
"2011","Manchester 001B","E01005099",1180,33,14,19,118,99,53,114,241,238,168,135,33,116
"2011","Manchester 001C","E01005100",1150,66,19,47,177,155,110,96,195,169,100,76,24,82
"2011","Manchester 001D","E01005102",1029,41,12,29,170,201,59,84,200,159,55,30,25,60
"2011","Manchester 001E","E01005103",1144,28,9,19,141,147,75,84,229,234,136,102,34,70
"2011","Manchester 002A","E01005101",1215,36,9,27,187,178,77,92,209,182,145,117,28,109
"2011","Manchester 002B","E01005135",1131,35,7,28,123,118,62,98,198,226,149,120,29,122
"2011","Manchester 002C","E01005136",1127,60,14,46,205,159,103,92,179,153,95,71,24,81
"2011","Manchester 002D","E01005138",1175,21,2,19,121,120,64,93,226,228,205,145,60,97
"2011","Manchester 002E","E01005140",2048,131,27,104,334,292,158,143,365,299,164,130,34,162
"2011","Manchester 003B","E01005139",1252,70,18,52,206,172,99,101,220,166,112,79,33,106
"2011","Manchester 003C","E01005141",1240,21,8,13,120,158,75,81,271,229,178,133,45,107
"2011","Manchester 003D","E01005251",1118,43,11,32,146,154,70,80,231,181,95,71,24,118
"2011","Manchester 003E","E01005252",1306,36,13,23,168,172,85,91,288,208,141,104,37,117
"2011","Manchester 003F","E01033685",1110,106,17,89,203,164,102,84,173,122,57,42,15,99
"2011","Manchester 003G","E01033687",1089,77,16,61,158,144,62,86,167,228,99,69,30,68
"2011","Manchester 004A","E01005104",1242,63,12,51,208,165,76,97,199,194,133,88,45,107
"2011","Manchester 004B","E01005160",1258,104,16,88,206,179,139,80,196,120,109,91,18,125
"2011","Manchester 004C","E01005161",1110,54,13,41,221,201,79,81,189,154,74,56,18,57
"2011","Manchester 004D","E01005162",1205,100,24,76,197,156,132,58,167,136,138,109,29,121
"2011","Manchester 004E","E01005163",1158,85,18,67,190,184,104,83,155,120,128,100,28,109
"2011","Manchester 005A","E01005247",1087,73,21,52,200,199,91,82,194,120,46,30,16,82
"2011","Manchester 005B","E01005248",1094,75,20,55,207,200,83,99,169,123,52,37,15,86
"2011","Manchester 005C","E01005249",1353,87,19,68,224,225,108,107,180,215,109,78,31,98
"2011","Manchester 005D","E01005250",1255,47,9,38,163,196,78,88,244,196,139,94,45,104
"2011","Manchester 005E","E01005253",1088,30,8,22,117,139,79,86,221,203,115,72,43,98
"2011","Manchester 005F","E01005254",1231,78,17,61,238,238,103,94,181,144,57,46,11,98
"2011","Manchester 006A","E01005164",1159,65,12,53,141,119,78,70,179,185,187,161,26,135
"2011","Manchester 006B","E01005205",1425,35,6,29,147,153,83,100,294,275,219,178,41,119
"2011","Manchester 006C","E01005206",1286,57,12,45,192,169,92,101,226,248,118,94,24,83
"2011","Manchester 006D","E01005207",1461,52,8,44,183,169,84,101,295,234,136,96,40,207
"2011","Manchester 007A","E01005223",941,41,5,36,124,131,73,72,173,178,79,62,17,70
"2011","Manchester 007B","E01005224",1278,54,11,43,171,106,87,112,255,202,140,106,34,151
"2011","Manchester 007C","E01005225",1351,32,8,24,145,180,102,96,255,257,175,124,51,109
"2011","Manchester 007D","E01005226",1126,42,5,37,154,166,65,92,217,175,106,74,32,109
"2011","Manchester 007E","E01005229",1126,49,9,40,176,227,86,107,197,149,57,38,19,78
"2011","Manchester 008A","E01005145",1805,91,6,85,167,143,174,54,202,174,411,382,29,389
"2011","Manchester 008B","E01005146",1613,98,12,86,199,177,128,84,210,178,299,255,44,240
"2011","Manchester 008C","E01005149",1163,35,6,29,95,83,117,48,146,126,271,246,25,242
"2011","Manchester 008D","E01005165",1522,72,9,63,195,144,135,109,243,211,242,185,57,171
"2011","Manchester 008E","E01005166",1271,50,8,42,149,100,123,71,182,175,257,230,27,164
"2011","Manchester 008F","E01005167",1304,69,10,59,160,108,100,72,188,133,260,240,20,214
"2011","Manchester 009A","E01005202",1240,19,5,14,101,121,73,91,243,233,254,204,50,105
"2011","Manchester 009B","E01005203",1382,26,4,22,131,104,48,91,242,298,308,240,68,134
"2011","Manchester 009D","E01005227",1188,50,8,42,116,135,81,82,232,215,166,129,37,111
"2011","Manchester 009E","E01005228",1171,17,3,14,94,83,58,91,257,209,227,182,45,135
"2011","Manchester 009F","E01033678",1107,24,2,22,91,100,60,65,225,247,191,153,38,104
"2011","Manchester 009G","E01033679",1016,14,3,11,66,73,55,65,180,227,233,187,46,103
"2011","Manchester 011A","E01005256",1463,42,12,30,151,171,79,113,273,273,224,167,57,137
"2011","Manchester 011B","E01005257",1276,23,3,20,94,126,71,94,277,278,216,157,59,97
"2011","Manchester 011C","E01005258",1233,43,5,38,167,182,68,91,243,226,110,78,32,103
"2011","Manchester 011D","E01005259",1158,24,5,19,113,110,68,80,273,230,169,123,46,91
"2011","Manchester 011E","E01005260",1118,55,15,40,169,176,111,99,195,158,78,56,22,77
"2011","Manchester 012A","E01005093",1144,38,8,30,132,92,65,89,234,221,190,160,30,83
"2011","Manchester 012B","E01005094",1011,18,8,10,97,127,40,93,225,178,118,89,29,115
"2011","Manchester 012C","E01005097",1139,22,8,14,98,85,52,85,227,235,183,137,46,152
"2011","Manchester 012D","E01005255",1165,31,10,21,97,102,55,102,233,254,191,144,47,100
"2011","Manchester 012E","E01005261",1091,18,5,13,101,116,53,49,249,234,180,135,45,91
"2011","Manchester 013B","E01005129",1054,34,5,29,83,99,53,78,197,216,185,153,32,109
"2011","Manchester 013C","E01005132",1038,29,5,24,88,81,59,75,190,220,190,157,33,106
"2011","Manchester 013D","E01005133",1036,55,9,46,149,69,33,61,179,194,179,143,36,117
"2011","Manchester 013E","E01033663",1102,205,23,182,293,138,47,45,72,70,56,33,23,176
"2011","Manchester 013F","E01033684",1180,187,12,175,364,175,27,56,76,34,15,6,9,246
"2011","Manchester 013G","E01033688",1104,37,8,29,116,109,66,91,174,228,170,138,32,113
"2011","Manchester 015A","E01005092",1106,27,5,22,122,111,57,84,241,232,145,103,42,87
"2011","Manchester 015C","E01005105",1462,121,12,109,216,139,85,106,184,186,209,164,45,216
"2011","Manchester 015D","E01005106",1342,40,6,34,112,117,74,93,285,272,190,140,50,159
"2011","Manchester 015E","E01005107",1203,42,11,31,114,130,83,79,220,211,200,155,45,124
"2011","Manchester 015F","E01033668",941,88,9,79,194,138,36,55,124,93,85,61,24,128
"2011","Manchester 015G","E01033669",1061,38,6,32,111,119,56,74,197,209,147,120,27,110
"2011","Manchester 017A","E01005108",1745,41,10,31,173,168,103,118,348,328,254,192,62,212
"2011","Manchester 017D","E01005189",1200,39,9,30,88,126,57,114,230,254,190,141,49,102
"2011","Manchester 017E","E01005190",1432,56,9,47,184,168,70,109,298,255,172,121,51,120
"2011","Manchester 017F","E01033666",1935,105,19,86,250,246,133,149,354,305,210,161,49,183
"2011","Manchester 018A","E01005061",1155,21,1,20,111,96,52,76,222,188,243,179,64,146
"2011","Manchester 018B","E01005062",2434,101,14,87,147,106,56,52,176,130,166,139,27,1500
"2011","Manchester 018C","E01005063",1039,53,5,48,121,94,51,55,157,145,173,136,37,190
"2011","Manchester 018D","E01005065",1599,79,3,76,160,138,84,92,225,212,267,207,60,342
"2011","Manchester 018E","E01005066",1494,51,4,47,93,66,40,49,110,109,77,57,20,899
"2011","Manchester 019A","E01005208",1930,197,22,175,394,194,89,65,182,131,144,113,31,534
"2011","Manchester 019B","E01005209",2350,99,4,95,159,117,62,62,162,147,173,145,28,1369
"2011","Manchester 019C","E01005210",3016,41,3,38,105,76,32,29,83,110,130,103,27,2410
"2011","Manchester 019D","E01005214",1920,230,37,193,395,234,68,90,159,109,141,102,39,494
"2011","Manchester 020A","E01005067",940,14,6,8,78,71,52,64,156,204,184,135,49,117
"2011","Manchester 020B","E01005186",1648,87,20,67,201,190,121,115,264,278,221,177,44,171
"2011","Manchester 020C","E01005232",1315,52,8,44,159,121,109,65,194,173,240,197,43,202
"2011","Manchester 020D","E01005235",1231,24,4,20,106,125,58,65,234,181,261,218,43,177
"2011","Manchester 020E","E01005239",1108,27,3,24,100,82,60,56,173,174,247,203,44,189
"2011","Manchester 021A","E01005187",1323,34,6,28,160,153,90,95,245,237,172,124,48,137
"2011","Manchester 021B","E01005188",1224,48,9,39,176,198,81,99,232,179,107,77,30,104
"2011","Manchester 021C","E01005191",1214,37,11,26,150,158,69,79,262,207,143,95,48,109
"2011","Manchester 021D","E01005192",1193,60,18,42,191,165,101,102,201,168,108,67,41,97
"2011","Manchester 021E","E01005193",1338,55,8,47,198,184,93,107,274,205,117,82,35,105
"2011","Manchester 022B","E01005230",1736,92,10,82,151,127,64,56,154,124,254,209,45,714
"2011","Manchester 022C","E01005231",2457,79,5,74,164,89,40,50,83,77,95,79,16,1780
"2011","Manchester 022D","E01005236",1624,65,5,60,140,102,78,70,161,133,243,208,35,632
"2011","Manchester 022E","E01005237",1405,55,9,46,108,106,113,80,144,139,332,299,33,328
"2011","Manchester 022F","E01033652",1381,33,5,28,70,52,31,27,99,70,102,70,32,897
"2011","Manchester 022G","E01033657",1354,38,4,34,70,52,25,33,94,83,80,64,16,879
"2011","Manchester 023A","E01005195",1320,42,8,34,139,130,71,84,267,236,200,151,49,151
"2011","Manchester 023B","E01005196",1525,62,8,54,183,183,74,86,257,256,228,181,47,196
"2011","Manchester 023C","E01005197",1096,40,3,37,147,118,64,76,194,208,138,110,28,111
"2011","Manchester 023D","E01005198",1057,22,3,19,100,94,61,69,189,187,214,168,46,121
"2011","Manchester 023E","E01005201",1352,37,5,32,140,134,80,81,240,220,230,163,67,190
"2011","Manchester 024A","E01005240",1749,62,10,52,216,175,93,82,251,212,355,299,56,303
"2011","Manchester 024B","E01005243",1666,62,12,50,183,164,69,96,276,232,321,273,48,263
"2011","Manchester 024C","E01005245",1504,44,17,27,117,135,69,69,210,183,358,315,43,319
"2011","Manchester 024D","E01005246",1279,24,2,22,95,100,74,67,188,167,364,311,53,200
"2011","Manchester 025A","E01005241",1819,117,6,111,273,208,88,108,227,172,174,135,39,452
"2011","Manchester 025B","E01005242",1824,64,2,62,192,150,85,104,223,215,301,246,55,490
"2011","Manchester 025C","E01005244",2449,50,4,46,174,152,63,68,143,160,255,219,36,1384
"2011","Manchester 025D","E01005285",993,27,0,27,95,70,44,46,82,137,187,163,24,305
"2011","Manchester 025E","E01005288",1424,65,5,60,140,91,55,61,130,97,140,124,16,645
"2011","Manchester 026A","E01005280",1299,66,7,59,117,109,115,73,145,145,265,232,33,264
"2011","Manchester 026B","E01005281",2123,82,3,79,145,78,34,37,72,57,52,44,8,1566
"2011","Manchester 026C","E01005284",3265,179,9,170,152,94,42,34,79,52,106,92,14,2527
"2011","Manchester 026D","E01005286",1937,187,16,171,239,115,80,50,99,67,117,106,11,983
"2011","Manchester 026E","E01005287",1486,53,4,49,122,103,103,87,156,164,352,309,43,346
"2011","Manchester 027A","E01005194",1793,49,3,46,185,131,143,114,246,245,349,296,53,331
"2011","Manchester 027B","E01005199",1597,94,12,82,253,175,124,100,233,174,238,207,31,206
"2011","Manchester 027C","E01005200",1322,75,12,63,224,170,108,85,225,172,142,120,22,121
"2011","Manchester 027D","E01005233",1560,44,4,40,144,136,110,78,219,214,302,257,45,313
"2011","Manchester 027E","E01005234",1414,52,6,46,92,112,122,78,154,184,340,309,31,280
"2011","Manchester 027F","E01005238",1408,56,10,46,111,126,148,53,159,142,319,294,25,294
"2011","Manchester 028A","E01005297",1804,228,22,206,363,206,154,77,196,133,232,174,58,215
"2011","Manchester 028B","E01005298",1308,194,27,167,263,135,119,51,131,71,168,144,24,176
"2011","Manchester 028C","E01005302",1492,207,31,176,369,152,116,89,173,115,120,87,33,151
"2011","Manchester 028E","E01033680",1061,130,9,121,242,127,92,81,90,67,84,57,27,148
"2011","Manchester 028F","E01033686",1005,135,17,118,250,126,77,54,100,103,79,56,23,81
"2011","Manchester 029A","E01005150",1644,320,31,289,519,202,85,81,113,102,72,46,26,150
"2011","Manchester 029B","E01005151",1119,235,30,205,346,129,86,46,92,50,48,37,11,87
"2011","Manchester 029C","E01005152",1121,283,34,249,377,121,69,45,68,48,30,24,6,80
"2011","Manchester 029D","E01005159",1271,282,42,240,412,142,76,45,85,45,57,40,17,127
"2011","Manchester 029E","E01005296",1259,196,32,164,341,142,119,45,122,61,99,82,17,134
"2011","Manchester 029F","E01005299",1182,156,21,135,242,119,116,48,105,73,160,144,16,163
"2011","Manchester 030A","E01005178",1478,91,10,81,243,169,69,69,204,134,179,128,51,320
"2011","Manchester 030B","E01005179",1780,221,24,197,418,220,135,63,175,103,173,148,25,272
"2011","Manchester 030C","E01005180",1311,76,14,62,171,166,75,85,186,190,180,136,44,182
"2011","Manchester 030D","E01005181",1507,177,19,158,286,156,164,70,149,88,189,165,24,228
"2011","Manchester 030E","E01005182",1103,41,3,38,134,106,72,65,137,139,150,122,28,259
"2011","Manchester 030F","E01005183",1256,41,3,38,144,130,66,73,189,169,234,185,49,210
"2011","Manchester 031A","E01005219",1629,145,22,123,293,158,146,72,192,143,187,151,36,293
"2011","Manchester 031B","E01005220",1342,84,10,74,215,156,126,82,195,172,166,138,28,146
"2011","Manchester 031C","E01005221",1612,136,28,108,240,173,133,87,241,151,224,194,30,227
"2011","Manchester 031D","E01005222",1520,107,18,89,269,202,104,90,226,182,160,128,32,180
"2011","Manchester 032A","E01005184",1822,132,18,114,199,121,72,50,123,101,97,77,20,927
"2011","Manchester 032B","E01005185",3945,55,4,51,102,68,16,22,50,49,35,29,6,3548
"2011","Manchester 032C","E01005271",1953,98,5,93,164,105,50,38,74,62,61,47,14,1301
"2011","Manchester 032D","E01005282",1361,82,10,72,158,100,111,51,122,103,194,163,31,440
"2011","Manchester 032E","E01005283",1424,16,3,13,59,31,7,16,46,34,29,22,7,1186
"2011","Manchester 033A","E01005154",1311,299,41,258,401,155,91,43,111,72,34,22,12,105
"2011","Manchester 033B","E01005156",1183,327,33,294,416,115,72,36,69,48,26,14,12,74
"2011","Manchester 033C","E01005158",1172,212,23,189,310,160,86,61,98,88,68,40,28,89
"2011","Manchester 033D","E01005300",1109,125,17,108,192,114,150,35,101,53,151,138,13,188
"2011","Manchester 033E","E01005301",1191,238,28,210,323,141,116,23,95,39,90,77,13,126
"2011","Manchester 034A","E01005118",1047,90,15,75,160,136,120,65,121,122,103,89,14,130
"2011","Manchester 034B","E01005120",1261,97,19,78,211,144,108,79,186,126,161,129,32,149
"2011","Manchester 034C","E01005215",1411,91,13,78,243,170,123,78,178,155,186,148,38,187
"2011","Manchester 034D","E01005216",1108,119,8,111,266,142,101,51,134,102,93,82,11,100
"2011","Manchester 034E","E01005217",1361,168,26,142,253,192,129,72,148,91,116,102,14,192
"2011","Manchester 034F","E01005218",1300,87,16,71,178,106,104,55,138,117,139,128,11,376
"2011","Manchester 035A","E01005270",1301,97,12,85,164,147,66,66,195,184,176,117,59,206
"2011","Manchester 035B","E01005272",1215,76,9,67,162,148,78,60,210,189,157,123,34,135
"2011","Manchester 035C","E01005273",1412,97,10,87,149,98,29,35,85,61,49,35,14,809
"2011","Manchester 035D","E01005278",1490,68,7,61,130,96,69,54,115,115,134,107,27,709
"2011","Manchester 035E","E01005279",1465,175,21,154,240,161,117,69,201,172,161,128,33,169
"2011","Manchester 036A","E01005305",1434,151,22,129,248,157,102,48,103,80,96,76,20,449
"2011","Manchester 036B","E01005309",2182,142,12,130,251,166,42,50,93,74,52,34,18,1312
"2011","Manchester 036C","E01005310",1626,25,5,20,96,79,30,30,109,92,74,56,18,1091
"2011","Manchester 036D","E01005311",1519,109,13,96,219,133,64,37,112,87,106,85,21,652
"2011","Manchester 036E","E01005312",1697,62,4,58,137,64,40,35,94,76,51,38,13,1138
"2011","Manchester 037A","E01005082",1134,108,11,97,235,140,81,65,152,142,115,92,23,96
"2011","Manchester 037B","E01005153",1325,346,35,311,416,155,89,45,83,77,32,19,13,82
"2011","Manchester 037C","E01005155",1119,326,40,286,376,100,73,38,70,51,13,10,3,72
"2011","Manchester 037D","E01005157",1150,295,52,243,413,118,79,35,69,42,19,14,5,80
"2011","Manchester 038A","E01005274",1426,146,25,121,235,136,53,74,143,143,99,76,23,397
"2011","Manchester 038B","E01005275",1538,305,26,279,437,171,73,45,89,50,42,21,21,326
"2011","Manchester 038C","E01005276",1372,266,28,238,319,147,52,48,75,51,58,40,18,356
"2011","Manchester 038D","E01005277",1436,381,33,348,451,165,76,34,85,36,41,28,13,167
"2011","Manchester 039A","E01005076",1313,341,34,307,402,149,60,31,74,52,50,37,13,154
"2011","Manchester 039C","E01005081",1273,88,16,72,186,152,77,76,185,189,146,97,49,174
"2011","Manchester 039D","E01005083",1520,387,40,347,491,182,58,49,91,43,54,32,22,165
"2011","Manchester 039E","E01033670",1124,437,35,402,371,106,40,29,35,10,22,15,7,74
"2011","Manchester 039F","E01033671",1489,457,53,404,449,161,66,42,70,36,33,26,7,175
"2011","Manchester 040A","E01005125",1173,96,15,81,220,153,86,63,157,129,129,100,29,140
"2011","Manchester 040B","E01005304",1594,179,11,168,282,116,51,57,75,59,57,43,14,718
"2011","Manchester 040C","E01005306",1189,368,30,338,345,131,76,28,53,44,37,23,14,107
"2011","Manchester 040D","E01005307",1662,228,24,204,321,182,74,62,85,63,48,37,11,599
"2011","Manchester 040E","E01005308",1292,122,12,110,253,132,88,59,136,137,136,102,34,229
"2011","Manchester 041A","E01005119",1080,47,12,35,150,137,78,62,206,150,128,96,32,122
"2011","Manchester 041B","E01005121",1090,40,6,34,129,129,97,64,199,160,134,109,25,138
"2011","Manchester 041C","E01005122",1163,68,20,48,161,150,85,73,176,175,143,108,35,132
"2011","Manchester 041D","E01005123",1166,50,10,40,131,122,69,84,187,178,181,131,50,164
"2011","Manchester 041E","E01005124",1249,72,9,63,182,149,97,97,200,173,140,117,23,139
"2011","Manchester 042A","E01005077",1065,77,12,65,157,111,76,46,165,167,145,113,32,121
"2011","Manchester 042B","E01005078",1222,406,30,376,383,114,66,38,48,32,30,19,11,105
"2011","Manchester 042C","E01005079",1114,235,34,201,261,121,64,49,114,77,97,64,33,96
"2011","Manchester 042D","E01005084",1528,239,35,204,372,201,85,95,179,148,108,71,37,101
"2011","Manchester 043A","E01005172",1250,408,46,362,338,121,77,26,57,43,37,28,9,143
"2011","Manchester 043B","E01005173",1210,416,47,369,368,113,73,22,49,33,23,18,5,113
"2011","Manchester 043C","E01005174",1155,368,41,327,345,127,63,26,52,25,31,27,4,118
"2011","Manchester 043D","E01005175",1221,310,44,266,327,138,69,44,90,90,62,47,15,91
"2011","Manchester 043E","E01005176",1563,481,39,442,521,166,88,38,63,55,47,34,13,104
"2011","Manchester 043F","E01005177",1024,298,35,263,303,120,65,30,64,32,23,14,9,89
"2011","Manchester 044A","E01005115",1317,128,25,103,236,202,101,88,211,154,114,70,44,83
"2011","Manchester 044B","E01005262",1371,142,25,117,281,189,103,89,179,172,119,86,33,97
"2011","Manchester 044C","E01005264",1067,49,10,39,147,157,68,70,196,170,109,75,34,101
"2011","Manchester 044D","E01005265",1187,83,14,69,175,142,83,77,178,200,129,87,42,120
"2011","Manchester 044E","E01005266",1370,68,20,48,183,175,75,95,266,202,180,133,47,126
"2011","Manchester 045A","E01005126",1499,205,32,173,363,190,100,81,161,140,96,79,17,163
"2011","Manchester 045B","E01005168",994,191,24,167,270,135,102,40,66,46,44,33,11,100
"2011","Manchester 045C","E01005169",1044,251,25,226,257,93,91,30,48,39,24,15,9,211
"2011","Manchester 045D","E01005170",1073,206,22,184,273,155,94,52,92,63,47,39,8,91
"2011","Manchester 045E","E01005171",1317,231,36,195,318,192,111,68,114,71,66,56,10,146
"2011","Manchester 046A","E01005263",1270,124,19,105,254,177,92,95,203,165,91,59,32,69
"2011","Manchester 046B","E01005267",1154,156,26,130,273,153,92,61,161,117,59,41,18,82
"2011","Manchester 046C","E01005268",1594,292,45,247,439,201,114,96,185,109,72,44,28,86
"2011","Manchester 046D","E01005269",1088,117,21,96,241,166,109,78,141,103,67,59,8,66
"2011","Manchester 047A","E01005069",1163,85,14,71,270,202,109,71,194,124,42,23,19,66
"2011","Manchester 047B","E01005111",966,54,16,38,162,143,67,67,189,145,73,45,28,66
"2011","Manchester 047C","E01005113",1162,64,16,48,155,172,69,88,260,191,111,70,41,52
"2011","Manchester 047D","E01005114",1273,191,50,141,328,199,120,84,136,83,50,35,15,82
"2011","Manchester 047E","E01005116",1526,158,27,131,346,235,107,116,227,171,82,50,32,84
"2011","Manchester 048A","E01005071",1115,45,13,32,170,167,54,96,197,197,87,67,20,102
"2011","Manchester 048B","E01005072",1234,99,22,77,221,171,64,93,224,174,108,79,29,80
"2011","Manchester 048C","E01005073",1090,76,13,63,189,223,101,79,165,112,64,45,19,81
"2011","Manchester 048D","E01005112",1155,63,11,52,214,157,75,95,179,167,104,75,29,101
"2011","Manchester 048E","E01005117",1454,63,7,56,211,167,84,113,250,273,183,127,56,110
"2011","Manchester 049A","E01005085",1072,44,9,35,121,133,58,99,213,199,112,72,40,93
"2011","Manchester 049B","E01005086",1250,46,9,37,163,99,52,106,240,283,147,96,51,114
"2011","Manchester 049C","E01005089",1268,43,7,36,133,148,62,105,243,254,179,118,61,101
"2011","Manchester 049D","E01005289",1049,25,9,16,108,106,55,71,207,233,148,102,46,96
"2011","Manchester 049E","E01005295",1919,256,36,220,501,273,163,132,204,173,107,71,36,110
"2011","Manchester 050A","E01005087",1438,35,7,28,177,133,69,112,273,297,197,140,57,145
"2011","Manchester 050B","E01005088",1140,19,6,13,94,100,44,80,257,260,182,125,57,104
"2011","Manchester 050C","E01005090",1106,24,5,19,109,116,45,91,224,225,179,126,53,93
"2011","Manchester 050D","E01005091",1521,71,9,62,163,147,72,129,309,323,178,129,49,129
"2011","Manchester 050E","E01005291",1053,20,8,12,117,140,52,81,217,208,129,87,42,89
"2011","Manchester 051A","E01005068",1110,41,9,32,166,129,66,94,223,201,111,79,32,79
"2011","Manchester 051B","E01005070",1196,69,8,61,198,162,52,94,228,191,100,72,28,102
"2011","Manchester 051C","E01005074",1093,23,7,16,157,153,56,91,206,223,102,67,35,82
"2011","Manchester 051D","E01005075",992,41,14,27,172,168,65,71,172,156,80,54,26,67
"2011","Manchester 051E","E01005319",1534,46,12,34,194,192,86,151,307,289,161,115,46,108
"2011","Manchester 052A","E01005290",1114,26,8,18,129,131,54,90,244,248,113,61,52,79
"2011","Manchester 052B","E01005292",1062,34,11,23,117,143,58,91,230,206,116,86,30,67
"2011","Manchester 052C","E01005293",945,50,13,37,199,171,68,85,166,130,26,14,12,50
"2011","Manchester 052D","E01005294",1116,82,21,61,224,184,86,100,161,132,62,38,24,85
"2011","Manchester 052E","E01005317",1222,40,12,28,179,190,90,96,206,208,108,85,23,105
"2011","Manchester 053A","E01005313",1059,29,5,24,116,147,66,84,221,196,118,65,53,82
"2011","Manchester 053B","E01005314",1118,27,7,20,143,146,64,98,219,206,116,83,33,99
"2011","Manchester 053C","E01005315",1092,31,10,21,128,139,72,106,209,213,109,71,38,85
"2011","Manchester 053D","E01005316",1246,69,16,53,213,190,80,112,194,215,90,55,35,83
"2011","Manchester 053E","E01005318",1311,47,9,38,186,181,85,103,258,236,124,88,36,91
"2011","Manchester 054A","E01005130",1155,37,2,35,161,101,46,77,205,237,196,147,49,95
"2011","Manchester 054B","E01033651",1092,201,23,178,308,121,33,48,61,43,43,38,5,234
"2011","Manchester 054C","E01033658",1186,236,27,209,290,119,47,45,53,35,29,17,12,332
"2011","Manchester 054D","E01033664",1094,245,17,228,316,138,32,42,58,27,12,8,4,224
"2011","Manchester 054E","E01033667",969,182,15,167,301,125,53,25,70,47,22,16,6,144
"2011","Manchester 055A","E01005128",1681,232,10,222,161,79,30,24,41,26,36,25,11,1052
"2011","Manchester 055B","E01033653",1531,331,34,297,417,160,75,56,88,30,41,38,3,333
"2011","Manchester 055C","E01033654",2935,195,12,183,253,107,35,23,44,20,22,18,4,2236
"2011","Manchester 055D","E01033659",1297,306,30,276,435,165,49,33,47,32,12,11,1,218
"2011","Manchester 055E","E01033661",1103,226,14,212,303,124,41,29,61,39,35,26,9,245
"2011","Manchester 056A","E01005143",1743,64,4,60,144,118,154,60,222,194,425,383,42,362
"2011","Manchester 056B","E01033655",1158,259,28,231,344,183,25,43,59,33,28,23,5,184
"2011","Manchester 056C","E01033665",1118,157,10,147,280,177,64,54,87,82,52,40,12,165
"2011","Manchester 056D","E01033676",1153,37,1,36,105,104,67,70,189,212,218,169,49,151
"2011","Manchester 057A","E01005212",1914,97,8,89,197,94,43,44,98,103,117,80,37,1121
"2011","Manchester 057B","E01033656",3469,191,19,172,170,84,15,26,33,21,63,38,25,2866
"2011","Manchester 057C","E01033662",1312,244,29,215,253,98,45,34,47,37,35,20,15,519
"2011","Manchester 058A","E01005142",1304,28,4,24,100,78,82,58,224,208,325,278,47,201
"2011","Manchester 058B","E01005147",1684,81,13,68,159,124,122,89,247,225,351,308,43,286
"2011","Manchester 058C","E01033674",1936,173,23,150,295,168,136,132,225,342,281,232,49,184
"2011","Manchester 058D","E01033675",1428,70,4,66,215,115,106,92,201,205,225,184,41,199
"2011","Manchester 059A","E01005213",1785,123,16,107,271,185,111,98,201,214,238,179,59,344
"2011","Manchester 059B","E01033660",1153,279,25,254,390,198,38,25,46,29,14,11,3,134
"2011","Manchester 059C","E01033672",1009,108,11,97,177,115,54,44,138,115,111,91,20,147
"2011","Manchester 059D","E01033673",1087,310,34,276,369,157,45,46,36,17,9,6,3,98
"2011","Manchester 060A","E01033677",1140,254,30,224,221,70,31,14,18,9,24,14,10,499
"2011","Manchester 060B","E01033681",1332,457,46,411,416,130,61,27,32,11,16,10,6,182
"2011","Manchester 060C","E01033682",1234,404,49,355,369,139,56,30,41,23,11,5,6,161
"2011","Manchester 060D","E01033683",1215,322,44,278,283,107,33,23,32,13,21,18,3,381
"2011","Oldham 001A","E01005357",1102,112,35,77,280,182,95,103,133,121,20,15,5,56
"2011","Oldham 001B","E01005358",1214,60,22,38,223,175,104,97,205,223,47,29,18,80
"2011","Oldham 001C","E01005359",1222,100,26,74,324,200,131,93,152,137,19,12,7,66
"2011","Oldham 001D","E01005360",1022,72,17,55,212,137,86,98,158,161,41,20,21,57
"2011","Oldham 002A","E01005441",1200,70,21,49,236,159,91,88,207,212,59,38,21,78
"2011","Oldham 002B","E01005442",1120,113,34,79,288,190,102,100,130,112,21,12,9,64
"2011","Oldham 002C","E01005444",1135,53,15,38,177,182,90,95,214,206,44,27,17,74
"2011","Oldham 002D","E01005445",1122,32,9,23,203,158,79,86,221,225,55,34,21,63
"2011","Oldham 003A","E01005361",1263,137,44,93,294,196,125,110,153,127,40,28,12,81
"2011","Oldham 003B","E01005443",1077,147,36,111,307,187,114,76,81,85,24,15,9,56
"2011","Oldham 003C","E01005446",1066,88,39,49,227,170,90,83,151,146,38,22,16,73
"2011","Oldham 003D","E01005447",1062,49,14,35,187,124,89,82,187,201,89,63,26,54
"2011","Oldham 004A","E01005390",1119,91,24,67,263,205,101,86,173,124,22,7,15,54
"2011","Oldham 004B","E01005394",1151,128,33,95,302,178,111,81,129,110,29,14,15,83
"2011","Oldham 004C","E01005395",1098,91,30,61,253,209,91,89,149,135,19,11,8,62
"2011","Oldham 004D","E01005396",1133,105,28,77,258,195,87,92,155,121,49,28,21,71
"2011","Oldham 005A","E01005355",1129,63,9,54,187,164,81,91,211,213,40,31,9,79
"2011","Oldham 005B","E01005356",1035,121,44,77,270,186,85,73,118,81,27,15,12,74
"2011","Oldham 005C","E01005399",1249,88,30,58,244,208,112,129,182,190,34,14,20,62
"2011","Oldham 005D","E01005403",1224,112,29,83,269,221,96,119,166,126,29,15,14,86
"2011","Oldham 006A","E01005410",1191,198,53,145,345,151,158,55,112,79,20,10,10,73
"2011","Oldham 006B","E01005411",1112,178,49,129,348,137,142,52,76,74,19,10,9,86
"2011","Oldham 006C","E01005414",1001,180,61,119,283,125,161,45,74,66,13,9,4,54
"2011","Oldham 006D","E01005415",826,106,37,69,223,104,86,60,102,74,24,13,11,47
"2011","Oldham 007C","E01005452",1081,91,29,62,252,174,122,78,156,111,26,17,9,71
"2011","Oldham 007D","E01005453",981,116,33,83,251,156,88,73,142,73,27,18,9,55
"2011","Oldham 007E","E01032558",1006,24,7,17,97,97,76,68,214,241,113,68,45,76
"2011","Oldham 007F","E01032559",1962,143,43,100,394,282,204,175,294,233,105,72,33,132
"2011","Oldham 008A","E01005391",1197,100,36,64,254,181,115,85,173,182,40,24,16,67
"2011","Oldham 008B","E01005392",1077,47,19,28,167,138,65,98,191,253,60,42,18,58
"2011","Oldham 008C","E01005393",957,86,18,68,209,160,93,79,134,121,19,11,8,56
"2011","Oldham 008D","E01005401",1202,127,42,85,283,242,102,87,150,97,37,28,9,77
"2011","Oldham 009A","E01005397",1094,71,16,55,214,179,81,132,182,138,39,22,17,58
"2011","Oldham 009B","E01005398",1118,73,23,50,221,180,96,96,178,171,39,28,11,64
"2011","Oldham 009C","E01005400",1096,69,22,47,173,142,81,97,195,213,69,39,30,57
"2011","Oldham 009D","E01005402",1089,92,24,68,248,177,76,79,139,153,43,27,16,82
"2011","Oldham 010A","E01005335",1016,106,30,76,263,182,75,77,152,88,18,11,7,55
"2011","Oldham 010B","E01005337",1249,47,17,30,140,124,96,135,239,191,169,136,33,108
"2011","Oldham 010C","E01005339",1060,150,36,114,251,186,111,69,103,90,26,19,7,74
"2011","Oldham 010D","E01005340",1004,40,15,25,123,102,72,110,207,177,75,51,24,98
"2011","Oldham 011A","E01005421",1201,40,16,24,168,137,82,113,252,248,90,46,44,71
"2011","Oldham 011B","E01005422",964,14,3,11,106,96,41,78,203,211,127,96,31,88
"2011","Oldham 011E","E01032920",1376,42,8,34,148,145,100,113,334,314,103,65,38,77
"2011","Oldham 012A","E01005448",1029,24,6,18,117,96,75,74,232,246,110,69,41,55
"2011","Oldham 012B","E01005449",887,33,8,25,115,100,70,84,186,174,65,37,28,60
"2011","Oldham 012C","E01005454",1089,82,27,55,225,159,103,84,193,134,36,19,17,73
"2011","Oldham 012D","E01005455",1192,82,30,52,231,192,97,122,180,182,35,20,15,71
"2011","Oldham 012E","E01005456",1160,37,11,26,162,112,72,114,266,224,102,64,38,71
"2011","Oldham 013A","E01005407",1331,257,68,189,407,190,168,51,103,64,19,11,8,72
"2011","Oldham 013B","E01005412",1295,227,45,182,426,167,140,73,92,75,26,9,17,69
"2011","Oldham 013C","E01005416",1045,178,52,126,319,137,137,43,80,80,27,16,11,44
"2011","Oldham 013D","E01005417",1140,137,42,95,283,173,142,95,129,96,27,16,11,58
"2011","Oldham 014A","E01005348",1059,28,5,23,130,90,51,74,171,211,191,151,40,113
"2011","Oldham 014B","E01005350",1389,19,2,17,94,72,57,121,259,343,288,231,57,136
"2011","Oldham 014C","E01005432",1029,15,5,10,106,81,55,79,201,236,141,101,40,115
"2011","Oldham 014D","E01005433",1007,20,6,14,94,84,60,54,207,279,133,91,42,76
"2011","Oldham 015A","E01005329",1195,127,42,85,311,202,99,78,158,109,29,15,14,82
"2011","Oldham 015B","E01005330",1202,111,31,80,291,205,130,96,156,123,28,19,9,62
"2011","Oldham 015C","E01005333",1017,109,30,79,241,172,100,77,125,86,28,17,11,79
"2011","Oldham 015D","E01005336",1174,118,33,85,289,206,101,101,124,118,26,12,14,91
"2011","Oldham 016A","E01005349",1436,26,4,22,96,66,84,158,158,201,425,378,47,222
"2011","Oldham 016B","E01005351",1181,17,1,16,77,74,69,99,144,180,321,294,27,200
"2011","Oldham 016C","E01005352",924,28,1,27,67,59,55,104,125,177,219,180,39,90
"2011","Oldham 016D","E01005353",1293,16,1,15,62,84,64,111,193,245,357,300,57,161
"2011","Oldham 016E","E01005354",1174,62,9,53,141,146,69,107,159,169,192,163,29,129
"2011","Oldham 017A","E01005327",1325,100,25,75,252,223,98,114,181,175,87,70,17,95
"2011","Oldham 017B","E01005328",978,36,8,28,93,104,69,77,208,218,105,72,33,68
"2011","Oldham 017C","E01005331",1128,67,19,48,209,159,79,108,183,192,61,49,12,70
"2011","Oldham 017D","E01005334",1111,127,35,92,291,204,79,69,137,87,25,13,12,92
"2011","Oldham 017E","E01005338",1115,35,7,28,113,116,53,109,233,250,123,94,29,83
"2011","Oldham 018A","E01005387",1108,81,25,56,231,163,113,101,171,155,26,13,13,67
"2011","Oldham 018B","E01005388",980,50,16,34,208,162,82,90,155,138,30,17,13,65
"2011","Oldham 018C","E01005389",1166,85,26,59,186,126,84,93,220,195,102,68,34,75
"2011","Oldham 018D","E01005418",1139,131,34,97,276,195,126,101,127,88,16,7,9,79
"2011","Oldham 019A","E01005428",1121,23,4,19,74,95,144,56,143,207,269,232,37,110
"2011","Oldham 019B","E01005431",1196,53,17,36,202,150,79,96,220,206,116,85,31,74
"2011","Oldham 019C","E01005450",1108,22,1,21,121,109,103,74,213,197,181,150,31,88
"2011","Oldham 019D","E01005451",959,61,18,43,175,120,112,72,134,110,95,77,18,80
"2011","Oldham 020C","E01005408",1316,215,57,158,368,192,132,89,141,86,17,12,5,76
"2011","Oldham 020D","E01005409",1217,215,54,161,344,164,149,67,104,64,26,14,12,84
"2011","Oldham 020E","E01032922",1788,242,75,167,470,246,198,101,221,145,43,25,18,122
"2011","Oldham 021A","E01005406",1059,197,53,144,320,148,136,37,93,35,23,14,9,70
"2011","Oldham 021B","E01005413",1196,180,45,135,359,193,137,77,95,69,22,11,11,64
"2011","Oldham 021C","E01005419",1158,106,33,73,289,192,130,87,147,107,21,16,5,79
"2011","Oldham 021D","E01005420",1210,103,31,72,227,184,137,100,175,165,47,31,16,72
"2011","Oldham 022A","E01005321",1086,28,5,23,126,90,97,71,189,185,193,163,30,107
"2011","Oldham 022B","E01005326",1848,57,8,49,87,115,208,72,190,248,550,516,34,321
"2011","Oldham 022C","E01005427",1230,26,3,23,64,64,106,74,148,161,411,379,32,176
"2011","Oldham 022D","E01005429",1147,26,1,25,64,60,148,51,140,157,330,306,24,171
"2011","Oldham 022E","E01005430",1526,22,5,17,104,124,176,85,225,227,356,301,55,207
"2011","Oldham 024A","E01005320",1233,41,12,29,110,88,106,91,213,216,226,178,48,142
"2011","Oldham 024B","E01005434",978,29,8,21,82,60,84,82,200,209,161,119,42,71
"2011","Oldham 024C","E01005437",1263,53,5,48,129,103,126,78,180,196,221,196,25,177
"2011","Oldham 024D","E01005459",841,14,0,14,47,58,81,48,111,124,234,208,26,124
"2011","Oldham 026A","E01005383",1286,56,12,44,170,151,90,88,233,221,170,139,31,107
"2011","Oldham 026D","E01005386",964,33,12,21,120,82,70,81,189,185,126,87,39,78
"2011","Oldham 026E","E01032556",1084,91,28,63,248,175,90,98,186,123,31,27,4,42
"2011","Oldham 026F","E01032557",1124,25,9,16,114,91,67,90,267,262,139,106,33,69
"2011","Oldham 027A","E01005342",934,27,10,17,109,126,57,69,199,193,95,63,32,59
"2011","Oldham 027B","E01005343",971,40,8,32,122,139,51,98,179,215,67,45,22,60
"2011","Oldham 027C","E01005344",1073,41,13,28,140,137,58,89,217,237,87,60,27,67
"2011","Oldham 027D","E01005381",1016,24,8,16,101,87,97,87,183,197,151,117,34,89
"2011","Oldham 028A","E01005332",1625,87,27,60,253,237,118,140,274,285,103,73,30,128
"2011","Oldham 028B","E01005341",1080,58,10,48,178,156,74,105,204,176,56,31,25,73
"2011","Oldham 028C","E01005345",1107,77,22,55,216,202,93,90,171,137,48,32,16,73
"2011","Oldham 028D","E01005346",1084,72,20,52,211,212,69,112,153,140,50,34,16,65
"2011","Oldham 028E","E01005347",980,59,14,45,152,177,69,86,174,164,37,21,16,62
"2011","Oldham 029A","E01005322",888,20,5,15,52,62,45,60,197,206,142,108,34,104
"2011","Oldham 029B","E01005323",1005,36,14,22,120,128,66,93,228,217,58,34,24,59
"2011","Oldham 029C","E01005324",997,20,9,11,99,92,42,76,238,242,106,69,37,82
"2011","Oldham 029D","E01005325",668,12,5,7,55,39,40,66,155,151,88,48,40,62
"2011","Oldham 029E","E01005438",1628,99,25,74,228,160,148,148,318,275,140,108,32,112
"2011","Oldham 030A","E01005377",943,13,5,8,72,81,57,80,189,221,131,87,44,99
"2011","Oldham 030B","E01005379",808,19,3,16,58,83,31,59,217,184,86,52,34,71
"2011","Oldham 030C","E01005380",1017,75,16,59,121,99,64,70,176,202,110,75,35,100
"2011","Oldham 030D","E01005382",1041,42,18,24,89,111,61,83,228,241,107,76,31,79
"2011","Oldham 030E","E01005439",1089,68,21,47,191,180,113,93,177,147,50,33,17,70
"2011","Oldham 031A","E01005362",1119,60,15,45,194,186,90,111,191,173,39,24,15,75
"2011","Oldham 031B","E01005364",1227,67,19,48,230,217,115,103,197,169,38,22,16,91
"2011","Oldham 031C","E01005368",1140,45,15,30,160,187,92,94,223,203,54,31,23,82
"2011","Oldham 031D","E01005376",888,31,10,21,104,110,59,80,183,195,68,41,27,58
"2011","Oldham 031E","E01005378",1119,46,16,30,161,134,84,106,250,203,64,35,29,71
"2011","Oldham 032A","E01005363",1132,62,19,43,175,202,117,90,178,159,64,37,27,85
"2011","Oldham 032B","E01005369",1077,50,8,42,150,173,54,85,213,192,96,64,32,64
"2011","Oldham 032C","E01005370",1010,40,9,31,120,130,79,70,220,210,78,55,23,63
"2011","Oldham 032D","E01005371",974,42,10,32,158,165,71,70,189,151,60,40,20,68
"2011","Oldham 033A","E01005365",1122,110,29,81,253,178,134,86,152,117,20,13,7,72
"2011","Oldham 033B","E01005366",1069,39,15,24,170,166,68,90,204,201,62,41,21,69
"2011","Oldham 033C","E01005367",1076,103,31,72,257,189,138,81,127,99,17,14,3,65
"2011","Oldham 033D","E01005440",1034,69,18,51,190,130,94,117,176,148,47,22,25,63
"2011","Oldham 034A","E01005372",854,36,6,30,137,136,88,68,143,127,44,17,27,75
"2011","Oldham 034B","E01005373",887,64,19,45,165,173,82,79,138,113,19,8,11,54
"2011","Oldham 034C","E01005374",1031,50,11,39,192,155,63,100,186,177,57,37,20,51
"2011","Oldham 034D","E01005375",1054,74,16,58,205,192,100,112,175,104,20,12,8,72
"2011","Oldham 035A","E01005435",1232,26,5,21,103,116,142,85,166,172,251,217,34,171
"2011","Oldham 035B","E01005436",1131,83,11,72,166,121,106,61,150,149,148,135,13,147
"2011","Oldham 035C","E01005460",1538,41,5,36,138,153,137,95,248,235,319,282,37,172
"2011","Oldham 035D","E01005461",1531,47,6,41,121,103,176,74,195,159,414,379,35,242
"2011","Oldham 035E","E01005462",1251,99,19,80,176,133,133,52,139,127,203,180,23,189
"2011","Oldham 035F","E01005463",746,20,5,15,50,35,76,43,105,153,192,180,12,72
"2011","Oldham 035G","E01032921",1730,42,11,31,139,136,176,76,234,253,464,408,56,210
"2011","Rochdale 001A","E01005518",1055,72,19,53,219,108,125,94,151,150,58,34,24,78
"2011","Rochdale 001B","E01005520",1285,148,35,113,273,179,121,106,184,149,51,26,25,74
"2011","Rochdale 001C","E01005522",973,62,16,46,190,138,83,97,174,131,41,24,17,57
"2011","Rochdale 001D","E01005523",1416,137,42,95,324,187,138,94,219,190,33,19,14,94
"2011","Rochdale 002A","E01005519",1131,94,19,75,278,161,99,98,160,138,27,15,12,76
"2011","Rochdale 002B","E01005594",1100,81,31,50,234,154,98,75,186,146,39,23,16,87
"2011","Rochdale 002C","E01005597",1182,112,47,65,307,179,122,93,147,122,28,19,9,72
"2011","Rochdale 002D","E01005598",1208,126,25,101,315,200,110,90,136,128,21,12,9,82
"2011","Rochdale 003A","E01005516",1051,109,32,77,285,155,121,81,124,89,19,8,11,68
"2011","Rochdale 003B","E01005517",1133,134,39,95,311,173,97,81,146,93,36,20,16,62
"2011","Rochdale 003C","E01005521",1077,113,33,80,320,147,122,70,125,106,21,16,5,53
"2011","Rochdale 003D","E01005596",1417,156,40,116,347,222,151,98,176,128,50,43,7,89
"2011","Rochdale 004A","E01005578",930,32,4,28,92,77,84,70,154,140,166,140,26,115
"2011","Rochdale 004B","E01005579",1036,8,3,5,60,78,95,66,201,208,219,173,46,101
"2011","Rochdale 004C","E01005586",1039,21,7,14,91,87,69,79,213,252,161,120,41,66
"2011","Rochdale 004D","E01005593",1064,49,19,30,180,124,63,81,187,183,94,57,37,103
"2011","Rochdale 004E","E01005595",1004,44,17,27,127,131,87,80,188,186,100,68,32,61
"2011","Rochdale 005A","E01005489",875,89,28,61,205,160,101,49,106,79,30,20,10,56
"2011","Rochdale 005B","E01005490",1168,32,12,20,116,87,116,91,207,262,181,150,31,76
"2011","Rochdale 005C","E01005491",1080,102,33,69,227,144,101,65,171,155,49,34,15,66
"2011","Rochdale 005D","E01005493",1240,177,40,137,343,185,142,66,119,78,33,23,10,97
"2011","Rochdale 005E","E01005494",1265,131,45,86,262,185,111,86,165,135,76,54,22,114
"2011","Rochdale 005F","E01005495",1176,84,29,55,212,168,123,83,183,134,95,75,20,94
"2011","Rochdale 006A","E01005488",1118,148,38,110,345,188,104,64,98,65,35,24,11,71
"2011","Rochdale 006B","E01005492",1174,141,36,105,304,193,118,75,131,83,42,32,10,87
"2011","Rochdale 006C","E01005499",1153,102,30,72,272,167,153,79,154,131,36,19,17,59
"2011","Rochdale 006D","E01005571",1218,143,41,102,354,193,136,75,120,83,35,23,12,79
"2011","Rochdale 007A","E01005570",943,126,28,98,283,149,100,51,90,66,20,12,8,58
"2011","Rochdale 007B","E01005572",1212,158,42,116,304,200,129,65,130,103,33,26,7,90
"2011","Rochdale 007C","E01005573",1090,159,43,116,315,151,123,53,90,73,32,28,4,94
"2011","Rochdale 007D","E01005574",1273,217,53,164,373,153,171,47,101,55,60,47,13,96
"2011","Rochdale 007E","E01005587",1086,171,32,139,334,154,107,37,86,53,32,22,10,112
"2011","Rochdale 007F","E01005588",944,71,17,54,193,137,72,65,148,123,67,49,18,68
"2011","Rochdale 008A","E01005580",1081,43,6,37,132,117,104,78,161,189,155,122,33,102
"2011","Rochdale 008B","E01005581",1030,24,3,21,98,73,79,87,168,202,211,180,31,88
"2011","Rochdale 008D","E01005583",1141,26,2,24,76,96,85,64,113,181,347,324,23,153
"2011","Rochdale 008F","E01005585",982,20,3,17,121,90,84,88,133,140,205,177,28,101
"2011","Rochdale 008G","E01033258",1979,50,7,43,148,150,171,109,255,295,526,478,48,275
"2011","Rochdale 009A","E01005496",977,26,6,20,103,79,74,66,211,219,115,81,34,84
"2011","Rochdale 009B","E01005589",1149,68,24,44,237,161,133,82,189,138,71,50,21,70
"2011","Rochdale 009C","E01005590",1115,45,9,36,144,109,125,64,161,155,188,163,25,124
"2011","Rochdale 009D","E01005591",1014,99,25,74,254,139,98,77,139,104,36,31,5,68
"2011","Rochdale 009E","E01005592",1060,45,10,35,142,96,99,78,174,167,150,101,49,109
"2011","Rochdale 010A","E01005472",1048,35,11,24,126,115,75,77,213,207,125,102,23,75
"2011","Rochdale 010B","E01005473",1030,44,7,37,123,92,94,72,154,139,178,155,23,134
"2011","Rochdale 010C","E01005482",1630,29,8,21,156,113,90,110,295,396,321,226,95,120
"2011","Rochdale 010D","E01005483",1370,36,7,29,117,98,117,83,203,305,273,215,58,138
"2011","Rochdale 010E","E01005484",1499,36,4,32,95,94,107,76,198,295,425,340,85,173
"2011","Rochdale 010F","E01005486",1044,15,2,13,123,92,92,78,192,160,188,156,32,104
"2011","Rochdale 010G","E01005487",1161,60,13,47,153,97,111,66,189,158,197,174,23,130
"2011","Rochdale 011A","E01005474",891,73,10,63,188,121,93,56,127,105,71,60,11,57
"2011","Rochdale 011B","E01005575",1188,201,53,148,327,193,128,61,102,53,50,35,15,73
"2011","Rochdale 011C","E01005576",1106,248,63,185,290,153,128,40,67,40,57,54,3,83
"2011","Rochdale 011D","E01005577",1072,176,43,133,357,141,126,44,74,47,24,19,5,83
"2011","Rochdale 012A","E01005469",1299,69,19,50,229,197,133,116,219,161,59,37,22,116
"2011","Rochdale 012B","E01005563",1210,32,9,23,147,123,113,77,199,187,175,148,27,157
"2011","Rochdale 012C","E01005565",1095,50,8,42,156,96,93,75,175,208,141,101,40,101
"2011","Rochdale 012D","E01005566",1440,77,13,64,221,157,120,100,237,226,167,127,40,135
"2011","Rochdale 012E","E01005568",1129,20,6,14,58,79,60,59,188,218,319,256,63,128
"2011","Rochdale 012F","E01005569",1123,29,5,24,123,123,83,66,211,212,148,112,36,128
"2011","Rochdale 013A","E01005556",1190,104,23,81,274,197,110,85,170,140,37,18,19,73
"2011","Rochdale 013B","E01005559",1101,68,18,50,195,113,77,69,233,176,96,66,30,74
"2011","Rochdale 013C","E01005560",1148,103,28,75,255,173,122,97,163,120,42,23,19,73
"2011","Rochdale 013D","E01005567",1110,63,16,47,198,160,108,93,182,165,74,43,31,67
"2011","Rochdale 014A","E01005555",1043,98,31,67,254,154,108,96,136,93,20,15,5,84
"2011","Rochdale 014B","E01005557",933,75,21,54,239,151,86,66,137,89,31,22,9,59
"2011","Rochdale 014C","E01005558",1240,87,22,65,267,183,112,107,199,173,47,27,20,65
"2011","Rochdale 014D","E01005561",1034,96,31,65,250,144,112,83,147,124,24,17,7,54
"2011","Rochdale 014E","E01005562",1116,73,21,52,198,167,121,99,179,156,50,34,16,73
"2011","Rochdale 015A","E01005470",1141,38,6,32,92,95,127,53,139,176,262,237,25,159
"2011","Rochdale 015B","E01005471",1096,41,11,30,113,122,104,59,158,182,201,164,37,116
"2011","Rochdale 015C","E01005475",1140,42,11,31,119,129,113,57,162,192,203,170,33,123
"2011","Rochdale 015D","E01005485",1524,57,4,53,134,108,171,63,167,189,393,359,34,242
"2011","Rochdale 015E","E01005564",1292,46,9,37,108,128,118,75,167,187,285,247,38,178
"2011","Rochdale 016A","E01005464",1161,36,7,29,91,88,86,97,214,249,194,138,56,106
"2011","Rochdale 016B","E01005465",1234,91,32,59,275,167,105,93,179,151,69,42,27,104
"2011","Rochdale 016C","E01005466",1630,37,15,22,134,147,73,120,344,397,242,181,61,136
"2011","Rochdale 016D","E01005467",1215,25,9,16,123,106,70,90,289,250,182,113,69,80
"2011","Rochdale 016E","E01005468",1167,142,38,104,326,181,137,55,122,89,36,27,9,79
"2011","Rochdale 017A","E01005476",1210,68,17,51,236,183,106,114,194,168,72,49,23,69
"2011","Rochdale 017B","E01005477",1231,64,17,47,167,164,95,97,205,234,117,65,52,88
"2011","Rochdale 017C","E01005478",1186,64,19,45,196,197,118,89,180,182,73,44,29,87
"2011","Rochdale 017D","E01005479",1299,83,25,58,242,183,153,92,194,177,86,60,26,89
"2011","Rochdale 017E","E01005480",1188,91,15,76,192,151,93,99,222,186,75,59,16,79
"2011","Rochdale 017F","E01005481",1158,57,24,33,194,149,109,75,200,170,108,89,19,96
"2011","Rochdale 018A","E01005497",1126,47,17,30,131,139,84,78,200,227,119,80,39,101
"2011","Rochdale 018B","E01005501",1099,42,6,36,173,113,76,85,212,242,108,65,43,48
"2011","Rochdale 018C","E01005502",1127,39,13,26,165,171,91,117,211,193,91,56,35,49
"2011","Rochdale 018D","E01005504",1084,48,14,34,172,153,89,77,214,172,77,48,29,82
"2011","Rochdale 018E","E01005505",1272,49,8,41,170,173,121,109,222,274,80,46,34,74
"2011","Rochdale 018F","E01005509",1370,36,13,23,143,133,85,95,274,374,148,88,60,82
"2011","Rochdale 019A","E01005510",886,68,19,49,170,159,84,95,125,123,13,11,2,49
"2011","Rochdale 019B","E01005511",953,64,15,49,176,178,73,87,181,115,33,26,7,46
"2011","Rochdale 019C","E01005512",1155,63,14,49,197,152,99,103,172,227,82,49,33,60
"2011","Rochdale 019D","E01005513",954,26,4,22,102,96,60,65,213,220,121,77,44,51
"2011","Rochdale 019E","E01005514",1102,43,18,25,141,145,91,88,206,238,73,45,28,77
"2011","Rochdale 019F","E01005515",1154,26,5,21,103,107,62,84,259,280,143,88,55,90
"2011","Rochdale 020A","E01005498",1078,43,12,31,173,141,95,78,179,214,76,47,29,79
"2011","Rochdale 020B","E01005500",1178,81,24,57,252,156,138,85,172,159,61,37,24,74
"2011","Rochdale 020C","E01005503",1017,124,40,84,240,188,89,72,116,91,27,11,16,70
"2011","Rochdale 020D","E01005506",1124,50,13,37,179,166,93,100,177,202,80,52,28,77
"2011","Rochdale 020E","E01005507",1187,58,14,44,222,195,91,82,185,221,55,30,25,78
"2011","Rochdale 020F","E01005508",1412,172,51,121,327,222,177,104,164,93,42,29,13,111
"2011","Rochdale 021A","E01005524",1132,78,17,61,214,179,99,90,180,148,68,44,24,76
"2011","Rochdale 021B","E01005525",1150,42,11,31,143,124,87,88,219,253,117,70,47,77
"2011","Rochdale 021C","E01005526",1167,71,13,58,167,157,104,84,216,196,88,55,33,84
"2011","Rochdale 021D","E01005528",1073,48,10,38,141,130,85,95,213,204,81,44,37,76
"2011","Rochdale 021E","E01005536",1166,72,19,53,175,163,84,102,216,188,76,48,28,90
"2011","Rochdale 021F","E01005543",970,65,15,50,194,153,96,78,151,125,30,21,9,78
"2011","Rochdale 022A","E01005527",1058,20,4,16,110,101,70,83,212,250,117,66,51,95
"2011","Rochdale 022B","E01005529",1176,33,8,25,120,107,57,110,252,283,130,87,43,84
"2011","Rochdale 022C","E01005551",1206,51,9,42,159,123,78,91,218,261,153,115,38,72
"2011","Rochdale 022D","E01005552",1360,40,13,27,130,102,56,127,302,306,201,146,55,96
"2011","Rochdale 022E","E01005553",1326,44,16,28,145,136,95,112,264,290,135,99,36,105
"2011","Rochdale 022F","E01005554",1007,97,26,71,196,156,112,75,140,130,40,25,15,61
"2011","Rochdale 023A","E01005534",1094,54,14,40,184,161,91,100,170,170,52,31,21,112
"2011","Rochdale 023B","E01005535",1243,71,17,54,200,178,97,123,190,198,76,43,33,110
"2011","Rochdale 023C","E01005537",1097,76,17,59,198,191,93,112,162,185,19,9,10,61
"2011","Rochdale 023D","E01005538",1034,39,13,26,128,136,67,96,194,219,77,46,31,78
"2011","Rochdale 023E","E01005540",1048,62,14,48,178,176,78,96,170,183,49,32,17,56
"2011","Rochdale 023F","E01005541",1231,65,23,42,185,195,88,96,222,248,57,35,22,75
"2011","Rochdale 023G","E01005542",928,42,13,29,109,140,75,77,158,212,66,44,22,49
"2011","Rochdale 024A","E01005533",1273,116,30,86,250,226,98,90,151,207,68,41,27,67
"2011","Rochdale 024B","E01005539",1044,55,17,38,144,160,61,96,185,215,81,55,26,47
"2011","Rochdale 024C","E01005546",948,73,20,53,144,147,103,73,159,152,43,23,20,54
"2011","Rochdale 024D","E01005547",1087,45,11,34,163,188,98,115,188,154,73,43,30,63
"2011","Rochdale 024E","E01005548",964,54,12,42,165,144,70,70,143,178,79,42,37,61
"2011","Rochdale 025A","E01005530",996,118,32,86,230,186,81,84,112,98,16,10,6,71
"2011","Rochdale 025B","E01005531",866,43,10,33,185,142,68,80,137,122,32,24,8,57
"2011","Rochdale 025C","E01005532",1028,41,12,29,118,118,81,75,205,218,99,62,37,73
"2011","Rochdale 025D","E01005544",1054,119,32,87,266,189,96,79,116,85,25,12,13,79
"2011","Rochdale 025E","E01005545",865,120,27,93,210,177,76,53,77,66,23,17,6,63
"2011","Rochdale 025F","E01005549",1124,178,48,130,303,187,136,53,84,59,36,25,11,88
"2011","Rochdale 025G","E01005550",983,99,29,70,224,197,83,66,120,105,28,17,11,61
"2011","Salford 001A","E01005659",1024,28,11,17,128,142,79,105,193,183,83,54,29,83
"2011","Salford 001B","E01005660",949,21,5,16,99,95,72,79,215,203,103,69,34,62
"2011","Salford 001C","E01005663",988,37,5,32,150,134,81,95,188,168,74,46,28,61
"2011","Salford 001D","E01005664",987,25,8,17,83,73,51,51,234,233,150,94,56,87
"2011","Salford 001E","E01005665",969,17,7,10,81,87,49,84,190,223,149,102,47,89
"2011","Salford 002A","E01005703",1096,27,8,19,111,139,86,67,232,210,147,91,56,77
"2011","Salford 002B","E01005704",1039,39,13,26,133,151,85,95,219,179,66,47,19,72
"2011","Salford 002C","E01005706",996,27,8,19,120,141,63,90,218,174,95,60,35,68
"2011","Salford 002D","E01005708",1076,55,22,33,158,172,74,87,204,165,92,59,33,69
"2011","Salford 003A","E01005702",1566,77,19,58,267,271,139,107,275,204,111,77,34,115
"2011","Salford 003B","E01005705",1371,98,20,78,288,216,101,113,228,180,65,41,24,82
"2011","Salford 003C","E01005707",1194,49,10,39,180,173,64,85,240,219,117,67,50,67
"2011","Salford 004A","E01005661",1226,76,24,52,225,142,80,100,232,169,120,85,35,82
"2011","Salford 004B","E01005662",977,16,6,10,90,109,56,68,209,201,161,114,47,67
"2011","Salford 004C","E01005709",975,20,8,12,97,102,53,82,211,204,132,79,53,74
"2011","Salford 004D","E01005710",1123,96,16,80,223,180,99,77,155,154,69,48,21,70
"2011","Salford 005A","E01005670",1202,62,18,44,165,184,80,102,203,207,110,68,42,89
"2011","Salford 005B","E01005672",1057,76,22,54,191,220,72,84,181,117,56,35,21,60
"2011","Salford 005C","E01005676",990,102,25,77,230,192,84,71,132,85,28,23,5,66
"2011","Salford 005D","E01005677",1129,85,18,67,198,204,95,107,166,151,46,30,16,77
"2011","Salford 006A","E01005686",1081,61,13,48,156,192,68,85,211,142,79,53,26,87
"2011","Salford 006B","E01005688",1127,68,12,56,163,225,89,76,210,161,62,37,25,73
"2011","Salford 006C","E01005691",1091,67,16,51,228,218,92,86,191,108,36,24,12,65
"2011","Salford 006D","E01005692",980,35,10,25,150,130,77,95,189,172,80,53,27,52
"2011","Salford 007A","E01005711",1143,99,20,79,262,198,115,75,179,111,31,14,17,73
"2011","Salford 007B","E01005712",1224,82,24,58,216,193,108,95,206,165,66,42,24,93
"2011","Salford 007C","E01005713",1079,132,37,95,296,203,89,64,130,72,25,17,8,68
"2011","Salford 007D","E01005714",1028,60,7,53,182,157,90,71,178,161,60,38,22,69
"2011","Salford 007E","E01005715",1208,179,41,138,357,184,118,79,111,59,38,20,18,83
"2011","Salford 007F","E01005718",1291,103,30,73,259,250,113,103,192,152,35,19,16,84
"2011","Salford 008A","E01005673",1102,77,21,56,223,205,77,90,175,132,59,35,24,64
"2011","Salford 008B","E01005675",2119,121,22,99,300,256,206,158,283,431,254,213,41,110
"2011","Salford 008C","E01005678",1095,41,4,37,141,133,53,93,221,215,108,79,29,90
"2011","Salford 008D","E01005679",1077,19,6,13,129,139,65,87,223,210,136,79,57,69
"2011","Salford 009A","E01005687",1274,93,22,71,288,208,107,101,203,152,58,36,22,64
"2011","Salford 009B","E01005689",935,24,6,18,132,126,46,68,169,176,117,83,34,77
"2011","Salford 009C","E01005690",1180,74,17,57,245,198,95,89,194,145,70,58,12,70
"2011","Salford 009D","E01005693",1056,56,17,39,206,223,78,74,183,144,32,17,15,60
"2011","Salford 010A","E01005646",894,107,33,74,200,136,111,21,58,66,97,82,15,98
"2011","Salford 010B","E01005649",1035,160,23,137,286,134,113,18,81,53,94,78,16,96
"2011","Salford 010C","E01005650",954,77,16,61,161,117,89,61,122,108,107,84,23,112
"2011","Salford 010D","E01005651",1146,80,22,58,213,160,86,50,127,79,158,136,22,193
"2011","Salford 011A","E01005647",1156,113,15,98,250,157,123,43,98,81,48,36,12,243
"2011","Salford 011B","E01005648",1396,181,30,151,319,194,168,94,144,129,67,50,17,100
"2011","Salford 011C","E01005652",980,35,8,27,143,144,73,92,189,161,87,70,17,56
"2011","Salford 011D","E01005653",1073,20,3,17,110,116,48,77,210,205,167,131,36,120
"2011","Salford 012A","E01005671",1069,56,9,47,180,150,70,89,197,207,60,44,16,60
"2011","Salford 012B","E01005674",1051,68,11,57,195,144,75,92,178,144,73,48,25,82
"2011","Salford 012C","E01005694",1240,130,29,101,280,235,97,94,180,117,37,19,18,70
"2011","Salford 012D","E01005696",1132,105,33,72,299,185,83,77,155,104,36,23,13,88
"2011","Salford 012E","E01005698",1147,43,12,31,152,166,78,91,174,233,123,78,45,87
"2011","Salford 012F","E01005700",1158,82,18,64,240,204,104,85,177,137,58,34,24,71
"2011","Salford 013A","E01005716",1351,274,64,210,363,235,101,82,116,52,29,19,10,99
"2011","Salford 013B","E01005717",1124,260,52,208,345,162,99,38,83,43,18,12,6,76
"2011","Salford 013C","E01005734",994,124,26,98,245,161,93,66,128,77,34,25,9,66
"2011","Salford 013D","E01005735",1035,149,37,112,290,191,85,70,102,63,18,9,9,67
"2011","Salford 013E","E01005736",1115,126,30,96,305,189,103,75,137,95,29,20,9,56
"2011","Salford 013F","E01005737",1101,232,57,175,322,162,122,51,75,47,24,19,5,66
"2011","Salford 013G","E01005739",1132,211,45,166,324,178,106,56,107,46,26,13,13,78
"2011","Salford 014A","E01005695",1119,172,40,132,339,189,111,68,94,60,16,12,4,70
"2011","Salford 014B","E01005697",1128,147,32,115,299,217,105,75,119,67,31,15,16,68
"2011","Salford 014C","E01005738",1250,248,55,193,387,206,134,58,92,43,26,13,13,56
"2011","Salford 014D","E01005740",1125,222,52,170,371,177,109,43,88,49,9,2,7,57
"2011","Salford 014E","E01005741",1188,253,58,195,361,163,120,43,99,46,22,10,12,81
"2011","Salford 014F","E01005742",1158,153,38,115,324,197,93,73,130,84,20,11,9,84
"2011","Salford 015A","E01005625",979,81,14,67,204,193,73,85,162,91,28,15,13,62
"2011","Salford 015B","E01005627",871,60,15,45,191,164,77,83,134,77,18,11,7,67
"2011","Salford 015C","E01005699",1097,75,20,55,241,208,85,78,172,138,26,14,12,74
"2011","Salford 015D","E01005701",1179,109,25,84,275,199,106,88,159,109,41,31,10,93
"2011","Salford 016A","E01005609",1366,72,17,55,205,180,67,93,230,206,156,127,29,157
"2011","Salford 016B","E01005611",1500,44,7,37,181,147,85,98,253,260,166,135,31,266
"2011","Salford 016C","E01005612",1348,43,8,35,180,138,88,83,219,254,244,200,44,99
"2011","Salford 016D","E01005613",1568,50,4,46,150,114,98,104,274,288,280,218,62,210
"2011","Salford 016E","E01005614",985,57,12,45,183,124,80,35,136,99,150,128,22,121
"2011","Salford 016F","E01005615",1334,54,11,43,153,117,95,90,215,203,220,177,43,187
"2011","Salford 017A","E01005624",1170,38,6,32,144,148,58,83,243,225,132,101,31,99
"2011","Salford 017B","E01005680",1095,33,5,28,119,119,55,63,212,201,166,125,41,127
"2011","Salford 017C","E01005683",1144,19,4,15,91,108,57,98,242,244,171,138,33,114
"2011","Salford 017F","E01032919",3110,41,6,35,123,161,70,122,277,310,199,147,52,1807
"2011","Salford 018A","E01005622",1059,111,27,84,238,193,62,66,143,119,45,25,20,82
"2011","Salford 018B","E01005623",981,100,25,75,258,155,78,68,99,79,34,25,9,110
"2011","Salford 018C","E01005626",980,85,18,67,204,174,81,89,122,100,40,32,8,85
"2011","Salford 018D","E01005628",1272,100,19,81,240,179,100,71,162,122,72,58,14,226
"2011","Salford 019A","E01005725",931,17,6,11,111,105,60,61,175,200,123,95,28,79
"2011","Salford 019B","E01005726",1088,65,20,45,185,184,60,88,183,166,65,48,17,92
"2011","Salford 019C","E01005727",1057,103,31,72,226,152,62,84,152,146,60,36,24,72
"2011","Salford 019D","E01005728",991,63,20,43,207,182,82,90,173,117,28,14,14,49
"2011","Salford 019E","E01005733",946,55,15,40,123,116,51,75,179,156,111,93,18,80
"2011","Salford 020A","E01005631",1177,100,23,77,187,123,97,109,172,221,123,102,21,45
"2011","Salford 020B","E01005632",1528,139,25,114,309,211,106,112,214,153,139,116,23,145
"2011","Salford 020C","E01005633",1005,44,17,27,163,144,87,89,172,153,74,61,13,79
"2011","Salford 020D","E01005634",1124,215,42,173,330,180,70,56,111,68,23,18,5,71
"2011","Salford 020E","E01005635",1177,188,33,155,298,154,98,76,120,93,65,45,20,85
"2011","Salford 020F","E01005636",1158,241,52,189,301,159,107,54,92,62,50,34,16,92
"2011","Salford 020G","E01005637",1011,115,17,98,213,157,78,92,126,112,60,38,22,58
"2011","Salford 021A","E01005629",967,93,24,69,227,145,83,61,142,95,54,39,15,67
"2011","Salford 021B","E01005630",1069,93,17,76,243,155,69,90,185,121,39,26,13,74
"2011","Salford 021C","E01005719",1377,121,12,109,245,180,83,88,202,205,99,69,30,154
"2011","Salford 021D","E01005720",1824,95,21,74,339,287,89,120,294,273,148,118,30,179
"2011","Salford 021E","E01005722",1257,50,11,39,171,189,80,73,224,207,130,93,37,133
"2011","Salford 021F","E01005723",1045,38,9,29,138,143,61,78,200,187,93,79,14,107
"2011","Salford 021G","E01005724",1076,125,31,94,286,179,89,76,126,85,38,24,14,72
"2011","Salford 022D","E01005610",923,5,1,4,58,51,29,43,145,180,110,97,13,302
"2011","Salford 022E","E01032684",1651,91,7,84,205,103,57,82,99,113,57,42,15,844
"2011","Salford 022F","E01032687",1241,210,20,190,287,159,45,93,102,69,41,24,17,235
"2011","Salford 022G","E01032906",1141,108,14,94,233,122,28,78,138,106,100,61,39,228
"2011","Salford 022H","E01032907",1043,71,10,61,184,135,34,54,140,145,75,43,32,205
"2011","Salford 022I","E01032909",1295,295,51,244,385,163,53,41,64,26,28,20,8,240
"2011","Salford 022J","E01032911",1081,178,22,156,317,150,39,74,66,46,38,27,11,173
"2011","Salford 022K","E01033330",1154,49,8,41,185,130,97,82,181,175,160,129,31,95
"2011","Salford 023A","E01005654",1171,110,18,92,295,182,48,77,171,146,63,42,21,79
"2011","Salford 023B","E01005656",1101,45,10,35,156,147,64,83,211,186,98,74,24,111
"2011","Salford 023C","E01005657",1074,50,15,35,156,142,57,68,208,199,93,68,25,101
"2011","Salford 023D","E01005721",1096,38,9,29,142,152,61,76,213,178,61,44,17,175
"2011","Salford 024A","E01005655",1078,31,1,30,104,97,41,72,180,170,173,128,45,210
"2011","Salford 024B","E01005658",999,20,6,14,65,100,36,84,210,236,155,124,31,93
"2011","Salford 024C","E01005681",1404,13,2,11,64,74,45,60,142,195,101,79,22,710
"2011","Salford 024D","E01005682",1229,39,4,35,121,134,44,78,256,265,205,145,60,87
"2011","Salford 025A","E01005729",987,33,6,27,111,84,53,79,194,214,150,93,57,69
"2011","Salford 025B","E01005730",1208,72,21,51,231,199,83,101,200,177,45,30,15,100
"2011","Salford 025C","E01005731",1062,17,7,10,124,110,73,75,217,215,112,72,40,119
"2011","Salford 025D","E01005732",869,37,11,26,117,142,60,65,171,168,52,35,17,57
"2011","Salford 026A","E01005599",1230,45,10,35,169,149,95,105,211,244,137,88,49,75
"2011","Salford 026B","E01005600",1074,66,14,52,174,153,67,79,210,156,84,64,20,85
"2011","Salford 026C","E01005601",1077,26,6,20,136,136,65,87,238,184,109,77,32,96
"2011","Salford 026D","E01005602",1058,55,24,31,135,159,60,73,202,190,132,75,57,52
"2011","Salford 027A","E01005603",1140,51,12,39,178,170,78,124,201,150,83,56,27,105
"2011","Salford 027B","E01005604",1136,61,19,42,176,204,67,92,228,190,65,40,25,53
"2011","Salford 027C","E01005605",1065,55,18,37,175,184,69,92,189,174,69,42,27,58
"2011","Salford 027D","E01005638",1169,72,10,62,196,160,83,110,194,193,106,69,37,55
"2011","Salford 028B","E01005667",1369,77,10,67,190,171,64,89,181,264,199,151,48,134
"2011","Salford 028E","E01032685",1425,409,60,349,453,155,74,43,66,34,47,31,16,144
"2011","Salford 028F","E01032686",1357,269,36,233,395,226,50,53,110,53,27,14,13,174
"2011","Salford 028G","E01032912",1144,70,9,61,153,114,50,77,197,234,124,105,19,125
"2011","Salford 028H","E01032914",1476,204,28,176,357,215,66,91,163,120,67,45,22,193
"2011","Salford 028I","E01032915",1126,66,10,56,145,137,36,66,208,181,134,101,33,153
"2011","Salford 028J","E01032917",937,103,16,87,260,114,36,46,118,72,60,39,21,128
"2011","Salford 029A","E01005639",980,25,10,15,88,105,59,90,218,180,138,90,48,77
"2011","Salford 029B","E01005640",978,33,9,24,117,118,65,95,200,170,97,59,38,83
"2011","Salford 029C","E01005641",1014,30,10,20,147,159,74,96,215,180,53,25,28,60
"2011","Salford 029D","E01005642",910,87,20,67,185,163,89,80,131,85,23,13,10,67
"2011","Salford 029E","E01005643",1009,56,18,38,191,193,63,103,169,143,29,19,10,62
"2011","Salford 029F","E01005644",1184,90,26,64,250,209,83,110,202,140,38,17,21,62
"2011","Salford 029G","E01005645",1118,87,29,58,208,215,83,114,185,128,22,14,8,76
"2011","Salford 030A","E01005616",1044,31,9,22,128,148,65,109,217,205,67,48,19,74
"2011","Salford 030B","E01005617",1131,77,12,65,192,203,86,114,195,174,30,24,6,60
"2011","Salford 030C","E01005618",1028,51,12,39,141,150,77,106,198,192,61,41,20,52
"2011","Salford 030D","E01005619",959,54,14,40,127,116,80,113,165,182,63,43,20,59
"2011","Salford 030E","E01005620",1840,183,42,141,410,284,140,158,281,206,61,36,25,117
"2011","Salford 030F","E01005621",1211,75,16,59,208,195,91,114,195,191,68,47,21,74
"2011","Stockport 001A","E01005886",1124,62,18,44,191,168,99,91,198,176,70,38,32,69
"2011","Stockport 001B","E01005888",1098,69,12,57,193,198,92,84,180,140,54,32,22,88
"2011","Stockport 001C","E01005889",1030,63,20,43,173,168,71,85,203,151,57,40,17,59
"2011","Stockport 001D","E01005891",1041,87,23,64,196,236,99,74,155,112,24,17,7,58
"2011","Stockport 001E","E01005894",1044,52,13,39,182,174,98,87,194,163,30,14,16,64
"2011","Stockport 002A","E01005887",1040,66,20,46,154,150,93,74,176,157,91,60,31,79
"2011","Stockport 002B","E01005890",1022,42,5,37,172,148,83,69,202,148,78,54,24,80
"2011","Stockport 002C","E01005893",1288,74,26,48,268,191,134,104,216,183,48,21,27,70
"2011","Stockport 002D","E01005896",1269,82,24,58,259,202,99,126,223,171,41,20,21,66
"2011","Stockport 002E","E01005919",1084,61,16,45,157,135,100,69,238,171,76,43,33,77
"2011","Stockport 003A","E01005862",1160,130,27,103,310,173,126,70,155,82,24,15,9,90
"2011","Stockport 003B","E01005892",987,60,20,40,163,167,86,109,170,131,40,24,16,61
"2011","Stockport 003C","E01005895",828,56,18,38,162,129,79,60,126,115,43,27,16,58
"2011","Stockport 003D","E01005920",1163,131,31,100,251,181,87,87,176,107,43,27,16,100
"2011","Stockport 003E","E01005921",1057,72,15,57,195,188,70,97,192,135,41,22,19,67
"2011","Stockport 003F","E01005922",1065,103,30,73,227,186,96,101,154,108,30,16,14,60
"2011","Stockport 004A","E01005753",1082,24,7,17,92,98,64,102,245,236,135,92,43,86
"2011","Stockport 004B","E01005754",1313,27,9,18,98,123,79,109,318,275,212,140,72,72
"2011","Stockport 004C","E01005755",1105,30,7,23,99,116,51,86,250,269,123,89,34,81
"2011","Stockport 004D","E01005756",1080,22,6,16,82,87,53,75,230,235,224,137,87,72
"2011","Stockport 005A","E01005745",1113,112,35,77,249,191,111,81,141,103,39,25,14,86
"2011","Stockport 005B","E01005746",1028,52,16,36,165,152,95,71,192,168,76,46,30,57
"2011","Stockport 005C","E01005747",1112,115,25,90,305,195,91,91,127,90,22,12,10,76
"2011","Stockport 005D","E01005748",1109,140,38,102,286,197,125,65,129,79,20,14,6,68
"2011","Stockport 006A","E01005863",1285,268,49,219,338,177,121,42,124,64,63,49,14,88
"2011","Stockport 006B","E01005864",1086,258,34,224,354,121,100,49,69,51,22,14,8,62
"2011","Stockport 006C","E01005866",1343,238,39,199,335,189,116,87,155,70,68,38,30,85
"2011","Stockport 006D","E01005869",1099,163,27,136,297,154,111,59,127,72,41,33,8,75
"2011","Stockport 007A","E01005914",1058,49,20,29,171,190,102,99,190,151,41,21,20,65
"2011","Stockport 007B","E01005915",1103,61,11,50,198,178,93,83,214,159,61,40,21,56
"2011","Stockport 007C","E01005916",1204,92,14,78,256,177,101,81,192,165,76,43,33,64
"2011","Stockport 007D","E01005917",1256,82,18,64,259,175,95,106,241,164,69,42,27,65
"2011","Stockport 008A","E01005859",1049,245,40,205,315,114,91,35,89,44,30,13,17,86
"2011","Stockport 008B","E01005865",1056,239,44,195,294,133,114,42,65,37,36,25,11,96
"2011","Stockport 008C","E01005867",1004,222,42,180,332,141,86,40,73,24,29,12,17,57
"2011","Stockport 008D","E01005868",1041,177,30,147,277,158,107,39,95,49,40,21,19,99
"2011","Stockport 009A","E01005743",1030,69,21,48,223,183,102,92,170,118,24,11,13,49
"2011","Stockport 009B","E01005744",1024,55,15,40,166,162,107,92,177,161,49,37,12,55
"2011","Stockport 009C","E01005749",1256,129,29,100,306,227,98,113,171,117,30,17,13,65
"2011","Stockport 009D","E01005750",1256,91,27,64,245,235,118,129,211,132,33,16,17,62
"2011","Stockport 009E","E01005751",996,74,17,57,175,173,97,101,170,132,32,16,16,42
"2011","Stockport 010A","E01005897",1059,84,21,63,200,164,111,84,176,131,46,28,18,63
"2011","Stockport 010B","E01005898",1186,149,34,115,285,182,133,61,140,110,47,32,15,79
"2011","Stockport 010C","E01005900",1124,119,30,89,270,165,118,80,146,104,56,31,25,66
"2011","Stockport 010D","E01005903",1027,182,50,132,324,165,123,31,84,40,15,9,6,63
"2011","Stockport 010E","E01005904",1020,174,42,132,296,174,98,55,92,41,17,8,9,73
"2011","Stockport 011A","E01005853",1130,130,28,102,220,165,104,72,159,116,85,57,28,79
"2011","Stockport 011B","E01005856",1193,158,23,135,318,192,126,58,129,70,36,22,14,106
"2011","Stockport 011C","E01005860",1040,202,39,163,308,139,100,48,86,61,19,12,7,77
"2011","Stockport 011D","E01005861",1134,171,37,134,284,170,105,68,140,87,35,22,13,74
"2011","Stockport 012A","E01005752",1005,58,10,48,178,154,80,99,148,147,62,34,28,79
"2011","Stockport 012B","E01005899",1099,110,33,77,249,182,112,79,158,106,42,28,14,61
"2011","Stockport 012C","E01005901",1051,116,35,81,256,207,93,82,122,90,27,22,5,58
"2011","Stockport 012D","E01005902",1136,70,12,58,170,164,98,96,215,188,76,43,33,59
"2011","Stockport 012E","E01005905",966,53,12,41,128,137,73,99,177,156,81,54,27,62
"2011","Stockport 013A","E01005852",1187,240,30,210,343,129,118,38,98,65,49,39,10,107
"2011","Stockport 013B","E01005854",1202,263,44,219,401,169,104,45,76,53,22,10,12,69
"2011","Stockport 013C","E01005855",1105,203,41,162,321,152,109,51,79,45,37,28,9,108
"2011","Stockport 013D","E01005857",1145,179,25,154,286,152,139,41,111,37,80,67,13,120
"2011","Stockport 013E","E01005858",1205,235,36,199,372,179,104,68,109,48,32,22,10,58
"2011","Stockport 014A","E01005757",1163,58,14,44,222,186,89,91,232,165,60,30,30,60
"2011","Stockport 014B","E01005758",1522,55,15,40,173,196,93,129,311,327,185,108,77,53
"2011","Stockport 014C","E01005766",1145,88,15,73,165,128,87,77,204,186,126,88,38,84
"2011","Stockport 014D","E01005918",1158,30,9,21,124,93,71,100,257,240,200,120,80,43
"2011","Stockport 015A","E01005870",1009,57,14,43,207,159,79,95,187,130,37,15,22,58
"2011","Stockport 015B","E01005871",1011,74,28,46,184,166,99,90,190,116,45,26,19,47
"2011","Stockport 015C","E01005873",1084,65,18,47,204,210,102,88,192,115,21,10,11,87
"2011","Stockport 015D","E01005875",1185,105,31,74,239,221,109,128,164,122,31,12,19,66
"2011","Stockport 016A","E01005764",1200,104,12,92,303,203,78,84,182,144,55,27,28,47
"2011","Stockport 016B","E01005816",1177,119,20,99,264,227,67,71,185,119,51,29,22,74
"2011","Stockport 016C","E01005817",1035,86,15,71,223,176,88,79,170,107,53,32,21,53
"2011","Stockport 016D","E01005822",1192,63,8,55,175,152,72,97,225,211,128,87,41,69
"2011","Stockport 017A","E01005880",1080,180,43,137,315,168,141,52,89,49,21,9,12,65
"2011","Stockport 017B","E01005881",934,256,60,196,291,124,84,27,55,27,8,4,4,62
"2011","Stockport 017C","E01005883",1121,261,56,205,341,171,111,41,80,40,22,12,10,54
"2011","Stockport 017D","E01005908",1117,281,71,210,329,127,164,29,70,27,16,8,8,74
"2011","Stockport 018A","E01005765",1027,99,22,77,280,173,74,67,146,101,22,12,10,65
"2011","Stockport 018B","E01005818",994,83,13,70,195,153,81,74,171,112,56,44,12,69
"2011","Stockport 018C","E01005819",1190,115,25,90,262,213,105,109,171,108,36,26,10,71
"2011","Stockport 018D","E01005820",1059,98,17,81,263,186,69,79,167,107,35,17,18,55
"2011","Stockport 018E","E01005821",1113,89,17,72,249,164,80,81,193,135,63,42,21,59
"2011","Stockport 018F","E01005823",1212,87,15,72,250,189,88,93,179,162,67,41,26,97
"2011","Stockport 019A","E01005825",1159,129,36,93,295,185,105,91,137,100,42,25,17,75
"2011","Stockport 019B","E01005872",1282,88,19,69,230,211,107,98,225,194,70,47,23,59
"2011","Stockport 019C","E01005874",1287,59,11,48,218,195,95,111,233,232,84,56,28,60
"2011","Stockport 019D","E01005876",1122,75,18,57,200,211,98,105,176,140,41,27,14,76
"2011","Stockport 019E","E01005877",1028,66,15,51,161,174,86,104,189,142,49,22,27,57
"2011","Stockport 020A","E01005878",960,59,10,49,169,133,94,79,207,115,52,38,14,52
"2011","Stockport 020B","E01005879",947,93,22,71,205,137,97,77,135,97,43,32,11,63
"2011","Stockport 020C","E01005882",981,195,48,147,298,150,74,33,76,38,52,48,4,65
"2011","Stockport 020D","E01005884",1073,182,46,136,329,169,101,53,90,51,14,10,4,84
"2011","Stockport 020E","E01005885",925,148,23,125,244,123,90,64,104,59,40,34,6,53
"2011","Stockport 021A","E01005832",1069,103,29,74,216,195,107,77,157,115,26,15,11,73
"2011","Stockport 021B","E01005833",757,85,18,67,172,119,91,45,106,70,24,18,6,45
"2011","Stockport 021C","E01005835",1057,119,36,83,273,191,124,69,128,66,18,6,12,69
"2011","Stockport 021D","E01005837",1204,117,30,87,286,215,110,100,176,101,30,18,12,69
"2011","Stockport 021E","E01005843",1164,148,31,117,279,207,113,89,157,85,19,8,11,67
"2011","Stockport 022A","E01005769",1079,201,35,166,343,133,70,46,108,63,36,22,14,79
"2011","Stockport 022B","E01005778",1107,127,30,97,263,180,86,89,153,92,34,17,17,83
"2011","Stockport 022C","E01005779",1057,118,16,102,241,185,87,91,139,95,21,15,6,80
"2011","Stockport 022D","E01005780",1065,121,30,91,232,180,92,83,140,97,39,21,18,81
"2011","Stockport 022E","E01005781",1104,60,9,51,175,167,68,94,220,168,95,63,32,57
"2011","Stockport 023A","E01005759",1271,107,25,82,289,204,100,98,204,136,52,37,15,81
"2011","Stockport 023B","E01005760",1360,104,15,89,263,196,120,116,242,157,83,46,37,79
"2011","Stockport 023C","E01005797",1080,127,17,110,274,154,67,66,139,123,55,32,23,75
"2011","Stockport 023D","E01005800",1186,201,37,164,306,185,115,60,130,80,24,15,9,85
"2011","Stockport 023E","E01005804",812,96,20,76,198,112,63,42,122,77,37,21,16,65
"2011","Stockport 024A","E01005824",1080,71,23,48,219,183,100,78,176,143,33,21,12,77
"2011","Stockport 024B","E01005826",949,43,11,32,123,128,62,91,207,186,56,44,12,53
"2011","Stockport 024C","E01005827",1053,87,24,63,217,181,129,76,148,122,25,17,8,68
"2011","Stockport 024D","E01005828",889,26,6,20,99,93,56,81,198,201,95,57,38,40
"2011","Stockport 024E","E01005829",890,54,9,45,163,150,62,57,172,121,54,39,15,57
"2011","Stockport 025A","E01005768",1127,206,38,168,284,147,146,43,93,52,48,30,18,108
"2011","Stockport 025B","E01005770",973,169,34,135,266,145,107,40,89,42,39,25,14,76
"2011","Stockport 025C","E01005771",961,157,22,135,265,146,90,48,98,49,36,27,9,72
"2011","Stockport 025D","E01005775",1057,210,34,176,303,138,113,38,85,57,26,14,12,87
"2011","Stockport 026A","E01005761",988,53,13,40,150,127,87,75,202,149,64,44,20,81
"2011","Stockport 026B","E01005762",1050,31,11,20,113,110,38,75,223,238,135,102,33,87
"2011","Stockport 026C","E01005763",1149,64,11,53,188,152,71,101,236,162,96,66,30,79
"2011","Stockport 026D","E01005799",1201,82,15,67,169,150,80,84,207,191,143,115,28,95
"2011","Stockport 027A","E01005798",1090,170,40,130,272,160,109,50,132,69,45,33,12,83
"2011","Stockport 027B","E01005801",1093,119,23,96,239,173,87,70,171,115,49,30,19,70
"2011","Stockport 027C","E01005802",1136,152,34,118,327,190,106,59,131,60,18,10,8,93
"2011","Stockport 027D","E01005803",1076,199,50,149,315,165,109,53,97,32,14,8,6,92
"2011","Stockport 027E","E01005830",1090,92,24,68,264,198,94,107,116,100,34,15,19,85
"2011","Stockport 027F","E01005831",1143,126,33,93,280,204,85,79,153,98,48,27,21,70
"2011","Stockport 028A","E01005767",1057,173,37,136,261,167,129,39,92,46,44,37,7,106
"2011","Stockport 028B","E01005772",1003,170,33,137,236,133,121,37,100,48,55,44,11,103
"2011","Stockport 028C","E01005773",1052,232,41,191,266,128,115,39,97,42,43,27,16,90
"2011","Stockport 028D","E01005774",975,91,18,73,167,116,84,70,167,128,76,54,22,76
"2011","Stockport 028E","E01005776",1110,225,34,191,283,125,138,46,67,45,56,44,12,125
"2011","Stockport 029A","E01005909",1127,230,58,172,317,170,114,42,105,52,23,12,11,74
"2011","Stockport 029B","E01005910",1087,114,30,84,241,173,94,73,169,129,34,14,20,60
"2011","Stockport 029C","E01005911",962,117,21,96,245,160,90,72,115,68,30,26,4,65
"2011","Stockport 029D","E01005912",1035,163,33,130,286,153,142,59,108,59,19,9,10,46
"2011","Stockport 030A","E01005782",922,157,21,136,225,180,100,44,107,43,18,11,7,48
"2011","Stockport 030B","E01005783",1114,158,31,127,298,187,98,65,131,77,35,25,10,65
"2011","Stockport 030C","E01005784",969,188,46,142,276,147,100,39,75,34,38,32,6,72
"2011","Stockport 030D","E01005785",1108,167,38,129,318,182,94,56,121,61,28,19,9,81
"2011","Stockport 030E","E01005786",1109,194,41,153,330,173,105,55,102,35,29,18,11,86
"2011","Stockport 031A","E01005834",1106,53,8,45,201,161,100,100,189,160,60,37,23,82
"2011","Stockport 031B","E01005836",1308,144,25,119,332,228,119,101,181,97,49,31,18,57
"2011","Stockport 031C","E01005838",1252,118,21,97,276,227,101,103,191,131,45,17,28,60
"2011","Stockport 031D","E01005840",1087,111,25,86,243,178,93,90,168,96,46,26,20,62
"2011","Stockport 032A","E01005927",973,205,44,161,291,121,110,36,82,27,13,8,5,88
"2011","Stockport 032B","E01005928",1108,91,16,75,250,160,116,77,167,126,48,28,20,73
"2011","Stockport 032C","E01005929",958,248,53,195,283,122,123,21,56,21,20,14,6,64
"2011","Stockport 032D","E01005930",1098,279,66,213,338,131,102,30,78,28,13,8,5,99
"2011","Stockport 033A","E01005806",858,101,31,70,199,166,87,73,98,58,22,11,11,54
"2011","Stockport 033B","E01005813",1113,166,31,135,300,201,110,57,131,51,12,8,4,85
"2011","Stockport 033C","E01005814",970,138,42,96,279,160,72,56,104,63,25,18,7,73
"2011","Stockport 033D","E01005815",1028,151,33,118,257,194,98,71,106,70,18,14,4,63
"2011","Stockport 034A","E01005777",1088,122,25,97,233,183,95,74,147,103,51,33,18,80
"2011","Stockport 034B","E01005787",991,204,48,156,286,150,116,30,80,24,13,8,5,88
"2011","Stockport 034C","E01005788",1084,190,37,153,323,176,93,59,96,51,23,19,4,73
"2011","Stockport 034D","E01005790",899,105,17,88,186,138,96,50,124,81,40,22,18,79
"2011","Stockport 035A","E01005805",1092,170,36,134,308,209,96,55,107,49,11,5,6,87
"2011","Stockport 035B","E01005807",1126,169,47,122,282,218,110,58,117,53,28,18,10,91
"2011","Stockport 035C","E01005839",1003,181,60,121,258,185,100,50,98,40,30,21,9,61
"2011","Stockport 035D","E01005841",1061,115,38,77,272,194,112,72,114,74,37,32,5,71
"2011","Stockport 036A","E01005844",1060,134,30,104,220,156,116,60,115,64,102,88,14,93
"2011","Stockport 036B","E01005845",1162,124,29,95,234,189,118,65,162,95,69,46,23,106
"2011","Stockport 036C","E01005849",1139,125,38,87,297,214,132,53,134,53,35,21,14,96
"2011","Stockport 036D","E01005851",1060,116,23,93,254,191,113,60,136,51,43,32,11,96
"2011","Stockport 037A","E01005808",954,211,39,172,303,129,101,36,58,21,12,8,4,83
"2011","Stockport 037B","E01005809",916,171,38,133,245,134,80,42,104,42,36,25,11,62
"2011","Stockport 037C","E01005810",1070,234,46,188,328,144,83,38,84,48,37,27,10,74
"2011","Stockport 037D","E01005811",1060,189,49,140,308,167,104,43,113,42,18,8,10,76
"2011","Stockport 037E","E01005812",917,213,30,183,281,122,99,27,70,17,14,8,6,74
"2011","Stockport 038A","E01005842",1135,132,27,105,265,179,157,90,148,82,16,10,6,66
"2011","Stockport 038B","E01005906",1035,185,59,126,272,181,143,48,78,44,20,9,11,64
"2011","Stockport 038C","E01005907",874,116,28,88,227,138,123,57,101,37,33,18,15,42
"2011","Stockport 038D","E01005913",1039,158,29,129,270,159,146,62,100,62,25,9,16,57
"2011","Stockport 039A","E01005789",1116,260,39,221,330,181,94,41,73,26,21,12,9,90
"2011","Stockport 039B","E01005791",1104,172,38,134,295,160,108,61,148,60,26,16,10,74
"2011","Stockport 039C","E01005793",1037,135,29,106,281,173,97,63,134,68,28,17,11,58
"2011","Stockport 039D","E01005795",943,189,34,155,255,150,82,46,102,39,14,10,4,66
"2011","Stockport 039E","E01005796",939,185,42,143,267,155,76,39,87,38,27,20,7,65
"2011","Stockport 040A","E01005846",1164,132,26,106,258,163,115,83,164,94,53,35,18,102
"2011","Stockport 040B","E01005847",1161,114,20,94,249,224,104,84,172,86,37,29,8,91
"2011","Stockport 040C","E01005848",1358,196,37,159,354,217,128,62,137,62,53,41,12,149
"2011","Stockport 040D","E01005850",1260,122,28,94,255,198,109,100,185,126,70,40,30,95
"2011","Stockport 041A","E01005792",1032,248,50,198,312,171,88,31,87,34,9,3,6,52
"2011","Stockport 041B","E01005794",915,160,25,135,277,148,59,38,77,52,17,10,7,87
"2011","Stockport 041C","E01005923",1064,233,51,182,335,181,94,32,72,33,14,7,7,70
"2011","Stockport 041D","E01005931",976,220,47,173,303,130,95,38,81,25,13,6,7,71
"2011","Stockport 042A","E01005924",885,227,44,183,289,99,67,27,60,24,16,10,6,76
"2011","Stockport 042B","E01005925",934,202,49,153,291,120,94,25,73,34,29,18,11,66
"2011","Stockport 042C","E01005926",899,176,50,126,251,123,149,27,56,32,13,6,7,72
"2011","Stockport 042D","E01005932",1008,211,48,163,294,155,80,44,106,33,11,7,4,74
"2011","Tameside 001A","E01006053",1466,181,50,131,429,247,143,96,160,105,27,16,11,78
"2011","Tameside 001B","E01006054",1148,79,22,57,195,139,119,102,176,192,90,55,35,56
"2011","Tameside 001C","E01006055",1108,133,35,98,312,167,100,70,144,109,27,13,14,46
"2011","Tameside 001D","E01006057",1135,105,25,80,278,201,79,96,176,104,35,17,18,61
"2011","Tameside 001E","E01006058",1515,163,37,126,340,239,163,106,196,185,55,29,26,68
"2011","Tameside 001F","E01006059",1077,112,26,86,243,175,90,79,174,112,33,20,13,59
"2011","Tameside 002A","E01005938",1192,99,27,72,245,165,113,69,191,147,75,52,23,88
"2011","Tameside 002B","E01005939",1036,115,32,83,200,173,114,77,142,75,52,43,9,88
"2011","Tameside 002C","E01005940",1124,95,17,78,220,211,125,70,180,103,53,38,15,67
"2011","Tameside 002D","E01005955",1278,132,42,90,288,201,142,100,165,115,35,23,12,100
"2011","Tameside 003A","E01006056",824,30,9,21,92,97,53,71,160,177,82,44,38,62
"2011","Tameside 003B","E01006061",1718,133,42,91,331,205,163,142,278,233,120,72,48,113
"2011","Tameside 003C","E01006062",1589,205,62,143,388,280,130,150,189,126,21,12,9,100
"2011","Tameside 003D","E01006063",1158,115,37,78,269,187,100,107,155,120,35,21,14,70
"2011","Tameside 004A","E01005936",1140,116,37,79,237,178,113,73,179,127,37,22,15,80
"2011","Tameside 004B","E01005937",1095,68,13,55,178,182,103,75,199,150,75,45,30,65
"2011","Tameside 004C","E01005945",1323,58,15,43,160,125,95,89,252,283,165,106,59,96
"2011","Tameside 004D","E01005946",1216,57,15,42,200,161,95,85,225,229,73,53,20,91
"2011","Tameside 004E","E01005947",1173,44,13,31,151,112,64,106,250,254,120,75,45,72
"2011","Tameside 005A","E01005954",1098,74,26,48,153,159,109,85,203,194,70,50,20,51
"2011","Tameside 005B","E01005956",1087,78,20,58,215,167,108,98,178,146,34,25,9,63
"2011","Tameside 005C","E01005957",1059,62,17,45,196,179,90,93,191,113,55,41,14,80
"2011","Tameside 005D","E01005958",1052,41,13,28,119,128,88,108,218,168,93,63,30,89
"2011","Tameside 005E","E01005959",1189,37,10,27,135,145,83,99,281,178,118,84,34,113
"2011","Tameside 006A","E01005933",1028,23,2,21,105,100,44,102,236,217,110,72,38,91
"2011","Tameside 006B","E01005934",1080,76,28,48,236,158,76,72,184,126,68,40,28,84
"2011","Tameside 006C","E01005935",1033,28,11,17,100,101,76,91,225,219,119,74,45,74
"2011","Tameside 006D","E01005949",1182,55,5,50,180,171,92,107,208,203,77,56,21,89
"2011","Tameside 006E","E01005960",1167,59,14,45,148,153,84,104,255,214,69,51,18,81
"2011","Tameside 007A","E01005941",1230,57,5,52,155,126,90,88,255,246,139,110,29,74
"2011","Tameside 007B","E01005942",1231,92,18,74,268,209,97,109,170,136,61,42,19,89
"2011","Tameside 007C","E01005943",1359,95,25,70,265,211,123,128,231,161,63,34,29,82
"2011","Tameside 007D","E01005944",1110,116,19,97,225,162,94,87,159,122,74,63,11,71
"2011","Tameside 008A","E01006060",1052,44,15,29,146,129,89,78,215,185,105,65,40,61
"2011","Tameside 008B","E01006064",1106,38,11,27,112,114,88,83,238,252,113,79,34,68
"2011","Tameside 008C","E01006065",935,49,13,36,117,104,55,72,193,174,92,50,42,79
"2011","Tameside 008D","E01006066",1023,56,11,45,179,130,79,74,200,169,64,42,22,72
"2011","Tameside 009A","E01006067",1418,164,41,123,313,262,137,87,190,133,40,30,10,92
"2011","Tameside 009B","E01006068",1177,91,22,69,217,155,112,86,242,152,61,30,31,61
"2011","Tameside 009C","E01006069",1168,55,18,37,169,135,73,96,227,203,99,67,32,111
"2011","Tameside 009D","E01006073",1214,78,14,64,210,152,98,88,207,192,100,64,36,89
"2011","Tameside 010A","E01005993",1044,74,31,43,171,168,108,99,156,155,42,25,17,71
"2011","Tameside 010B","E01005995",1114,102,31,71,255,219,95,85,129,86,27,22,5,116
"2011","Tameside 010C","E01005996",1428,81,21,60,266,240,124,146,239,191,60,35,25,81
"2011","Tameside 010D","E01005997",1099,61,19,42,174,195,96,100,227,149,42,24,18,55
"2011","Tameside 010E","E01006000",1139,66,15,51,170,150,68,100,218,177,105,75,30,85
"2011","Tameside 011A","E01005994",1078,45,12,33,149,183,101,100,207,152,47,31,16,94
"2011","Tameside 011B","E01005999",1367,55,11,44,206,204,88,130,250,197,130,94,36,107
"2011","Tameside 011C","E01006002",984,46,8,38,157,169,69,94,189,145,35,16,19,80
"2011","Tameside 011D","E01006004",1152,78,25,53,184,204,84,91,239,164,30,16,14,78
"2011","Tameside 011E","E01006005",955,21,7,14,144,120,70,86,229,172,60,33,27,53
"2011","Tameside 011F","E01006007",1130,59,11,48,176,178,86,103,227,177,54,32,22,70
"2011","Tameside 012A","E01005998",1272,77,18,59,190,229,107,115,197,201,73,50,23,83
"2011","Tameside 012B","E01006001",1156,51,16,35,207,222,84,108,192,153,52,33,19,87
"2011","Tameside 012C","E01006003",1082,65,18,47,142,205,100,101,190,158,47,30,17,74
"2011","Tameside 012D","E01006006",1135,64,18,46,171,210,111,120,189,155,38,25,13,77
"2011","Tameside 013A","E01005948",1401,50,10,40,147,145,122,89,284,292,198,150,48,74
"2011","Tameside 013B","E01005950",1261,37,4,33,96,108,114,87,198,197,261,233,28,163
"2011","Tameside 013C","E01005951",1143,48,14,34,143,140,83,100,236,225,98,70,28,70
"2011","Tameside 013D","E01005952",1712,37,13,24,192,162,98,120,326,426,250,160,90,101
"2011","Tameside 013E","E01005953",1397,45,12,33,142,145,110,115,269,270,183,143,40,118
"2011","Tameside 014A","E01005961",1060,99,26,73,221,173,125,85,134,113,36,27,9,74
"2011","Tameside 014B","E01005962",1069,96,24,72,195,192,99,88,148,122,45,35,10,84
"2011","Tameside 014C","E01005968",1116,69,13,56,216,237,109,100,155,142,31,22,9,57
"2011","Tameside 014D","E01005969",1031,79,22,57,213,207,89,91,140,99,38,26,12,75
"2011","Tameside 015A","E01006022",1242,94,23,71,246,208,126,103,175,156,67,41,26,67
"2011","Tameside 015B","E01006023",1191,58,16,42,168,157,114,119,233,200,83,44,39,59
"2011","Tameside 015C","E01006070",1069,111,27,84,270,178,110,63,147,89,28,13,15,73
"2011","Tameside 015D","E01006071",1230,199,54,145,358,187,163,58,106,65,23,17,6,71
"2011","Tameside 015E","E01006072",1334,223,56,167,402,203,146,70,131,52,16,11,5,91
"2011","Tameside 016A","E01006009",1065,61,20,41,146,164,76,107,214,193,39,22,17,65
"2011","Tameside 016B","E01006017",1061,96,36,60,264,164,92,112,167,94,25,15,10,47
"2011","Tameside 016C","E01006018",1061,81,25,56,227,205,104,99,140,122,21,11,10,62
"2011","Tameside 016D","E01006021",991,69,20,49,176,159,99,99,178,119,36,21,15,56
"2011","Tameside 017A","E01006008",1098,76,24,52,234,163,81,118,177,142,47,30,17,60
"2011","Tameside 017B","E01006010",958,53,17,36,123,125,58,103,194,185,70,45,25,47
"2011","Tameside 017C","E01006012",1357,96,22,74,268,200,111,129,233,180,58,39,19,82
"2011","Tameside 017D","E01006015",1089,138,42,96,238,182,98,74,121,101,47,32,15,90
"2011","Tameside 017E","E01006016",1356,58,21,37,149,174,75,121,304,282,138,74,64,55
"2011","Tameside 018A","E01006011",1151,48,14,34,133,111,90,97,243,251,103,63,40,75
"2011","Tameside 018B","E01006013",948,76,19,57,174,152,91,64,152,159,29,18,11,51
"2011","Tameside 018C","E01006014",923,47,19,28,130,144,68,67,189,145,65,40,25,68
"2011","Tameside 018D","E01006019",1120,50,17,33,144,157,76,121,244,207,72,48,24,49
"2011","Tameside 018E","E01006020",1046,43,11,32,150,139,98,95,214,177,54,31,23,76
"2011","Tameside 019A","E01005963",906,59,19,40,202,145,68,93,151,112,30,22,8,46
"2011","Tameside 019B","E01005964",1158,94,25,69,221,212,92,93,178,134,48,30,18,86
"2011","Tameside 019C","E01005965",1026,29,10,19,150,142,74,97,184,204,85,56,29,61
"2011","Tameside 019D","E01005966",1007,66,27,39,168,159,79,84,180,119,66,51,15,86
"2011","Tameside 019E","E01005967",1037,42,13,29,132,154,83,96,199,195,74,39,35,62
"2011","Tameside 020A","E01006031",1091,37,7,30,118,122,76,115,223,207,126,94,32,67
"2011","Tameside 020B","E01006032",961,41,10,31,116,117,83,94,213,142,91,57,34,64
"2011","Tameside 020C","E01006033",1043,47,15,32,139,140,66,106,200,183,91,51,40,71
"2011","Tameside 020D","E01006034",1531,95,22,73,242,233,121,136,271,243,96,65,31,94
"2011","Tameside 020E","E01006035",1486,106,26,80,247,214,110,136,294,216,74,42,32,89
"2011","Tameside 020F","E01006036",1381,81,19,62,257,180,95,107,256,214,89,61,28,102
"2011","Tameside 021A","E01005970",1148,103,24,79,205,198,106,108,210,117,28,17,11,73
"2011","Tameside 021B","E01005972",1242,61,19,42,191,214,81,120,239,186,65,37,28,85
"2011","Tameside 021C","E01005974",1172,60,20,40,190,173,92,100,230,179,72,43,29,76
"2011","Tameside 021D","E01005975",1180,66,17,49,175,175,83,118,243,179,73,51,22,68
"2011","Tameside 022A","E01006024",1367,170,49,121,331,235,162,80,166,74,39,18,21,110
"2011","Tameside 022B","E01006026",1176,91,23,68,236,199,109,106,191,129,51,31,20,64
"2011","Tameside 022C","E01006037",1150,123,42,81,240,227,118,114,148,102,25,12,13,53
"2011","Tameside 022D","E01006038",1194,90,29,61,218,204,82,100,228,151,58,41,17,63
"2011","Tameside 023A","E01006047",1000,90,29,61,211,160,109,71,145,106,42,31,11,66
"2011","Tameside 023B","E01006048",1121,151,35,116,299,174,148,77,118,93,17,12,5,44
"2011","Tameside 023C","E01006049",1182,111,27,84,263,150,138,108,166,133,52,35,17,61
"2011","Tameside 023D","E01006051",1253,177,44,133,324,150,142,77,134,133,46,31,15,70
"2011","Tameside 024A","E01005985",1029,68,21,47,233,207,86,104,158,97,27,15,12,49
"2011","Tameside 024B","E01005987",1099,86,27,59,205,223,109,99,169,127,31,15,16,50
"2011","Tameside 024C","E01005988",1151,102,24,78,298,218,107,75,155,96,17,10,7,83
"2011","Tameside 024D","E01005990",960,72,20,52,204,185,84,71,138,103,33,19,14,70
"2011","Tameside 024E","E01005991",1064,100,29,71,207,182,110,94,162,109,23,13,10,77
"2011","Tameside 025A","E01005971",1036,66,19,47,163,170,85,96,209,147,44,24,20,56
"2011","Tameside 025B","E01005986",907,43,13,30,152,166,62,76,178,133,42,30,12,55
"2011","Tameside 025C","E01005989",959,79,30,49,185,199,82,102,144,82,20,14,6,66
"2011","Tameside 025D","E01005992",942,54,14,40,148,144,70,92,181,153,47,38,9,53
"2011","Tameside 026A","E01005973",1102,67,15,52,224,187,98,99,172,128,43,31,12,84
"2011","Tameside 026B","E01005976",1097,39,15,24,129,163,98,89,216,202,76,45,31,85
"2011","Tameside 026C","E01005977",1135,66,18,48,194,199,90,100,205,172,42,31,11,67
"2011","Tameside 026D","E01005978",1005,37,11,26,123,165,71,88,217,162,70,45,25,72
"2011","Tameside 027A","E01006025",988,26,9,17,92,113,63,80,244,194,110,74,36,66
"2011","Tameside 027B","E01006027",986,22,8,14,76,107,63,81,247,225,116,76,40,49
"2011","Tameside 027C","E01006050",1203,22,9,13,93,137,76,104,280,253,160,111,49,78
"2011","Tameside 027D","E01006052",1085,39,15,24,120,111,85,110,220,232,96,65,31,72
"2011","Tameside 028A","E01006028",1240,47,24,23,156,156,106,100,258,231,119,91,28,67
"2011","Tameside 028B","E01006029",1287,63,17,46,163,180,95,110,241,169,155,115,40,111
"2011","Tameside 028C","E01006030",1309,74,19,55,185,163,136,98,260,200,109,68,41,84
"2011","Tameside 028D","E01006039",958,38,8,30,131,104,75,90,147,94,150,134,16,129
"2011","Tameside 028E","E01006040",1165,44,9,35,133,136,106,97,150,154,203,172,31,142
"2011","Tameside 028F","E01006041",1122,78,19,59,179,140,100,115,201,136,101,78,23,72
"2011","Tameside 029A","E01005979",1197,69,18,51,212,191,109,112,228,168,49,32,17,59
"2011","Tameside 029B","E01005980",1017,37,11,26,164,142,77,79,210,177,66,40,26,65
"2011","Tameside 029C","E01005981",1037,56,13,43,125,156,63,107,224,173,75,52,23,58
"2011","Tameside 029D","E01005982",1002,60,19,41,138,149,85,79,203,138,63,38,25,87
"2011","Tameside 029E","E01005983",1209,106,32,74,276,220,125,102,166,116,36,26,10,62
"2011","Tameside 029F","E01005984",1108,24,11,13,137,132,86,97,227,216,119,67,52,70
"2011","Tameside 030A","E01006042",1241,131,38,93,316,204,142,97,168,95,26,14,12,62
"2011","Tameside 030B","E01006043",1056,53,20,33,216,171,88,100,169,130,57,37,20,72
"2011","Tameside 030C","E01006044",1008,103,32,71,201,168,126,92,143,103,25,13,12,47
"2011","Tameside 030D","E01006045",954,137,40,97,241,152,121,72,95,56,24,18,6,56
"2011","Tameside 030E","E01006046",1061,98,23,75,257,184,122,84,154,86,22,11,11,54
"2011","Trafford 001A","E01006109",1091,38,7,31,143,112,74,51,195,164,230,152,78,84
"2011","Trafford 001B","E01006110",1240,132,18,114,217,147,80,53,177,108,186,163,23,140
"2011","Trafford 001C","E01006111",1148,46,2,44,151,120,57,70,196,143,190,153,37,175
"2011","Trafford 001D","E01006112",1183,54,9,45,159,107,76,47,176,127,257,223,34,180
"2011","Trafford 001E","E01006185",1547,129,23,106,233,194,79,105,238,201,184,136,48,184
"2011","Trafford 001F","E01006188",1119,122,17,105,222,135,73,52,149,100,149,125,24,117
"2011","Trafford 002A","E01006116",970,92,25,67,202,182,84,74,146,83,30,18,12,77
"2011","Trafford 002B","E01006117",1214,144,37,107,299,218,86,79,167,98,27,21,6,96
"2011","Trafford 002C","E01006118",1022,88,21,67,206,164,59,75,166,146,35,25,10,83
"2011","Trafford 002D","E01006119",1204,144,30,114,264,226,90,101,170,85,40,27,13,84
"2011","Trafford 002E","E01006121",1161,89,21,68,228,214,79,100,203,137,32,22,10,79
"2011","Trafford 003A","E01006141",1131,66,16,50,202,176,116,68,192,133,84,65,19,94
"2011","Trafford 003B","E01006186",1374,119,23,96,272,241,102,97,200,147,97,70,27,99
"2011","Trafford 003C","E01006187",1948,143,20,123,375,350,114,125,322,270,101,55,46,148
"2011","Trafford 003D","E01006189",1596,114,28,86,327,272,107,112,238,198,115,73,42,113
"2011","Trafford 004A","E01006113",1064,101,20,81,204,113,119,35,103,77,141,124,17,171
"2011","Trafford 004B","E01006114",1143,112,15,97,166,120,97,55,139,135,167,148,19,152
"2011","Trafford 004C","E01006115",1130,120,17,103,217,136,103,48,128,95,144,121,23,139
"2011","Trafford 004D","E01006145",1243,63,8,55,203,143,108,75,216,164,130,92,38,141
"2011","Trafford 004E","E01006146",1317,150,20,130,262,191,127,80,151,103,94,81,13,159
"2011","Trafford 005A","E01006122",1124,119,33,86,236,248,81,82,166,105,26,15,11,61
"2011","Trafford 005B","E01006123",1210,149,34,115,303,208,118,84,128,82,30,16,14,108
"2011","Trafford 005C","E01006124",1090,184,45,139,302,184,101,56,113,61,15,8,7,74
"2011","Trafford 005D","E01006128",1261,166,42,124,341,223,111,85,136,101,23,17,6,75
"2011","Trafford 005E","E01006131",1123,171,39,132,294,187,102,85,117,71,20,8,12,76
"2011","Trafford 006A","E01006155",1204,106,28,78,274,218,97,93,167,118,41,21,20,90
"2011","Trafford 006B","E01006157",1153,87,29,58,217,232,88,66,179,136,47,23,24,101
"2011","Trafford 006C","E01006159",1217,67,16,51,201,175,77,80,247,182,93,55,38,95
"2011","Trafford 006D","E01006182",1119,100,28,72,229,235,95,77,151,86,56,39,17,90
"2011","Trafford 006E","E01006183",1220,134,34,100,249,202,100,93,190,117,40,28,12,95
"2011","Trafford 007A","E01006125",1091,79,20,59,237,209,83,86,160,114,35,25,10,88
"2011","Trafford 007B","E01006126",1175,65,14,51,181,168,100,113,240,157,69,45,24,82
"2011","Trafford 007C","E01006127",1199,80,13,67,264,217,121,110,197,109,27,17,10,74
"2011","Trafford 007D","E01006130",1310,144,29,115,341,228,105,88,178,114,25,16,9,87
"2011","Trafford 007E","E01006132",1129,121,33,88,267,205,101,88,139,105,34,26,8,69
"2011","Trafford 008A","E01006156",1144,98,24,74,238,193,86,62,190,139,53,30,23,85
"2011","Trafford 008B","E01006158",1206,82,14,68,201,187,81,94,245,189,61,35,26,66
"2011","Trafford 008C","E01006179",1314,129,23,106,268,186,112,95,210,165,60,37,23,89
"2011","Trafford 008D","E01006184",1208,84,23,61,228,170,105,89,221,144,67,42,25,100
"2011","Trafford 009A","E01006198",1125,130,27,103,288,182,80,71,140,107,35,23,12,92
"2011","Trafford 009B","E01006199",1201,112,22,90,255,207,81,84,186,146,60,45,15,70
"2011","Trafford 009C","E01006200",980,106,26,80,213,149,97,72,150,88,40,28,12,65
"2011","Trafford 009D","E01006201",1085,148,21,127,292,182,81,65,130,72,49,39,10,66
"2011","Trafford 009E","E01006202",1015,163,40,123,274,161,71,52,116,85,24,11,13,69
"2011","Trafford 010A","E01006120",1061,127,31,96,251,217,85,74,136,77,18,9,9,76
"2011","Trafford 010B","E01006129",940,100,28,72,221,174,71,68,140,91,34,25,9,41
"2011","Trafford 010C","E01006133",1092,110,34,76,253,216,89,78,159,108,14,7,7,65
"2011","Trafford 010D","E01006197",1070,127,18,109,305,178,95,54,128,70,30,22,8,83
"2011","Trafford 010E","E01006203",1012,139,28,111,265,173,93,66,113,54,22,15,7,87
"2011","Trafford 011A","E01006142",1173,127,24,103,259,169,86,72,172,122,73,51,22,93
"2011","Trafford 011B","E01006143",1206,184,27,157,348,174,89,59,115,65,64,38,26,108
"2011","Trafford 011C","E01006144",1022,84,19,65,180,146,56,65,187,140,93,63,30,71
"2011","Trafford 011D","E01006180",1410,152,23,129,342,226,95,66,192,168,72,43,29,97
"2011","Trafford 011E","E01006181",1187,83,13,70,237,209,95,91,156,128,89,69,20,99
"2011","Trafford 012A","E01006147",987,174,37,137,285,155,72,46,100,63,20,7,13,72
"2011","Trafford 012B","E01006149",1036,198,30,168,287,154,68,59,124,74,20,12,8,52
"2011","Trafford 012C","E01006150",1119,214,45,169,327,155,110,50,98,64,31,21,10,70
"2011","Trafford 012D","E01006154",1139,206,41,165,335,184,92,61,117,57,27,12,15,60
"2011","Trafford 012E","E01006165",1496,260,33,227,411,259,100,92,168,96,46,25,21,64
"2011","Trafford 013A","E01006166",1187,106,25,81,223,200,106,91,189,135,61,43,18,76
"2011","Trafford 013B","E01006169",1182,153,30,123,291,202,117,86,134,89,37,20,17,73
"2011","Trafford 013C","E01006170",1108,158,41,117,318,166,92,69,127,89,30,15,15,59
"2011","Trafford 013D","E01006171",1275,87,17,70,188,222,111,104,212,172,95,56,39,84
"2011","Trafford 014A","E01006098",897,208,36,172,306,134,71,30,56,21,19,10,9,52
"2011","Trafford 014B","E01006099",993,177,24,153,259,154,79,59,91,77,28,16,12,69
"2011","Trafford 014C","E01006164",1184,185,34,151,365,202,115,51,110,72,18,9,9,66
"2011","Trafford 014D","E01006174",1276,237,53,184,371,203,98,63,133,74,31,16,15,66
"2011","Trafford 014E","E01006178",1357,240,56,184,385,211,115,67,147,81,36,25,11,75
"2011","Trafford 015A","E01006097",1239,288,43,245,364,198,87,47,106,56,19,10,9,74
"2011","Trafford 015B","E01006160",1315,236,29,207,335,168,100,87,158,106,44,28,16,81
"2011","Trafford 015C","E01006161",1442,352,45,307,446,199,122,54,94,48,55,35,20,72
"2011","Trafford 015D","E01006162",1239,308,46,262,379,177,98,40,81,48,23,15,8,85
"2011","Trafford 015E","E01006163",1399,260,40,220,476,210,97,68,121,65,27,12,15,75
"2011","Trafford 016A","E01006148",1176,224,37,187,331,180,106,48,97,33,53,46,7,104
"2011","Trafford 016B","E01006151",1075,235,55,180,301,163,107,32,81,42,29,25,4,85
"2011","Trafford 016C","E01006152",1157,295,45,250,285,156,134,39,76,44,33,28,5,95
"2011","Trafford 016D","E01006153",1105,212,39,173,250,180,102,67,135,53,31,16,15,75
"2011","Trafford 016E","E01006172",1095,170,44,126,272,180,94,68,122,73,38,23,15,78
"2011","Trafford 017A","E01006104",1232,64,13,51,216,194,113,106,240,174,53,40,13,72
"2011","Trafford 017B","E01006105",1227,39,16,23,161,151,57,95,294,229,135,93,42,66
"2011","Trafford 017C","E01006106",1082,50,13,37,164,168,69,94,223,164,67,46,21,83
"2011","Trafford 017D","E01006107",1129,61,12,49,186,160,101,90,205,170,84,56,28,72
"2011","Trafford 017E","E01006108",1101,28,4,24,109,123,42,86,239,232,160,101,59,82
"2011","Trafford 018A","E01006102",940,128,28,100,255,157,80,50,110,69,30,16,14,61
"2011","Trafford 018B","E01006173",1097,141,32,109,284,209,86,63,138,80,20,12,8,76
"2011","Trafford 018C","E01006175",1079,59,14,45,162,164,67,106,197,156,90,63,27,78
"2011","Trafford 018D","E01006176",1304,170,37,133,308,208,128,87,170,93,54,36,18,86
"2011","Trafford 018E","E01006177",1134,79,18,61,192,158,80,83,181,158,106,71,35,97
"2011","Trafford 019A","E01006091",1772,357,50,307,475,289,125,102,181,117,49,33,16,77
"2011","Trafford 019B","E01006092",947,54,14,40,128,119,53,84,212,147,72,47,25,78
"2011","Trafford 019C","E01006095",1257,202,31,171,341,226,111,82,125,83,26,16,10,61
"2011","Trafford 019D","E01006167",1181,63,11,52,163,143,71,92,224,211,109,69,40,105
"2011","Trafford 019E","E01006168",1313,50,12,38,186,153,72,89,277,215,146,97,49,125
"2011","Trafford 020A","E01006090",1549,230,51,179,363,301,124,116,186,107,35,16,19,87
"2011","Trafford 020B","E01006094",1056,191,38,153,293,194,80,59,94,49,21,9,12,75
"2011","Trafford 020C","E01006096",1092,201,32,169,308,170,103,61,107,50,21,13,8,71
"2011","Trafford 020D","E01006100",1093,173,39,134,304,183,85,66,105,62,29,20,9,86
"2011","Trafford 020E","E01006103",1162,209,38,171,312,201,101,67,108,53,28,13,15,83
"2011","Trafford 021A","E01006101",1071,217,43,174,324,180,95,38,84,42,16,7,9,75
"2011","Trafford 021B","E01006190",1223,206,38,168,345,193,119,65,133,59,28,20,8,75
"2011","Trafford 021C","E01006195",1306,187,36,151,346,230,116,78,181,66,19,11,8,83
"2011","Trafford 021D","E01006196",1311,167,36,131,368,233,113,94,144,68,27,12,15,97
"2011","Trafford 021E","E01006210",1181,228,51,177,311,196,122,59,95,63,37,20,17,70
"2011","Trafford 022A","E01006204",1149,178,31,147,305,189,103,46,126,72,33,21,12,97
"2011","Trafford 022B","E01006206",1280,148,33,115,285,189,121,78,182,107,78,47,31,92
"2011","Trafford 022C","E01006207",1201,58,19,39,194,129,105,116,236,195,79,56,23,89
"2011","Trafford 022D","E01006208",1154,118,21,97,267,169,101,63,179,111,55,33,22,91
"2011","Trafford 022E","E01006211",1070,80,17,63,226,157,96,69,193,115,58,48,10,76
"2011","Trafford 023A","E01006093",1156,215,36,179,308,189,97,64,121,62,25,10,15,75
"2011","Trafford 023B","E01006191",1185,191,40,151,349,194,116,64,98,56,15,12,3,102
"2011","Trafford 023C","E01006192",1072,196,44,152,291,172,101,51,102,58,25,11,14,76
"2011","Trafford 023D","E01006205",934,170,33,137,260,169,86,41,97,42,17,13,4,52
"2011","Trafford 023E","E01006209",1060,180,32,148,309,175,118,41,95,44,38,22,16,60
"2011","Trafford 024A","E01006078",1471,234,42,192,420,219,119,91,160,116,47,31,16,65
"2011","Trafford 024B","E01006080",1352,279,50,229,389,186,97,80,141,83,27,16,11,70
"2011","Trafford 024C","E01006089",1144,139,22,117,258,180,118,92,149,109,35,19,16,64
"2011","Trafford 024D","E01006193",1096,243,52,191,287,170,86,69,101,45,21,16,5,74
"2011","Trafford 024E","E01006194",1709,371,70,301,512,202,143,75,163,106,43,25,18,94
"2011","Trafford 025A","E01006074",1083,133,24,109,231,136,90,74,145,112,70,46,24,92
"2011","Trafford 025B","E01006075",1333,352,62,290,402,160,114,56,72,57,45,23,22,75
"2011","Trafford 025C","E01006076",1068,286,59,227,295,122,118,26,76,37,35,25,10,73
"2011","Trafford 025D","E01006079",1507,365,70,295,446,190,130,86,111,53,30,18,12,96
"2011","Trafford 025E","E01006087",1113,253,62,191,264,129,207,34,58,37,33,23,10,98
"2011","Trafford 026A","E01006083",953,285,54,231,275,116,91,24,38,17,16,12,4,91
"2011","Trafford 026B","E01006084",1189,388,106,282,350,105,120,13,53,26,26,15,11,108
"2011","Trafford 026C","E01006088",1126,378,73,305,334,100,104,32,61,32,20,7,13,65
"2011","Trafford 026D","E01006139",1175,288,58,230,368,148,124,33,82,41,21,10,11,70
"2011","Trafford 026E","E01006140",1161,268,51,217,335,135,97,49,112,50,29,22,7,86
"2011","Trafford 027A","E01006077",1175,284,50,234,345,129,113,45,91,61,37,22,15,70
"2011","Trafford 027B","E01006081",959,270,62,208,305,103,106,22,31,14,33,23,10,75
"2011","Trafford 027C","E01006082",1142,372,87,285,339,102,136,16,47,24,20,15,5,86
"2011","Trafford 027D","E01006085",1047,312,69,243,314,108,132,21,60,22,18,9,9,60
"2011","Trafford 027E","E01006086",1154,244,78,166,308,126,119,52,109,63,42,22,20,91
"2011","Trafford 028A","E01006134",1089,293,77,216,300,102,143,14,63,25,41,36,5,108
"2011","Trafford 028B","E01006135",1058,277,49,228,278,133,129,27,71,30,40,32,8,73
"2011","Trafford 028C","E01006136",1054,248,48,200,288,133,157,25,70,35,36,28,8,62
"2011","Trafford 028D","E01006137",967,226,37,189,241,99,138,18,46,31,50,43,7,118
"2011","Trafford 028E","E01006138",1182,209,36,173,293,173,131,52,122,72,51,39,12,79
"2011","Wigan 001A","E01006315",932,104,25,79,233,139,97,84,106,89,17,8,9,63
"2011","Wigan 001B","E01006316",1172,151,39,112,313,160,121,86,119,110,40,22,18,72
"2011","Wigan 001C","E01006317",1147,82,24,58,217,137,86,104,246,165,33,16,17,77
"2011","Wigan 001D","E01006319",991,127,43,84,272,165,83,81,89,78,21,19,2,75
"2011","Wigan 002A","E01006229",1140,153,37,116,313,173,82,90,128,100,42,24,18,59
"2011","Wigan 002B","E01006230",1067,173,43,130,308,149,107,55,99,71,18,9,9,87
"2011","Wigan 002C","E01006233",1106,183,41,142,346,151,127,48,74,44,35,24,11,98
"2011","Wigan 002D","E01006237",1134,164,50,114,300,183,91,64,143,93,17,10,7,79
"2011","Wigan 002E","E01006238",1090,53,10,43,168,131,82,104,198,221,80,44,36,53
"2011","Wigan 003A","E01006259",1009,100,21,79,208,149,95,83,135,143,23,12,11,73
"2011","Wigan 003B","E01006312",1130,119,28,91,314,180,98,88,151,82,27,11,16,71
"2011","Wigan 003C","E01006313",788,39,8,31,133,93,63,62,150,149,42,21,21,57
"2011","Wigan 003D","E01006314",1260,140,44,96,334,165,154,86,162,117,33,23,10,69
"2011","Wigan 003E","E01006318",1115,127,43,84,290,163,101,77,155,111,16,9,7,75
"2011","Wigan 003F","E01006320",1087,137,33,104,287,173,102,65,146,86,30,15,15,61
"2011","Wigan 003G","E01006321",1298,169,45,124,360,225,103,93,148,96,28,10,18,76
"2011","Wigan 004A","E01006231",1138,119,31,88,279,156,122,81,158,111,36,20,16,76
"2011","Wigan 004B","E01006232",1413,190,57,133,437,190,150,88,131,111,21,12,9,95
"2011","Wigan 004C","E01006234",952,52,17,35,170,145,76,98,171,162,30,15,15,48
"2011","Wigan 004D","E01006235",1035,62,20,42,173,96,80,95,217,196,56,36,20,60
"2011","Wigan 005A","E01006253",1132,44,17,27,147,131,76,109,236,253,69,47,22,67
"2011","Wigan 005B","E01006254",1094,34,11,23,118,103,58,80,246,268,102,65,37,85
"2011","Wigan 005C","E01006255",1141,80,19,61,227,199,95,94,192,161,32,21,11,61
"2011","Wigan 005D","E01006256",1083,76,28,48,174,135,96,110,221,183,29,19,10,59
"2011","Wigan 005E","E01006260",1085,51,13,38,152,142,65,104,197,239,56,32,24,79
"2011","Wigan 006A","E01006370",1272,163,25,138,259,167,113,80,190,148,76,40,36,76
"2011","Wigan 006B","E01006372",1230,221,54,167,380,162,118,53,117,63,20,16,4,96
"2011","Wigan 006C","E01006373",1133,150,29,121,345,166,103,62,135,84,19,11,8,69
"2011","Wigan 006D","E01006374",1125,145,38,107,340,193,101,78,112,72,24,6,18,60
"2011","Wigan 006E","E01006390",1130,69,19,50,193,169,98,79,219,195,45,23,22,63
"2011","Wigan 007A","E01006236",1156,125,36,89,293,184,158,82,139,102,17,8,9,56
"2011","Wigan 007B","E01006388",1267,57,17,40,189,179,81,136,265,244,54,27,27,62
"2011","Wigan 007C","E01006389",1059,51,16,35,194,161,79,100,204,162,41,26,15,67
"2011","Wigan 007D","E01006391",1219,73,25,48,187,166,88,132,259,226,27,13,14,61
"2011","Wigan 008A","E01006257",970,44,11,33,221,153,70,86,174,127,24,12,12,71
"2011","Wigan 008B","E01006258",1227,62,17,45,222,185,85,127,229,197,50,31,19,70
"2011","Wigan 008C","E01006369",1337,49,9,40,201,161,91,106,259,258,124,76,48,88
"2011","Wigan 008D","E01006371",1156,86,20,66,226,183,81,91,197,173,40,22,18,79
"2011","Wigan 008E","E01006375",1193,118,26,92,321,127,130,73,175,118,42,20,22,89
"2011","Wigan 009A","E01006306",1191,27,6,21,131,95,80,130,282,279,117,64,53,50
"2011","Wigan 009B","E01006307",1075,21,9,12,134,103,93,73,252,247,70,39,31,82
"2011","Wigan 009C","E01006386",1204,23,9,14,91,70,81,117,293,339,150,78,72,40
"2011","Wigan 009D","E01006387",937,34,8,26,136,132,60,64,215,171,62,41,21,63
"2011","Wigan 009E","E01006392",1057,20,7,13,93,88,60,71,259,266,121,84,37,79
"2011","Wigan 010A","E01006350",1274,26,10,16,106,99,58,124,268,334,164,111,53,95
"2011","Wigan 010B","E01006351",1470,30,12,18,116,108,57,142,336,370,201,121,80,110
"2011","Wigan 010C","E01006357",1160,16,4,12,62,82,68,92,238,362,167,101,66,73
"2011","Wigan 010D","E01006360",1183,18,8,10,66,64,58,85,279,340,185,129,56,88
"2011","Wigan 010E","E01006361",1140,26,10,16,91,89,65,82,231,322,168,117,51,66
"2011","Wigan 011A","E01006356",1075,35,5,30,92,93,56,91,261,274,103,73,30,70
"2011","Wigan 011B","E01006396",1116,77,17,60,206,166,126,89,199,157,33,20,13,63
"2011","Wigan 011C","E01006397",835,37,15,22,92,85,55,92,217,168,64,46,18,25
"2011","Wigan 011D","E01006398",834,25,3,22,112,90,64,82,175,194,52,36,16,40
"2011","Wigan 011E","E01006399",1150,66,15,51,210,141,101,106,205,181,58,35,23,82
"2011","Wigan 012A","E01006305",1254,28,5,23,109,81,77,84,292,335,151,102,49,97
"2011","Wigan 012B","E01006308",1175,35,10,25,123,116,84,105,261,269,116,78,38,66
"2011","Wigan 012C","E01006309",1160,25,7,18,110,115,77,94,260,283,114,67,47,82
"2011","Wigan 012D","E01006310",1072,36,7,29,120,104,83,90,223,231,111,67,44,74
"2011","Wigan 012E","E01006311",1145,37,10,27,129,93,75,130,236,279,95,58,37,71
"2011","Wigan 013A","E01006269",1204,62,21,41,182,181,93,130,230,190,58,38,20,78
"2011","Wigan 013B","E01006271",1342,128,33,95,282,195,111,120,222,159,46,31,15,79
"2011","Wigan 013C","E01006272",1195,69,17,52,219,143,79,99,218,232,79,50,29,57
"2011","Wigan 013D","E01006273",1130,60,24,36,150,134,105,108,231,213,60,37,23,69
"2011","Wigan 013E","E01006276",1659,130,39,91,310,235,128,158,282,265,57,40,17,94
"2011","Wigan 014A","E01006353",1192,45,15,30,186,148,98,124,220,246,55,35,20,70
"2011","Wigan 014B","E01006354",1104,26,12,14,151,129,73,106,236,244,92,66,26,47
"2011","Wigan 014C","E01006355",1191,55,10,45,199,181,89,131,212,229,42,27,15,53
"2011","Wigan 014D","E01006358",1295,46,16,30,167,149,113,127,264,303,68,42,26,58
"2011","Wigan 014E","E01006359",1097,44,14,30,139,111,76,94,244,246,88,55,33,55
"2011","Wigan 015A","E01006349",1393,95,13,82,265,178,105,121,240,258,59,33,26,72
"2011","Wigan 015B","E01006352",1252,47,18,29,208,147,70,122,248,268,93,58,35,49
"2011","Wigan 015C","E01006404",1170,47,17,30,154,144,97,106,227,245,79,49,30,71
"2011","Wigan 015D","E01006405",1061,36,9,27,142,114,61,86,230,265,67,41,26,60
"2011","Wigan 015E","E01006411",1193,27,8,19,124,96,79,79,249,318,161,90,71,60
"2011","Wigan 016A","E01006270",1127,48,14,34,110,102,88,112,247,259,95,65,30,66
"2011","Wigan 016B","E01006274",1053,24,5,19,125,119,73,123,216,234,74,44,30,65
"2011","Wigan 016C","E01006275",1062,30,6,24,92,84,81,108,249,255,98,71,27,65
"2011","Wigan 016D","E01006277",1325,135,34,101,334,208,119,103,172,101,29,22,7,124
"2011","Wigan 016E","E01006286",1199,52,18,34,191,132,104,134,278,216,45,32,13,47
"2011","Wigan 017A","E01006239",1472,57,16,41,184,143,130,106,291,306,177,112,65,78
"2011","Wigan 017B","E01006240",1100,27,5,22,104,93,83,90,236,238,133,82,51,96
"2011","Wigan 017C","E01006241",1436,68,20,48,204,162,112,117,256,266,163,113,50,88
"2011","Wigan 017D","E01006287",971,83,17,66,191,201,113,68,128,99,20,11,9,68
"2011","Wigan 017E","E01006289",1271,35,13,22,150,127,118,100,239,258,159,96,63,85
"2011","Wigan 018A","E01006362",1312,138,36,102,309,231,114,113,170,123,26,15,11,88
"2011","Wigan 018B","E01006363",1099,94,30,64,263,159,99,102,169,119,30,20,10,64
"2011","Wigan 018C","E01006364",1310,139,28,111,289,170,129,105,170,180,49,26,23,79
"2011","Wigan 018D","E01006365",1604,197,50,147,442,256,126,114,176,139,37,26,11,117
"2011","Wigan 018E","E01006366",1272,114,28,86,288,187,119,96,173,177,47,31,16,71
"2011","Wigan 018F","E01006367",1189,143,44,99,350,183,92,77,154,104,24,19,5,62
"2011","Wigan 018G","E01006368",1197,118,25,93,290,182,130,94,162,137,29,16,13,55
"2011","Wigan 019A","E01006278",1200,65,15,50,193,176,120,116,232,193,48,28,20,57
"2011","Wigan 019B","E01006279",1241,101,30,71,248,228,89,108,200,161,27,18,9,79
"2011","Wigan 019C","E01006280",1037,51,21,30,164,141,85,109,203,191,49,30,19,44
"2011","Wigan 019D","E01006281",1364,105,31,74,293,207,129,128,238,159,35,27,8,70
"2011","Wigan 019E","E01006285",1449,127,40,87,310,218,133,140,239,169,37,25,12,76
"2011","Wigan 020A","E01006406",1173,73,27,46,170,170,85,121,250,215,36,27,9,53
"2011","Wigan 020B","E01006407",1201,74,17,57,224,189,100,115,215,186,25,10,15,73
"2011","Wigan 020C","E01006408",1139,41,12,29,150,126,72,101,224,264,77,43,34,84
"2011","Wigan 020D","E01006409",1080,63,20,43,209,180,72,107,185,178,31,16,15,55
"2011","Wigan 020E","E01006410",1104,84,27,57,242,169,89,101,177,147,29,21,8,66
"2011","Wigan 021A","E01006393",1165,85,23,62,262,202,90,115,198,119,21,14,7,73
"2011","Wigan 021B","E01006394",1206,119,33,86,292,214,98,86,181,119,19,10,9,78
"2011","Wigan 021C","E01006395",1822,194,53,141,516,329,141,157,203,128,17,10,7,137
"2011","Wigan 021D","E01006400",1034,88,28,60,250,192,78,60,157,121,11,7,4,77
"2011","Wigan 021E","E01006401",1125,84,22,62,246,179,121,107,168,142,18,12,6,60
"2011","Wigan 021F","E01006402",950,80,13,67,228,171,78,85,139,109,9,3,6,51
"2011","Wigan 021G","E01006403",1318,89,23,66,275,207,101,139,231,191,26,17,9,59
"2011","Wigan 022A","E01006290",1070,105,24,81,233,166,90,93,161,140,24,15,9,58
"2011","Wigan 022B","E01006291",1083,64,15,49,200,164,95,90,189,178,50,26,24,53
"2011","Wigan 022C","E01006292",1197,79,28,51,225,193,107,118,204,163,39,23,16,69
"2011","Wigan 022D","E01006293",1145,47,15,32,209,164,121,104,205,169,59,34,25,67
"2011","Wigan 023A","E01006242",1239,68,28,40,201,163,141,118,244,189,61,36,25,54
"2011","Wigan 023B","E01006243",1527,164,51,113,390,232,150,124,204,158,32,14,18,73
"2011","Wigan 023C","E01006244",1130,44,14,30,187,135,105,75,266,185,87,52,35,46
"2011","Wigan 023D","E01006245",1868,161,41,120,431,305,168,160,264,230,65,38,27,84
"2011","Wigan 024A","E01006213",1176,43,8,35,140,111,80,93,242,253,129,90,39,85
"2011","Wigan 024B","E01006215",1177,36,11,25,118,94,78,128,259,260,139,96,43,65
"2011","Wigan 024C","E01006217",1666,74,20,54,272,219,132,143,330,280,117,77,40,99
"2011","Wigan 024D","E01006218",1527,83,32,51,214,171,123,141,278,300,117,71,46,100
"2011","Wigan 024E","E01006219",1014,35,14,21,153,139,73,101,203,229,41,25,16,40
"2011","Wigan 025A","E01006288",1285,47,12,35,158,129,105,133,254,223,145,94,51,91
"2011","Wigan 025B","E01006294",1481,96,23,73,296,217,133,144,226,209,68,37,31,92
"2011","Wigan 025C","E01006295",1232,67,17,50,183,175,104,119,222,204,83,42,41,75
"2011","Wigan 025D","E01006377",1247,120,43,77,303,207,112,87,146,144,37,32,5,91
"2011","Wigan 025E","E01006378",1019,94,25,69,258,178,107,80,137,100,24,12,12,41
"2011","Wigan 026A","E01006212",1065,68,24,44,179,164,79,120,199,172,33,21,12,51
"2011","Wigan 026B","E01006214",998,42,11,31,143,105,68,112,199,207,82,45,37,40
"2011","Wigan 026C","E01006216",1633,101,27,74,338,240,138,148,285,246,65,37,28,72
"2011","Wigan 026D","E01006322",1152,51,15,36,112,145,109,107,241,228,76,44,32,83
"2011","Wigan 026E","E01006329",1024,23,9,14,131,98,69,78,168,195,171,146,25,91
"2011","Wigan 027A","E01006282",1256,67,17,50,210,134,111,115,237,216,75,50,25,91
"2011","Wigan 027B","E01006283",1093,48,12,36,154,126,95,90,193,208,103,63,40,76
"2011","Wigan 027C","E01006284",1134,44,8,36,149,131,99,113,223,239,76,50,26,60
"2011","Wigan 027D","E01006336",1115,21,7,14,95,97,85,81,231,275,168,105,63,62
"2011","Wigan 027E","E01006337",1140,61,12,49,240,159,130,107,185,159,36,17,19,63
"2011","Wigan 028A","E01006376",1175,67,10,57,170,154,104,92,230,207,71,42,29,80
"2011","Wigan 028B","E01006381",1436,181,55,126,418,210,117,85,164,109,24,14,10,128
"2011","Wigan 028C","E01006382",1127,139,39,100,265,218,97,79,137,93,21,10,11,78
"2011","Wigan 028D","E01006383",1269,123,44,79,290,189,103,112,177,134,35,24,11,106
"2011","Wigan 028E","E01006384",1136,134,36,98,267,207,102,93,135,113,17,6,11,68
"2011","Wigan 029A","E01006250",1199,127,34,93,322,221,136,99,130,90,13,10,3,61
"2011","Wigan 029B","E01006251",1127,107,28,79,277,195,131,76,149,97,31,22,9,64
"2011","Wigan 029C","E01006379",1179,125,21,104,261,203,117,105,149,143,28,21,7,48
"2011","Wigan 029D","E01006380",1176,71,14,57,217,142,107,107,201,181,63,37,26,87
"2011","Wigan 029E","E01006385",1158,137,28,109,283,222,88,81,163,100,13,7,6,71
"2011","Wigan 030A","E01006328",1084,34,11,23,138,121,95,109,237,195,90,51,39,65
"2011","Wigan 030B","E01006333",1342,61,16,45,213,176,118,114,242,254,88,59,29,76
"2011","Wigan 030C","E01006334",1306,39,13,26,181,159,82,109,283,254,132,86,46,67
"2011","Wigan 030D","E01006338",1167,59,7,52,205,169,102,95,221,207,59,38,21,50
"2011","Wigan 031A","E01006248",1151,25,5,20,113,86,108,105,251,273,132,71,61,58
"2011","Wigan 031B","E01006249",1150,49,15,34,155,125,103,98,222,208,103,70,33,87
"2011","Wigan 031C","E01006330",1261,122,44,78,290,228,138,100,155,108,45,29,16,75
"2011","Wigan 031D","E01006331",1231,132,48,84,318,205,100,103,146,117,35,22,13,75
"2011","Wigan 031E","E01006332",1447,119,43,76,302,187,126,120,216,229,59,32,27,89
"2011","Wigan 032A","E01006262",1134,47,10,37,168,131,94,91,212,251,78,47,31,62
"2011","Wigan 032B","E01006263",1188,109,26,83,286,216,89,94,153,139,32,18,14,70
"2011","Wigan 032C","E01006266",1081,63,18,45,218,162,94,93,203,168,23,14,9,57
"2011","Wigan 032D","E01006267",1155,39,13,26,144,117,89,95,247,261,98,59,39,65
"2011","Wigan 032E","E01006268",1304,85,20,65,260,188,109,112,205,201,56,39,17,88
"2011","Wigan 033A","E01006323",1108,26,8,18,152,112,87,117,237,236,73,40,33,68
"2011","Wigan 033B","E01006324",994,37,8,29,131,104,75,96,246,183,66,38,28,56
"2011","Wigan 033C","E01006325",1212,55,17,38,178,172,120,108,213,217,63,35,28,86
"2011","Wigan 033D","E01006326",1084,33,11,22,139,143,64,102,246,207,68,38,30,82
"2011","Wigan 033E","E01006327",1045,32,9,23,114,102,77,96,213,214,122,85,37,75
"2011","Wigan 034A","E01006246",1184,69,16,53,185,160,102,119,203,202,75,41,34,69
"2011","Wigan 034B","E01006247",1003,67,20,47,206,150,112,88,153,141,31,20,11,55
"2011","Wigan 034C","E01006252",1102,71,24,47,230,205,114,90,175,137,35,23,12,45
"2011","Wigan 034D","E01006297",1160,38,7,31,120,127,63,105,261,277,95,52,43,74
"2011","Wigan 034E","E01006335",1283,47,21,26,198,189,110,113,230,223,89,53,36,84
"2011","Wigan 035A","E01006220",1292,52,17,35,190,145,116,98,257,289,77,48,29,68
"2011","Wigan 035B","E01006221",1232,72,19,53,265,212,103,100,195,173,43,26,17,69
"2011","Wigan 035C","E01006222",1173,97,31,66,270,189,97,93,169,143,30,16,14,85
"2011","Wigan 035D","E01006224",1111,117,33,84,267,181,94,91,129,129,18,8,10,85
"2011","Wigan 035E","E01006226",1339,81,25,56,310,192,117,130,199,211,38,25,13,61
"2011","Wigan 036A","E01006223",1193,78,23,55,248,159,109,117,204,178,38,22,16,62
"2011","Wigan 036B","E01006225",1096,107,29,78,268,167,107,84,148,117,40,24,16,58
"2011","Wigan 036C","E01006261",1125,60,23,37,202,158,99,111,192,201,36,26,10,66
"2011","Wigan 036D","E01006264",1103,118,33,85,278,213,82,91,144,94,22,13,9,61
"2011","Wigan 036E","E01006265",1082,76,19,57,233,166,88,97,157,156,42,35,7,67
"2011","Wigan 037A","E01006296",1114,37,14,23,131,136,64,103,238,223,108,61,47,74
"2011","Wigan 037B","E01006298",1008,50,8,42,136,142,73,67,200,181,88,59,29,71
"2011","Wigan 037C","E01006299",1439,175,35,140,354,254,137,116,160,126,36,22,14,81
"2011","Wigan 037D","E01006300",993,164,35,129,291,147,102,70,87,69,16,12,4,47
"2011","Wigan 037E","E01006301",1032,154,34,120,297,167,118,55,88,53,20,10,10,80
"2011","Wigan 038A","E01006227",1166,75,21,54,245,166,90,103,186,192,37,24,13,72
"2011","Wigan 038B","E01006228",1270,63,20,43,218,156,96,119,246,244,57,30,27,71
"2011","Wigan 038C","E01006342",1127,47,19,28,163,124,90,92,211,258,59,40,19,83
"2011","Wigan 038D","E01006344",1019,34,18,16,139,97,65,88,201,240,92,57,35,63
"2011","Wigan 038E","E01006346",1584,125,33,92,321,208,126,131,268,263,59,31,28,83
"2011","Wigan 039A","E01006339",1088,114,31,83,255,192,96,88,154,107,20,14,6,62
"2011","Wigan 039B","E01006340",1046,72,20,52,192,124,74,86,193,190,62,44,18,53
"2011","Wigan 039C","E01006343",1279,191,41,150,355,228,104,79,112,99,30,15,15,81
"2011","Wigan 039D","E01006345",1139,144,37,107,306,177,91,86,139,101,47,36,11,48
"2011","Wigan 039E","E01006348",1207,181,57,124,292,194,176,72,125,75,26,15,11,66
"2011","Wigan 040A","E01006302",1243,119,27,92,318,177,125,103,160,132,29,15,14,80
"2011","Wigan 040B","E01006303",1090,98,25,73,233,191,117,103,162,105,22,17,5,59
"2011","Wigan 040C","E01006304",1079,108,29,79,235,152,118,77,158,121,39,25,14,71
"2011","Wigan 040D","E01006341",1213,115,32,83,262,170,106,85,183,156,70,43,27,66
"2011","Wigan 040E","E01006347",1157,151,37,114,314,195,114,80,123,79,16,11,5,85
"2011","Burnley 001A","E01024859",1170,80,24,56,248,208,86,115,197,140,31,18,13,65
"2011","Burnley 001B","E01024861",1016,87,22,65,213,170,91,86,163,118,20,13,7,68
"2011","Burnley 001C","E01024862",1205,83,29,54,281,196,88,119,213,145,24,12,12,56
"2011","Burnley 001D","E01024891",1115,105,23,82,218,141,89,78,157,151,89,68,21,87
"2011","Burnley 001E","E01024892",1022,60,18,42,177,141,87,95,185,150,60,49,11,67
"2011","Burnley 001F","E01024894",1026,68,24,44,207,122,65,90,189,160,47,32,15,78
"2011","Burnley 002A","E01024893",1014,49,9,40,151,103,65,96,179,194,103,77,26,74
"2011","Burnley 002B","E01024896",1020,65,17,48,212,143,88,75,181,156,44,30,14,56
"2011","Burnley 002C","E01024897",905,59,13,46,157,100,88,80,142,122,94,77,17,63
"2011","Burnley 002D","E01024898",1155,35,12,23,149,120,68,104,245,232,133,97,36,69
"2011","Burnley 003A","E01024856",1063,23,4,19,124,82,85,92,206,202,176,148,28,73
"2011","Burnley 003B","E01024875",898,23,2,21,51,51,94,42,132,152,251,223,28,102
"2011","Burnley 003C","E01024876",945,35,3,32,67,70,95,46,144,134,253,217,36,101
"2011","Burnley 003D","E01024877",1021,21,3,18,68,57,86,83,133,152,300,266,34,121
"2011","Burnley 003E","E01024878",975,33,4,29,50,72,65,77,139,145,280,258,22,114
"2011","Burnley 003F","E01024895",967,22,4,18,86,64,81,96,170,191,180,137,43,77
"2011","Burnley 004A","E01024883",1065,57,20,37,172,129,105,71,209,183,69,39,30,70
"2011","Burnley 004B","E01024884",1132,72,25,47,237,146,98,99,192,167,47,31,16,74
"2011","Burnley 004C","E01024885",1269,59,16,43,192,147,104,122,255,257,76,47,29,57
"2011","Burnley 004D","E01024886",1019,24,3,21,149,123,75,110,234,205,40,23,17,59
"2011","Burnley 004E","E01024889",947,66,16,50,213,119,91,91,134,137,43,24,19,53
"2011","Burnley 004F","E01024890",1027,28,9,19,137,104,86,88,233,202,77,46,31,72
"2011","Burnley 005A","E01024879",954,33,9,24,166,121,69,89,183,163,55,31,24,75
"2011","Burnley 005B","E01024880",1022,69,20,49,203,126,87,83,169,152,70,57,13,63
"2011","Burnley 005C","E01024912",1032,140,32,108,266,158,105,75,137,76,22,17,5,53
"2011","Burnley 005D","E01024913",1007,118,31,87,257,142,94,90,138,70,16,12,4,82
"2011","Burnley 005E","E01024914",1157,130,38,92,313,188,113,84,148,90,29,17,12,62
"2011","Burnley 006A","E01024881",1059,54,18,36,188,144,74,79,213,178,51,34,17,78
"2011","Burnley 006B","E01024882",1090,39,11,28,169,127,68,92,251,206,64,38,26,74
"2011","Burnley 006C","E01024902",1101,45,17,28,186,141,76,100,216,222,50,30,20,65
"2011","Burnley 006D","E01024911",1301,89,26,63,221,158,98,139,237,207,81,59,22,71
"2011","Burnley 007A","E01024855",1031,24,11,13,129,115,48,85,240,244,84,61,23,62
"2011","Burnley 007B","E01024857",1025,63,27,36,173,129,64,73,196,162,89,69,20,76
"2011","Burnley 007C","E01024858",955,25,3,22,102,60,78,72,192,210,151,98,53,65
"2011","Burnley 007D","E01024864",1218,46,10,36,191,145,65,109,298,243,50,20,30,71
"2011","Burnley 008A","E01024863",1047,41,8,33,149,115,74,115,218,181,71,39,32,83
"2011","Burnley 008B","E01024865",1061,34,16,18,137,125,66,103,236,226,60,41,19,74
"2011","Burnley 008C","E01024866",1303,92,27,65,246,152,98,108,268,201,56,35,21,82
"2011","Burnley 008D","E01024867",1076,114,33,81,307,184,98,89,144,72,12,5,7,56
"2011","Burnley 009A","E01024860",983,114,40,74,238,138,135,69,138,83,15,9,6,53
"2011","Burnley 009B","E01024868",896,89,27,62,242,130,107,58,118,75,22,9,13,55
"2011","Burnley 009C","E01024869",1068,124,41,83,241,166,152,64,159,96,14,8,6,52
"2011","Burnley 009D","E01024870",887,106,28,78,246,131,135,50,96,59,12,8,4,52
"2011","Burnley 010A","E01024872",969,22,6,16,94,77,59,77,224,230,117,82,35,69
"2011","Burnley 010B","E01024899",1160,42,18,24,145,123,83,98,240,228,127,85,42,74
"2011","Burnley 010C","E01024900",1127,34,15,19,100,66,47,107,287,275,133,93,40,78
"2011","Burnley 010D","E01024907",917,32,11,21,109,77,64,90,202,191,99,51,48,53
"2011","Burnley 010E","E01024908",807,20,5,15,58,62,31,64,188,205,128,84,44,51
"2011","Burnley 010F","E01024909",1139,48,17,31,191,129,72,93,216,193,118,87,31,79
"2011","Burnley 011A","E01024874",838,97,31,66,213,109,110,60,103,70,21,13,8,55
"2011","Burnley 011B","E01024887",1134,64,21,43,197,130,132,112,212,180,48,39,9,59
"2011","Burnley 011C","E01024888",1252,123,47,76,279,188,153,97,181,139,32,19,13,60
"2011","Burnley 011D","E01024901",1425,125,40,85,369,200,126,125,201,153,24,14,10,102
"2011","Burnley 014D","E01024871",988,108,28,80,208,149,102,79,131,100,53,38,15,58
"2011","Burnley 014E","E01024873",1012,69,25,44,200,140,88,90,201,129,36,21,15,59
"2011","Burnley 014F","E01024903",886,39,12,27,117,90,64,83,199,141,67,38,29,86
"2011","Burnley 014A","E01024904",1299,99,24,75,257,134,117,103,230,162,95,64,31,102
"2011","Burnley 014G","E01024905",922,87,24,63,218,137,103,84,123,80,27,20,7,63
"2011","Burnley 014B","E01024906",1174,31,8,23,111,71,71,114,271,297,137,82,55,71
"2011","Burnley 014C","E01024910",1078,60,16,44,176,120,64,102,219,163,84,46,38,90
"2011","Chorley 001A","E01024951",884,47,12,35,109,100,41,72,183,181,70,45,25,81
"2011","Chorley 001B","E01024952",971,78,19,59,199,130,58,99,168,134,58,33,25,47
"2011","Chorley 001C","E01024953",1046,43,17,26,148,119,64,101,230,170,110,70,40,61
"2011","Chorley 001D","E01024954",1108,70,15,55,254,162,97,99,201,132,43,29,14,50
"2011","Chorley 002A","E01024921",1644,203,53,150,483,203,261,115,140,90,46,40,6,103
"2011","Chorley 002B","E01024978",999,142,37,105,249,137,103,60,138,98,22,12,10,50
"2011","Chorley 002C","E01024979",1045,192,41,151,332,119,155,56,72,39,15,6,9,65
"2011","Chorley 002D","E01024980",1009,153,34,119,275,111,113,63,116,95,22,12,10,61
"2011","Chorley 003A","E01024946",891,137,32,105,243,145,75,65,82,72,22,10,12,50
"2011","Chorley 003B","E01024947",985,176,45,131,297,148,89,55,102,47,13,9,4,58
"2011","Chorley 003C","E01024955",1193,166,46,120,303,206,84,98,137,80,51,43,8,68
"2011","Chorley 003D","E01024956",1115,178,42,136,319,203,77,70,121,68,22,14,8,57
"2011","Chorley 003E","E01024957",1096,148,38,110,291,153,112,59,133,96,27,22,5,77
"2011","Chorley 003F","E01024958",1003,69,21,48,197,163,79,101,185,118,36,22,14,55
"2011","Chorley 004A","E01024948",1087,141,35,106,272,164,125,83,128,91,25,17,8,58
"2011","Chorley 004B","E01024949",1743,236,55,181,510,252,150,119,205,143,47,29,18,81
"2011","Chorley 004C","E01024950",999,217,54,163,319,121,114,43,65,40,15,7,8,65
"2011","Chorley 004D","E01024977",1656,358,101,257,536,201,181,71,129,73,17,10,7,90
"2011","Chorley 005A","E01024967",1010,124,34,90,252,160,112,85,126,79,15,9,6,57
"2011","Chorley 005B","E01024968",1303,242,60,182,409,221,96,60,118,66,23,13,10,68
"2011","Chorley 005C","E01024969",999,144,39,105,215,146,96,54,131,117,42,28,14,54
"2011","Chorley 005D","E01024970",1035,121,28,93,275,165,99,74,158,88,15,9,6,40
"2011","Chorley 005E","E01024971",952,152,46,106,244,162,90,66,92,59,26,24,2,61
"2011","Chorley 005F","E01024972",989,106,30,76,237,175,94,76,134,95,12,5,7,60
"2011","Chorley 006A","E01024929",919,26,8,18,108,103,64,87,185,221,55,42,13,70
"2011","Chorley 006B","E01024930",1062,88,22,66,193,133,104,79,194,174,32,19,13,65
"2011","Chorley 006C","E01024931",1086,75,17,58,195,149,94,79,203,174,53,34,19,64
"2011","Chorley 006D","E01024932",792,123,34,89,200,119,89,48,71,73,22,14,8,47
"2011","Chorley 006E","E01024933",1029,93,20,73,209,133,76,86,181,136,45,28,17,70
"2011","Chorley 006F","E01024937",1104,152,36,116,321,160,101,68,116,83,25,16,9,78
"2011","Chorley 007A","E01024964",1084,166,42,124,324,140,171,59,86,58,17,9,8,63
"2011","Chorley 007B","E01024974",1159,192,41,151,321,146,166,46,106,89,16,9,7,77
"2011","Chorley 007C","E01024975",2785,150,37,113,283,206,358,270,357,685,397,363,34,79
"2011","Chorley 007D","E01024976",1131,118,34,84,294,149,127,75,140,125,25,14,11,78
"2011","Chorley 008A","E01024919",1882,230,40,190,478,254,132,106,274,179,114,68,46,115
"2011","Chorley 008B","E01024920",1521,258,67,191,405,242,103,82,200,128,40,22,18,63
"2011","Chorley 008C","E01024934",1063,150,26,124,295,147,93,70,125,85,34,17,17,64
"2011","Chorley 008D","E01024935",1056,77,22,55,244,206,90,96,168,117,22,16,6,36
"2011","Chorley 009A","E01024925",1165,45,7,38,139,123,89,98,220,244,137,103,34,70
"2011","Chorley 009B","E01024926",1404,92,23,69,237,147,125,123,226,264,106,73,33,84
"2011","Chorley 009C","E01024927",1244,61,12,49,233,164,122,104,228,217,50,35,15,65
"2011","Chorley 009D","E01024928",1142,83,31,52,188,162,109,102,219,182,43,22,21,54
"2011","Chorley 010A","E01024936",1171,72,12,60,240,152,97,94,220,170,60,40,20,66
"2011","Chorley 010B","E01024938",1208,97,26,71,256,193,84,108,210,173,23,13,10,64
"2011","Chorley 010C","E01024939",1281,179,40,139,348,229,125,99,114,98,21,12,9,68
"2011","Chorley 010D","E01024940",1334,51,13,38,219,162,89,101,262,272,91,59,32,87
"2011","Chorley 010E","E01024941",1170,58,12,46,165,129,76,98,205,271,98,74,24,70
"2011","Chorley 011A","E01024923",939,134,40,94,257,101,148,67,97,70,11,9,2,54
"2011","Chorley 011B","E01024924",1088,113,37,76,258,159,148,103,154,80,14,8,6,59
"2011","Chorley 011C","E01024963",1134,119,42,77,260,166,109,111,151,133,17,9,8,68
"2011","Chorley 011D","E01024965",1059,154,57,97,298,171,138,66,81,64,13,9,4,74
"2011","Chorley 011E","E01024966",1192,125,35,90,287,177,160,75,155,118,20,13,7,75
"2011","Chorley 012A","E01024942",1158,63,17,46,137,120,79,95,245,266,87,53,34,66
"2011","Chorley 012B","E01024943",1645,129,35,94,320,196,144,144,291,219,102,63,39,100
"2011","Chorley 012C","E01024944",1299,165,34,131,363,209,108,87,145,99,27,14,13,96
"2011","Chorley 012D","E01024945",2021,189,40,149,437,279,157,174,320,243,97,69,28,125
"2011","Chorley 013A","E01024922",1053,103,36,67,223,134,126,94,151,146,30,17,13,46
"2011","Chorley 013B","E01024959",1254,54,11,43,198,125,112,125,256,229,82,45,37,73
"2011","Chorley 013C","E01024960",1172,67,13,54,200,163,101,125,215,208,29,18,11,64
"2011","Chorley 013D","E01024961",1230,93,31,62,249,161,120,116,203,183,31,18,13,74
"2011","Chorley 013E","E01024962",1158,96,29,67,239,172,108,125,193,144,30,19,11,51
"2011","Chorley 014A","E01024915",1562,153,29,124,332,223,156,119,268,179,37,17,20,95
"2011","Chorley 014B","E01024916",1251,153,43,110,330,191,131,92,146,125,31,21,10,52
"2011","Chorley 014C","E01024917",1304,122,35,87,232,160,101,120,217,226,47,21,26,79
"2011","Chorley 014D","E01024918",1292,168,35,133,378,199,139,88,144,92,17,12,5,67
"2011","Chorley 014E","E01024973",1586,220,47,173,429,225,191,105,176,133,27,21,6,80
"2011","Fylde 001A","E01024993",1110,163,45,118,304,128,156,75,126,81,12,7,5,65
"2011","Fylde 001B","E01025026",973,114,37,77,253,100,228,49,99,52,23,18,5,55
"2011","Fylde 001C","E01025027",1287,151,48,103,312,214,159,89,133,105,44,24,20,80
"2011","Fylde 001D","E01025028",1024,105,28,77,242,150,136,76,132,74,25,12,13,84
"2011","Fylde 001E","E01025031",884,86,25,61,195,104,183,57,122,88,12,9,3,37
"2011","Fylde 002A","E01025007",984,165,33,132,226,155,78,78,109,63,20,17,3,90
"2011","Fylde 002B","E01025008",850,108,23,85,228,140,80,82,95,56,14,10,4,47
"2011","Fylde 002C","E01025009",1078,90,16,74,202,170,85,107,178,146,42,26,16,58
"2011","Fylde 002D","E01025011",1046,62,21,41,159,106,83,124,219,178,60,39,21,55
"2011","Fylde 002E","E01025012",1478,176,50,126,339,220,136,129,199,150,22,13,9,107
"2011","Fylde 002F","E01025013",1199,100,16,84,219,150,88,124,222,174,42,23,19,80
"2011","Fylde 002G","E01025019",1011,220,45,175,283,146,112,45,86,49,17,9,8,53
"2011","Fylde 003A","E01024998",1253,111,30,81,250,161,127,101,210,159,56,30,26,78
"2011","Fylde 003B","E01025010",1485,135,32,103,259,167,174,126,196,234,134,105,29,60
"2011","Fylde 003C","E01025014",1280,180,56,124,303,176,211,95,127,89,29,22,7,70
"2011","Fylde 003D","E01025015",1171,201,47,154,281,173,94,96,139,92,21,14,7,74
"2011","Fylde 004A","E01025004",931,108,23,85,197,171,114,66,117,68,31,14,17,59
"2011","Fylde 004B","E01025006",952,49,6,43,140,114,89,97,226,127,52,37,15,58
"2011","Fylde 004C","E01025023",985,120,19,101,242,192,94,64,135,58,21,12,9,59
"2011","Fylde 004D","E01025024",932,96,18,78,182,130,111,61,162,108,38,17,21,44
"2011","Fylde 004E","E01025025",1108,113,15,98,243,162,105,66,172,115,49,35,14,83
"2011","Fylde 005A","E01025001",1046,98,27,71,193,159,139,72,172,106,38,28,10,69
"2011","Fylde 005B","E01025002",1056,122,14,108,238,178,112,76,156,77,30,17,13,67
"2011","Fylde 005C","E01025005",1007,127,30,97,233,184,141,56,125,77,29,18,11,35
"2011","Fylde 005D","E01025016",1648,357,86,271,499,240,188,64,127,47,35,27,8,91
"2011","Fylde 005E","E01025018",861,120,25,95,232,145,117,47,94,44,23,16,7,39
"2011","Fylde 006A","E01024984",987,144,30,114,294,158,114,29,109,56,25,16,9,58
"2011","Fylde 006B","E01024985",975,155,27,128,253,145,98,54,134,51,25,18,7,60
"2011","Fylde 006C","E01024986",1035,125,26,99,226,144,132,75,150,73,67,40,27,43
"2011","Fylde 006D","E01024987",1037,77,10,67,192,124,112,66,196,148,73,46,27,49
"2011","Fylde 006E","E01024988",1047,145,28,117,271,120,126,66,128,78,58,43,15,55
"2011","Fylde 006F","E01024989",1046,140,37,103,270,128,121,76,131,73,41,26,15,66
"2011","Fylde 006G","E01024996",874,119,34,85,160,98,110,53,144,78,63,39,24,49
"2011","Fylde 007A","E01024997",1045,150,34,116,210,169,112,95,144,66,13,6,7,86
"2011","Fylde 007B","E01024999",1108,108,23,85,198,179,116,106,194,122,20,9,11,65
"2011","Fylde 007C","E01025000",993,107,18,89,184,178,80,96,149,118,25,15,10,56
"2011","Fylde 007D","E01025029",1475,173,39,134,343,202,168,137,214,145,29,17,12,64
"2011","Fylde 007E","E01025030",1186,119,23,96,227,157,93,104,203,137,57,39,18,89
"2011","Fylde 008A","E01024981",948,206,45,161,291,146,87,41,83,40,12,10,2,42
"2011","Fylde 008B","E01024982",829,178,44,134,215,99,110,29,67,50,40,31,9,41
"2011","Fylde 008C","E01024983",1061,192,35,157,293,154,115,47,109,45,23,10,13,83
"2011","Fylde 008D","E01024994",1114,253,48,205,340,162,115,45,88,26,25,12,13,60
"2011","Fylde 008E","E01024995",1017,198,43,155,297,162,106,40,74,42,28,15,13,70
"2011","Fylde 008F","E01025003",1123,163,43,120,305,206,122,49,130,60,25,15,10,63
"2011","Fylde 008G","E01025017",971,94,18,76,219,145,90,77,151,120,25,20,5,50
"2011","Fylde 009A","E01024990",1135,208,39,169,325,147,154,62,98,38,40,24,16,63
"2011","Fylde 009B","E01024991",638,133,28,105,173,73,98,26,62,20,16,10,6,37
"2011","Fylde 009C","E01024992",897,145,24,121,235,185,74,47,119,41,18,10,8,33
"2011","Fylde 009D","E01025020",931,124,31,93,220,117,101,56,136,85,33,20,13,59
"2011","Fylde 009E","E01025021",1053,207,49,158,318,138,91,46,105,60,26,16,10,62
"2011","Fylde 009F","E01025022",1380,247,53,194,352,196,135,94,148,80,35,27,8,93
"2011","Hyndburn 001A","E01025060",1062,36,8,28,140,124,76,94,233,182,79,50,29,98
"2011","Hyndburn 001B","E01025061",1027,89,26,63,194,124,116,100,166,139,41,31,10,58
"2011","Hyndburn 001C","E01025062",1103,38,13,25,119,110,121,99,243,185,98,79,19,90
"2011","Hyndburn 001D","E01025063",1133,59,21,38,190,131,110,126,228,165,47,28,19,77
"2011","Hyndburn 001E","E01025064",1204,160,47,113,315,171,172,91,127,76,26,20,6,66
"2011","Hyndburn 001F","E01025065",1218,58,26,32,210,157,113,140,237,189,47,33,14,67
"2011","Hyndburn 001G","E01025066",1172,96,33,63,283,167,97,111,189,122,32,24,8,75
"2011","Hyndburn 002A","E01025032",1028,50,17,33,168,111,79,87,195,207,54,38,16,77
"2011","Hyndburn 002B","E01025033",1652,175,58,117,435,256,173,127,198,128,43,28,15,117
"2011","Hyndburn 002C","E01025034",1267,67,16,51,237,175,115,120,203,195,77,50,27,78
"2011","Hyndburn 002D","E01025048",1180,120,34,86,285,193,117,101,148,107,21,18,3,88
"2011","Hyndburn 002E","E01025049",1194,40,13,27,129,123,108,123,261,238,99,74,25,73
"2011","Hyndburn 002F","E01025050",1133,86,30,56,227,149,137,99,168,147,42,34,8,78
"2011","Hyndburn 002G","E01025053",1143,89,31,58,255,166,117,91,164,149,47,38,9,65
"2011","Hyndburn 003A","E01025070",832,38,11,27,110,86,70,72,173,157,52,31,21,74
"2011","Hyndburn 003B","E01025071",1067,71,25,46,202,150,92,99,160,158,44,29,15,91
"2011","Hyndburn 003C","E01025072",997,38,10,28,162,110,88,90,202,172,69,42,27,66
"2011","Hyndburn 003D","E01025073",987,72,22,50,220,135,87,98,159,122,39,24,15,55
"2011","Hyndburn 003E","E01025074",1064,124,42,82,256,163,112,90,136,86,24,18,6,73
"2011","Hyndburn 004A","E01025051",1019,68,19,49,178,107,96,94,165,148,107,83,24,56
"2011","Hyndburn 004B","E01025052",1145,101,40,61,260,183,103,108,163,127,29,22,7,71
"2011","Hyndburn 004C","E01025057",1137,72,23,49,176,168,101,107,199,153,57,47,10,104
"2011","Hyndburn 004D","E01025058",969,51,16,35,166,144,83,79,184,157,51,34,17,54
"2011","Hyndburn 004E","E01025059",1008,33,14,19,151,103,89,94,192,199,77,51,26,70
"2011","Hyndburn 004F","E01025067",1113,30,8,22,148,109,72,113,235,249,69,52,17,88
"2011","Hyndburn 004G","E01025068",1055,44,8,36,121,100,78,90,216,212,108,60,48,86
"2011","Hyndburn 004H","E01025069",1051,46,18,28,149,148,80,117,212,183,52,29,23,64
"2011","Hyndburn 005A","E01025044",876,28,6,22,123,87,65,79,194,162,75,47,28,63
"2011","Hyndburn 005B","E01025045",829,22,7,15,89,84,36,79,171,175,90,62,28,83
"2011","Hyndburn 005C","E01025046",882,21,10,11,105,82,66,91,187,191,89,50,39,50
"2011","Hyndburn 005D","E01025081",1275,88,28,60,290,203,129,133,166,148,19,12,7,99
"2011","Hyndburn 006A","E01025041",1101,24,6,18,99,68,123,73,184,178,249,227,22,103
"2011","Hyndburn 006B","E01025042",1356,26,5,21,90,81,140,74,218,185,360,330,30,182
"2011","Hyndburn 006E","E01025082",1170,26,15,11,111,85,90,84,252,241,177,136,41,104
"2011","Hyndburn 006F","E01025083",1328,30,7,23,140,113,111,128,273,235,197,150,47,101
"2011","Hyndburn 006G","E01025084",1091,34,11,23,74,75,124,59,190,208,226,193,33,101
"2011","Hyndburn 006H","E01033231",1861,60,13,47,136,134,201,119,313,259,412,371,41,227
"2011","Hyndburn 007A","E01025055",1054,48,12,36,144,112,107,115,211,200,55,36,19,62
"2011","Hyndburn 007B","E01025075",1281,82,23,59,251,152,89,118,224,214,62,39,23,89
"2011","Hyndburn 007C","E01025076",926,58,18,40,200,112,77,77,171,139,36,24,12,56
"2011","Hyndburn 007D","E01025077",1005,52,16,36,170,114,92,82,185,196,53,39,14,61
"2011","Hyndburn 007E","E01025078",1172,87,32,55,240,186,101,132,183,165,23,15,8,55
"2011","Hyndburn 008A","E01025035",1130,90,23,67,232,146,113,114,183,118,55,39,16,79
"2011","Hyndburn 008B","E01025036",1146,42,11,31,146,107,97,82,253,215,142,104,38,62
"2011","Hyndburn 008C","E01025037",1046,76,22,54,223,127,111,73,163,129,81,58,23,63
"2011","Hyndburn 008D","E01025038",986,108,33,75,220,166,92,77,152,98,18,7,11,55
"2011","Hyndburn 008E","E01025039",939,110,35,75,229,151,93,74,123,77,9,5,4,73
"2011","Hyndburn 008F","E01025040",1128,117,40,77,259,171,121,96,146,114,34,23,11,70
"2011","Hyndburn 009A","E01025054",1324,105,39,66,269,173,163,107,214,175,41,26,15,77
"2011","Hyndburn 009B","E01025056",1010,84,29,55,239,141,99,112,164,113,14,10,4,44
"2011","Hyndburn 009C","E01025079",1252,75,22,53,232,201,107,138,216,171,33,24,9,79
"2011","Hyndburn 009D","E01025080",1228,108,36,72,266,161,151,109,184,128,42,35,7,79
"2011","Lancaster 001A","E01025088",828,81,19,62,207,115,77,89,111,75,19,15,4,54
"2011","Lancaster 001B","E01025096",1181,72,23,49,277,163,109,132,206,132,25,11,14,65
"2011","Lancaster 001C","E01025097",1049,48,9,39,160,104,67,123,233,189,55,39,16,70
"2011","Lancaster 001D","E01025098",984,106,22,84,220,126,122,93,154,104,14,10,4,45
"2011","Lancaster 001E","E01025148",1460,290,55,235,426,144,207,77,126,81,22,16,6,87
"2011","Lancaster 001F","E01025168",813,86,17,69,177,104,112,58,116,97,22,12,10,41
"2011","Lancaster 001G","E01025169",920,108,28,80,239,119,113,70,131,75,18,15,3,47
"2011","Lancaster 002A","E01025130",1583,239,46,193,392,203,303,99,158,90,26,18,8,73
"2011","Lancaster 002B","E01025132",1126,176,40,136,298,104,246,59,97,66,25,19,6,55
"2011","Lancaster 002C","E01025166",827,145,29,116,226,95,136,44,68,52,21,14,7,40
"2011","Lancaster 002D","E01025167",884,157,39,118,202,83,193,42,89,52,11,8,3,55
"2011","Lancaster 003A","E01025089",1006,114,32,82,256,134,141,79,127,85,19,14,5,51
"2011","Lancaster 003B","E01025090",1234,113,26,87,303,205,149,91,167,116,22,15,7,68
"2011","Lancaster 003C","E01025158",934,142,36,106,289,153,119,42,83,44,13,8,5,49
"2011","Lancaster 003D","E01025159",1081,150,35,115,257,147,131,73,108,76,26,16,10,113
"2011","Lancaster 003E","E01025160",910,149,34,115,238,154,112,43,98,53,9,5,4,54
"2011","Lancaster 004A","E01025085",968,88,21,67,248,137,113,63,128,89,46,39,7,56
"2011","Lancaster 004B","E01025086",924,95,24,71,218,142,133,61,133,77,19,11,8,46
"2011","Lancaster 004C","E01025087",776,53,11,42,185,99,98,46,146,76,35,21,14,38
"2011","Lancaster 004D","E01025161",733,59,13,46,168,110,94,65,99,87,21,12,9,30
"2011","Lancaster 005A","E01025108",888,129,21,108,243,137,72,54,114,82,17,13,4,40
"2011","Lancaster 005B","E01025109",744,111,29,82,213,93,88,52,86,58,10,6,4,33
"2011","Lancaster 005C","E01025131",1128,147,30,117,273,117,164,78,136,105,35,29,6,73
"2011","Lancaster 005D","E01025133",984,157,29,128,242,139,121,60,122,80,21,14,7,42
"2011","Lancaster 006A","E01025112",1207,54,12,42,168,131,108,84,262,223,96,67,29,81
"2011","Lancaster 006B","E01025136",1070,24,4,20,138,106,86,96,255,185,101,53,48,79
"2011","Lancaster 006C","E01025138",1021,34,8,26,170,123,84,111,209,164,49,29,20,77
"2011","Lancaster 006D","E01025139",1255,52,8,44,148,90,147,121,255,202,126,81,45,114
"2011","Lancaster 006E","E01025140",1068,55,10,45,176,116,107,79,178,177,103,77,26,77
"2011","Lancaster 008A","E01025111",1283,45,15,30,193,173,121,104,281,204,69,45,24,93
"2011","Lancaster 008B","E01025113",1180,51,18,33,225,162,100,101,244,180,33,22,11,84
"2011","Lancaster 008C","E01025118",796,23,3,20,113,79,78,80,173,142,51,39,12,57
"2011","Lancaster 008D","E01025119",945,36,15,21,151,136,88,101,204,142,34,17,17,53
"2011","Lancaster 009A","E01025110",1105,38,17,21,134,89,102,94,225,215,112,58,54,96
"2011","Lancaster 009B","E01025116",1041,53,11,42,210,140,121,82,163,124,95,77,18,53
"2011","Lancaster 009C","E01025117",1072,40,12,28,135,80,70,84,209,235,116,74,42,103
"2011","Lancaster 009D","E01025120",1015,41,11,30,143,73,99,72,241,187,76,44,32,83
"2011","Lancaster 010A","E01025170",1196,53,18,35,204,164,109,109,277,184,36,22,14,60
"2011","Lancaster 010B","E01025171",1173,35,9,26,153,136,87,89,264,216,96,65,31,97
"2011","Lancaster 010C","E01025172",1135,73,23,50,201,172,82,93,251,135,56,38,18,72
"2011","Lancaster 010D","E01025173",1163,20,7,13,150,122,108,115,287,238,62,46,16,61
"2011","Lancaster 011A","E01025149",1605,108,28,80,363,214,108,140,302,219,68,42,26,83
"2011","Lancaster 011B","E01025150",1092,70,13,57,204,100,82,104,232,166,60,45,15,74
"2011","Lancaster 011C","E01025151",1194,51,13,38,195,107,86,93,244,221,79,55,24,118
"2011","Lancaster 011D","E01025152",1077,61,8,53,182,139,83,95,204,166,66,44,22,81
"2011","Lancaster 011E","E01025154",890,37,8,29,95,66,42,71,232,204,83,59,24,60
"2011","Lancaster 013A","E01025091",1034,55,9,46,160,120,63,100,177,209,67,51,16,83
"2011","Lancaster 013B","E01025092",841,31,6,25,104,83,64,83,167,185,60,35,25,64
"2011","Lancaster 013C","E01025095",1210,159,11,148,274,96,75,68,124,113,163,154,9,138
"2011","Lancaster 013D","E01025126",1486,253,36,217,411,167,81,74,142,86,30,16,14,242
"2011","Lancaster 014A","E01025093",1484,105,15,90,205,91,67,64,106,104,41,26,15,701
"2011","Lancaster 014B","E01025094",1078,79,9,70,239,105,50,68,137,101,47,31,16,252
"2011","Lancaster 014C","E01025099",1268,171,21,150,274,123,72,73,132,97,59,33,26,267
"2011","Lancaster 014E","E01033071",1058,157,15,142,196,63,61,42,71,69,28,15,13,371
"2011","Lancaster 014F","E01033073",1434,193,23,170,238,109,72,37,89,75,41,26,15,580
"2011","Lancaster 015A","E01025125",1235,56,3,53,119,65,39,29,72,64,15,9,6,776
"2011","Lancaster 015B","E01025128",1129,108,16,92,222,124,46,69,102,83,25,14,11,350
"2011","Lancaster 015C","E01025129",1061,74,3,71,168,64,42,47,95,71,27,17,10,473
"2011","Lancaster 015D","E01025147",1110,146,9,137,238,115,74,64,106,70,21,12,9,276
"2011","Lancaster 016A","E01025114",1065,83,15,68,240,159,132,57,175,120,42,29,13,57
"2011","Lancaster 016B","E01025115",1085,39,11,28,163,112,112,88,217,192,87,56,31,75
"2011","Lancaster 016C","E01025121",1273,85,16,69,283,196,116,133,226,124,38,25,13,72
"2011","Lancaster 016D","E01025122",1242,85,24,61,296,192,154,88,184,135,37,28,9,71
"2011","Lancaster 016E","E01025123",1667,132,29,103,408,278,126,155,250,152,52,30,22,114
"2011","Lancaster 016F","E01025124",1064,60,12,48,163,142,89,91,217,163,82,66,16,57
"2011","Lancaster 016I","E01033072",1791,103,26,77,354,206,247,159,315,249,71,53,18,87
"2011","Lancaster 017A","E01025100",1128,120,10,110,248,151,63,89,159,138,48,31,17,112
"2011","Lancaster 017B","E01025101",1012,89,10,79,160,96,53,68,175,165,87,54,33,119
"2011","Lancaster 017C","E01025102",1142,118,14,104,230,97,74,51,116,66,66,62,4,324
"2011","Lancaster 017D","E01025103",1017,200,37,163,314,121,82,48,80,31,14,9,5,127
"2011","Lancaster 017E","E01025144",1560,184,23,161,318,156,64,64,142,106,50,40,10,476
"2011","Lancaster 017F","E01025146",1449,328,60,268,401,178,98,61,127,69,22,18,4,165
"2011","Lancaster 018A","E01025127",1013,110,15,95,255,167,102,63,123,86,14,10,4,93
"2011","Lancaster 018B","E01025141",1053,116,17,99,265,127,78,58,150,92,33,18,15,134
"2011","Lancaster 018C","E01025143",1012,86,12,74,180,117,66,75,149,141,66,43,23,132
"2011","Lancaster 018D","E01025145",1089,118,20,98,245,140,57,51,148,92,24,19,5,214
"2011","Lancaster 019A","E01025105",5809,177,34,143,247,107,216,64,88,90,26,19,7,4794
"2011","Lancaster 019B","E01025106",2006,180,27,153,280,136,141,110,135,142,37,18,19,845
"2011","Lancaster 019C","E01025107",1237,171,31,140,309,124,245,87,124,82,17,12,5,78
"2011","Lancaster 019D","E01025142",1120,189,30,159,263,162,113,56,146,90,16,13,3,85
"2011","Lancaster 020A","E01025137",1021,60,12,48,206,146,110,99,171,125,35,28,7,69
"2011","Lancaster 020F","E01025153",934,50,12,38,193,124,72,83,191,137,37,25,12,47
"2011","Lancaster 020G","E01025155",929,70,21,49,219,136,98,81,149,104,22,12,10,50
"2011","Lancaster 020H","E01025156",761,11,1,10,81,46,46,70,134,178,121,84,37,74
"2011","Lancaster 020I","E01025157",829,34,6,28,120,99,60,64,205,146,49,28,21,52
"2011","Lancaster 020B","E01025162",928,81,22,59,231,150,89,75,145,101,15,9,6,41
"2011","Lancaster 020C","E01025163",1016,78,19,59,238,181,89,76,171,95,25,10,15,63
"2011","Lancaster 020D","E01025164",969,79,16,63,220,175,86,70,145,115,26,19,7,53
"2011","Lancaster 020E","E01025165",1099,99,33,66,277,155,112,88,167,96,26,16,10,79
"2011","Pendle 001A","E01025191",924,89,25,64,204,106,113,90,131,106,32,17,15,53
"2011","Pendle 001B","E01025192",1021,61,21,40,165,98,81,108,207,203,46,21,25,52
"2011","Pendle 001C","E01025193",1006,69,26,43,185,132,95,90,185,154,38,24,14,58
"2011","Pendle 001D","E01025194",1014,67,17,50,159,117,89,113,186,173,42,24,18,68
"2011","Pendle 002A","E01025195",937,90,28,62,211,108,127,80,138,110,18,14,4,55
"2011","Pendle 002B","E01025196",1261,73,21,52,183,122,120,123,236,245,95,56,39,64
"2011","Pendle 002C","E01025197",1003,88,26,62,204,133,103,85,209,110,16,6,10,55
"2011","Pendle 002D","E01025198",996,55,17,38,156,103,78,98,217,180,42,33,9,67
"2011","Pendle 003A","E01025199",1287,116,46,70,290,164,162,123,185,136,43,24,19,68
"2011","Pendle 003B","E01025200",1114,68,19,49,211,111,126,110,215,172,34,20,14,67
"2011","Pendle 003C","E01025201",1153,72,22,50,181,144,108,117,256,166,44,19,25,65
"2011","Pendle 003D","E01025202",1031,95,29,66,256,107,127,94,158,107,27,13,14,60
"2011","Pendle 004A","E01025205",1021,46,6,40,169,92,75,101,235,175,67,36,31,61
"2011","Pendle 004B","E01025206",853,62,23,39,160,89,99,78,160,127,24,19,5,54
"2011","Pendle 004C","E01025207",983,41,11,30,128,92,84,87,239,188,74,44,30,50
"2011","Pendle 004D","E01025208",865,43,7,36,125,86,73,85,185,165,61,42,19,42
"2011","Pendle 005A","E01025220",1059,41,14,27,113,88,68,106,257,208,112,74,38,66
"2011","Pendle 005B","E01025221",948,38,13,25,132,102,87,94,194,168,51,32,19,82
"2011","Pendle 005C","E01025222",1079,86,36,50,220,144,113,93,193,128,33,19,14,69
"2011","Pendle 005D","E01025223",997,48,15,33,143,100,80,97,223,181,71,44,27,54
"2011","Pendle 006A","E01025178",1357,198,61,137,371,172,159,94,177,96,21,10,11,69
"2011","Pendle 006B","E01025179",1190,109,31,78,271,161,136,102,184,129,25,16,9,73
"2011","Pendle 006C","E01025180",1432,164,50,114,341,178,215,119,189,120,23,14,9,83
"2011","Pendle 006D","E01025203",1307,170,54,116,344,176,196,111,146,85,14,8,6,65
"2011","Pendle 007A","E01025226",1190,62,13,49,165,104,104,117,219,260,87,63,24,72
"2011","Pendle 007B","E01025227",1512,58,11,47,188,147,119,130,296,312,157,114,43,105
"2011","Pendle 007C","E01025228",1181,87,30,57,229,156,113,104,219,159,30,17,13,84
"2011","Pendle 008A","E01025174",1073,135,39,96,277,153,135,70,136,63,47,41,6,57
"2011","Pendle 008B","E01025175",1175,167,57,110,309,151,143,82,130,87,20,12,8,86
"2011","Pendle 008C","E01025176",1494,148,40,108,390,208,150,122,214,164,28,18,10,70
"2011","Pendle 008D","E01025177",1327,215,70,145,413,174,190,69,109,78,24,13,11,55
"2011","Pendle 008E","E01025204",1284,200,66,134,396,142,206,67,112,73,17,11,6,71
"2011","Pendle 008F","E01025211",1074,174,57,117,309,142,156,49,106,74,17,11,6,47
"2011","Pendle 009A","E01025181",990,22,12,10,94,72,61,79,212,235,122,87,35,93
"2011","Pendle 009B","E01025182",1142,30,9,21,81,65,123,70,199,243,227,195,32,104
"2011","Pendle 009C","E01025183",1179,33,9,24,103,90,104,64,251,288,169,140,29,77
"2011","Pendle 009D","E01025184",1101,22,7,15,66,86,103,37,186,227,251,217,34,123
"2011","Pendle 010A","E01025188",1339,33,10,23,131,114,104,107,238,291,230,180,50,91
"2011","Pendle 010B","E01025189",1209,46,11,35,136,119,68,93,217,298,132,102,30,100
"2011","Pendle 010C","E01025210",1302,38,12,26,177,149,90,132,269,276,80,58,22,91
"2011","Pendle 010D","E01025217",1069,30,3,27,102,88,101,75,212,224,155,109,46,82
"2011","Pendle 010E","E01025218",860,15,5,10,56,65,59,61,144,223,184,157,27,53
"2011","Pendle 010F","E01025219",816,17,3,14,63,78,51,85,144,210,124,91,33,44
"2011","Pendle 011A","E01025224",1394,41,7,34,143,147,109,71,254,234,287,245,42,108
"2011","Pendle 011B","E01025225",1139,74,15,59,227,140,83,81,193,138,114,94,20,89
"2011","Pendle 011C","E01025229",1510,46,7,39,130,122,148,78,213,243,384,348,36,146
"2011","Pendle 011D","E01025230",1127,27,5,22,80,77,102,65,179,214,282,239,43,101
"2011","Pendle 012A","E01025187",1021,80,15,65,163,113,90,78,176,140,104,93,11,77
"2011","Pendle 012B","E01025190",1234,94,17,77,243,164,118,103,187,170,67,54,13,88
"2011","Pendle 012C","E01025209",1204,66,22,44,194,131,113,120,230,195,63,44,19,92
"2011","Pendle 012D","E01025216",1439,111,22,89,236,152,179,104,203,213,120,93,27,121
"2011","Pendle 013A","E01025185",1345,64,15,49,169,129,109,71,223,237,217,188,29,126
"2011","Pendle 013B","E01025186",1066,54,15,39,150,110,97,61,180,153,176,151,25,85
"2011","Pendle 013C","E01025212",1003,127,39,88,213,143,105,57,122,86,79,71,8,71
"2011","Pendle 013D","E01025213",782,71,19,52,137,87,119,41,89,100,83,80,3,55
"2011","Pendle 013E","E01025214",1046,119,34,85,280,146,97,63,125,94,37,30,7,85
"2011","Pendle 013F","E01025215",975,31,7,24,106,105,88,41,139,155,200,178,22,110
"2011","Preston 001A","E01025278",1818,273,73,200,516,274,225,122,174,92,32,22,10,110
"2011","Preston 001B","E01025279",1452,212,60,152,362,154,327,79,123,70,24,17,7,101
"2011","Preston 001C","E01025282",1003,125,32,93,264,151,121,69,106,80,21,15,6,66
"2011","Preston 002A","E01025257",1040,224,56,168,311,161,84,42,69,36,14,8,6,99
"2011","Preston 002B","E01025277",1226,221,50,171,324,190,137,80,113,59,23,14,9,79
"2011","Preston 002C","E01025280",1353,243,52,191,349,174,212,84,101,60,21,15,6,109
"2011","Preston 002D","E01025281",1098,191,35,156,318,148,186,54,83,43,15,12,3,60
"2011","Preston 003A","E01025256",1031,141,22,119,266,181,84,72,105,68,19,16,3,95
"2011","Preston 003B","E01025258",1057,138,25,113,288,188,85,68,124,75,22,13,9,69
"2011","Preston 003C","E01025259",1498,227,50,177,409,277,107,96,163,75,24,15,9,120
"2011","Preston 003D","E01025299",1046,148,27,121,298,185,54,67,117,71,27,23,4,79
"2011","Preston 003E","E01025301",853,81,17,64,238,136,52,74,119,70,20,12,8,63
"2011","Preston 003F","E01025302",901,99,20,79,220,153,65,78,143,58,28,17,11,57
"2011","Preston 004A","E01025253",1344,302,52,250,409,203,88,61,119,54,27,24,3,81
"2011","Preston 004B","E01025254",853,127,27,100,190,156,61,70,104,64,17,12,5,64
"2011","Preston 004C","E01025255",1152,211,37,174,312,184,72,84,113,74,21,12,9,81
"2011","Preston 004D","E01025300",768,102,21,81,170,104,56,43,103,68,42,32,10,80
"2011","Preston 004E","E01025303",1040,151,31,120,271,186,53,70,130,72,31,17,14,76
"2011","Preston 005A","E01025260",1056,48,6,42,149,133,61,101,226,198,94,49,45,46
"2011","Preston 005B","E01025262",1116,64,13,51,185,167,95,102,213,165,57,37,20,68
"2011","Preston 005C","E01025263",1037,65,16,49,155,152,63,91,202,154,81,47,34,74
"2011","Preston 005D","E01025264",1104,78,13,65,201,160,70,79,217,159,59,34,25,81
"2011","Preston 006A","E01025239",991,106,27,79,217,162,88,80,144,104,35,26,9,55
"2011","Preston 006B","E01025241",1133,179,37,142,268,183,84,66,142,72,46,38,8,93
"2011","Preston 006C","E01025242",1114,221,39,182,288,186,93,58,114,53,43,39,4,58
"2011","Preston 006D","E01025243",1443,261,47,214,367,167,134,57,128,77,102,88,14,150
"2011","Preston 006E","E01025251",1020,129,35,94,216,142,93,41,124,73,65,50,15,137
"2011","Preston 007A","E01025234",1051,68,23,45,162,129,77,102,192,178,74,52,22,69
"2011","Preston 007B","E01025235",1195,76,21,55,186,196,88,115,206,184,64,48,16,80
"2011","Preston 007C","E01025237",1069,62,12,50,137,147,75,83,225,189,70,42,28,81
"2011","Preston 007D","E01025238",1064,26,7,19,124,123,64,93,244,223,87,52,35,80
"2011","Preston 007E","E01025245",1771,60,13,47,226,195,127,126,314,338,217,166,51,168
"2011","Preston 007F","E01025252",1036,69,15,54,224,195,72,91,123,148,40,29,11,74
"2011","Preston 008A","E01025233",982,130,32,98,244,160,80,75,104,69,23,14,9,97
"2011","Preston 008B","E01025240",1150,113,30,83,249,218,91,83,175,116,23,16,7,82
"2011","Preston 008C","E01025261",1040,111,28,83,221,175,104,91,126,119,32,24,8,61
"2011","Preston 008D","E01025266",922,85,15,70,174,182,66,72,171,90,24,15,9,58
"2011","Preston 008E","E01025309",832,51,9,42,155,130,54,94,148,113,37,20,17,50
"2011","Preston 009A","E01025236",970,28,9,19,109,123,62,82,198,182,116,80,36,70
"2011","Preston 009B","E01025283",1065,20,3,17,87,79,66,92,250,241,151,94,57,79
"2011","Preston 009C","E01025284",1244,53,12,41,200,158,104,133,208,217,89,75,14,82
"2011","Preston 009D","E01025285",975,37,7,30,118,114,70,79,182,179,86,67,19,110
"2011","Preston 009E","E01025286",1192,29,8,21,111,114,58,98,210,305,174,125,49,93
"2011","Preston 009F","E01025287",1428,32,9,23,149,178,84,122,249,344,175,113,62,95
"2011","Preston 010A","E01025270",1192,115,22,93,271,216,98,112,158,111,23,14,9,88
"2011","Preston 010B","E01025272",1175,224,49,175,344,174,106,64,95,54,20,15,5,94
"2011","Preston 010C","E01025273",1051,218,51,167,304,185,69,47,82,37,12,9,3,97
"2011","Preston 010D","E01025288",1308,237,48,189,331,157,99,74,168,111,49,37,12,82
"2011","Preston 011A","E01025246",1178,31,4,27,113,156,92,53,170,223,210,186,24,130
"2011","Preston 011B","E01025274",1590,68,13,55,194,167,76,103,207,187,111,71,40,477
"2011","Preston 011C","E01025275",1252,57,12,45,158,109,55,92,196,203,93,60,33,289
"2011","Preston 011D","E01025294",1365,53,8,45,144,187,72,82,195,185,128,102,26,319
"2011","Preston 012A","E01025276",1286,98,16,82,214,169,71,96,213,129,94,74,20,202
"2011","Preston 012B","E01025308",1346,86,14,72,257,178,49,89,188,161,57,36,21,281
"2011","Preston 012C","E01025310",1225,65,8,57,216,180,68,105,178,161,47,25,22,205
"2011","Preston 012D","E01025311",1030,66,12,54,208,175,60,97,164,131,41,19,22,88
"2011","Preston 012E","E01025312",1305,94,15,79,273,149,69,98,229,174,48,29,19,171
"2011","Preston 012F","E01025313",1738,29,4,25,112,84,47,67,177,201,64,35,29,957
"2011","Preston 012G","E01025314",2422,129,16,113,202,198,70,83,157,147,56,33,23,1380
"2011","Preston 013A","E01025231",1007,157,26,131,238,153,88,72,127,80,18,11,7,74
"2011","Preston 013B","E01025232",1298,108,9,99,242,163,78,101,188,135,65,42,23,218
"2011","Preston 013C","E01025265",1131,124,23,101,250,196,78,101,162,108,39,20,19,73
"2011","Preston 013D","E01025267",1023,65,14,51,158,170,69,83,189,167,52,39,13,70
"2011","Preston 013E","E01025268",1192,58,12,46,154,175,89,119,259,192,82,59,23,64
"2011","Preston 013F","E01025269",1114,65,10,55,149,151,60,94,224,212,81,52,29,78
"2011","Preston 013G","E01025271",1095,65,18,47,199,160,85,105,202,140,49,35,14,90
"2011","Preston 014A","E01025295",2042,67,7,60,215,172,144,150,315,469,361,295,66,149
"2011","Preston 014B","E01025296",1332,44,6,38,144,144,70,93,264,273,181,136,45,119
"2011","Preston 014C","E01025297",1422,47,11,36,133,174,82,98,274,303,187,141,46,124
"2011","Preston 014D","E01025298",1093,37,7,30,92,110,65,74,211,220,169,133,36,115
"2011","Preston 015A","E01025244",1158,43,7,36,97,103,84,39,185,190,242,219,23,175
"2011","Preston 015B","E01025292",2955,34,3,31,101,85,57,59,159,202,123,79,44,2135
"2011","Preston 015C","E01025293",1544,37,10,27,129,126,84,77,266,319,274,223,51,232
"2011","Preston 016A","E01025247",1212,64,7,57,114,164,104,69,195,182,204,166,38,116
"2011","Preston 016B","E01025248",873,21,6,15,57,88,52,65,204,204,117,92,25,65
"2011","Preston 016C","E01025249",733,41,9,32,114,105,61,70,130,106,51,41,10,55
"2011","Preston 016D","E01025250",1163,28,3,25,110,114,99,83,233,202,187,146,41,107
"2011","Preston 016E","E01025304",1252,86,10,76,156,181,116,76,194,184,133,115,18,126
"2011","Preston 016F","E01025305",1213,48,9,39,149,171,79,58,189,213,191,165,26,115
"2011","Preston 017A","E01025289",1400,85,7,78,219,135,51,89,215,150,94,78,16,362
"2011","Preston 017B","E01025290",1434,77,2,75,185,146,74,60,222,161,105,74,31,404
"2011","Preston 017C","E01025291",1036,90,13,77,189,183,59,70,142,126,48,35,13,129
"2011","Preston 017D","E01025306",1506,187,17,170,267,133,72,75,162,157,134,103,31,319
"2011","Preston 017F","E01033223",1166,42,8,34,85,70,47,43,90,94,80,53,27,615
"2011","Preston 017G","E01033224",834,37,4,33,87,85,43,66,135,151,78,58,20,152
"2011","Preston 017H","E01033226",861,36,7,29,106,70,43,69,177,151,115,79,36,94
"2011","Ribble Valley 001A","E01025315",1214,160,40,120,290,104,206,68,79,67,10,8,2,230
"2011","Ribble Valley 001B","E01025320",999,133,42,91,234,87,282,57,92,39,16,13,3,59
"2011","Ribble Valley 001C","E01025331",1061,123,36,87,285,99,257,56,84,67,38,33,5,52
"2011","Ribble Valley 001D","E01025348",1142,125,33,92,282,140,204,79,125,119,23,15,8,45
"2011","Ribble Valley 001E","E01025349",1037,200,58,142,277,116,185,58,82,58,15,6,9,46
"2011","Ribble Valley 002A","E01025334",1098,124,37,87,265,143,111,93,154,120,27,16,11,61
"2011","Ribble Valley 002B","E01025344",927,91,23,68,250,95,103,79,138,91,21,13,8,59
"2011","Ribble Valley 002C","E01025345",1007,133,39,94,292,125,111,89,114,74,10,5,5,59
"2011","Ribble Valley 002D","E01025346",1119,126,36,90,266,134,97,82,174,130,32,20,12,78
"2011","Ribble Valley 002E","E01025347",1183,122,24,98,284,141,126,93,172,142,22,14,8,81
"2011","Ribble Valley 003A","E01025329",1019,76,24,52,203,116,100,98,173,154,30,20,10,69
"2011","Ribble Valley 003B","E01025330",952,76,19,57,186,137,85,85,167,135,29,18,11,52
"2011","Ribble Valley 003C","E01025335",930,49,17,32,175,92,93,95,175,155,42,22,20,54
"2011","Ribble Valley 003D","E01025338",1197,83,19,64,262,119,134,119,213,163,39,29,10,65
"2011","Ribble Valley 003E","E01025339",1103,65,19,46,211,106,111,125,219,173,39,24,15,54
"2011","Ribble Valley 004A","E01025322",1032,137,43,94,234,130,205,66,103,77,17,12,5,63
"2011","Ribble Valley 004B","E01025326",1099,93,23,70,241,164,131,89,156,146,19,11,8,60
"2011","Ribble Valley 004C","E01025327",974,135,31,104,250,129,108,70,132,92,12,10,2,46
"2011","Ribble Valley 004D","E01025342",1169,155,43,112,324,150,183,90,115,67,25,12,13,60
"2011","Ribble Valley 005A","E01025321",957,104,28,76,223,97,135,91,142,102,12,8,4,51
"2011","Ribble Valley 005B","E01025340",1021,126,32,94,264,165,128,55,111,76,12,9,3,84
"2011","Ribble Valley 005C","E01025341",847,163,44,119,257,131,119,32,54,30,8,3,5,53
"2011","Ribble Valley 005D","E01025343",1047,113,26,87,289,122,155,67,125,84,19,11,8,73
"2011","Ribble Valley 005E","E01025354",963,158,45,113,303,102,146,54,82,54,17,14,3,47
"2011","Ribble Valley 006A","E01025316",1119,113,32,81,251,180,135,90,153,100,12,7,5,85
"2011","Ribble Valley 006B","E01025317",797,57,15,42,181,102,101,87,137,68,17,6,11,47
"2011","Ribble Valley 006C","E01025325",1090,66,15,51,202,146,110,108,210,173,22,14,8,53
"2011","Ribble Valley 006D","E01025328",837,97,11,86,184,101,103,73,125,95,18,9,9,41
"2011","Ribble Valley 007A","E01025318",770,86,21,65,223,105,66,70,87,64,20,9,11,49
"2011","Ribble Valley 007B","E01025319",1526,256,72,184,444,187,182,84,163,88,14,11,3,108
"2011","Ribble Valley 007C","E01025333",914,149,43,106,233,138,126,58,76,60,14,5,9,60
"2011","Ribble Valley 007D","E01025350",886,183,56,127,268,104,92,46,70,51,12,8,4,60
"2011","Ribble Valley 007E","E01025351",1872,326,94,232,499,191,205,79,149,100,165,155,10,158
"2011","Ribble Valley 008A","E01025323",800,127,39,88,210,103,141,36,69,50,17,9,8,47
"2011","Ribble Valley 008B","E01025324",987,151,32,119,284,122,126,54,98,67,16,8,8,69
"2011","Ribble Valley 008C","E01025332",753,104,27,77,227,115,86,44,76,36,13,8,5,52
"2011","Ribble Valley 008D","E01025336",828,157,41,116,263,104,108,33,64,39,11,7,4,49
"2011","Ribble Valley 008E","E01025337",1131,181,45,136,285,176,149,91,113,60,9,8,1,67
"2011","Ribble Valley 008F","E01025352",1101,163,49,114,351,175,112,49,75,51,46,39,7,79
"2011","Ribble Valley 008G","E01025353",777,150,45,105,241,113,88,33,73,33,4,1,3,42
"2011","Rossendale 001A","E01025355",1692,281,85,196,474,250,157,91,190,98,39,28,11,112
"2011","Rossendale 001B","E01025361",1572,186,50,136,399,233,191,107,191,135,49,24,25,81
"2011","Rossendale 001C","E01025362",1449,200,53,147,377,206,183,84,160,132,30,21,9,77
"2011","Rossendale 001D","E01025393",1135,104,35,69,222,140,165,83,159,150,37,25,12,75
"2011","Rossendale 002A","E01025363",909,96,33,63,210,113,92,72,129,90,34,25,9,73
"2011","Rossendale 002B","E01025364",1015,145,41,104,277,137,101,62,112,69,35,26,9,77
"2011","Rossendale 002C","E01025366",1089,77,25,52,160,129,114,57,167,135,135,102,33,115
"2011","Rossendale 002D","E01025395",1192,118,34,84,236,145,150,107,169,165,30,20,10,72
"2011","Rossendale 002E","E01025396",975,45,10,35,116,85,79,85,184,211,94,72,22,76
"2011","Rossendale 002F","E01025397",1180,75,18,57,174,119,119,100,199,174,122,101,21,98
"2011","Rossendale 002G","E01025398",962,53,14,39,156,95,81,74,163,178,87,62,25,75
"2011","Rossendale 003A","E01025367",1330,129,49,80,349,183,171,87,172,107,31,20,11,101
"2011","Rossendale 003B","E01025368",1169,89,27,62,215,152,136,90,191,170,58,39,19,68
"2011","Rossendale 003C","E01025369",860,37,9,28,133,89,88,56,175,164,66,42,24,52
"2011","Rossendale 003D","E01025381",1060,50,11,39,191,113,93,74,180,213,89,60,29,57
"2011","Rossendale 003E","E01025382",1267,54,19,35,186,115,99,106,259,257,124,65,59,67
"2011","Rossendale 003F","E01025383",1712,153,55,98,361,236,201,120,254,202,63,41,22,122
"2011","Rossendale 004A","E01025356",1055,74,20,54,200,136,92,92,163,149,83,57,26,66
"2011","Rossendale 004C","E01025373",1155,162,50,112,305,137,151,53,133,94,55,38,17,65
"2011","Rossendale 004D","E01025385",906,26,9,17,100,103,81,71,195,201,72,29,43,57
"2011","Rossendale 004F","E01025387",975,129,41,88,207,110,94,53,125,110,66,54,12,81
"2011","Rossendale 004G","E01033281",1906,161,49,112,389,231,180,133,254,248,140,104,36,170
"2011","Rossendale 007A","E01025377",1093,173,40,133,330,146,127,56,117,53,16,10,6,75
"2011","Rossendale 007B","E01025378",1183,166,43,123,343,164,129,81,123,84,19,13,6,74
"2011","Rossendale 007C","E01025379",894,45,14,31,165,115,87,83,159,153,45,33,12,42
"2011","Rossendale 007D","E01025380",1104,137,46,91,328,177,93,59,143,79,14,10,4,74
"2011","Rossendale 008A","E01025357",1004,114,34,80,224,142,109,65,145,117,27,17,10,61
"2011","Rossendale 008B","E01025358",1684,283,93,190,512,245,210,101,132,83,25,17,8,93
"2011","Rossendale 008C","E01025365",1149,111,37,74,300,166,115,72,157,119,28,20,8,81
"2011","Rossendale 008D","E01025384",901,108,29,79,263,114,109,44,89,92,38,27,11,44
"2011","Rossendale 009A","E01025359",1284,109,36,73,332,166,154,85,180,140,42,28,14,76
"2011","Rossendale 009B","E01025360",1444,99,37,62,266,199,170,106,242,212,66,37,29,84
"2011","Rossendale 009C","E01025375",1311,146,43,103,332,178,148,80,181,118,36,19,17,92
"2011","Rossendale 009D","E01025376",1553,80,16,64,282,174,138,129,290,268,86,45,41,106
"2011","Rossendale 010F","E01025370",933,71,19,52,180,123,114,71,131,148,39,20,19,56
"2011","Rossendale 010A","E01025371",991,51,13,38,146,96,95,91,189,207,49,21,28,67
"2011","Rossendale 010B","E01025374",1094,96,32,64,222,129,112,76,158,155,81,62,19,65
"2011","Rossendale 010G","E01025388",1076,56,16,40,178,127,114,86,195,193,64,41,23,63
"2011","Rossendale 010H","E01025389",900,51,14,37,138,111,73,62,156,183,61,36,25,65
"2011","Rossendale 010I","E01025390",779,44,12,32,134,72,88,48,135,170,39,26,13,49
"2011","Rossendale 010C","E01025391",1062,67,25,42,181,133,89,88,169,201,62,31,31,72
"2011","Rossendale 010D","E01025392",931,78,23,55,186,120,126,78,120,128,35,23,12,60
"2011","Rossendale 010E","E01025394",1140,98,39,59,201,131,121,99,182,184,51,31,20,73
"2011","South Ribble 001A","E01025424",942,105,26,79,261,177,75,67,120,52,14,7,7,71
"2011","South Ribble 001B","E01025425",962,139,24,115,254,175,57,62,118,53,19,11,8,85
"2011","South Ribble 001C","E01025426",900,175,51,124,265,147,82,42,69,33,14,2,12,73
"2011","South Ribble 001D","E01025466",1040,129,27,102,319,185,88,61,108,64,14,9,5,72
"2011","South Ribble 002A","E01025413",1321,123,32,91,298,224,119,118,199,135,27,14,13,78
"2011","South Ribble 002B","E01025414",1200,152,32,120,308,204,129,91,137,93,10,3,7,76
"2011","South Ribble 002C","E01025456",913,139,38,101,213,97,164,52,93,56,56,53,3,43
"2011","South Ribble 002D","E01025458",1130,100,30,70,247,170,106,101,159,141,43,27,16,63
"2011","South Ribble 003A","E01025408",1101,157,42,115,357,206,62,60,111,46,25,19,6,77
"2011","South Ribble 003B","E01025409",1018,140,20,120,265,186,79,65,117,59,24,14,10,83
"2011","South Ribble 003C","E01025410",1035,150,36,114,301,190,70,60,102,51,14,9,5,97
"2011","South Ribble 003D","E01025467",1470,176,34,142,353,313,123,99,179,99,21,14,7,107
"2011","South Ribble 004A","E01025403",1479,251,54,197,400,267,109,89,166,96,19,12,7,82
"2011","South Ribble 004B","E01025457",1067,132,29,103,230,175,123,103,146,86,27,18,9,45
"2011","South Ribble 004C","E01025463",1026,98,37,61,231,199,100,86,123,103,23,17,6,63
"2011","South Ribble 004D","E01025464",990,149,39,110,289,158,66,80,123,48,8,5,3,69
"2011","South Ribble 004E","E01025465",830,80,16,64,185,135,57,74,138,104,13,7,6,44
"2011","South Ribble 005A","E01025411",1540,138,31,107,362,272,119,138,219,174,34,19,15,84
"2011","South Ribble 005B","E01025448",1236,112,18,94,288,212,96,93,188,139,28,13,15,80
"2011","South Ribble 005C","E01025449",735,113,22,91,190,117,65,54,72,55,11,9,2,58
"2011","South Ribble 005D","E01025450",736,49,12,37,128,113,63,58,133,102,31,19,12,59
"2011","South Ribble 006A","E01025412",1077,74,23,51,222,175,107,115,178,120,34,23,11,52
"2011","South Ribble 006B","E01025427",1084,96,14,82,236,151,84,82,178,135,51,27,24,71
"2011","South Ribble 006C","E01025428",1087,110,17,93,241,137,76,100,174,127,33,25,8,89
"2011","South Ribble 006D","E01025429",962,62,18,44,174,152,60,80,172,140,53,29,24,69
"2011","South Ribble 007A","E01025404",886,88,21,67,168,172,57,89,153,106,11,8,3,42
"2011","South Ribble 007B","E01025405",870,35,10,25,125,130,69,96,201,146,32,26,6,36
"2011","South Ribble 007C","E01025406",929,73,19,54,171,177,61,95,144,131,23,16,7,54
"2011","South Ribble 007D","E01025407",1431,106,22,84,246,230,84,135,275,228,53,32,21,74
"2011","South Ribble 008A","E01025399",1115,56,13,43,152,161,72,105,222,205,59,37,22,83
"2011","South Ribble 008B","E01025400",1324,153,43,110,309,183,132,95,180,149,37,27,10,86
"2011","South Ribble 008C","E01025401",1140,53,12,41,185,195,84,114,213,211,29,22,7,56
"2011","South Ribble 008D","E01025402",1055,81,19,62,213,184,98,94,169,124,25,15,10,67
"2011","South Ribble 009A","E01025442",811,43,11,32,156,118,61,81,136,122,49,28,21,45
"2011","South Ribble 009B","E01025443",1040,94,32,62,245,186,85,94,163,98,21,15,6,54
"2011","South Ribble 009C","E01025444",1008,79,21,58,190,169,79,122,160,133,19,6,13,57
"2011","South Ribble 009D","E01025461",1448,196,56,140,345,234,136,124,195,96,22,15,7,100
"2011","South Ribble 009E","E01025462",1268,90,22,68,263,218,124,123,190,156,28,18,10,76
"2011","South Ribble 010A","E01025439",948,109,16,93,281,146,134,51,90,67,18,8,10,52
"2011","South Ribble 010B","E01025453",1231,183,39,144,370,206,110,64,114,69,20,8,12,95
"2011","South Ribble 010C","E01025454",911,128,29,99,256,152,121,46,97,42,12,6,6,57
"2011","South Ribble 010D","E01025455",1065,125,30,95,272,179,150,72,127,75,13,11,2,52
"2011","South Ribble 011A","E01025436",1744,204,51,153,412,277,244,127,198,151,28,19,9,103
"2011","South Ribble 011B","E01025437",1339,128,35,93,303,211,210,118,157,121,20,16,4,71
"2011","South Ribble 011C","E01025438",989,134,43,91,276,170,126,53,110,43,13,7,6,64
"2011","South Ribble 011D","E01025440",1026,128,33,95,276,152,116,69,128,83,15,12,3,59
"2011","South Ribble 011E","E01025441",996,154,50,104,267,144,125,63,107,56,20,15,5,60
"2011","South Ribble 012A","E01025417",1074,76,25,51,219,215,79,104,191,118,24,15,9,48
"2011","South Ribble 012B","E01025418",1057,62,18,44,213,192,74,122,182,146,20,10,10,46
"2011","South Ribble 012C","E01025419",1148,103,24,79,220,184,134,101,176,126,32,21,11,72
"2011","South Ribble 012D","E01025420",2075,239,70,169,507,333,202,183,242,175,62,47,15,132
"2011","South Ribble 013A","E01025421",1663,165,39,126,388,243,128,147,252,185,68,35,33,87
"2011","South Ribble 013B","E01025422",952,62,26,36,178,137,60,98,190,123,37,20,17,67
"2011","South Ribble 013C","E01025431",1315,83,24,59,241,205,100,148,245,171,55,33,22,67
"2011","South Ribble 013D","E01025433",1393,103,26,77,298,237,90,121,251,171,43,27,16,79
"2011","South Ribble 014A","E01025416",1165,108,34,74,260,189,110,102,165,117,33,26,7,81
"2011","South Ribble 014B","E01025451",1485,202,53,149,413,266,142,94,148,92,31,23,8,97
"2011","South Ribble 014C","E01025452",1272,81,23,58,187,173,109,117,265,199,62,35,27,79
"2011","South Ribble 015A","E01025415",1549,87,33,54,251,230,132,140,340,213,68,46,22,88
"2011","South Ribble 015B","E01025423",929,26,7,19,113,86,75,90,237,196,53,31,22,53
"2011","South Ribble 015C","E01025435",1056,103,28,75,232,185,67,83,160,119,45,28,17,62
"2011","South Ribble 015D","E01025446",1101,121,31,90,251,163,99,92,177,120,18,15,3,60
"2011","South Ribble 016A","E01025430",1458,152,34,118,345,255,111,116,218,143,24,9,15,94
"2011","South Ribble 016C","E01025434",1485,226,61,165,432,261,117,96,157,74,33,23,10,89
"2011","South Ribble 016D","E01032928",1452,238,49,189,428,248,98,88,162,91,22,10,12,77
"2011","South Ribble 016E","E01032929",801,73,16,57,164,128,58,72,143,97,27,17,10,39
"2011","South Ribble 017A","E01025445",951,42,8,34,126,100,70,75,220,172,83,57,26,63
"2011","South Ribble 017B","E01025447",812,28,1,27,107,90,56,64,180,155,70,47,23,62
"2011","South Ribble 017C","E01025459",1261,91,25,66,238,186,115,113,239,163,58,37,21,58
"2011","South Ribble 017D","E01025460",1549,86,27,59,311,208,136,134,311,208,74,48,26,81
"2011","West Lancashire 001A","E01025496",896,66,26,40,191,97,159,83,136,95,22,13,9,47
"2011","West Lancashire 001B","E01025497",1138,120,32,88,295,177,160,73,142,67,19,11,8,85
"2011","West Lancashire 001C","E01025498",947,77,22,55,194,135,112,82,157,99,37,18,19,54
"2011","West Lancashire 001D","E01025530",1104,139,35,104,308,164,123,71,142,93,14,7,7,50
"2011","West Lancashire 001E","E01025532",1095,163,47,116,257,175,151,56,134,59,22,13,9,78
"2011","West Lancashire 001F","E01025533",1154,126,37,89,286,154,165,75,141,123,18,14,4,66
"2011","West Lancashire 002A","E01025507",1183,112,28,84,289,161,150,86,156,116,32,20,12,81
"2011","West Lancashire 002B","E01025508",1034,63,15,48,206,127,165,86,171,127,35,27,8,54
"2011","West Lancashire 002C","E01025509",898,53,9,44,153,117,150,79,150,99,42,22,20,55
"2011","West Lancashire 002D","E01025513",1480,233,77,156,410,186,210,81,140,103,27,14,13,90
"2011","West Lancashire 002E","E01025531",871,70,22,48,166,100,186,66,130,94,18,13,5,41
"2011","West Lancashire 003A","E01025474",853,73,20,53,170,116,138,66,135,94,18,8,10,43
"2011","West Lancashire 003B","E01025495",1507,164,46,118,401,205,267,84,169,108,28,14,14,81
"2011","West Lancashire 003C","E01025514",1718,177,50,127,431,221,237,124,228,153,42,29,13,105
"2011","West Lancashire 003D","E01025515",1214,120,38,82,294,127,208,69,174,106,34,23,11,82
"2011","West Lancashire 004A","E01025483",1583,123,25,98,356,213,146,127,248,195,71,52,19,104
"2011","West Lancashire 004B","E01025484",1411,186,46,140,376,198,151,101,179,111,27,18,9,82
"2011","West Lancashire 004C","E01025485",1271,121,31,90,298,188,126,98,193,139,25,12,13,83
"2011","West Lancashire 004D","E01025486",1230,85,21,64,287,179,125,108,179,147,32,15,17,88
"2011","West Lancashire 004E","E01025487",1164,112,24,88,257,154,130,82,178,135,38,20,18,78
"2011","West Lancashire 005A","E01025510",972,213,52,161,313,106,126,36,66,32,10,7,3,70
"2011","West Lancashire 005B","E01025511",847,153,37,116,247,96,159,43,58,39,9,4,5,43
"2011","West Lancashire 005C","E01025512",925,116,22,94,270,135,82,64,120,60,16,8,8,62
"2011","West Lancashire 005D","E01025538",1158,192,48,144,304,141,191,62,102,89,22,12,10,55
"2011","West Lancashire 005E","E01025539",979,136,34,102,281,150,96,59,89,77,23,14,9,68
"2011","West Lancashire 006A","E01025499",1036,96,22,74,245,133,73,53,137,114,41,27,14,144
"2011","West Lancashire 006B","E01025501",794,92,24,68,234,131,56,57,105,50,10,8,2,59
"2011","West Lancashire 006C","E01025502",1122,164,37,127,354,189,73,54,102,64,24,12,12,98
"2011","West Lancashire 006D","E01025516",1114,107,24,83,291,174,89,63,156,112,27,15,12,95
"2011","West Lancashire 006E","E01025517",1110,74,11,63,228,117,85,73,172,151,66,40,26,144
"2011","West Lancashire 006F","E01025519",899,122,21,101,236,140,83,55,128,59,21,8,13,55
"2011","West Lancashire 007A","E01025488",1646,152,28,124,261,141,89,64,91,75,33,23,10,740
"2011","West Lancashire 007B","E01025489",990,107,17,90,221,110,67,52,134,92,21,13,8,186
"2011","West Lancashire 007C","E01025490",1492,113,16,97,168,92,68,45,66,70,15,12,3,855
"2011","West Lancashire 007D","E01025500",1105,100,18,82,227,145,81,62,131,92,26,16,10,241
"2011","West Lancashire 007E","E01025518",1132,64,10,54,148,97,60,53,160,120,41,25,16,389
"2011","West Lancashire 008A","E01025479",1489,202,64,138,328,189,277,83,162,110,35,21,14,103
"2011","West Lancashire 008B","E01025491",1299,169,34,135,239,145,129,58,108,92,29,23,6,330
"2011","West Lancashire 008C","E01025506",1502,252,60,192,394,202,219,78,142,97,32,21,11,86
"2011","West Lancashire 009A","E01025468",1288,109,28,81,271,208,116,98,192,139,25,15,10,130
"2011","West Lancashire 009B","E01025469",1188,78,17,61,213,155,88,107,202,204,62,33,29,79
"2011","West Lancashire 009C","E01025470",1162,114,30,84,271,189,120,80,153,116,24,18,6,95
"2011","West Lancashire 009D","E01025522",868,51,13,38,141,112,70,76,186,154,30,22,8,48
"2011","West Lancashire 010A","E01025471",1094,35,9,26,143,105,81,91,227,222,102,58,44,88
"2011","West Lancashire 010B","E01025480",1006,37,14,23,135,106,39,65,207,206,93,61,32,118
"2011","West Lancashire 010C","E01025481",1093,23,6,17,150,123,55,92,236,250,95,62,33,69
"2011","West Lancashire 010D","E01025482",998,28,6,22,79,73,62,65,209,251,141,93,48,90
"2011","West Lancashire 010E","E01025520",860,25,9,16,104,93,61,78,167,198,77,41,36,57
"2011","West Lancashire 010F","E01025521",1198,39,13,26,125,141,67,93,281,255,103,63,40,94
"2011","West Lancashire 011A","E01025523",1201,75,15,60,219,157,97,113,186,220,58,35,23,76
"2011","West Lancashire 011B","E01025524",1129,33,5,28,125,98,83,97,241,267,94,54,40,91
"2011","West Lancashire 011C","E01025525",1190,39,14,25,166,156,82,109,257,252,40,24,16,89
"2011","West Lancashire 011D","E01025526",1269,65,17,48,203,169,81,121,238,246,51,28,23,95
"2011","West Lancashire 012A","E01025472",1020,179,56,123,312,147,119,46,85,36,22,16,6,74
"2011","West Lancashire 012B","E01025473",1025,138,28,110,260,153,139,48,105,62,29,11,18,91
"2011","West Lancashire 012C","E01025475",1059,168,37,131,302,175,108,55,95,61,23,12,11,72
"2011","West Lancashire 012D","E01025476",900,148,38,110,272,150,106,33,70,37,24,17,7,60
"2011","West Lancashire 012E","E01025477",904,139,35,104,246,138,110,37,90,59,18,14,4,67
"2011","West Lancashire 012F","E01025478",861,164,36,128,265,133,70,27,70,35,16,10,6,81
"2011","West Lancashire 013A","E01025492",969,60,22,38,143,131,71,78,181,172,52,31,21,81
"2011","West Lancashire 013B","E01025527",1004,29,11,18,118,101,67,78,209,230,98,51,47,74
"2011","West Lancashire 013C","E01025528",1200,52,19,33,131,100,68,96,261,253,134,72,62,105
"2011","West Lancashire 013D","E01025529",1273,76,18,58,229,161,91,91,225,196,101,59,42,103
"2011","West Lancashire 014A","E01025493",1110,28,10,18,87,82,46,86,235,283,169,106,63,94
"2011","West Lancashire 014B","E01025494",1124,23,9,14,85,78,78,81,268,297,128,86,42,86
"2011","West Lancashire 014C","E01025503",951,29,5,24,72,99,56,89,220,212,89,57,32,85
"2011","West Lancashire 014D","E01025504",786,21,8,13,62,65,41,65,143,208,111,73,38,70
"2011","West Lancashire 014E","E01025505",1074,32,8,24,141,136,74,104,233,220,60,43,17,74
"2011","West Lancashire 015A","E01025534",1232,174,42,132,315,185,113,77,142,127,29,13,16,70
"2011","West Lancashire 015B","E01025535",1114,112,27,85,270,152,128,78,127,107,43,31,12,97
"2011","West Lancashire 015C","E01025536",1064,70,17,53,178,102,89,84,175,205,82,47,35,79
"2011","West Lancashire 015D","E01025537",1131,120,27,93,278,169,108,89,177,104,26,17,9,60
"2011","West Lancashire 015E","E01025540",894,128,30,98,260,112,109,57,89,62,21,12,9,56
"2011","Wyre 001A","E01025573",1017,43,14,29,175,168,109,109,171,139,39,30,9,64
"2011","Wyre 001B","E01025574",1089,29,8,21,116,106,121,99,226,246,90,55,35,56
"2011","Wyre 001C","E01025581",1045,44,9,35,171,135,115,106,193,148,52,34,18,81
"2011","Wyre 001D","E01025582",940,34,12,22,95,107,84,87,214,181,85,57,28,53
"2011","Wyre 001E","E01025583",948,41,9,32,128,135,92,82,207,137,73,47,26,53
"2011","Wyre 001F","E01025584",1166,34,10,24,163,113,123,114,225,200,106,67,39,88
"2011","Wyre 002A","E01025605",969,73,14,59,171,182,109,102,146,106,17,13,4,63
"2011","Wyre 002B","E01025606",859,18,3,15,105,91,56,65,185,183,100,61,39,56
"2011","Wyre 002C","E01025607",1136,48,12,36,206,201,132,111,220,121,25,14,11,72
"2011","Wyre 002D","E01025608",1154,56,22,34,197,204,105,131,215,145,22,16,6,79
"2011","Wyre 003A","E01025590",1012,31,7,24,97,90,55,109,227,215,109,64,45,79
"2011","Wyre 003B","E01025591",1131,64,15,49,255,193,141,102,192,119,24,12,12,41
"2011","Wyre 003C","E01025592",1021,24,4,20,118,87,64,98,251,198,108,73,35,73
"2011","Wyre 003D","E01025593",1308,95,30,65,229,183,113,102,163,87,39,32,7,297
"2011","Wyre 004A","E01025563",824,75,24,51,180,126,153,67,96,87,10,8,2,30
"2011","Wyre 004B","E01025564",1181,108,21,87,297,158,194,90,138,105,15,7,8,76
"2011","Wyre 004C","E01025565",1097,92,23,69,227,155,207,79,159,103,19,11,8,56
"2011","Wyre 004D","E01025586",1110,77,19,58,220,145,159,94,196,130,30,17,13,59
"2011","Wyre 004E","E01025587",1078,70,21,49,218,156,173,88,148,128,32,17,15,65
"2011","Wyre 004F","E01025588",932,52,19,33,174,106,154,86,173,126,30,21,9,31
"2011","Wyre 004G","E01025589",934,60,15,45,212,113,143,73,139,89,31,22,9,74
"2011","Wyre 005A","E01025557",1143,98,20,78,260,215,135,88,139,112,27,11,16,69
"2011","Wyre 005B","E01025575",772,12,2,10,94,82,52,50,191,156,81,59,22,54
"2011","Wyre 005C","E01025578",1100,35,12,23,153,138,92,129,232,186,58,42,16,77
"2011","Wyre 005D","E01025579",944,21,7,14,90,91,70,103,234,190,74,44,30,71
"2011","Wyre 005E","E01025580",979,86,29,57,209,155,88,70,139,87,33,23,10,112
"2011","Wyre 006A","E01025547",1522,169,40,129,259,129,231,87,150,97,21,11,10,379
"2011","Wyre 006B","E01025549",1547,249,72,177,392,172,220,94,151,117,46,36,10,106
"2011","Wyre 006C","E01025609",1501,216,44,172,366,161,282,90,159,95,28,15,13,104
"2011","Wyre 007A","E01025548",1096,97,32,65,236,138,157,101,153,141,19,17,2,54
"2011","Wyre 007B","E01025553",1954,234,51,183,468,253,221,152,270,194,30,21,9,132
"2011","Wyre 007C","E01025558",1156,208,52,156,276,161,100,92,146,94,20,13,7,59
"2011","Wyre 007D","E01025559",1357,122,36,86,264,124,218,145,205,167,38,24,14,74
"2011","Wyre 007E","E01025560",933,96,19,77,229,120,87,72,147,109,21,15,6,52
"2011","Wyre 008A","E01025554",1036,48,14,34,195,145,141,87,190,138,34,29,5,58
"2011","Wyre 008B","E01025556",1047,53,11,42,214,132,113,87,180,137,43,31,12,88
"2011","Wyre 008C","E01025570",835,37,13,24,119,94,112,54,193,127,63,33,30,36
"2011","Wyre 008D","E01025571",1006,60,19,41,166,127,106,76,200,139,56,43,13,76
"2011","Wyre 008E","E01025572",940,60,17,43,184,136,140,71,163,112,28,21,7,46
"2011","Wyre 008F","E01025604",1088,86,24,62,219,182,136,87,164,106,37,25,12,71
"2011","Wyre 009A","E01025561",1110,133,40,93,274,145,205,75,111,78,21,9,12,68
"2011","Wyre 009B","E01025562",1547,199,50,149,357,146,314,111,185,105,29,24,5,101
"2011","Wyre 009C","E01025585",1700,167,39,128,395,185,354,121,203,150,33,25,8,92
"2011","Wyre 010A","E01025542",1243,107,27,80,307,221,144,88,159,93,34,20,14,90
"2011","Wyre 010B","E01025555",925,68,13,55,193,154,118,79,155,95,21,12,9,42
"2011","Wyre 010C","E01025601",1019,111,25,86,272,188,133,61,115,65,18,13,5,56
"2011","Wyre 010D","E01025602",1168,114,27,87,309,229,102,77,127,91,26,12,14,93
"2011","Wyre 010E","E01025603",1043,112,27,85,236,198,147,78,130,73,16,10,6,53
"2011","Wyre 011A","E01025541",1211,67,18,49,252,213,122,101,178,150,37,20,17,91
"2011","Wyre 011B","E01025543",1271,80,26,54,255,210,123,92,221,156,46,25,21,88
"2011","Wyre 011C","E01025544",1117,57,15,42,207,162,122,119,201,154,34,20,14,61
"2011","Wyre 011D","E01025576",1662,144,31,113,409,269,210,131,224,125,40,27,13,110
"2011","Wyre 011E","E01025577",1023,57,9,48,191,142,97,109,169,127,52,39,13,79
"2011","Wyre 012A","E01025550",1050,136,30,106,269,185,127,61,126,71,17,11,6,58
"2011","Wyre 012B","E01025552",976,134,41,93,293,165,90,72,88,62,15,9,6,57
"2011","Wyre 012C","E01025594",1076,101,23,78,241,190,111,86,151,107,29,20,9,60
"2011","Wyre 012D","E01025595",1048,111,22,89,278,200,146,70,123,54,15,10,5,51
"2011","Wyre 012E","E01025596",1488,169,40,129,391,264,157,123,170,108,15,9,6,91
"2011","Wyre 012F","E01025597",763,69,13,56,184,136,92,61,92,62,25,19,6,42
"2011","Wyre 013A","E01025545",1287,201,48,153,384,180,174,53,113,62,37,20,17,83
"2011","Wyre 013B","E01025546",1084,135,31,104,322,138,126,63,131,80,22,10,12,67
"2011","Wyre 013C","E01025551",1016,118,32,86,299,185,91,69,95,69,15,8,7,75
"2011","Wyre 013D","E01025567",1129,116,25,91,257,191,131,55,161,114,30,21,9,74
"2011","Wyre 013E","E01025598",1045,139,25,114,219,191,142,70,126,81,22,12,10,55
"2011","Wyre 014A","E01025566",1375,242,59,183,376,227,189,60,107,52,24,16,8,98
"2011","Wyre 014B","E01025568",1220,105,29,76,273,214,161,98,172,94,39,21,18,64
"2011","Wyre 014C","E01025569",1307,150,24,126,337,232,193,81,150,75,23,15,8,66
"2011","Wyre 014D","E01025599",739,86,17,69,175,125,116,50,88,48,13,8,5,38
"2011","Wyre 014E","E01025600",1114,133,21,112,326,180,127,87,119,63,11,6,5,68
"2011","Knowsley 001A","E01006448",1128,16,4,12,86,115,53,74,247,226,204,163,41,107
"2011","Knowsley 001B","E01006492",1069,28,9,19,126,150,62,113,208,180,109,82,27,93
"2011","Knowsley 001C","E01006493",789,6,1,5,43,90,41,62,157,163,165,139,26,62
"2011","Knowsley 001D","E01006494",988,12,8,4,68,100,53,43,220,207,198,160,38,87
"2011","Knowsley 001E","E01006495",1304,52,13,39,190,165,76,94,218,266,150,112,38,93
"2011","Knowsley 002A","E01006454",949,46,18,28,166,163,70,76,183,136,38,24,14,71
"2011","Knowsley 002B","E01006456",1201,68,15,53,187,204,118,100,199,146,80,60,20,99
"2011","Knowsley 002C","E01006457",897,36,11,25,157,159,77,66,163,143,53,39,14,43
"2011","Knowsley 002D","E01006458",1074,42,14,28,117,161,62,90,220,223,102,78,24,57
"2011","Knowsley 002E","E01006490",1984,159,38,121,447,378,149,139,308,212,69,38,31,123
"2011","Knowsley 002F","E01006491",1463,106,30,76,351,256,122,112,226,142,46,27,19,102
"2011","Knowsley 003A","E01006415",1478,66,17,49,207,223,117,102,271,240,128,87,41,124
"2011","Knowsley 003B","E01006417",992,15,4,11,60,100,71,55,203,240,176,117,59,72
"2011","Knowsley 003C","E01006436",1097,25,5,20,74,149,66,67,226,239,163,123,40,88
"2011","Knowsley 003D","E01006437",1014,24,7,17,123,122,45,80,213,190,139,103,36,78
"2011","Knowsley 003E","E01006447",997,33,12,21,129,129,47,74,207,177,131,104,27,70
"2011","Knowsley 004A","E01006455",1165,30,10,20,126,146,53,86,240,226,167,119,48,91
"2011","Knowsley 004B","E01006506",1042,42,6,36,157,208,61,89,204,134,81,44,37,66
"2011","Knowsley 004C","E01006507",1014,21,6,15,109,143,63,63,189,206,141,100,41,79
"2011","Knowsley 004D","E01006508",1000,43,15,28,175,172,73,74,167,148,81,52,29,67
"2011","Knowsley 004E","E01006509",1159,30,5,25,139,144,94,87,211,204,156,119,37,94
"2011","Knowsley 004F","E01006510",934,44,10,34,158,188,65,72,164,124,45,30,15,74
"2011","Knowsley 005A","E01006416",1050,18,3,15,97,143,50,73,220,228,138,112,26,83
"2011","Knowsley 005B","E01006418",969,17,5,12,85,122,50,74,196,202,138,95,43,85
"2011","Knowsley 005C","E01006434",1089,26,11,15,119,162,49,80,216,200,144,103,41,93
"2011","Knowsley 005D","E01006435",1120,30,8,22,117,152,62,91,238,171,169,119,50,90
"2011","Knowsley 005E","E01006438",872,105,22,83,189,129,118,49,100,78,43,31,12,61
"2011","Knowsley 005F","E01006439",1208,61,19,42,185,168,116,103,208,192,76,57,19,99
"2011","Knowsley 005G","E01006446",977,22,5,17,97,105,59,78,209,186,152,121,31,69
"2011","Knowsley 006A","E01006412",1084,32,7,25,62,121,48,67,271,234,161,128,33,88
"2011","Knowsley 006B","E01006413",1082,21,4,17,107,128,78,62,223,227,188,118,70,48
"2011","Knowsley 006C","E01006414",1023,20,2,18,106,110,53,79,249,222,114,73,41,70
"2011","Knowsley 006D","E01006441",1742,87,29,58,273,209,136,141,331,292,155,120,35,118
"2011","Knowsley 007A","E01006460",1110,24,7,17,121,108,44,77,249,212,175,135,40,100
"2011","Knowsley 007B","E01006461",1106,38,9,29,101,118,66,74,236,215,156,115,41,102
"2011","Knowsley 007C","E01006463",1391,60,12,48,212,205,94,87,270,238,156,99,57,69
"2011","Knowsley 007D","E01006464",1143,101,32,69,198,151,91,89,214,147,73,53,20,79
"2011","Knowsley 007E","E01006466",1119,72,21,51,276,149,86,94,171,138,57,39,18,76
"2011","Knowsley 008A","E01006453",833,14,5,9,75,98,44,62,165,156,134,93,41,85
"2011","Knowsley 008B","E01006467",927,12,2,10,77,88,34,48,199,173,200,158,42,96
"2011","Knowsley 008E","E01006470",1017,18,5,13,81,94,51,75,217,203,181,133,48,97
"2011","Knowsley 008F","E01033228",1335,21,7,14,106,108,71,81,303,262,268,208,60,115
"2011","Knowsley 009A","E01006459",1215,83,24,59,244,188,73,94,203,165,58,39,19,107
"2011","Knowsley 009B","E01006462",1068,80,21,59,215,184,88,84,158,134,46,29,17,79
"2011","Knowsley 009C","E01006496",988,52,24,28,155,150,69,89,182,169,49,34,15,73
"2011","Knowsley 009D","E01006498",1160,122,27,95,301,206,61,79,133,100,57,45,12,101
"2011","Knowsley 009E","E01006499",1176,76,18,58,266,198,97,89,177,140,58,38,20,75
"2011","Knowsley 010A","E01006440",1025,25,6,19,112,119,68,57,244,166,152,115,37,82
"2011","Knowsley 010B","E01006442",944,14,5,9,84,90,40,67,187,211,171,118,53,80
"2011","Knowsley 010C","E01006443",982,21,3,18,98,104,44,80,229,200,135,101,34,71
"2011","Knowsley 010D","E01006444",964,21,7,14,93,85,32,69,216,168,202,150,52,78
"2011","Knowsley 010E","E01006445",967,22,5,17,94,118,42,80,217,164,156,117,39,74
"2011","Knowsley 011A","E01006465",1256,135,37,98,270,204,99,113,167,108,49,34,15,111
"2011","Knowsley 011B","E01006482",1089,50,14,36,154,159,63,77,198,158,123,76,47,107
"2011","Knowsley 011C","E01006483",924,22,10,12,110,118,62,62,199,159,124,93,31,68
"2011","Knowsley 011D","E01006484",1022,28,9,19,121,122,55,90,230,169,114,81,33,93
"2011","Knowsley 012A","E01006449",1081,55,17,38,159,157,71,82,226,198,59,37,22,74
"2011","Knowsley 012B","E01006450",976,24,4,20,105,141,52,87,200,162,124,92,32,81
"2011","Knowsley 012C","E01006451",1067,58,15,43,176,130,81,68,235,155,83,61,22,81
"2011","Knowsley 012D","E01006452",1107,54,11,43,177,148,70,90,221,182,78,45,33,87
"2011","Knowsley 013A","E01006497",833,55,15,40,134,124,60,70,147,142,48,29,19,53
"2011","Knowsley 013B","E01006500",811,30,7,23,98,93,36,82,185,166,68,48,20,53
"2011","Knowsley 013C","E01006501",1001,78,18,60,203,152,86,83,160,124,49,30,19,66
"2011","Knowsley 013D","E01006504",1013,26,5,21,152,110,43,92,202,174,123,81,42,91
"2011","Knowsley 013E","E01006505",1235,25,6,19,127,136,90,95,291,236,141,101,40,94
"2011","Knowsley 014A","E01006472",1134,110,25,85,272,220,96,91,122,73,53,31,22,97
"2011","Knowsley 014B","E01006485",1099,62,11,51,198,186,86,99,218,98,61,42,19,91
"2011","Knowsley 014C","E01006486",878,63,13,50,188,157,80,68,147,88,32,21,11,55
"2011","Knowsley 014D","E01006487",1145,65,13,52,222,212,99,111,189,122,34,18,16,91
"2011","Knowsley 014E","E01006488",1303,97,22,75,284,221,109,106,183,129,80,57,23,94
"2011","Knowsley 014F","E01006489",1053,58,17,41,199,179,89,92,174,115,42,27,15,105
"2011","Knowsley 015A","E01006477",1027,21,6,15,164,157,70,83,230,150,76,52,24,76
"2011","Knowsley 015B","E01006478",982,41,15,26,141,121,47,86,161,174,124,75,49,87
"2011","Knowsley 015C","E01006479",989,53,17,36,156,153,66,75,176,144,73,50,23,93
"2011","Knowsley 015D","E01006480",966,17,2,15,108,100,58,88,207,189,122,88,34,77
"2011","Knowsley 015E","E01006481",933,47,14,33,125,117,68,65,208,148,93,70,23,62
"2011","Knowsley 016A","E01006471",1059,77,21,56,219,211,104,91,150,88,24,17,7,95
"2011","Knowsley 016B","E01006473",951,93,25,68,226,162,78,69,116,73,43,25,18,91
"2011","Knowsley 016C","E01006474",1044,77,20,57,222,174,109,94,169,88,44,32,12,67
"2011","Knowsley 016D","E01006475",1077,100,24,76,258,172,120,73,139,84,54,42,12,77
"2011","Knowsley 016E","E01006476",1085,113,30,83,282,204,85,64,117,78,32,20,12,110
"2011","Knowsley 017A","E01006420",1527,209,43,166,386,213,171,115,181,98,39,27,12,115
"2011","Knowsley 017B","E01006424",1601,157,48,109,399,253,137,116,221,120,63,38,25,135
"2011","Knowsley 017C","E01006502",1323,76,18,58,260,229,112,116,228,180,50,29,21,72
"2011","Knowsley 017D","E01006503",917,96,31,65,230,138,87,83,115,73,24,15,9,71
"2011","Knowsley 018A","E01006421",917,85,23,62,247,153,67,65,137,60,17,8,9,86
"2011","Knowsley 018B","E01006425",1012,89,32,57,207,135,85,85,162,92,64,43,21,93
"2011","Knowsley 018C","E01006430",880,34,12,22,120,89,42,78,191,153,110,75,35,63
"2011","Knowsley 018D","E01006433",1028,51,11,40,151,161,59,83,231,159,71,57,14,62
"2011","Knowsley 019A","E01006419",1138,92,22,70,284,200,89,103,167,82,32,13,19,89
"2011","Knowsley 019B","E01006422",949,70,15,55,168,163,81,91,175,94,32,19,13,75
"2011","Knowsley 019C","E01006423",1116,73,23,50,253,201,91,105,180,98,42,27,15,73
"2011","Knowsley 019D","E01006427",1040,64,16,48,203,165,63,96,187,130,53,34,19,79
"2011","Knowsley 020A","E01006426",907,26,12,14,93,99,63,62,202,174,119,85,34,69
"2011","Knowsley 020B","E01006428",1087,52,14,38,182,136,74,83,238,172,96,62,34,54
"2011","Knowsley 020C","E01006429",830,22,5,17,97,96,40,55,200,131,126,95,31,63
"2011","Knowsley 020D","E01006431",1236,95,23,72,242,168,78,114,231,138,89,60,29,81
"2011","Knowsley 020E","E01006432",1083,33,10,23,129,123,52,73,287,163,139,101,38,84
"2011","Liverpool 001A","E01006651",1214,92,27,65,297,209,112,85,161,111,36,23,13,111
"2011","Liverpool 001B","E01006653",1100,37,10,27,206,131,67,84,181,198,124,92,32,72
"2011","Liverpool 001C","E01006655",1272,93,17,76,244,167,83,88,210,182,117,81,36,88
"2011","Liverpool 001D","E01006658",971,19,9,10,101,113,51,72,225,195,132,103,29,63
"2011","Liverpool 001E","E01006660",1008,24,4,20,152,142,73,74,207,182,82,54,28,72
"2011","Liverpool 002A","E01006652",1118,64,14,50,215,185,86,65,217,144,66,41,25,76
"2011","Liverpool 002B","E01006656",1135,62,21,41,233,211,69,108,179,139,62,36,26,72
"2011","Liverpool 002C","E01006657",905,39,13,26,153,152,66,82,184,96,79,50,29,54
"2011","Liverpool 002D","E01006780",1085,39,7,32,236,212,90,82,187,122,42,24,18,75
"2011","Liverpool 002E","E01006783",1138,46,15,31,196,214,56,93,226,140,81,48,33,86
"2011","Liverpool 003A","E01006781",1160,83,26,57,237,213,87,95,178,122,49,31,18,96
"2011","Liverpool 003B","E01006782",1189,63,18,45,204,216,61,102,198,145,96,54,42,104
"2011","Liverpool 003C","E01006784",1028,54,10,44,221,200,66,67,172,114,54,32,22,80
"2011","Liverpool 003D","E01006785",1310,77,17,60,229,223,90,88,208,178,112,58,54,105
"2011","Liverpool 003E","E01006786",1337,76,24,52,251,287,91,102,219,153,71,44,27,87
"2011","Liverpool 004A","E01006661",1176,28,7,21,118,134,61,69,281,236,168,122,46,81
"2011","Liverpool 004B","E01006662",1165,37,10,27,164,150,61,77,220,244,131,98,33,81
"2011","Liverpool 004C","E01006663",820,34,7,27,128,130,49,53,151,152,81,62,19,42
"2011","Liverpool 004D","E01006664",1264,57,16,41,148,143,89,82,270,224,181,129,52,70
"2011","Liverpool 004E","E01006669",1109,112,23,89,187,177,108,75,151,120,60,40,20,119
"2011","Liverpool 005A","E01006654",1080,52,14,38,198,178,80,84,197,150,52,27,25,89
"2011","Liverpool 005B","E01006659",1476,54,13,41,123,117,137,128,262,348,242,198,44,65
"2011","Liverpool 005C","E01006734",968,18,4,14,86,117,41,69,220,203,124,71,53,90
"2011","Liverpool 005D","E01006735",948,19,5,14,102,106,46,76,194,195,125,91,34,85
"2011","Liverpool 005E","E01006736",1073,24,8,16,152,140,52,71,194,195,140,105,35,105
"2011","Liverpool 005F","E01006737",1048,32,7,25,104,109,51,72,219,190,160,128,32,111
"2011","Liverpool 006A","E01006787",1987,55,15,40,217,182,182,154,257,447,328,267,61,165
"2011","Liverpool 006B","E01006788",1299,75,21,54,223,236,79,97,237,158,89,54,35,105
"2011","Liverpool 006C","E01006790",1183,30,4,26,132,135,67,80,238,233,157,101,56,111
"2011","Liverpool 006D","E01006791",1280,27,7,20,146,141,80,95,240,301,166,111,55,84
"2011","Liverpool 007A","E01006665",1172,69,16,53,284,204,98,80,189,96,52,33,19,100
"2011","Liverpool 007B","E01006666",1107,113,34,79,247,184,93,72,148,83,40,25,15,127
"2011","Liverpool 007C","E01006667",1079,53,15,38,189,151,92,91,202,153,86,60,26,62
"2011","Liverpool 007D","E01006668",1118,95,21,74,261,207,117,71,129,105,35,23,12,98
"2011","Liverpool 007E","E01006670",1150,118,27,91,237,174,110,77,172,104,64,44,20,94
"2011","Liverpool 008A","E01006607",1084,21,10,11,121,142,57,68,229,208,124,83,41,114
"2011","Liverpool 008B","E01006612",1073,30,6,24,107,152,64,80,220,188,159,107,52,73
"2011","Liverpool 008C","E01006729",923,20,8,12,99,109,43,71,176,181,116,75,41,108
"2011","Liverpool 008F","E01032510",1358,68,15,53,213,218,86,110,235,216,99,66,33,113
"2011","Liverpool 008G","E01032511",1079,54,13,41,161,158,83,73,192,167,111,74,37,80
"2011","Liverpool 009A","E01006608",926,35,10,25,159,133,71,56,186,142,78,47,31,66
"2011","Liverpool 009B","E01006609",975,30,9,21,141,150,53,84,176,137,118,80,38,86
"2011","Liverpool 009C","E01006610",1015,33,13,20,118,149,46,80,198,173,124,93,31,94
"2011","Liverpool 009D","E01006613",1016,28,7,21,111,151,70,61,200,187,114,75,39,94
"2011","Liverpool 009E","E01006705",1106,34,7,27,139,148,85,86,230,174,123,73,50,87
"2011","Liverpool 010A","E01006598",927,17,6,11,76,87,43,62,203,190,160,109,51,89
"2011","Liverpool 010B","E01006599",778,9,4,5,82,93,39,50,139,175,121,73,48,70
"2011","Liverpool 010E","E01006672",1353,47,14,33,158,162,89,98,255,252,179,126,53,113
"2011","Liverpool 010F","E01033759",810,27,8,19,127,104,54,55,150,147,87,59,28,59
"2011","Liverpool 011A","E01006600",1030,31,9,22,135,141,67,67,221,174,102,72,30,92
"2011","Liverpool 011B","E01006603",1025,27,5,22,131,109,66,70,246,160,138,96,42,78
"2011","Liverpool 011C","E01006730",943,20,6,14,122,98,45,73,203,168,116,79,37,98
"2011","Liverpool 011D","E01006731",859,10,1,9,116,103,54,63,200,154,94,68,26,65
"2011","Liverpool 011E","E01006732",1083,17,1,16,85,118,39,81,244,219,163,119,44,117
"2011","Liverpool 012A","E01006611",994,15,3,12,92,135,44,73,182,221,167,116,51,65
"2011","Liverpool 012B","E01006614",989,23,6,17,121,153,56,78,221,172,106,66,40,59
"2011","Liverpool 012C","E01006615",998,20,5,15,103,141,49,66,245,189,114,77,37,71
"2011","Liverpool 012D","E01006698",1244,28,6,22,178,196,76,89,244,225,105,66,39,103
"2011","Liverpool 012E","E01006700",1085,35,7,28,121,116,78,68,220,214,141,99,42,92
"2011","Liverpool 013A","E01006623",1150,112,34,78,237,188,130,95,135,99,46,34,12,108
"2011","Liverpool 013B","E01006624",1174,55,17,38,209,157,98,80,217,140,128,88,40,90
"2011","Liverpool 013C","E01006627",1033,75,15,60,225,172,62,89,168,115,60,45,15,67
"2011","Liverpool 013D","E01006671",1046,76,22,54,203,141,91,63,140,139,82,57,25,111
"2011","Liverpool 014A","E01006699",1186,20,6,14,113,125,58,83,224,264,194,144,50,105
"2011","Liverpool 014B","E01006701",1111,32,9,23,135,149,66,105,232,204,114,78,36,74
"2011","Liverpool 014C","E01006702",1179,21,5,16,116,125,58,68,225,259,209,162,47,98
"2011","Liverpool 014D","E01006703",1210,21,7,14,107,105,49,89,269,272,208,155,53,90
"2011","Liverpool 014E","E01006778",1758,39,9,30,187,159,83,139,333,356,301,225,76,161
"2011","Liverpool 015A","E01006541",1211,51,14,37,167,206,78,96,208,197,123,89,34,85
"2011","Liverpool 015B","E01006543",966,40,12,28,147,172,81,81,166,145,42,29,13,92
"2011","Liverpool 015C","E01006544",1190,23,4,19,129,164,59,85,234,207,171,134,37,118
"2011","Liverpool 015D","E01006616",1068,38,15,23,150,167,75,81,202,189,86,61,25,80
"2011","Liverpool 015E","E01006762",1231,32,10,22,145,168,80,79,265,231,138,89,49,93
"2011","Liverpool 016A","E01006604",1019,29,9,20,113,171,70,74,218,171,98,56,42,75
"2011","Liverpool 016B","E01006605",1121,43,17,26,131,137,75,79,217,211,137,89,48,91
"2011","Liverpool 016C","E01006618",1205,38,14,24,168,196,76,102,219,201,96,72,24,109
"2011","Liverpool 016D","E01006625",1010,79,23,56,222,154,85,64,159,106,51,37,14,90
"2011","Liverpool 016E","E01006626",1116,79,24,55,235,212,76,82,164,110,51,31,20,107
"2011","Liverpool 017A","E01006637",1109,23,5,18,159,113,55,71,243,163,168,125,43,114
"2011","Liverpool 017B","E01006638",872,14,4,10,75,112,39,53,188,155,150,102,48,86
"2011","Liverpool 017C","E01006639",1097,62,15,47,207,181,96,61,191,139,79,65,14,81
"2011","Liverpool 017D","E01006644",1507,78,21,57,234,224,85,104,277,223,166,118,48,116
"2011","Liverpool 017E","E01006645",993,20,4,16,98,94,56,70,190,212,179,129,50,74
"2011","Liverpool 018A","E01006542",1025,38,13,25,124,125,62,65,171,196,152,122,30,92
"2011","Liverpool 018B","E01006558",1057,15,2,13,116,110,49,69,207,237,194,133,61,60
"2011","Liverpool 018E","E01006562",1109,17,6,11,116,121,64,50,227,222,195,150,45,97
"2011","Liverpool 018F","E01033747",729,10,2,8,59,58,49,44,135,127,170,133,37,77
"2011","Liverpool 019A","E01006545",1083,40,5,35,158,180,58,93,197,183,77,49,28,97
"2011","Liverpool 019B","E01006546",942,29,11,18,121,152,61,63,196,147,99,61,38,74
"2011","Liverpool 019C","E01006547",1125,30,5,25,130,127,89,71,183,202,176,113,63,117
"2011","Liverpool 019D","E01006548",1177,25,7,18,141,155,62,87,206,193,153,111,42,155
"2011","Liverpool 019E","E01006766",916,19,3,16,94,100,46,56,212,166,139,92,47,84
"2011","Liverpool 019F","E01006767",1316,63,13,50,187,169,86,96,235,185,134,72,62,161
"2011","Liverpool 020A","E01006606",1155,53,16,37,156,192,90,91,203,193,110,76,34,67
"2011","Liverpool 020B","E01006761",1219,35,9,26,188,169,83,97,210,192,153,94,59,92
"2011","Liverpool 020C","E01006763",1061,43,13,30,191,164,75,69,188,139,99,65,34,93
"2011","Liverpool 020D","E01006764",1153,50,5,45,177,132,73,73,196,190,136,98,38,126
"2011","Liverpool 020E","E01006765",1076,56,15,41,151,192,56,94,175,149,105,61,44,98
"2011","Liverpool 020F","E01006768",1104,61,11,50,206,153,94,68,141,124,152,102,50,105
"2011","Liverpool 021A","E01006617",1093,119,30,89,278,174,90,67,122,117,41,26,15,85
"2011","Liverpool 021B","E01006619",1196,73,12,61,262,221,105,70,181,126,62,45,17,96
"2011","Liverpool 021C","E01006620",1021,86,29,57,218,191,98,53,149,105,43,28,15,78
"2011","Liverpool 021D","E01006621",1123,120,27,93,285,167,150,54,113,72,37,25,12,125
"2011","Liverpool 021E","E01006622",1097,106,27,79,279,214,96,63,138,77,31,23,8,93
"2011","Liverpool 021F","E01006640",1358,127,29,98,321,216,119,89,171,134,89,65,24,92
"2011","Liverpool 022B","E01006776",1271,72,13,59,171,158,77,83,206,242,161,136,25,101
"2011","Liverpool 022D","E01006779",1417,28,5,23,111,170,55,84,256,338,252,200,52,123
"2011","Liverpool 022E","E01033764",1661,39,6,33,142,130,83,94,302,408,355,246,109,108
"2011","Liverpool 023A","E01006560",1419,19,3,16,93,127,62,88,312,347,272,195,77,99
"2011","Liverpool 023B","E01006564",1354,31,12,19,150,173,80,120,287,282,147,98,49,84
"2011","Liverpool 023C","E01006646",1543,128,13,115,220,136,62,90,198,257,235,187,48,217
"2011","Liverpool 023D","E01006648",1780,138,11,127,237,171,55,100,235,333,219,173,46,292
"2011","Liverpool 024A","E01006540",1139,28,6,22,122,93,48,73,188,201,265,180,85,121
"2011","Liverpool 024B","E01006563",1224,15,6,9,129,127,64,69,225,247,260,186,74,88
"2011","Liverpool 024C","E01006647",1000,20,3,17,70,93,33,68,158,255,217,179,38,86
"2011","Liverpool 024D","E01006693",1190,24,4,20,118,108,82,79,248,257,194,155,39,80
"2011","Liverpool 025A","E01006572",834,12,4,8,104,95,52,71,194,132,111,82,29,63
"2011","Liverpool 025B","E01006574",966,30,7,23,134,122,79,68,212,141,105,72,33,75
"2011","Liverpool 025C","E01006641",1187,84,22,62,303,180,92,80,204,118,67,45,22,59
"2011","Liverpool 025D","E01006642",900,14,7,7,91,82,46,59,202,162,151,98,53,93
"2011","Liverpool 025E","E01006643",1275,39,4,35,160,155,73,104,232,212,179,132,47,121
"2011","Liverpool 026A","E01006567",1237,87,18,69,164,161,106,78,190,202,151,111,40,98
"2011","Liverpool 026B","E01006568",1145,80,19,61,244,217,61,73,170,113,100,64,36,87
"2011","Liverpool 026C","E01006570",1082,91,16,75,273,170,91,60,147,101,51,35,16,98
"2011","Liverpool 026D","E01006571",1050,26,9,17,146,138,71,59,201,200,124,97,27,85
"2011","Liverpool 027A","E01006711",1138,41,14,27,197,150,94,83,183,159,127,79,48,104
"2011","Liverpool 027D","E01006717",1057,72,19,53,212,177,76,74,177,115,57,28,29,97
"2011","Liverpool 027E","E01006718",1207,54,7,47,213,203,88,72,206,164,102,66,36,105
"2011","Liverpool 027F","E01006719",1109,49,12,37,190,195,77,70,177,159,90,51,39,102
"2011","Liverpool 027G","E01032508",1296,49,17,32,177,148,65,69,261,225,187,130,57,115
"2011","Liverpool 027H","E01032509",1053,28,7,21,140,142,61,76,231,174,124,82,42,77
"2011","Liverpool 028A","E01006690",1227,44,6,38,159,119,65,79,215,182,191,129,62,173
"2011","Liverpool 028B","E01006692",1644,62,12,50,222,166,117,110,284,250,248,178,70,185
"2011","Liverpool 028C","E01006695",1496,62,9,53,168,150,85,89,245,201,284,185,99,212
"2011","Liverpool 028D","E01006759",848,52,18,34,140,121,75,62,129,100,87,57,30,82
"2011","Liverpool 028E","E01006760",1365,61,11,50,167,134,101,86,207,190,246,183,63,173
"2011","Liverpool 029A","E01006565",1119,38,6,32,184,182,67,75,210,164,117,88,29,82
"2011","Liverpool 029B","E01006569",1035,52,10,42,136,133,78,75,194,164,121,80,41,82
"2011","Liverpool 029C","E01006573",1055,47,11,36,167,171,68,69,230,143,95,57,38,65
"2011","Liverpool 029D","E01006712",949,44,7,37,176,148,59,78,171,137,77,49,28,59
"2011","Liverpool 029E","E01006713",994,49,13,36,184,183,67,65,187,135,65,41,24,59
"2011","Liverpool 030A","E01006691",1110,27,4,23,108,95,72,69,200,165,200,155,45,174
"2011","Liverpool 030B","E01006694",1392,32,1,31,157,148,59,82,271,230,208,147,61,205
"2011","Liverpool 030C","E01006696",1286,19,7,12,157,133,67,80,228,204,187,151,36,211
"2011","Liverpool 030D","E01006697",1365,33,7,26,153,129,89,80,256,215,221,164,57,189
"2011","Liverpool 030E","E01006746",1209,23,4,19,103,69,64,56,174,195,155,120,35,370
"2011","Liverpool 031A","E01006512",1666,156,11,145,134,58,35,42,84,52,131,109,22,974
"2011","Liverpool 031B","E01006747",3367,96,3,93,127,82,37,59,138,159,146,114,32,2523
"2011","Liverpool 031C","E01006748",1701,50,6,44,114,78,42,66,142,159,110,73,37,940
"2011","Liverpool 031F","E01006751",2116,37,1,36,130,98,45,68,218,227,242,209,33,1051
"2011","Liverpool 031G","E01033763",1279,38,13,25,105,94,59,74,197,202,236,179,57,274
"2011","Liverpool 032A","E01006566",1078,74,13,61,221,157,86,80,181,119,61,41,20,99
"2011","Liverpool 032B","E01006585",1005,47,13,34,144,134,63,68,199,170,99,72,27,81
"2011","Liverpool 032C","E01006586",1460,112,10,102,290,188,118,90,235,146,134,94,40,147
"2011","Liverpool 032D","E01006587",1280,121,31,90,293,199,111,58,167,142,98,68,30,91
"2011","Liverpool 032E","E01006716",1117,43,5,38,171,169,85,75,201,156,146,114,32,71
"2011","Liverpool 034A","E01006575",956,75,13,62,199,147,77,68,159,89,52,36,16,90
"2011","Liverpool 034B","E01006576",1264,119,31,88,355,214,95,79,160,115,36,22,14,91
"2011","Liverpool 034C","E01006577",1106,150,27,123,321,187,79,60,110,71,24,16,8,104
"2011","Liverpool 034D","E01006579",1177,147,22,125,315,195,102,69,145,80,42,27,15,82
"2011","Liverpool 034E","E01006584",1042,61,13,48,256,190,87,83,134,98,56,28,28,77
"2011","Liverpool 035A","E01006720",1604,67,5,62,191,110,87,73,201,199,257,206,51,419
"2011","Liverpool 035B","E01006725",1199,73,11,62,214,132,63,85,200,162,133,91,42,137
"2011","Liverpool 035C","E01006726",1262,61,15,46,175,96,56,74,181,128,97,67,30,394
"2011","Liverpool 035D","E01006727",1157,79,12,67,228,143,70,86,179,134,85,57,28,153
"2011","Liverpool 035E","E01006728",1229,48,11,37,169,145,51,72,238,149,169,122,47,188
"2011","Liverpool 035F","E01006752",801,28,7,21,106,86,49,58,126,107,110,78,32,131
"2011","Liverpool 036A","E01006578",1020,100,24,76,266,174,83,78,136,71,36,22,14,76
"2011","Liverpool 036B","E01006580",1015,132,29,103,302,159,80,55,104,52,32,19,13,99
"2011","Liverpool 036C","E01006581",1152,163,29,134,323,202,77,67,107,59,34,24,10,120
"2011","Liverpool 036D","E01006773",1049,92,19,73,229,212,70,60,149,118,40,25,15,79
"2011","Liverpool 036E","E01006774",1082,126,24,102,248,179,80,70,133,89,39,21,18,118
"2011","Liverpool 037A","E01006514",1955,168,17,151,308,106,75,65,111,111,143,95,48,868
"2011","Liverpool 037B","E01006515",921,67,6,61,141,85,43,73,135,116,140,121,19,121
"2011","Liverpool 037D","E01006673",1425,74,7,67,212,98,59,71,174,152,307,238,69,278
"2011","Liverpool 037E","E01033757",960,42,4,38,83,40,16,24,73,32,66,36,30,584
"2011","Liverpool 037F","E01033768",1102,118,16,102,225,95,45,39,135,63,170,101,69,212
"2011","Liverpool 038A","E01006550",1466,70,8,62,151,65,33,30,62,41,43,26,17,971
"2011","Liverpool 038B","E01006557",1874,78,10,68,154,88,48,36,122,71,72,54,18,1205
"2011","Liverpool 038C","E01006721",1265,51,10,41,168,124,63,65,221,149,173,127,46,251
"2011","Liverpool 038D","E01006722",1541,51,6,45,155,100,74,55,104,92,107,88,19,803
"2011","Liverpool 038E","E01006723",1639,67,7,60,163,131,53,64,169,140,125,83,42,727
"2011","Liverpool 038F","E01006724",1610,67,10,57,184,87,48,42,122,76,75,53,22,909
"2011","Liverpool 039A","E01006552",1403,87,9,78,162,116,124,67,176,138,290,220,70,243
"2011","Liverpool 039B","E01006556",1510,38,4,34,130,113,101,82,199,182,415,330,85,250
"2011","Liverpool 039C","E01006674",1277,47,8,39,108,89,69,58,199,135,379,325,54,193
"2011","Liverpool 039D","E01006679",1460,44,5,39,143,79,90,75,168,114,493,405,88,254
"2011","Liverpool 040A","E01006709",1064,54,14,40,154,130,75,83,201,179,97,61,36,91
"2011","Liverpool 040B","E01006769",894,28,9,19,112,110,48,84,176,179,102,71,31,55
"2011","Liverpool 040C","E01006770",712,17,6,11,85,89,42,60,162,129,77,55,22,51
"2011","Liverpool 040D","E01006771",1049,24,12,12,115,106,52,92,238,201,125,86,39,96
"2011","Liverpool 040E","E01006772",820,49,11,38,135,103,62,66,144,129,68,56,12,64
"2011","Liverpool 040F","E01006775",986,12,8,4,92,115,47,80,227,182,151,114,37,80
"2011","Liverpool 041A","E01006582",1192,184,38,146,354,173,90,57,99,51,34,24,10,150
"2011","Liverpool 041B","E01006589",1116,139,31,108,293,194,87,72,118,75,31,24,7,107
"2011","Liverpool 041C","E01006591",1289,206,36,170,381,160,71,43,109,44,48,28,20,227
"2011","Liverpool 041D","E01006592",1136,273,32,241,330,130,98,28,69,41,28,15,13,139
"2011","Liverpool 041E","E01006597",1232,270,55,215,386,148,94,53,94,35,33,20,13,119
"2011","Liverpool 042A","E01006553",1673,170,14,156,225,122,57,40,104,59,63,46,17,833
"2011","Liverpool 042C","E01006588",1264,149,24,125,303,171,84,59,148,93,69,44,25,188
"2011","Liverpool 042D","E01006590",1369,154,19,135,342,186,54,83,125,90,52,30,22,283
"2011","Liverpool 042E","E01006593",1255,154,25,129,319,165,65,64,102,74,38,25,13,274
"2011","Liverpool 042F","E01033749",1114,29,3,26,29,15,8,5,19,14,12,9,3,983
"2011","Liverpool 042G","E01033766",926,104,16,88,184,92,48,51,82,51,39,21,18,275
"2011","Liverpool 043A","E01006520",1523,300,30,270,435,147,90,78,138,76,133,85,48,126
"2011","Liverpool 043B","E01006549",1456,167,22,145,302,114,92,73,150,95,188,139,49,275
"2011","Liverpool 043C","E01006675",1604,202,24,178,355,134,109,125,191,94,219,162,57,175
"2011","Liverpool 043D","E01006677",704,14,5,9,57,46,49,38,122,127,178,150,28,73
"2011","Liverpool 044A","E01006518",1229,43,5,38,152,108,65,74,247,219,199,160,39,122
"2011","Liverpool 044B","E01006630",970,33,7,26,89,60,35,65,192,199,197,154,43,100
"2011","Liverpool 044C","E01006632",1352,64,16,48,161,145,82,100,226,272,192,135,57,110
"2011","Liverpool 044D","E01006676",1208,45,6,39,117,87,89,67,195,168,260,206,54,180
"2011","Liverpool 044E","E01006678",1657,74,13,61,222,146,104,112,277,270,252,185,67,200
"2011","Liverpool 045A","E01006706",1010,18,5,13,84,95,49,80,237,214,150,115,35,83
"2011","Liverpool 045B","E01006707",935,13,4,9,82,77,37,85,218,218,135,99,36,70
"2011","Liverpool 045C","E01006708",1257,54,14,40,204,168,85,98,232,189,124,99,25,103
"2011","Liverpool 045D","E01006710",1139,35,12,23,150,152,53,105,269,199,91,57,34,85
"2011","Liverpool 046A","E01006792",964,188,28,160,271,143,108,45,83,35,25,19,6,66
"2011","Liverpool 046B","E01006794",1196,200,40,160,342,163,123,53,106,63,64,40,24,82
"2011","Liverpool 046C","E01006800",1002,100,18,82,258,180,97,74,133,63,31,15,16,66
"2011","Liverpool 046D","E01006801",1000,103,27,76,245,171,92,71,132,95,34,23,11,57
"2011","Liverpool 047A","E01006532",1132,224,38,186,348,120,139,42,85,37,33,21,12,104
"2011","Liverpool 047B","E01006539",1117,257,45,212,297,126,118,27,85,39,65,52,13,103
"2011","Liverpool 047C","E01006583",1408,155,34,121,281,155,93,27,61,31,33,22,11,572
"2011","Liverpool 047D","E01006594",1054,214,32,182,313,152,101,40,73,31,26,22,4,104
"2011","Liverpool 047E","E01006796",1166,263,42,221,345,130,139,29,69,38,35,25,10,118
"2011","Liverpool 048A","E01006522",1564,269,21,248,423,171,88,74,124,106,174,118,56,135
"2011","Liverpool 048B","E01006524",2033,211,18,193,247,110,73,41,56,29,46,41,5,1220
"2011","Liverpool 048C","E01006526",1029,131,20,111,302,137,79,61,98,83,60,42,18,78
"2011","Liverpool 048D","E01006529",1007,150,17,133,292,137,57,51,109,82,42,25,17,87
"2011","Liverpool 048E","E01006551",1298,122,18,104,184,85,57,43,119,111,131,102,29,446
"2011","Liverpool 048F","E01006554",1500,191,23,168,241,80,76,35,86,68,91,59,32,632
"2011","Liverpool 049A","E01006525",942,135,31,104,264,158,76,42,87,58,24,11,13,98
"2011","Liverpool 049B","E01006595",1313,178,26,152,340,222,80,76,146,101,58,35,23,112
"2011","Liverpool 049C","E01006596",1095,160,30,130,328,148,71,54,114,73,48,32,16,99
"2011","Liverpool 049D","E01006689",1215,158,29,129,351,202,91,66,142,72,39,26,13,94
"2011","Liverpool 050B","E01006633",1036,17,6,11,101,92,46,65,201,252,186,145,41,76
"2011","Liverpool 050F","E01032505",999,94,13,81,182,122,109,59,120,125,86,70,16,102
"2011","Liverpool 050G","E01032506",1106,92,15,77,220,126,70,76,174,151,111,73,38,86
"2011","Liverpool 050H","E01032507",1285,129,12,117,323,169,62,75,145,143,65,44,21,174
"2011","Liverpool 050I","E01033748",1174,232,37,195,333,153,52,60,85,52,41,25,16,166
"2011","Liverpool 050J","E01033767",822,32,8,24,110,102,52,44,156,139,125,84,41,62
"2011","Liverpool 051A","E01006793",1070,149,40,109,241,146,96,69,119,93,72,38,34,85
"2011","Liverpool 051B","E01006795",1052,184,30,154,294,160,82,56,87,71,35,20,15,83
"2011","Liverpool 051C","E01006797",1099,58,12,46,197,169,80,79,184,143,95,62,33,94
"2011","Liverpool 051D","E01006798",1071,141,26,115,286,180,81,59,132,78,37,24,13,77
"2011","Liverpool 051E","E01006799",1294,135,20,115,282,171,117,85,200,169,76,56,20,59
"2011","Liverpool 052A","E01006521",1256,242,35,207,306,134,111,56,130,77,87,53,34,113
"2011","Liverpool 052B","E01006523",1242,232,15,217,349,134,77,56,123,79,92,59,33,100
"2011","Liverpool 052C","E01006528",1157,168,21,147,262,168,76,57,105,81,60,29,31,180
"2011","Liverpool 052D","E01006628",1525,177,22,155,298,150,91,69,145,73,75,49,26,447
"2011","Liverpool 052E","E01006629",1008,103,20,83,234,138,60,53,160,111,62,49,13,87
"2011","Liverpool 053A","E01006527",1103,131,25,106,235,133,69,68,138,96,49,26,23,184
"2011","Liverpool 053B","E01006680",1182,158,29,129,296,183,97,90,142,69,44,30,14,103
"2011","Liverpool 053C","E01006682",963,169,39,130,292,160,79,41,71,51,26,23,3,74
"2011","Liverpool 053D","E01006683",1118,178,33,145,288,192,76,60,131,68,37,26,11,88
"2011","Liverpool 053E","E01006686",1060,96,15,81,278,187,64,77,129,79,33,23,10,117
"2011","Liverpool 054A","E01006534",1158,103,20,83,209,144,87,82,201,132,76,53,23,124
"2011","Liverpool 054B","E01006535",1222,97,20,77,247,184,60,85,193,128,119,96,23,109
"2011","Liverpool 054C","E01006536",1386,71,12,59,207,203,83,87,264,224,130,83,47,117
"2011","Liverpool 054D","E01006681",1176,102,20,82,268,200,76,78,164,98,93,63,30,97
"2011","Liverpool 055A","E01006530",1005,98,27,71,278,173,64,89,126,67,22,15,7,88
"2011","Liverpool 055B","E01006531",997,97,26,71,265,174,76,72,123,71,32,25,7,87
"2011","Liverpool 055C","E01006533",992,114,17,97,235,145,83,72,137,74,57,37,20,75
"2011","Liverpool 055D","E01006537",1728,135,27,108,335,264,125,155,304,194,93,63,30,123
"2011","Liverpool 055E","E01006538",972,88,21,67,187,146,64,105,144,113,48,39,9,77
"2011","Liverpool 056A","E01006519",949,179,33,146,312,117,65,39,68,49,26,19,7,94
"2011","Liverpool 056B","E01006684",1629,340,59,281,462,274,106,86,154,66,43,21,22,98
"2011","Liverpool 056C","E01006685",1121,153,31,122,314,158,89,63,106,69,46,30,16,123
"2011","Liverpool 056D","E01006687",1483,333,45,288,419,152,109,64,129,79,117,89,28,81
"2011","Liverpool 056E","E01006688",1174,145,24,121,288,172,77,88,151,105,67,41,26,81
"2011","Liverpool 057A","E01006740",943,24,2,22,94,87,37,57,215,203,153,104,49,73
"2011","Liverpool 057B","E01006742",1056,58,12,46,193,135,57,88,185,168,87,62,25,85
"2011","Liverpool 057C","E01006744",1125,71,12,59,223,165,66,75,228,150,80,48,32,67
"2011","Liverpool 057D","E01006745",1422,68,13,55,243,190,93,111,268,194,148,102,46,107
"2011","Liverpool 058A","E01006738",1078,25,3,22,111,112,56,91,254,230,113,74,39,86
"2011","Liverpool 058B","E01006739",1233,22,9,13,122,128,51,110,287,234,181,132,49,98
"2011","Liverpool 058C","E01006741",1335,17,7,10,133,154,55,136,295,272,174,133,41,99
"2011","Liverpool 058D","E01006743",1619,87,20,67,262,254,94,177,273,216,138,91,47,118
"2011","Liverpool 059A","E01006753",1090,25,11,14,98,110,41,100,262,199,170,125,45,85
"2011","Liverpool 059B","E01006754",1199,27,6,21,117,117,72,97,286,248,149,108,41,86
"2011","Liverpool 059C","E01006755",1082,18,1,17,102,108,54,100,249,190,188,123,65,73
"2011","Liverpool 059D","E01006756",1236,11,7,4,111,122,68,88,308,243,196,136,60,89
"2011","Liverpool 059E","E01006757",1027,27,9,18,88,86,51,82,261,178,165,123,42,89
"2011","Liverpool 059F","E01006758",1062,26,3,23,110,114,39,95,246,205,142,97,45,85
"2011","Liverpool 060A","E01006513",2853,164,12,152,231,101,45,42,71,49,88,72,16,2062
"2011","Liverpool 060B","E01033758",1672,39,0,39,49,57,17,29,56,78,73,58,15,1274
"2011","Liverpool 060C","E01033760",2098,91,4,87,118,54,22,28,38,48,38,22,16,1661
"2011","Liverpool 060D","E01033761",1350,227,21,206,283,131,38,63,54,43,30,22,8,481
"2011","Liverpool 060E","E01033762",1746,70,12,58,120,59,15,37,52,43,39,31,8,1311
"2011","Liverpool 061A","E01033750",1360,319,40,279,376,159,84,64,71,40,36,24,12,211
"2011","Liverpool 061B","E01033754",1310,205,24,181,311,120,52,80,107,109,71,54,17,255
"2011","Liverpool 061C","E01033756",1139,223,20,203,244,94,46,28,36,28,31,22,9,409
"2011","Liverpool 061D","E01033765",1020,97,26,71,122,102,59,84,158,145,168,138,30,85
"2011","Liverpool 062A","E01033751",1753,169,26,143,224,95,58,44,74,79,95,75,20,915
"2011","Liverpool 062B","E01033752",1158,283,41,242,281,163,52,38,47,26,28,17,11,240
"2011","Liverpool 062C","E01033753",1021,232,25,207,302,138,49,19,37,22,23,16,7,199
"2011","Liverpool 062D","E01033755",1043,213,16,197,271,147,29,45,47,37,10,8,2,244
"2011","Sefton 001A","E01006946",970,59,12,47,218,144,111,89,181,99,20,10,10,49
"2011","Sefton 001B","E01007028",1005,64,20,44,234,151,102,81,186,94,34,20,14,59
"2011","Sefton 001C","E01007029",847,65,25,40,202,132,76,70,146,91,23,19,4,42
"2011","Sefton 001D","E01007030",1055,57,16,41,193,137,109,71,219,148,35,21,14,86
"2011","Sefton 001E","E01007036",925,81,22,59,229,155,84,78,149,80,18,12,6,51
"2011","Sefton 002A","E01006947",1037,105,29,76,281,158,114,67,146,64,29,17,12,73
"2011","Sefton 002B","E01007031",1052,92,22,70,257,155,103,76,173,85,29,20,9,82
"2011","Sefton 002C","E01007032",937,85,19,66,264,136,120,55,133,68,23,12,11,53
"2011","Sefton 002D","E01007033",1034,85,25,60,220,181,121,83,157,90,29,19,10,68
"2011","Sefton 002E","E01007035",981,120,32,88,289,135,127,55,100,71,27,18,9,57
"2011","Sefton 003A","E01006944",1037,95,26,69,226,149,126,67,166,113,73,60,13,22
"2011","Sefton 003B","E01006948",941,78,20,58,191,123,90,56,173,112,50,29,21,68
"2011","Sefton 003C","E01006949",977,122,36,86,246,154,132,48,131,69,15,12,3,60
"2011","Sefton 003D","E01006951",1038,143,37,106,272,130,137,52,140,65,46,38,8,53
"2011","Sefton 003E","E01007034",945,127,28,99,258,148,115,45,110,49,11,8,3,82
"2011","Sefton 004A","E01006945",1135,97,22,75,236,102,129,80,213,156,62,41,21,60
"2011","Sefton 004B","E01006950",1160,76,26,50,238,108,126,90,236,141,91,68,23,54
"2011","Sefton 004C","E01006968",1276,74,16,58,209,111,108,107,251,213,123,76,47,80
"2011","Sefton 004D","E01006969",1061,55,8,47,180,103,104,104,213,176,55,32,23,71
"2011","Sefton 004F","E01033094",813,64,18,46,147,56,92,50,160,106,104,61,43,34
"2011","Sefton 004G","E01033097",799,45,10,35,166,84,102,66,139,121,44,26,18,32
"2011","Sefton 005A","E01007055",1044,27,9,18,110,88,76,101,238,205,110,72,38,89
"2011","Sefton 005B","E01007056",1175,62,10,52,229,162,107,94,219,189,43,24,19,70
"2011","Sefton 005C","E01007057",1110,66,13,53,233,141,129,94,192,142,44,23,21,69
"2011","Sefton 005D","E01007062",1047,91,24,67,261,146,111,70,147,96,34,15,19,91
"2011","Sefton 005E","E01007063",1104,83,21,62,221,160,129,74,197,114,36,21,15,90
"2011","Sefton 006A","E01007058",1109,59,14,45,229,129,118,108,212,132,51,23,28,71
"2011","Sefton 006B","E01007059",1087,84,25,59,269,128,114,82,160,119,51,25,26,80
"2011","Sefton 006C","E01007060",1020,45,8,37,192,124,97,78,213,132,66,46,20,73
"2011","Sefton 006D","E01007061",1074,69,22,47,240,146,118,99,183,89,47,31,16,83
"2011","Sefton 006E","E01007064",965,125,30,95,257,125,109,43,124,62,27,19,8,93
"2011","Sefton 007A","E01006934",1105,103,24,79,255,135,140,64,175,103,47,31,16,83
"2011","Sefton 007B","E01006970",1215,83,13,70,233,108,126,102,255,165,66,44,22,77
"2011","Sefton 007C","E01006994",1130,75,19,56,227,119,107,90,211,141,69,34,35,91
"2011","Sefton 007D","E01006996",1137,103,34,69,212,126,121,93,197,114,87,61,26,84
"2011","Sefton 007E","E01006998",1202,58,11,47,217,121,127,115,230,188,63,33,30,83
"2011","Sefton 008A","E01006995",967,117,30,87,240,102,118,53,127,66,50,35,15,94
"2011","Sefton 008B","E01006997",1128,61,13,48,256,160,107,94,208,117,39,23,16,86
"2011","Sefton 008C","E01006999",1185,107,20,87,272,147,122,79,215,119,52,33,19,72
"2011","Sefton 008D","E01007000",937,59,19,40,199,107,85,63,177,98,64,39,25,85
"2011","Sefton 008E","E01007001",1129,66,21,45,205,135,130,88,219,144,59,35,24,83
"2011","Sefton 008F","E01007002",973,88,21,67,251,150,105,69,167,70,23,13,10,50
"2011","Sefton 009A","E01006928",1050,173,36,137,329,150,105,44,87,54,23,11,12,85
"2011","Sefton 009B","E01006935",1199,166,37,129,288,155,133,68,156,76,43,24,19,114
"2011","Sefton 009C","E01006971",1060,149,33,116,293,120,133,58,124,66,64,52,12,53
"2011","Sefton 009D","E01006972",994,148,41,107,283,148,105,49,128,59,23,15,8,51
"2011","Sefton 009E","E01006973",983,167,37,130,241,115,139,40,99,41,65,51,14,76
"2011","Sefton 009F","E01006974",1150,234,53,181,300,154,154,44,100,40,25,15,10,99
"2011","Sefton 010A","E01006929",1163,82,19,63,238,167,137,83,190,129,37,25,12,100
"2011","Sefton 010B","E01006930",1042,54,10,44,180,125,137,90,206,130,57,30,27,63
"2011","Sefton 010C","E01006931",1100,117,23,94,308,182,103,62,139,78,28,16,12,83
"2011","Sefton 010D","E01006932",1121,183,37,146,338,161,102,56,116,57,24,13,11,84
"2011","Sefton 010E","E01006933",1004,66,16,50,212,125,119,74,184,120,40,22,18,64
"2011","Sefton 011A","E01006920",1095,103,22,81,258,187,92,72,148,104,42,23,19,89
"2011","Sefton 011B","E01006924",995,53,8,45,163,130,96,67,183,163,73,51,22,67
"2011","Sefton 011C","E01006925",1102,52,9,43,229,134,107,73,195,138,87,55,32,87
"2011","Sefton 011D","E01006927",1139,132,40,92,283,155,122,54,173,100,48,37,11,72
"2011","Sefton 012A","E01006921",941,143,39,104,285,174,87,42,89,45,22,12,10,54
"2011","Sefton 012B","E01006922",1084,163,36,127,324,176,89,59,139,46,24,16,8,64
"2011","Sefton 012C","E01006923",1012,134,33,101,276,191,83,58,130,58,22,11,11,60
"2011","Sefton 012D","E01006926",1181,238,59,179,380,170,121,41,105,34,23,11,12,69
"2011","Sefton 013A","E01006985",1054,198,59,139,356,148,105,35,83,29,16,10,6,84
"2011","Sefton 013B","E01006986",954,172,43,129,285,160,88,30,94,23,40,34,6,62
"2011","Sefton 013C","E01006987",889,131,32,99,267,158,77,53,84,44,18,11,7,57
"2011","Sefton 013D","E01006989",966,163,39,124,278,163,60,51,104,33,52,45,7,62
"2011","Sefton 013E","E01006990",903,155,34,121,286,152,79,35,83,35,14,7,7,64
"2011","Sefton 014A","E01006988",959,115,26,89,247,134,87,62,125,93,40,29,11,56
"2011","Sefton 014B","E01007079",1090,222,54,168,318,157,122,37,96,39,22,16,6,77
"2011","Sefton 014C","E01007080",1044,108,24,84,274,157,111,61,140,88,39,25,14,66
"2011","Sefton 014D","E01007081",1006,161,38,123,320,131,94,55,89,61,29,18,11,66
"2011","Sefton 015A","E01006991",1075,180,37,143,338,179,92,45,97,40,21,12,9,83
"2011","Sefton 015B","E01006992",777,105,23,82,212,140,75,35,80,46,23,13,10,61
"2011","Sefton 015C","E01006993",1093,189,43,146,318,170,108,41,122,45,16,8,8,84
"2011","Sefton 015D","E01007078",1081,137,23,114,301,186,102,59,129,51,26,15,11,90
"2011","Sefton 016A","E01007075",966,104,26,78,261,180,68,51,142,87,13,9,4,60
"2011","Sefton 016B","E01007076",996,103,20,83,286,165,102,58,109,71,23,11,12,79
"2011","Sefton 016C","E01007077",1066,117,30,87,273,159,98,61,161,65,38,18,20,94
"2011","Sefton 016D","E01007082",1021,109,27,82,267,168,77,68,164,69,33,22,11,66
"2011","Sefton 017A","E01007067",1060,121,32,89,280,175,146,66,99,75,29,18,11,69
"2011","Sefton 017B","E01007068",987,107,25,82,247,174,96,50,115,92,30,21,9,76
"2011","Sefton 017C","E01007069",1024,72,22,50,211,178,91,78,159,136,36,22,14,63
"2011","Sefton 017D","E01007070",1091,110,22,88,273,221,70,91,140,91,20,10,10,75
"2011","Sefton 017E","E01007101",1037,96,29,67,285,192,67,88,143,73,19,11,8,74
"2011","Sefton 018C","E01007095",1086,74,18,56,274,199,106,75,152,98,15,7,8,93
"2011","Sefton 018D","E01007096",985,94,33,61,246,203,60,78,129,76,15,5,10,84
"2011","Sefton 018E","E01007100",1018,93,20,73,246,208,87,73,136,69,31,17,14,75
"2011","Sefton 018F","E01033096",1936,145,41,104,446,381,147,117,275,207,94,75,19,124
"2011","Sefton 019A","E01007074",1084,83,20,63,237,208,80,75,162,113,38,22,16,88
"2011","Sefton 019B","E01007097",1119,103,25,78,234,244,78,91,165,106,26,12,14,72
"2011","Sefton 019C","E01007098",1028,99,29,70,272,213,66,63,123,90,28,12,16,74
"2011","Sefton 019D","E01007099",1001,126,29,97,251,183,101,62,92,62,48,38,10,76
"2011","Sefton 020A","E01007065",1016,70,17,53,234,177,87,93,164,95,26,13,13,70
"2011","Sefton 020B","E01007066",1161,86,20,66,282,234,88,79,171,105,32,16,16,84
"2011","Sefton 020C","E01007071",943,91,25,66,245,173,84,64,129,57,28,16,12,72
"2011","Sefton 020D","E01007072",970,100,20,80,225,205,99,52,126,78,26,19,7,59
"2011","Sefton 020E","E01007073",978,111,28,83,259,189,91,65,96,64,14,11,3,89
"2011","Sefton 021A","E01007020",1013,53,15,38,146,138,88,76,201,147,55,38,17,109
"2011","Sefton 021B","E01007022",1044,86,23,63,199,168,98,67,169,103,91,78,13,63
"2011","Sefton 021C","E01007023",1000,136,40,96,272,158,119,50,98,61,24,18,6,82
"2011","Sefton 021D","E01007027",1619,236,68,168,485,284,152,76,159,76,37,21,16,114
"2011","Sefton 021E","E01007037",1132,97,20,77,261,205,113,91,166,90,39,25,14,70
"2011","Sefton 021F","E01007038",1127,112,33,79,283,176,130,47,133,101,64,38,26,81
"2011","Sefton 022A","E01006936",1080,208,45,163,307,151,130,47,75,36,57,43,14,69
"2011","Sefton 022B","E01006937",948,162,29,133,302,161,105,37,61,26,13,7,6,81
"2011","Sefton 022C","E01006938",883,171,39,132,252,125,121,31,63,28,27,15,12,65
"2011","Sefton 022D","E01006939",1090,150,36,114,289,201,92,48,127,71,31,18,13,81
"2011","Sefton 022E","E01006940",1025,205,38,167,313,127,113,31,79,43,34,20,14,80
"2011","Sefton 022F","E01006943",922,150,32,118,247,170,77,45,68,47,26,15,11,92
"2011","Sefton 023A","E01007083",890,36,8,28,128,182,53,75,168,140,36,19,17,72
"2011","Sefton 023B","E01007085",940,13,8,5,93,137,52,61,201,163,124,74,50,96
"2011","Sefton 023C","E01007086",827,19,6,13,86,107,38,50,176,178,120,97,23,53
"2011","Sefton 023D","E01007091",952,28,9,19,154,169,53,84,199,153,61,36,25,51
"2011","Sefton 023E","E01007092",766,22,6,16,96,116,47,60,157,131,77,47,30,60
"2011","Sefton 024A","E01006979",1019,28,9,19,77,130,55,85,244,163,154,101,53,83
"2011","Sefton 024B","E01006980",1030,24,7,17,111,139,71,84,204,190,139,84,55,68
"2011","Sefton 024C","E01007024",804,29,7,22,106,124,69,57,159,103,95,68,27,62
"2011","Sefton 024D","E01007026",819,35,10,25,128,126,44,54,180,119,74,53,21,59
"2011","Sefton 024E","E01007089",966,27,12,15,89,148,65,68,214,164,112,78,34,79
"2011","Sefton 025A","E01007021",972,111,31,80,301,185,67,49,92,56,21,9,12,90
"2011","Sefton 025B","E01007025",1016,137,37,100,290,186,67,54,116,53,20,9,11,93
"2011","Sefton 025C","E01007105",1162,115,27,88,297,203,94,70,157,88,39,20,19,99
"2011","Sefton 025D","E01007106",1075,79,17,62,268,213,82,67,157,110,39,16,23,60
"2011","Sefton 025E","E01007107",971,95,21,74,288,171,54,55,128,63,22,17,5,95
"2011","Sefton 025F","E01007108",1177,113,28,85,287,210,113,69,154,90,33,17,16,108
"2011","Sefton 026A","E01007039",912,63,22,41,198,170,87,67,124,86,39,25,14,78
"2011","Sefton 026B","E01007040",1746,141,40,101,332,253,226,125,210,200,151,130,21,108
"2011","Sefton 026C","E01007042",925,50,15,35,173,202,75,75,156,92,31,18,13,71
"2011","Sefton 026D","E01007044",936,79,19,60,205,182,97,88,115,83,29,19,10,58
"2011","Sefton 026E","E01007045",888,70,24,46,175,196,74,65,112,90,29,25,4,77
"2011","Sefton 027A","E01007041",1034,77,21,56,199,200,83,96,150,101,38,20,18,90
"2011","Sefton 027B","E01007043",1029,77,19,58,207,230,64,78,155,118,22,15,7,78
"2011","Sefton 027C","E01007046",1195,63,15,48,193,257,81,86,203,159,45,28,17,108
"2011","Sefton 027D","E01007053",1028,50,14,36,186,197,76,87,168,135,44,27,17,85
"2011","Sefton 027E","E01007084",1088,113,26,87,243,219,73,75,148,98,24,14,10,95
"2011","Sefton 028A","E01006941",1164,142,30,112,264,205,89,82,159,86,46,28,18,91
"2011","Sefton 028B","E01006942",1118,83,12,71,306,202,89,64,153,96,35,20,15,90
"2011","Sefton 028C","E01006954",1142,113,31,82,278,203,90,68,154,92,55,36,19,89
"2011","Sefton 028D","E01007104",1010,127,23,104,269,171,93,53,121,76,40,20,20,60
"2011","Sefton 028E","E01007109",1112,110,24,86,293,241,84,50,136,84,49,18,31,65
"2011","Sefton 029A","E01007048",1140,48,12,36,156,160,53,74,224,163,159,111,48,103
"2011","Sefton 029B","E01007054",1048,42,10,32,146,192,59,73,218,163,91,49,42,64
"2011","Sefton 029C","E01007087",971,28,10,18,107,146,53,57,203,171,123,83,40,83
"2011","Sefton 029D","E01007088",938,43,10,33,156,163,62,72,165,142,60,34,26,75
"2011","Sefton 029E","E01007090",820,18,7,11,98,114,53,69,172,155,94,63,31,47
"2011","Sefton 030A","E01006955",1244,118,30,88,309,226,89,63,181,103,55,32,23,100
"2011","Sefton 030B","E01006956",1198,110,24,86,280,210,74,91,151,107,83,49,34,92
"2011","Sefton 030C","E01006958",1118,114,18,96,256,162,96,78,165,102,75,47,28,70
"2011","Sefton 030D","E01007102",1124,107,28,79,253,199,96,67,157,102,42,29,13,101
"2011","Sefton 030E","E01007103",1083,140,26,114,302,188,75,59,129,80,26,13,13,84
"2011","Sefton 031A","E01006978",1071,61,18,43,225,184,100,97,176,115,33,16,17,80
"2011","Sefton 031B","E01006981",1065,28,8,20,120,145,65,68,225,183,141,85,56,90
"2011","Sefton 031C","E01006982",975,53,12,41,166,189,90,70,173,114,45,23,22,75
"2011","Sefton 031D","E01006983",1208,62,17,45,233,242,84,101,206,140,51,30,21,89
"2011","Sefton 031E","E01006984",871,29,10,19,96,124,50,71,160,152,123,78,45,66
"2011","Sefton 032A","E01006952",1046,22,9,13,128,148,74,70,182,186,143,83,60,93
"2011","Sefton 032B","E01006953",1095,53,8,45,172,165,65,69,230,175,93,47,46,73
"2011","Sefton 032C","E01006957",1222,76,8,68,227,179,127,73,179,154,142,100,42,65
"2011","Sefton 032D","E01006959",1150,107,18,89,245,209,85,87,161,121,53,44,9,82
"2011","Sefton 032E","E01006977",1132,60,14,46,202,145,97,84,210,170,86,59,27,78
"2011","Sefton 033A","E01006976",1088,66,19,47,210,206,80,83,153,137,68,42,26,85
"2011","Sefton 033B","E01007014",1172,92,13,79,227,246,102,78,168,131,36,19,17,92
"2011","Sefton 033E","E01007047",1055,49,12,37,159,190,65,61,195,179,80,56,24,77
"2011","Sefton 033F","E01033095",1382,71,21,50,223,307,102,82,227,188,58,33,25,124
"2011","Sefton 034A","E01007004",1059,28,5,23,127,181,78,68,222,142,114,76,38,99
"2011","Sefton 034B","E01007005",955,24,9,15,94,114,61,61,206,169,169,115,54,57
"2011","Sefton 034C","E01007011",1099,37,11,26,109,157,67,73,212,175,149,95,54,120
"2011","Sefton 034D","E01007016",1334,32,6,26,155,207,79,81,264,237,151,94,57,128
"2011","Sefton 034E","E01007017",1168,22,2,20,142,165,71,92,248,203,148,103,45,77
"2011","Sefton 035A","E01007019",956,23,4,19,88,121,53,73,195,173,134,92,42,96
"2011","Sefton 035B","E01007049",1101,57,14,43,174,190,110,77,175,138,97,57,40,83
"2011","Sefton 035C","E01007050",963,43,16,27,159,182,80,63,183,135,42,32,10,76
"2011","Sefton 035D","E01007051",877,20,4,16,105,134,29,60,200,150,104,65,39,75
"2011","Sefton 035E","E01007052",981,35,9,26,147,135,47,92,183,157,100,72,28,85
"2011","Sefton 036A","E01006964",1108,43,9,34,125,158,62,83,223,198,119,74,45,97
"2011","Sefton 036B","E01007003",893,20,5,15,87,140,49,68,191,146,131,77,54,61
"2011","Sefton 036C","E01007006",1007,17,5,12,93,157,50,60,218,201,137,100,37,74
"2011","Sefton 036D","E01007012",1002,33,9,24,149,198,55,69,190,152,79,55,24,77
"2011","Sefton 036E","E01007013",1057,31,5,26,103,144,72,109,223,171,133,82,51,71
"2011","Sefton 037A","E01006967",1107,32,12,20,158,162,94,76,189,189,128,92,36,79
"2011","Sefton 037B","E01007007",946,12,4,8,84,112,49,59,209,186,166,114,52,69
"2011","Sefton 037C","E01007008",982,19,5,14,97,132,35,70,186,203,150,88,62,90
"2011","Sefton 037D","E01007009",1007,33,9,24,104,142,60,65,202,207,145,105,40,49
"2011","Sefton 037E","E01007010",786,30,6,24,59,88,39,41,158,174,123,77,46,74
"2011","Sefton 038A","E01006960",881,43,12,31,174,145,104,73,152,88,40,21,19,62
"2011","Sefton 038B","E01006961",1115,45,9,36,155,169,84,87,193,178,119,76,43,85
"2011","Sefton 038C","E01006962",1024,33,7,26,159,212,64,89,165,162,71,54,17,69
"2011","Sefton 038D","E01006963",1059,34,10,24,114,133,59,76,209,207,154,105,49,73
"2011","Sefton 038E","E01006965",1037,28,8,20,117,172,70,80,192,156,122,94,28,100
"2011","Sefton 038F","E01006966",1134,46,6,40,172,190,84,91,199,169,90,57,33,93
"2011","St. Helens 001A","E01006882",861,127,31,96,256,141,60,53,82,55,14,5,9,73
"2011","St. Helens 001B","E01006883",973,140,41,99,263,169,79,49,101,95,18,11,7,59
"2011","St. Helens 001C","E01006884",1000,114,24,90,247,148,93,71,124,100,31,19,12,72
"2011","St. Helens 001D","E01006885",957,142,37,105,277,167,110,53,82,46,11,8,3,69
"2011","St. Helens 001E","E01006886",990,123,26,97,263,162,79,80,118,84,31,19,12,50
"2011","St. Helens 001F","E01006887",966,90,16,74,217,131,79,72,150,115,41,25,16,71
"2011","St. Helens 002A","E01006802",1276,124,35,89,307,186,110,109,146,161,46,30,16,87
"2011","St. Helens 002B","E01006804",1231,83,18,65,237,187,84,116,212,182,54,36,18,76
"2011","St. Helens 002C","E01006806",1149,144,35,109,290,191,86,94,156,96,19,15,4,73
"2011","St. Helens 002D","E01006807",1016,121,31,90,292,159,86,77,126,95,17,14,3,43
"2011","St. Helens 003A","E01006803",1108,108,33,75,288,165,126,104,119,114,31,25,6,53
"2011","St. Helens 003B","E01006805",1135,84,21,63,218,151,75,85,174,197,70,48,22,81
"2011","St. Helens 003C","E01006808",1067,106,24,82,267,182,82,94,140,101,29,17,12,66
"2011","St. Helens 003D","E01006809",1170,94,20,74,296,172,115,107,155,134,31,20,11,66
"2011","St. Helens 004A","E01006849",1020,41,14,27,131,88,71,82,226,202,115,77,38,64
"2011","St. Helens 004B","E01006850",1056,32,7,25,161,108,78,92,208,214,96,59,37,67
"2011","St. Helens 004C","E01006851",963,83,34,49,202,120,71,84,161,141,37,23,14,64
"2011","St. Helens 004D","E01006852",1055,74,22,52,229,155,69,108,203,123,30,19,11,64
"2011","St. Helens 004E","E01006853",1074,93,38,55,223,163,71,94,183,149,33,21,12,65
"2011","St. Helens 004F","E01006854",1092,53,19,34,180,151,77,94,228,189,51,33,18,69
"2011","St. Helens 004G","E01006855",1081,61,19,42,207,140,83,89,183,182,73,47,26,63
"2011","St. Helens 005A","E01006836",1065,55,17,38,160,134,77,106,215,200,62,40,22,56
"2011","St. Helens 005B","E01006839",1032,46,20,26,189,100,75,102,185,202,58,35,23,75
"2011","St. Helens 005C","E01006840",1163,58,19,39,208,156,86,117,202,232,51,30,21,53
"2011","St. Helens 005D","E01006842",1048,56,16,40,133,99,57,84,196,238,113,67,46,72
"2011","St. Helens 006A","E01006837",1120,65,14,51,214,150,82,118,194,166,77,50,27,54
"2011","St. Helens 006B","E01006838",1061,51,7,44,192,139,71,91,211,183,65,43,22,58
"2011","St. Helens 006C","E01006841",1258,124,37,87,293,205,80,112,175,154,25,12,13,90
"2011","St. Helens 006D","E01006843",897,42,10,32,128,125,61,80,175,179,50,39,11,57
"2011","St. Helens 007A","E01006914",890,108,23,85,295,142,76,55,92,52,12,6,6,58
"2011","St. Helens 007B","E01006915",1166,80,20,60,223,124,71,103,225,179,63,41,22,98
"2011","St. Helens 007C","E01006916",1172,108,29,79,272,150,103,100,181,123,61,48,13,74
"2011","St. Helens 007D","E01006917",1181,133,32,101,355,184,84,89,136,78,29,18,11,93
"2011","St. Helens 007E","E01006918",927,81,28,53,249,130,75,62,128,95,32,14,18,75
"2011","St. Helens 007F","E01006919",1043,36,7,29,135,94,42,86,236,211,125,82,43,78
"2011","St. Helens 008A","E01006810",1041,58,18,40,203,189,60,98,199,136,22,11,11,76
"2011","St. Helens 008B","E01006811",1030,59,14,45,147,139,68,110,207,202,54,38,16,44
"2011","St. Helens 008C","E01006812",975,34,10,24,101,104,46,96,242,173,99,61,38,80
"2011","St. Helens 008D","E01006813",1121,32,11,21,160,118,61,111,244,229,94,61,33,72
"2011","St. Helens 008E","E01006814",1242,57,16,41,242,188,94,124,238,204,32,26,6,63
"2011","St. Helens 008F","E01006815",954,41,16,25,131,108,43,95,197,196,65,45,20,78
"2011","St. Helens 008G","E01006818",1042,60,22,38,180,162,69,125,198,172,29,19,10,47
"2011","St. Helens 009A","E01006822",999,119,33,86,307,175,90,62,92,64,20,15,5,70
"2011","St. Helens 009B","E01006823",824,98,22,76,254,138,67,50,104,41,20,12,8,52
"2011","St. Helens 009C","E01006824",862,137,39,98,272,130,66,57,89,45,10,6,4,56
"2011","St. Helens 009D","E01006825",1077,188,45,143,323,164,105,58,81,55,21,12,9,82
"2011","St. Helens 010A","E01006866",1080,62,13,49,173,121,66,86,200,198,115,83,32,59
"2011","St. Helens 010B","E01006867",1522,157,31,126,399,236,114,132,178,145,50,32,18,111
"2011","St. Helens 010C","E01006868",1052,97,21,76,184,127,77,67,169,182,89,65,24,60
"2011","St. Helens 010D","E01006869",1120,61,14,47,189,136,95,96,188,193,85,56,29,77
"2011","St. Helens 011A","E01006819",1140,37,8,29,167,147,66,112,222,240,91,64,27,58
"2011","St. Helens 011B","E01006820",1033,28,13,15,102,90,57,87,232,242,132,93,39,63
"2011","St. Helens 011C","E01006821",961,19,7,12,75,81,42,82,236,250,120,82,38,56
"2011","St. Helens 011D","E01006871",1071,36,9,27,111,79,63,86,245,235,132,95,37,84
"2011","St. Helens 012A","E01006832",1262,97,23,74,260,171,78,101,192,182,104,58,46,77
"2011","St. Helens 012B","E01006834",911,39,14,25,130,110,60,76,183,178,80,54,26,55
"2011","St. Helens 012C","E01006877",1112,49,15,34,180,107,61,95,212,215,140,102,38,53
"2011","St. Helens 012D","E01006880",1082,32,10,22,143,118,69,81,223,207,146,93,53,63
"2011","St. Helens 012E","E01006881",1116,34,4,30,140,112,51,91,225,231,155,99,56,77
"2011","St. Helens 013A","E01006863",1208,48,9,39,127,151,91,119,244,254,109,71,38,65
"2011","St. Helens 013B","E01006864",1466,146,29,117,365,190,109,122,198,179,53,31,22,104
"2011","St. Helens 013C","E01006865",1209,45,12,33,161,146,86,94,239,235,135,92,43,68
"2011","St. Helens 014A","E01006845",1128,36,13,23,166,136,55,120,231,217,95,62,33,72
"2011","St. Helens 014B","E01006870",1029,25,7,18,162,108,56,111,220,196,92,56,36,59
"2011","St. Helens 014C","E01006872",1114,31,5,26,147,92,70,90,224,255,143,93,50,62
"2011","St. Helens 014D","E01006873",811,15,6,9,56,50,34,70,175,204,157,117,40,50
"2011","St. Helens 014E","E01006874",870,12,5,7,63,64,41,72,181,218,163,123,40,56
"2011","St. Helens 015A","E01006856",1032,165,36,129,274,157,85,58,119,82,33,23,10,59
"2011","St. Helens 015B","E01006857",1089,116,27,89,271,170,92,73,134,111,25,15,10,97
"2011","St. Helens 015C","E01006858",1057,67,20,47,166,141,58,85,182,184,90,62,28,84
"2011","St. Helens 015D","E01006859",1240,201,53,148,331,180,138,78,120,87,26,16,10,79
"2011","St. Helens 015E","E01006860",1045,75,14,61,182,147,78,77,190,169,78,45,33,49
"2011","St. Helens 015F","E01006861",1076,43,9,34,148,116,63,80,210,187,130,97,33,99
"2011","St. Helens 015G","E01006862",960,45,13,32,162,122,69,78,157,191,73,46,27,63
"2011","St. Helens 016A","E01006831",1109,58,19,39,206,171,58,103,234,161,55,34,21,63
"2011","St. Helens 016B","E01006833",1246,81,14,67,255,187,83,97,227,179,51,32,19,86
"2011","St. Helens 016C","E01006835",1063,99,37,62,246,155,85,79,154,110,59,35,24,76
"2011","St. Helens 016D","E01006876",1132,69,15,54,228,154,62,80,220,182,75,51,24,62
"2011","St. Helens 016E","E01006878",1042,49,8,41,179,165,57,91,215,177,48,28,20,61
"2011","St. Helens 016F","E01006879",1090,49,17,32,161,139,54,91,203,198,92,59,33,103
"2011","St. Helens 016G","E01006904",1215,63,13,50,212,141,75,102,233,202,91,61,30,96
"2011","St. Helens 017A","E01006816",1191,20,8,12,122,107,44,98,290,289,135,99,36,86
"2011","St. Helens 017B","E01006817",959,10,2,8,81,69,52,62,209,262,161,114,47,53
"2011","St. Helens 017C","E01006875",925,22,8,14,94,67,57,80,179,248,111,82,29,67
"2011","St. Helens 017D","E01006899",1433,67,21,46,185,180,78,152,295,279,119,82,37,78
"2011","St. Helens 018A","E01006826",1007,77,19,58,173,133,77,68,173,150,104,81,23,52
"2011","St. Helens 018B","E01006827",1168,153,41,112,325,185,105,82,118,78,31,18,13,91
"2011","St. Helens 018C","E01006828",1555,220,53,167,418,268,152,76,160,98,42,27,15,121
"2011","St. Helens 018D","E01006829",911,143,31,112,247,142,81,74,83,61,22,14,8,58
"2011","St. Helens 019A","E01006830",940,31,5,26,106,89,49,67,212,218,104,76,28,64
"2011","St. Helens 019C","E01006903",1090,33,8,25,142,112,54,97,217,245,122,77,45,68
"2011","St. Helens 019D","E01006905",1026,32,9,23,115,117,43,87,230,232,100,62,38,70
"2011","St. Helens 019E","E01006906",1124,65,18,47,222,153,78,81,206,157,80,51,29,82
"2011","St. Helens 019F","E01006907",1162,52,15,37,179,160,55,108,223,242,81,48,33,62
"2011","St. Helens 019G","E01006912",1078,85,18,67,170,120,63,71,186,181,117,72,45,85
"2011","St. Helens 019H","E01006913",955,28,12,16,104,92,47,85,209,231,82,55,27,77
"2011","St. Helens 019I","E01032904",1340,130,32,98,318,200,116,116,198,130,43,31,12,89
"2011","St. Helens 019J","E01032905",1089,136,33,103,288,160,83,68,126,106,31,19,12,91
"2011","St. Helens 020A","E01006844",1166,26,6,20,155,128,63,114,252,241,122,84,38,65
"2011","St. Helens 020B","E01006846",1022,59,16,43,188,157,68,86,186,174,48,26,22,56
"2011","St. Helens 020C","E01006847",1232,35,11,24,153,118,48,115,240,277,158,116,42,88
"2011","St. Helens 020D","E01006848",1114,80,21,59,190,161,64,105,220,188,42,26,16,64
"2011","St. Helens 020E","E01006896",1229,71,25,46,212,193,67,140,228,221,38,21,17,59
"2011","St. Helens 020F","E01006897",1152,68,24,44,226,145,81,121,194,206,38,25,13,73
"2011","St. Helens 020G","E01006901",1026,51,20,31,195,174,69,127,164,139,36,17,19,71
"2011","St. Helens 021A","E01006890",1077,56,9,47,211,157,82,89,175,183,39,25,14,85
"2011","St. Helens 021B","E01006892",901,70,14,56,190,147,69,79,117,118,39,26,13,72
"2011","St. Helens 021C","E01006893",1013,64,18,46,222,156,82,89,161,121,46,31,15,72
"2011","St. Helens 021D","E01006894",1017,90,22,68,223,193,74,89,143,132,25,14,11,48
"2011","St. Helens 022A","E01006898",1169,61,15,46,188,148,126,103,207,190,71,45,26,75
"2011","St. Helens 022B","E01006900",2025,195,55,140,477,288,128,171,316,257,61,37,24,132
"2011","St. Helens 022C","E01006908",1001,24,13,11,101,83,69,90,216,241,124,73,51,53
"2011","St. Helens 022D","E01006909",865,12,1,11,72,71,28,72,177,223,142,110,32,68
"2011","St. Helens 022E","E01006910",1291,57,14,43,179,161,69,123,260,258,99,68,31,85
"2011","St. Helens 022F","E01006911",1223,74,16,58,206,170,81,144,250,200,29,18,11,69
"2011","St. Helens 023A","E01006888",913,136,40,96,264,166,65,59,95,56,21,16,5,51
"2011","St. Helens 023B","E01006889",1104,164,33,131,306,168,95,76,109,80,23,16,7,83
"2011","St. Helens 023C","E01006891",966,81,24,57,205,181,58,75,147,86,43,32,11,90
"2011","St. Helens 023D","E01006895",1002,202,44,158,276,161,111,47,89,42,25,20,5,49
"2011","Wirral 001A","E01007229",1230,113,17,96,274,169,96,95,203,119,74,35,39,87
"2011","Wirral 001B","E01007230",941,68,17,51,228,150,71,66,139,102,52,33,19,65
"2011","Wirral 001C","E01007231",1201,143,30,113,304,184,103,83,148,102,62,41,21,72
"2011","Wirral 001D","E01007237",1069,97,19,78,242,143,102,87,150,112,95,63,32,41
"2011","Wirral 001E","E01007238",1187,65,18,47,216,149,101,94,233,158,102,63,39,69
"2011","Wirral 002A","E01007218",1115,41,10,31,167,140,86,100,248,148,104,65,39,81
"2011","Wirral 002B","E01007232",1106,92,26,66,287,172,97,69,108,89,127,104,23,65
"2011","Wirral 002C","E01007233",1265,83,22,61,253,212,80,113,201,132,105,71,34,86
"2011","Wirral 002D","E01007234",1195,95,28,67,290,136,124,93,182,110,75,45,30,90
"2011","Wirral 002E","E01007236",981,68,18,50,197,148,81,69,179,105,53,38,15,81
"2011","Wirral 003A","E01007307",1331,174,50,124,361,217,157,74,111,65,46,31,15,126
"2011","Wirral 003B","E01007308",1090,118,27,91,314,204,78,71,124,71,44,27,17,66
"2011","Wirral 003C","E01007312",1059,91,21,70,231,168,109,103,137,114,42,25,17,64
"2011","Wirral 003D","E01007313",1137,93,27,66,236,183,104,103,165,132,43,19,24,78
"2011","Wirral 003E","E01007315",1105,96,27,69,248,209,84,100,156,88,37,26,11,87
"2011","Wirral 004A","E01007211",878,80,24,56,199,162,70,61,135,82,25,8,17,64
"2011","Wirral 004B","E01007235",1091,74,18,56,235,175,104,68,197,111,51,27,24,76
"2011","Wirral 004C","E01007310",1042,130,36,94,297,181,93,63,93,50,35,22,13,100
"2011","Wirral 004D","E01007311",1133,123,27,96,319,206,102,71,113,87,23,18,5,89
"2011","Wirral 004E","E01007314",1108,97,24,73,244,188,84,83,154,118,40,20,20,100
"2011","Wirral 004F","E01007316",1158,108,33,75,281,207,95,90,155,80,49,33,16,93
"2011","Wirral 005A","E01007215",1091,60,20,40,159,128,94,78,219,144,125,88,37,84
"2011","Wirral 005B","E01007216",1115,60,17,43,201,184,83,89,196,135,88,50,38,79
"2011","Wirral 005C","E01007219",1154,70,15,55,195,167,81,94,218,137,100,71,29,92
"2011","Wirral 005D","E01007220",874,40,5,35,121,84,63,79,183,137,118,80,38,49
"2011","Wirral 005E","E01007275",1141,56,18,38,171,156,77,82,246,178,101,65,36,74
"2011","Wirral 006A","E01007203",1574,150,25,125,397,237,112,120,245,155,62,37,25,96
"2011","Wirral 006B","E01007205",1077,30,13,17,149,123,65,101,239,203,87,63,24,80
"2011","Wirral 006C","E01007210",1433,55,20,35,216,188,84,138,325,202,130,85,45,95
"2011","Wirral 006D","E01007309",1087,115,27,88,287,197,101,79,113,73,28,18,10,94
"2011","Wirral 007A","E01007212",1093,60,16,44,221,165,82,102,203,123,52,30,22,85
"2011","Wirral 007B","E01007213",1150,69,17,52,270,182,80,94,198,136,38,26,12,83
"2011","Wirral 007C","E01007214",1088,51,10,41,167,156,86,103,209,160,96,64,32,60
"2011","Wirral 007D","E01007217",1180,64,19,45,217,196,81,91,225,159,82,57,25,65
"2011","Wirral 007E","E01007276",1094,47,13,34,184,158,70,106,231,168,59,33,26,71
"2011","Wirral 008A","E01007272",1065,25,12,13,126,129,62,102,238,170,122,83,39,91
"2011","Wirral 008B","E01007273",953,16,9,7,92,103,61,78,213,177,143,102,41,70
"2011","Wirral 008C","E01007274",919,12,4,8,67,83,55,70,217,186,154,99,55,75
"2011","Wirral 008D","E01007277",1034,39,10,29,149,106,73,75,200,175,136,95,41,81
"2011","Wirral 008E","E01007278",1035,29,8,21,118,122,75,103,206,186,132,91,41,64
"2011","Wirral 009A","E01007204",1081,22,5,17,106,98,49,91,239,213,166,121,45,97
"2011","Wirral 009B","E01007206",1364,84,15,69,250,188,125,117,277,176,61,44,17,86
"2011","Wirral 009C","E01007207",954,28,2,26,78,90,50,92,227,211,124,92,32,54
"2011","Wirral 009D","E01007209",899,35,11,24,114,86,69,91,225,182,57,33,24,40
"2011","Wirral 010C","E01007269",1285,61,17,44,172,159,92,108,274,193,153,107,46,73
"2011","Wirral 010D","E01007270",1276,30,3,27,164,138,70,122,289,224,161,104,57,78
"2011","Wirral 010E","E01007271",1184,33,9,24,167,192,70,105,256,183,96,66,30,82
"2011","Wirral 010F","E01032903",1767,46,8,38,174,183,81,120,392,413,237,176,61,121
"2011","Wirral 011A","E01007120",965,55,10,45,171,88,99,63,147,149,101,71,30,92
"2011","Wirral 011B","E01007121",1060,15,7,8,108,83,40,80,252,253,169,114,55,60
"2011","Wirral 011C","E01007122",985,19,5,14,63,63,40,77,198,246,221,165,56,58
"2011","Wirral 011D","E01007123",1166,22,3,19,121,111,60,92,243,227,182,125,57,108
"2011","Wirral 011E","E01007124",1037,21,6,15,77,75,42,69,215,262,187,136,51,89
"2011","Wirral 012A","E01007208",1257,58,16,42,204,170,91,131,255,216,70,41,29,62
"2011","Wirral 012B","E01007221",1069,57,17,40,183,155,101,108,195,144,54,39,15,72
"2011","Wirral 012C","E01007225",1322,106,34,72,276,219,111,119,203,148,49,32,17,91
"2011","Wirral 012D","E01007227",1032,28,5,23,131,97,86,103,217,188,100,64,36,82
"2011","Wirral 012E","E01007228",1005,32,10,22,123,123,84,87,211,204,89,58,31,52
"2011","Wirral 013A","E01007195",1178,154,28,126,340,180,116,81,130,46,34,20,14,97
"2011","Wirral 013B","E01007199",1110,207,45,162,358,169,102,59,65,34,18,8,10,98
"2011","Wirral 013C","E01007222",1207,87,19,68,281,200,108,107,186,138,35,23,12,65
"2011","Wirral 013D","E01007223",1071,118,32,86,264,174,73,74,183,72,45,27,18,68
"2011","Wirral 014A","E01007193",1128,233,53,180,288,150,130,59,93,53,35,22,13,87
"2011","Wirral 014B","E01007194",1059,140,21,119,320,119,118,72,117,72,48,35,13,53
"2011","Wirral 014C","E01007200",1210,247,53,194,392,160,101,55,78,46,40,25,15,91
"2011","Wirral 014D","E01007201",1069,185,30,155,318,145,90,50,110,56,37,21,16,78
"2011","Wirral 014E","E01007202",1008,102,15,87,249,146,64,55,162,92,57,36,21,81
"2011","Wirral 015A","E01007125",1234,46,7,39,172,148,77,107,262,247,109,56,53,66
"2011","Wirral 015B","E01007156",1155,80,22,58,252,171,92,113,185,139,64,41,23,59
"2011","Wirral 015C","E01007157",1133,77,25,52,189,149,71,111,222,183,53,33,20,78
"2011","Wirral 015D","E01007158",1142,144,34,110,262,171,130,83,138,101,39,23,16,74
"2011","Wirral 015E","E01007159",1300,208,51,157,380,182,156,68,112,60,59,45,14,75
"2011","Wirral 016A","E01007126",1510,66,16,50,203,155,89,116,298,277,199,134,65,107
"2011","Wirral 016B","E01007127",1099,17,5,12,94,91,67,69,230,232,201,152,49,98
"2011","Wirral 016C","E01007128",1212,36,8,28,130,83,73,107,277,233,181,117,64,92
"2011","Wirral 016D","E01007129",1165,46,9,37,136,119,65,89,249,214,174,130,44,73
"2011","Wirral 016E","E01007133",863,8,3,5,66,51,44,64,198,204,184,134,50,44
"2011","Wirral 017A","E01007224",1117,101,31,70,263,180,95,88,187,92,24,12,12,87
"2011","Wirral 017B","E01007226",1206,84,27,57,237,173,115,113,228,142,42,25,17,72
"2011","Wirral 017C","E01007265",979,81,21,60,221,164,82,96,146,82,34,24,10,73
"2011","Wirral 017D","E01007299",1015,84,18,66,232,180,75,90,164,81,40,28,12,69
"2011","Wirral 017E","E01007306",1233,97,22,75,313,181,111,101,195,118,43,20,23,74
"2011","Wirral 018A","E01007297",906,54,8,46,170,117,50,71,172,135,61,40,21,76
"2011","Wirral 018B","E01007298",1069,163,47,116,314,152,112,66,99,55,31,21,10,77
"2011","Wirral 018C","E01007301",1217,118,31,87,319,196,106,90,171,99,40,18,22,78
"2011","Wirral 018D","E01007302",1075,71,14,57,228,170,81,96,171,149,56,38,18,53
"2011","Wirral 018E","E01007305",1225,121,37,84,287,208,94,127,184,91,38,23,15,75
"2011","Wirral 019A","E01007119",1029,33,11,22,137,111,60,93,197,203,102,66,36,93
"2011","Wirral 019B","E01007161",1123,93,30,63,245,169,91,95,170,138,44,25,19,78
"2011","Wirral 019C","E01007162",1034,21,1,20,118,97,47,78,228,204,124,83,41,117
"2011","Wirral 019D","E01007300",1281,37,6,31,170,170,98,104,271,219,117,79,38,95
"2011","Wirral 020A","E01007155",1368,118,22,96,264,161,108,82,215,170,165,108,57,85
"2011","Wirral 020B","E01007160",1293,168,21,147,336,207,89,82,152,122,67,33,34,70
"2011","Wirral 020C","E01007240",1222,166,24,142,317,157,108,60,143,100,103,74,29,68
"2011","Wirral 020D","E01007241",995,166,32,134,283,146,96,60,109,59,29,18,11,47
"2011","Wirral 020E","E01007242",1243,249,31,218,362,170,105,74,106,58,47,31,16,72
"2011","Wirral 021A","E01007130",1241,43,8,35,162,108,102,115,259,219,145,118,27,88
"2011","Wirral 021B","E01007131",1121,31,6,25,132,146,68,103,251,186,136,86,50,68
"2011","Wirral 021C","E01007179",971,35,6,29,150,115,55,77,191,172,112,77,35,64
"2011","Wirral 021D","E01007291",1282,32,5,27,145,147,74,104,254,247,191,128,63,88
"2011","Wirral 021E","E01007292",1030,29,10,19,122,120,65,94,186,221,124,78,46,69
"2011","Wirral 021F","E01007294",1023,29,5,24,169,132,61,85,223,188,77,46,31,59
"2011","Wirral 022A","E01007180",1182,72,14,58,209,181,88,111,177,174,77,53,24,93
"2011","Wirral 022B","E01007181",1079,58,13,45,209,167,78,102,200,129,64,35,29,72
"2011","Wirral 022C","E01007239",1250,111,23,88,239,167,116,93,191,159,101,60,41,73
"2011","Wirral 022D","E01007243",1223,182,23,159,327,159,81,84,142,103,71,45,26,74
"2011","Wirral 022E","E01007244",1506,84,21,63,294,209,93,111,292,193,120,81,39,110
"2011","Wirral 023A","E01007259",889,105,34,71,255,170,91,55,89,44,13,11,2,67
"2011","Wirral 023B","E01007261",976,137,27,110,292,181,97,49,89,52,20,14,6,59
"2011","Wirral 023C","E01007264",1044,133,26,107,299,170,82,80,135,64,23,14,9,58
"2011","Wirral 023D","E01007266",1054,153,32,121,287,199,82,63,119,59,19,9,10,73
"2011","Wirral 023E","E01007267",1103,124,23,101,280,193,102,71,129,95,28,17,11,81
"2011","Wirral 023F","E01007268",918,123,28,95,251,145,73,53,122,76,24,16,8,51
"2011","Wirral 024A","E01007163",1740,194,50,144,380,272,156,126,245,174,71,38,33,122
"2011","Wirral 024B","E01007245",1144,94,21,73,277,173,81,103,182,128,33,19,14,73
"2011","Wirral 024C","E01007246",1206,74,20,54,240,201,77,126,234,124,39,28,11,91
"2011","Wirral 024D","E01007247",1308,120,42,78,277,221,98,127,216,138,28,22,6,83
"2011","Wirral 024E","E01007252",1153,66,20,46,246,204,87,116,191,132,33,22,11,78
"2011","Wirral 025A","E01007249",929,30,6,24,125,118,75,83,205,151,76,45,31,66
"2011","Wirral 025B","E01007251",886,80,16,64,180,141,72,86,138,101,31,19,12,57
"2011","Wirral 025C","E01007257",922,23,8,15,112,83,48,74,209,190,104,71,33,79
"2011","Wirral 025D","E01007303",1010,25,5,20,123,102,51,74,268,203,103,81,22,61
"2011","Wirral 025E","E01007304",1045,30,13,17,117,97,64,95,224,202,128,95,33,88
"2011","Wirral 026A","E01007196",995,171,40,131,266,138,103,38,104,66,32,23,9,77
"2011","Wirral 026B","E01007197",1151,262,40,222,343,140,91,49,84,54,40,27,13,88
"2011","Wirral 026C","E01007198",1144,225,33,192,306,138,127,57,122,59,32,14,18,78
"2011","Wirral 026D","E01007263",1033,108,17,91,178,116,97,86,180,148,58,39,19,62
"2011","Wirral 026E","E01007282",1013,208,28,180,292,119,86,62,92,48,32,19,13,74
"2011","Wirral 027A","E01007175",1325,43,10,33,147,153,72,105,281,234,188,135,53,102
"2011","Wirral 027B","E01007290",1237,46,7,39,168,109,74,90,270,209,179,123,56,92
"2011","Wirral 027C","E01007293",1002,22,4,18,87,88,50,94,213,201,158,120,38,89
"2011","Wirral 027D","E01007295",873,16,3,13,103,85,47,74,173,159,145,97,48,71
"2011","Wirral 027E","E01007296",1227,36,2,34,170,129,62,110,294,232,125,82,43,69
"2011","Wirral 028A","E01007258",1089,163,37,126,312,162,97,77,126,71,21,15,6,60
"2011","Wirral 028B","E01007260",1078,196,34,162,331,157,82,52,92,49,30,18,12,89
"2011","Wirral 028C","E01007262",1057,228,47,181,329,160,86,41,65,36,23,11,12,89
"2011","Wirral 028D","E01007281",924,237,43,194,272,105,106,33,46,40,20,11,9,65
"2011","Wirral 028E","E01007283",891,241,50,191,270,114,108,16,31,14,14,7,7,83
"2011","Wirral 029A","E01007173",1141,85,16,69,236,159,65,104,181,150,74,50,24,87
"2011","Wirral 029B","E01007174",1134,56,17,39,211,151,67,104,236,163,66,31,35,80
"2011","Wirral 029C","E01007176",1171,46,14,32,196,147,69,118,212,192,109,74,35,82
"2011","Wirral 029D","E01007177",1077,51,13,38,175,155,57,102,219,171,67,36,31,80
"2011","Wirral 029E","E01007178",1131,65,14,51,218,142,89,100,212,156,71,37,34,78
"2011","Wirral 030A","E01007248",1127,146,29,117,314,167,94,69,117,70,60,48,12,90
"2011","Wirral 030B","E01007250",1051,81,22,59,238,176,105,100,147,86,38,23,15,80
"2011","Wirral 030C","E01007253",1098,67,12,55,178,157,76,94,211,176,64,42,22,75
"2011","Wirral 030D","E01007254",1111,167,39,128,317,178,106,72,116,58,29,19,10,68
"2011","Wirral 031A","E01007115",1153,92,24,68,251,164,68,84,193,154,62,48,14,85
"2011","Wirral 031B","E01007138",1209,48,10,38,147,123,71,106,272,243,141,91,50,58
"2011","Wirral 031C","E01007139",1169,61,11,50,158,150,96,103,243,191,90,61,29,77
"2011","Wirral 031D","E01007141",1162,103,24,79,252,162,70,108,201,141,62,38,24,63
"2011","Wirral 031E","E01007289",1102,29,7,22,103,90,54,75,233,234,198,143,55,86
"2011","Wirral 032A","E01007111",1168,141,35,106,330,201,70,98,132,79,28,18,10,89
"2011","Wirral 032B","E01007112",1113,75,15,60,266,159,70,93,194,145,41,26,15,70
"2011","Wirral 032C","E01007113",983,163,29,134,289,138,68,63,91,73,25,17,8,73
"2011","Wirral 032D","E01007114",1067,77,18,59,197,145,62,107,205,122,71,48,23,81
"2011","Wirral 032E","E01007116",1096,105,29,76,270,194,91,97,133,107,27,18,9,72
"2011","Wirral 033A","E01007280",1248,142,28,114,354,195,113,91,127,88,39,25,14,99
"2011","Wirral 033B","E01007284",1224,174,44,130,354,222,128,65,113,55,29,12,17,84
"2011","Wirral 033C","E01007285",1059,116,29,87,304,173,95,66,132,91,21,15,6,61
"2011","Wirral 033D","E01007287",1305,116,20,96,268,221,116,122,169,160,50,31,19,83
"2011","Wirral 034A","E01007183",948,139,25,114,290,144,103,48,83,54,28,20,8,59
"2011","Wirral 034B","E01007255",1092,134,42,92,261,181,112,72,136,83,42,30,12,71
"2011","Wirral 034C","E01007256",1098,130,32,98,298,179,116,78,129,79,21,12,9,68
"2011","Wirral 034D","E01007279",1202,149,41,108,315,196,94,77,169,82,37,20,17,83
"2011","Wirral 034E","E01007286",1060,108,22,86,271,157,96,86,131,112,30,21,9,69
"2011","Wirral 035A","E01007110",1167,133,36,97,302,183,95,101,146,94,32,16,16,81
"2011","Wirral 035B","E01007117",1186,129,39,90,320,201,93,93,156,75,25,15,10,94
"2011","Wirral 035C","E01007118",1076,67,17,50,200,150,68,88,204,156,64,37,27,79
"2011","Wirral 035D","E01007151",1106,135,42,93,301,190,77,74,135,75,30,19,11,89
"2011","Wirral 035E","E01007154",1125,121,26,95,294,207,69,90,132,93,37,26,11,82
"2011","Wirral 036A","E01007140",1265,62,17,45,264,178,81,142,233,171,55,32,23,79
"2011","Wirral 036B","E01007142",1353,204,37,167,372,200,98,79,169,125,39,22,17,67
"2011","Wirral 036C","E01007143",1233,85,26,59,254,194,67,128,204,147,69,46,23,85
"2011","Wirral 036D","E01007152",1143,131,24,107,270,166,88,82,189,114,41,21,20,62
"2011","Wirral 036E","E01007153",1016,86,19,67,220,137,61,91,171,121,62,47,15,67
"2011","Wirral 037A","E01007182",1044,238,59,179,291,132,98,39,119,43,26,16,10,58
"2011","Wirral 037B","E01007184",1037,160,38,122,325,149,98,55,110,46,21,8,13,73
"2011","Wirral 037C","E01007185",1135,171,32,139,303,152,111,72,129,92,26,9,17,79
"2011","Wirral 037D","E01007192",893,163,22,141,247,121,77,50,91,67,24,19,5,53
"2011","Wirral 037E","E01007288",1112,85,23,62,225,176,98,87,189,133,46,27,19,73
"2011","Wirral 038A","E01007144",938,140,32,108,277,122,119,59,83,53,32,25,7,53
"2011","Wirral 038B","E01007145",1017,175,32,143,299,179,61,73,102,37,19,13,6,72
"2011","Wirral 038C","E01007146",1169,163,40,123,327,208,79,99,121,87,18,9,9,67
"2011","Wirral 038D","E01007147",1017,172,38,134,314,162,69,63,99,50,26,13,13,62
"2011","Wirral 038E","E01007148",1253,220,52,168,367,194,91,90,113,47,58,51,7,73
"2011","Wirral 039A","E01007135",1087,83,16,67,246,158,71,120,165,112,60,40,20,72
"2011","Wirral 039B","E01007136",1201,45,11,34,165,140,75,139,247,220,96,70,26,74
"2011","Wirral 039C","E01007137",1197,67,14,53,249,170,69,101,230,160,74,45,29,77
"2011","Wirral 039D","E01007170",1103,101,23,78,251,184,75,109,177,98,36,21,15,72
"2011","Wirral 040A","E01007186",1089,246,43,203,345,154,82,44,82,36,20,14,6,80
"2011","Wirral 040B","E01007187",1048,253,53,200,336,120,121,36,72,29,23,15,8,58
"2011","Wirral 040C","E01007188",1038,204,37,167,321,160,97,45,87,40,18,10,8,66
"2011","Wirral 040D","E01007189",1090,252,55,197,339,170,112,40,68,30,14,9,5,65
"2011","Wirral 040E","E01007190",1014,272,63,209,349,124,87,22,51,26,14,9,5,69
"2011","Wirral 040F","E01007191",937,231,54,177,307,135,80,28,47,20,20,10,10,69
"2011","Wirral 041A","E01007149",1087,122,29,93,294,196,68,105,161,64,8,4,4,69
"2011","Wirral 041B","E01007150",1134,135,26,109,290,206,76,98,155,85,21,13,8,68
"2011","Wirral 041C","E01007165",1001,89,26,63,221,159,70,122,154,103,20,13,7,63
"2011","Wirral 041D","E01007171",1111,121,27,94,263,193,64,116,151,86,29,18,11,88
"2011","Wirral 041E","E01007172",1061,138,35,103,295,177,75,89,126,73,21,14,7,67
"2011","Wirral 042A","E01007164",1237,135,33,102,333,181,94,106,166,118,43,30,13,61
"2011","Wirral 042B","E01007166",1112,91,25,66,241,176,70,117,202,124,28,18,10,63
"2011","Wirral 042C","E01007167",1049,57,20,37,162,167,52,130,214,140,54,32,22,73
"2011","Wirral 042D","E01007168",1164,44,9,35,189,123,58,144,246,214,68,44,24,78
"2011","Wirral 042E","E01007169",1263,73,18,55,227,179,84,153,222,164,49,32,17,112
"2011","East Riding of Yorkshire 001A","E01012933",802,49,23,26,168,102,135,63,150,80,22,14,8,33
"2011","East Riding of Yorkshire 001B","E01012934",1132,49,18,31,167,140,176,109,222,162,44,27,17,63
"2011","East Riding of Yorkshire 001C","E01012938",1664,66,25,41,297,222,184,181,343,228,63,47,16,80
"2011","East Riding of Yorkshire 001D","E01012939",1306,98,32,66,327,188,193,81,206,129,26,17,9,58
"2011","East Riding of Yorkshire 001E","E01012940",1213,65,26,39,215,157,159,101,239,199,30,14,16,48
"2011","East Riding of Yorkshire 001F","E01012941",964,42,22,20,162,128,130,85,200,168,25,16,9,24
"2011","East Riding of Yorkshire 002A","E01012929",1393,40,17,23,206,162,146,125,324,218,67,31,36,105
"2011","East Riding of Yorkshire 002B","E01012930",1021,46,17,29,193,102,141,81,203,154,39,24,15,62
"2011","East Riding of Yorkshire 002C","E01012935",907,55,17,38,224,120,121,67,159,93,27,17,10,41
"2011","East Riding of Yorkshire 002D","E01012937",1660,72,22,50,330,192,276,161,277,211,69,37,32,72
"2011","East Riding of Yorkshire 002E","E01012942",841,51,15,36,169,139,126,77,150,76,22,15,7,31
"2011","East Riding of Yorkshire 003A","E01012928",1155,20,9,11,127,74,103,105,268,254,126,73,53,78
"2011","East Riding of Yorkshire 003B","E01012931",1099,30,8,22,139,67,123,101,260,209,120,86,34,50
"2011","East Riding of Yorkshire 003C","E01012932",1139,28,11,17,127,92,131,99,258,207,112,67,45,85
"2011","East Riding of Yorkshire 003D","E01012946",1084,25,8,17,103,70,103,88,254,253,111,71,40,77
"2011","East Riding of Yorkshire 003E","E01012949",966,24,8,16,96,86,101,92,230,219,62,41,21,56
"2011","East Riding of Yorkshire 004A","E01012936",940,63,20,43,208,113,139,62,166,105,33,16,17,51
"2011","East Riding of Yorkshire 004B","E01012943",1186,30,6,24,160,118,143,118,254,183,104,74,30,76
"2011","East Riding of Yorkshire 004C","E01012945",1180,30,5,25,155,93,155,98,263,204,104,73,31,78
"2011","East Riding of Yorkshire 004D","E01012952",1108,45,17,28,152,106,191,83,189,161,126,86,40,55
"2011","East Riding of Yorkshire 005A","E01012944",1129,29,10,19,135,63,118,94,237,220,165,89,76,68
"2011","East Riding of Yorkshire 005B","E01012947",1046,58,18,40,207,107,158,78,180,141,59,38,21,58
"2011","East Riding of Yorkshire 005C","E01012948",1088,18,7,11,123,58,147,87,234,208,145,82,63,68
"2011","East Riding of Yorkshire 005D","E01012951",947,51,18,33,148,63,152,68,160,154,97,63,34,54
"2011","East Riding of Yorkshire 006A","E01012950",988,77,29,48,196,134,154,76,143,132,25,19,6,51
"2011","East Riding of Yorkshire 006B","E01012990",1037,78,18,60,238,110,216,77,133,112,24,16,8,49
"2011","East Riding of Yorkshire 006C","E01012991",1197,126,38,88,275,134,207,83,162,105,30,19,11,75
"2011","East Riding of Yorkshire 006D","E01012992",1152,76,27,49,181,122,230,99,164,170,51,27,24,59
"2011","East Riding of Yorkshire 008A","E01012978",1011,99,25,74,250,144,95,87,169,97,15,10,5,55
"2011","East Riding of Yorkshire 008B","E01012981",1107,120,37,83,247,124,190,74,160,98,26,16,10,68
"2011","East Riding of Yorkshire 008C","E01012983",1328,116,35,81,306,179,109,102,235,177,28,16,12,76
"2011","East Riding of Yorkshire 008D","E01012989",1264,129,31,98,321,134,159,105,191,121,29,18,11,75
"2011","East Riding of Yorkshire 008E","E01013125",1312,144,46,98,323,162,216,64,154,131,35,16,19,83
"2011","East Riding of Yorkshire 009A","E01013057",1145,179,45,134,305,158,178,54,113,80,17,9,8,61
"2011","East Riding of Yorkshire 009B","E01013059",1219,191,56,135,292,176,178,90,130,98,14,7,7,50
"2011","East Riding of Yorkshire 009C","E01013060",1340,203,59,144,363,219,125,81,180,80,21,8,13,68
"2011","East Riding of Yorkshire 009D","E01013061",1179,132,37,95,262,150,137,91,182,129,23,15,8,73
"2011","East Riding of Yorkshire 009E","E01013126",1744,182,52,130,343,191,288,106,184,241,123,110,13,86
"2011","East Riding of Yorkshire 010A","E01012986",1180,58,16,42,268,113,207,108,196,152,35,16,19,43
"2011","East Riding of Yorkshire 010B","E01012987",1285,114,45,69,309,153,238,79,165,120,22,17,5,85
"2011","East Riding of Yorkshire 010C","E01012988",1140,100,38,62,280,131,217,81,132,107,43,32,11,49
"2011","East Riding of Yorkshire 010D","E01013048",1555,143,40,103,350,180,254,107,247,150,53,31,22,71
"2011","East Riding of Yorkshire 011A","E01013052",1162,128,47,81,253,162,130,75,172,133,27,16,11,82
"2011","East Riding of Yorkshire 011B","E01013053",993,124,42,82,268,140,114,54,131,87,34,28,6,41
"2011","East Riding of Yorkshire 011C","E01013054",1405,179,48,131,334,211,91,106,200,130,21,13,8,133
"2011","East Riding of Yorkshire 011D","E01013055",1106,126,38,88,225,130,113,92,152,157,37,18,19,74
"2011","East Riding of Yorkshire 011E","E01013056",1171,110,29,81,224,131,96,106,191,207,43,23,20,63
"2011","East Riding of Yorkshire 011F","E01013058",1009,125,25,100,267,141,138,51,123,99,21,14,7,44
"2011","East Riding of Yorkshire 011G","E01013119",1130,144,40,104,265,120,205,91,122,80,27,16,11,76
"2011","East Riding of Yorkshire 012A","E01013046",1236,108,32,76,337,170,118,96,183,116,44,23,21,64
"2011","East Riding of Yorkshire 012B","E01013047",1164,87,29,58,249,133,133,104,184,142,65,39,26,67
"2011","East Riding of Yorkshire 012C","E01013049",1112,87,26,61,221,120,168,86,182,118,62,39,23,68
"2011","East Riding of Yorkshire 012D","E01013050",1216,82,18,64,262,159,179,105,178,135,75,51,24,41
"2011","East Riding of Yorkshire 012E","E01013051",1106,41,11,30,182,109,126,108,229,185,56,32,24,70
"2011","East Riding of Yorkshire 013A","E01012922",1161,144,50,94,322,133,188,70,134,71,27,15,12,72
"2011","East Riding of Yorkshire 013B","E01012923",1180,125,58,67,309,183,143,79,135,111,35,21,14,60
"2011","East Riding of Yorkshire 013C","E01012925",976,170,47,123,283,127,132,48,82,59,21,14,7,54
"2011","East Riding of Yorkshire 013D","E01012927",1187,151,43,108,345,184,108,93,132,79,16,9,7,79
"2011","East Riding of Yorkshire 014A","E01012924",1306,170,59,111,390,175,151,85,131,95,23,15,8,86
"2011","East Riding of Yorkshire 014B","E01012926",1813,208,70,138,459,254,230,135,253,164,28,18,10,82
"2011","East Riding of Yorkshire 014C","E01013027",1224,98,27,71,258,171,167,101,194,127,31,11,20,77
"2011","East Riding of Yorkshire 014D","E01013034",1350,156,46,110,368,175,221,72,145,99,31,21,10,83
"2011","East Riding of Yorkshire 015A","E01013120",1452,183,52,131,390,207,196,89,178,88,42,31,11,79
"2011","East Riding of Yorkshire 015B","E01013121",1489,182,61,121,384,186,185,120,198,123,23,15,8,88
"2011","East Riding of Yorkshire 015C","E01013123",1144,83,27,56,256,154,102,99,213,167,23,13,10,47
"2011","East Riding of Yorkshire 015D","E01013124",1428,106,43,63,284,223,120,127,273,196,41,23,18,58
"2011","East Riding of Yorkshire 016A","E01013064",1058,168,42,126,335,182,58,58,96,59,14,7,7,88
"2011","East Riding of Yorkshire 016B","E01013065",1250,111,37,74,288,207,80,102,207,156,31,11,20,68
"2011","East Riding of Yorkshire 016C","E01013066",1171,148,39,109,373,172,91,89,114,87,17,11,6,80
"2011","East Riding of Yorkshire 016D","E01013067",1319,205,48,157,466,200,74,74,120,75,16,10,6,89
"2011","East Riding of Yorkshire 016E","E01013068",1006,153,39,114,312,146,116,42,100,55,22,15,7,60
"2011","East Riding of Yorkshire 016F","E01013070",1052,177,38,139,326,159,131,41,86,41,27,14,13,64
"2011","East Riding of Yorkshire 017A","E01013038",1026,30,10,20,129,84,64,104,233,209,98,59,39,75
"2011","East Riding of Yorkshire 017B","E01013045",1043,45,10,35,155,93,76,98,197,233,66,32,34,80
"2011","East Riding of Yorkshire 017C","E01013069",1180,90,26,64,279,152,87,111,185,177,24,12,12,75
"2011","East Riding of Yorkshire 017D","E01013071",1129,89,21,68,210,109,91,99,191,188,79,53,26,73
"2011","East Riding of Yorkshire 018A","E01013022",1472,221,72,149,334,170,242,94,176,123,20,10,10,92
"2011","East Riding of Yorkshire 018B","E01013023",1417,174,49,125,295,152,283,92,184,112,57,47,10,68
"2011","East Riding of Yorkshire 018C","E01013024",1376,133,42,91,286,180,140,111,212,190,32,18,14,92
"2011","East Riding of Yorkshire 018D","E01013122",1121,192,51,141,270,125,196,49,121,78,16,11,5,74
"2011","East Riding of Yorkshire 018E","E01013127",1126,174,54,120,290,141,213,53,108,77,23,19,4,47
"2011","East Riding of Yorkshire 019A","E01013036",1160,114,12,102,248,135,94,107,175,161,49,18,31,77
"2011","East Riding of Yorkshire 019B","E01013037",1153,87,15,72,264,171,98,93,182,154,31,19,12,73
"2011","East Riding of Yorkshire 019C","E01013040",1512,199,52,147,418,207,115,125,190,140,30,15,15,88
"2011","East Riding of Yorkshire 019D","E01013041",1088,170,31,139,309,145,93,77,140,93,25,18,7,36
"2011","East Riding of Yorkshire 019E","E01013062",1236,177,41,136,338,161,126,89,131,98,49,30,19,67
"2011","East Riding of Yorkshire 019F","E01013063",1120,196,43,153,329,157,89,53,114,92,16,7,9,74
"2011","East Riding of Yorkshire 020A","E01012919",1196,163,41,122,288,114,111,44,70,43,14,12,2,349
"2011","East Riding of Yorkshire 020B","E01012921",827,157,33,124,239,114,80,39,77,47,15,10,5,59
"2011","East Riding of Yorkshire 020C","E01013039",1352,149,45,104,295,169,199,111,167,138,44,25,19,80
"2011","East Riding of Yorkshire 020D","E01013042",1200,215,54,161,372,197,79,60,106,62,20,16,4,89
"2011","East Riding of Yorkshire 020E","E01013043",1043,156,41,115,280,164,62,75,99,68,35,21,14,104
"2011","East Riding of Yorkshire 020F","E01013044",1203,211,58,153,342,174,84,83,133,73,19,11,8,84
"2011","East Riding of Yorkshire 021A","E01013029",1089,63,26,37,203,127,151,108,186,146,58,32,26,47
"2011","East Riding of Yorkshire 021B","E01013030",1139,67,25,42,253,168,149,120,161,135,28,16,12,58
"2011","East Riding of Yorkshire 021C","E01013031",1173,91,49,42,257,161,146,110,159,131,30,24,6,88
"2011","East Riding of Yorkshire 021D","E01013032",1100,76,17,59,237,154,115,111,184,127,26,16,10,70
"2011","East Riding of Yorkshire 021E","E01013035",1055,83,28,55,262,187,115,102,154,92,13,7,6,47
"2011","East Riding of Yorkshire 022A","E01012954",916,148,35,113,230,127,67,68,94,69,51,37,14,62
"2011","East Riding of Yorkshire 022B","E01012956",900,125,24,101,230,148,77,48,106,65,28,20,8,73
"2011","East Riding of Yorkshire 022C","E01012958",799,102,22,80,221,156,56,56,89,49,23,17,6,47
"2011","East Riding of Yorkshire 022D","E01012961",1023,98,32,66,224,169,100,71,145,124,40,34,6,52
"2011","East Riding of Yorkshire 022E","E01012966",977,122,43,79,311,121,114,62,93,67,30,22,8,57
"2011","East Riding of Yorkshire 023A","E01012953",833,88,28,60,199,120,123,63,97,83,21,15,6,39
"2011","East Riding of Yorkshire 023B","E01012955",1117,147,36,111,314,194,100,69,124,73,26,11,15,70
"2011","East Riding of Yorkshire 023C","E01012959",1096,113,33,80,296,183,76,90,136,99,23,9,14,80
"2011","East Riding of Yorkshire 023D","E01012962",811,115,23,92,246,131,76,48,80,49,15,8,7,51
"2011","East Riding of Yorkshire 023E","E01012964",1189,71,26,45,223,188,81,99,205,172,56,34,22,94
"2011","East Riding of Yorkshire 024A","E01012920",1101,197,61,136,334,157,142,48,83,66,16,10,6,58
"2011","East Riding of Yorkshire 024B","E01012965",760,114,31,83,203,90,115,49,62,64,12,10,2,51
"2011","East Riding of Yorkshire 024C","E01012967",1121,201,55,146,300,168,78,72,136,90,14,7,7,62
"2011","East Riding of Yorkshire 024D","E01012968",1271,272,79,193,370,194,115,73,87,54,26,13,13,80
"2011","East Riding of Yorkshire 024E","E01012969",1532,114,39,75,245,131,164,148,215,290,157,139,18,68
"2011","East Riding of Yorkshire 025A","E01012957",2183,145,36,109,311,137,86,81,110,78,28,18,10,1207
"2011","East Riding of Yorkshire 025B","E01012960",1138,184,32,152,303,166,109,71,108,88,25,17,8,84
"2011","East Riding of Yorkshire 025C","E01012963",982,66,11,55,162,125,84,87,159,178,68,36,32,53
"2011","East Riding of Yorkshire 025D","E01013112",991,116,34,82,268,175,76,71,127,87,16,10,6,55
"2011","East Riding of Yorkshire 026A","E01013018",1324,118,39,79,272,164,174,98,221,183,37,24,13,57
"2011","East Riding of Yorkshire 026B","E01013019",926,100,31,69,207,116,155,64,113,90,27,19,8,54
"2011","East Riding of Yorkshire 026C","E01013021",1151,81,24,57,211,144,129,136,188,191,28,15,13,43
"2011","East Riding of Yorkshire 026D","E01013025",987,154,38,116,256,126,126,58,111,81,25,16,9,50
"2011","East Riding of Yorkshire 026E","E01013026",1241,110,38,72,236,157,175,103,188,170,33,18,15,69
"2011","East Riding of Yorkshire 027A","E01013105",1004,78,22,56,199,133,87,95,186,123,40,15,25,63
"2011","East Riding of Yorkshire 027B","E01013110",1059,120,30,90,309,157,91,78,125,76,25,18,7,78
"2011","East Riding of Yorkshire 027C","E01013111",1069,124,29,95,255,187,96,101,129,94,16,8,8,67
"2011","East Riding of Yorkshire 027D","E01013115",1153,100,26,74,243,197,109,120,171,123,21,12,9,69
"2011","East Riding of Yorkshire 027E","E01013117",1105,148,38,110,301,202,105,82,110,64,16,7,9,77
"2011","East Riding of Yorkshire 028A","E01013108",1116,184,45,139,299,181,140,60,112,55,16,9,7,69
"2011","East Riding of Yorkshire 028B","E01013113",1088,151,46,105,309,178,93,85,103,82,17,12,5,70
"2011","East Riding of Yorkshire 028C","E01013114",1101,218,67,151,312,155,146,45,82,56,13,6,7,74
"2011","East Riding of Yorkshire 028D","E01013116",1103,203,53,150,352,171,109,45,83,43,18,11,7,79
"2011","East Riding of Yorkshire 028E","E01013118",1056,155,42,113,314,162,107,66,114,61,14,7,7,63
"2011","East Riding of Yorkshire 029A","E01013094",1041,100,41,59,252,148,107,100,149,104,25,17,8,56
"2011","East Riding of Yorkshire 029B","E01013095",1142,101,29,72,237,182,104,113,176,124,55,36,19,50
"2011","East Riding of Yorkshire 029C","E01013096",1221,72,22,50,247,179,108,149,196,152,36,23,13,82
"2011","East Riding of Yorkshire 029D","E01013097",1089,61,15,46,211,180,83,131,192,157,26,17,9,48
"2011","East Riding of Yorkshire 029E","E01013102",1117,76,29,47,212,173,108,125,191,147,29,20,9,56
"2011","East Riding of Yorkshire 031A","E01013028",1214,121,43,78,270,157,198,95,158,117,34,19,15,64
"2011","East Riding of Yorkshire 031B","E01013078",1088,98,28,70,277,126,151,93,153,97,33,19,14,60
"2011","East Riding of Yorkshire 031C","E01013081",1172,82,22,60,246,164,162,105,172,146,35,20,15,60
"2011","East Riding of Yorkshire 031D","E01013082",1206,50,16,34,230,168,157,117,216,157,54,38,16,57
"2011","East Riding of Yorkshire 031E","E01013085",1250,94,25,69,251,170,125,125,188,173,55,36,19,69
"2011","East Riding of Yorkshire 032A","E01012970",1119,196,58,138,329,164,115,73,91,59,16,8,8,76
"2011","East Riding of Yorkshire 032C","E01012972",1057,179,44,135,288,164,84,84,113,67,24,17,7,54
"2011","East Riding of Yorkshire 032D","E01012973",2093,318,72,246,578,305,193,164,213,149,38,21,17,135
"2011","East Riding of Yorkshire 032E","E01012974",1102,126,31,95,245,160,68,106,177,108,40,21,19,72
"2011","East Riding of Yorkshire 032F","E01013092",1458,246,74,172,471,189,162,83,120,73,18,8,10,96
"2011","East Riding of Yorkshire 032G","E01033495",1035,189,46,143,333,171,70,63,85,54,12,6,6,58
"2011","East Riding of Yorkshire 032H","E01033496",1210,203,48,155,364,202,98,85,118,52,18,7,11,70
"2011","East Riding of Yorkshire 033A","E01013033",1211,97,36,61,276,195,108,135,152,143,37,19,18,68
"2011","East Riding of Yorkshire 033B","E01013098",1630,141,42,99,375,288,157,157,217,162,38,26,12,95
"2011","East Riding of Yorkshire 033C","E01013099",964,43,8,35,141,122,83,115,204,160,48,23,25,48
"2011","East Riding of Yorkshire 033D","E01013100",1255,98,25,73,260,213,144,102,181,139,36,17,19,82
"2011","East Riding of Yorkshire 033E","E01013101",1277,89,30,59,286,226,97,149,204,145,25,12,13,56
"2011","East Riding of Yorkshire 034A","E01013008",1115,75,20,55,229,183,95,101,190,141,36,22,14,65
"2011","East Riding of Yorkshire 034B","E01013009",1088,100,20,80,219,128,100,113,171,146,49,27,22,62
"2011","East Riding of Yorkshire 034C","E01013013",1166,85,19,66,252,200,81,126,195,130,34,18,16,63
"2011","East Riding of Yorkshire 034D","E01013014",1087,64,15,49,191,167,88,97,222,142,35,14,21,81
"2011","East Riding of Yorkshire 034E","E01013107",1011,74,28,46,187,125,72,105,179,154,53,30,23,62
"2011","East Riding of Yorkshire 035A","E01013088",1152,250,78,172,351,157,134,57,94,31,12,8,4,66
"2011","East Riding of Yorkshire 035B","E01013089",1242,228,55,173,400,174,116,72,97,53,31,25,6,71
"2011","East Riding of Yorkshire 035C","E01013090",1064,173,46,127,270,178,89,70,117,80,14,6,8,73
"2011","East Riding of Yorkshire 035D","E01013091",1104,198,44,154,330,157,108,62,104,46,22,10,12,77
"2011","East Riding of Yorkshire 035E","E01013093",1081,228,69,159,328,161,138,40,64,39,15,9,6,68
"2011","East Riding of Yorkshire 036A","E01013005",961,174,42,132,265,116,115,46,95,62,32,27,5,56
"2011","East Riding of Yorkshire 036B","E01013007",1119,138,25,113,285,173,93,81,144,98,44,28,16,63
"2011","East Riding of Yorkshire 036C","E01013011",1108,97,20,77,266,175,97,90,168,104,31,13,18,80
"2011","East Riding of Yorkshire 036D","E01013012",1041,172,48,124,295,160,111,75,90,45,27,14,13,66
"2011","East Riding of Yorkshire 037A","E01012996",1152,113,36,77,256,167,115,121,158,146,17,11,6,59
"2011","East Riding of Yorkshire 037B","E01012998",1619,92,36,56,308,232,113,189,278,246,58,44,14,103
"2011","East Riding of Yorkshire 037C","E01013015",1196,123,41,82,314,146,119,100,147,152,36,21,15,59
"2011","East Riding of Yorkshire 037D","E01013016",1297,184,45,139,332,171,177,103,117,124,29,21,8,60
"2011","East Riding of Yorkshire 038A","E01013003",1014,66,23,43,172,141,95,112,182,166,42,28,14,38
"2011","East Riding of Yorkshire 038B","E01013017",1167,110,23,87,238,123,144,102,160,171,51,38,13,68
"2011","East Riding of Yorkshire 038C","E01013020",1364,162,56,106,328,192,193,108,141,141,34,25,9,65
"2011","East Riding of Yorkshire 038D","E01013076",1085,69,26,43,204,128,159,86,207,140,43,27,16,49
"2011","East Riding of Yorkshire 039A","E01013079",1158,67,17,50,220,152,186,90,198,154,36,24,12,55
"2011","East Riding of Yorkshire 039B","E01013080",921,25,9,16,117,86,85,94,210,163,86,43,43,55
"2011","East Riding of Yorkshire 039C","E01013083",1036,30,14,16,147,112,114,94,203,176,102,58,44,58
"2011","East Riding of Yorkshire 039D","E01013084",983,30,6,24,124,103,94,89,201,180,113,73,40,49
"2011","East Riding of Yorkshire 039E","E01013086",1143,57,15,42,191,151,142,100,206,164,70,50,20,62
"2011","East Riding of Yorkshire 039F","E01013087",1032,47,10,37,184,129,165,99,171,150,49,29,20,38
"2011","East Riding of Yorkshire 040A","E01012993",980,52,19,33,212,140,73,106,174,157,30,24,6,36
"2011","East Riding of Yorkshire 040B","E01012997",1397,26,7,19,147,110,74,173,318,383,100,66,34,66
"2011","East Riding of Yorkshire 040C","E01012999",1302,27,6,21,118,110,61,139,291,370,103,55,48,83
"2011","East Riding of Yorkshire 040D","E01013001",1273,48,21,27,172,144,89,141,269,284,67,44,23,59
"2011","East Riding of Yorkshire 040E","E01013074",1240,121,41,80,250,173,175,118,170,142,43,28,15,48
"2011","East Riding of Yorkshire 041A","E01012994",1258,37,10,27,179,136,86,123,274,313,59,32,27,51
"2011","East Riding of Yorkshire 041B","E01012995",1374,37,11,26,146,129,73,152,309,353,71,44,27,104
"2011","East Riding of Yorkshire 041C","E01013000",1414,37,15,22,129,92,85,139,269,435,148,93,55,80
"2011","East Riding of Yorkshire 041D","E01013002",1159,25,12,13,106,86,42,126,249,342,123,71,52,60
"2011","East Riding of Yorkshire 041E","E01013004",1193,38,5,33,113,111,55,127,251,334,77,51,26,87
"2011","East Riding of Yorkshire 042A","E01013072",1230,78,30,48,252,146,124,124,203,191,44,29,15,68
"2011","East Riding of Yorkshire 042B","E01013073",1220,128,39,89,261,168,133,105,162,148,45,26,19,70
"2011","East Riding of Yorkshire 042C","E01013075",1037,100,29,71,205,122,170,93,154,110,32,17,15,51
"2011","East Riding of Yorkshire 042D","E01013077",1456,115,38,77,342,201,117,156,217,194,46,26,20,68
"2011","East Riding of Yorkshire 043A","E01013006",1135,76,15,61,210,160,106,128,198,150,37,19,18,70
"2011","East Riding of Yorkshire 043B","E01013010",1126,75,21,54,226,177,86,101,223,139,33,20,13,66
"2011","East Riding of Yorkshire 043C","E01013103",1084,66,25,41,222,208,75,115,184,123,24,16,8,67
"2011","East Riding of Yorkshire 043D","E01013104",929,74,24,50,185,177,72,90,168,112,15,8,7,36
"2011","East Riding of Yorkshire 043E","E01013106",827,42,15,27,118,101,72,96,188,111,49,24,25,50
"2011","East Riding of Yorkshire 043F","E01032596",1040,64,15,49,234,152,68,103,186,131,25,10,15,77
"2011","East Riding of Yorkshire 044A","E01012975",1167,95,23,72,235,153,126,104,208,157,26,14,12,63
"2011","East Riding of Yorkshire 044B","E01012977",1892,158,43,115,417,262,174,159,324,215,55,35,20,128
"2011","East Riding of Yorkshire 044C","E01012984",1246,117,37,80,329,149,202,79,160,102,24,13,11,84
"2011","East Riding of Yorkshire 044D","E01012985",1222,104,29,75,311,138,143,83,185,156,39,23,16,63
"2011","East Riding of Yorkshire 045A","E01012976",1072,40,14,26,165,101,63,109,232,221,72,36,36,69
"2011","East Riding of Yorkshire 045B","E01012979",1126,59,18,41,227,121,111,95,210,200,53,33,20,50
"2011","East Riding of Yorkshire 045C","E01012980",1262,66,18,48,222,134,94,129,259,197,87,55,32,74
"2011","East Riding of Yorkshire 045D","E01012982",1188,107,34,73,253,141,132,97,193,152,41,26,15,72
"2011","Kingston upon Hull 001A","E01012779",897,14,7,7,72,54,47,67,202,207,159,91,68,75
"2011","Kingston upon Hull 001B","E01012780",1089,18,4,14,83,73,62,100,264,258,158,102,56,73
"2011","Kingston upon Hull 001C","E01012781",852,15,3,12,60,65,41,68,214,216,130,93,37,43
"2011","Kingston upon Hull 001E","E01012832",1023,52,15,37,167,128,71,114,187,171,78,46,32,55
"2011","Kingston upon Hull 001F","E01033105",1123,106,23,83,295,167,72,93,158,108,36,20,16,88
"2011","Kingston upon Hull 001G","E01033106",928,106,22,84,252,158,67,84,98,59,28,18,10,76
"2011","Kingston upon Hull 001H","E01033107",1015,135,29,106,263,143,69,88,134,89,31,20,11,63
"2011","Kingston upon Hull 001I","E01033108",1089,68,16,52,276,175,65,97,175,120,32,18,14,81
"2011","Kingston upon Hull 002A","E01012782",947,6,2,4,73,52,38,78,223,238,136,82,54,103
"2011","Kingston upon Hull 002B","E01012785",882,11,3,8,58,67,42,70,215,214,129,83,46,76
"2011","Kingston upon Hull 002C","E01012786",907,13,6,7,65,71,41,91,248,220,100,64,36,58
"2011","Kingston upon Hull 002D","E01012787",1107,10,1,9,79,67,60,96,275,288,148,88,60,84
"2011","Kingston upon Hull 002E","E01012788",1042,11,4,7,75,76,53,92,244,236,163,99,64,92
"2011","Kingston upon Hull 002F","E01012789",952,10,4,6,98,72,39,88,234,254,94,52,42,63
"2011","Kingston upon Hull 003A","E01012875",988,7,3,4,60,44,45,89,199,242,223,122,101,79
"2011","Kingston upon Hull 003B","E01012876",1105,11,5,6,58,64,53,97,245,290,194,115,79,93
"2011","Kingston upon Hull 003C","E01012877",935,5,2,3,51,42,39,95,193,217,210,140,70,83
"2011","Kingston upon Hull 003D","E01012878",1106,13,5,8,73,81,43,79,263,274,194,133,61,86
"2011","Kingston upon Hull 003E","E01012879",979,14,6,8,58,63,31,73,206,221,235,156,79,78
"2011","Kingston upon Hull 004A","E01012778",1023,15,7,8,76,77,51,80,245,229,152,97,55,98
"2011","Kingston upon Hull 004B","E01012783",838,10,6,4,64,52,51,75,183,195,135,87,48,73
"2011","Kingston upon Hull 004C","E01012784",1497,55,19,36,229,187,79,137,315,257,133,83,50,105
"2011","Kingston upon Hull 004D","E01012790",971,20,9,11,79,84,53,85,229,238,118,78,40,65
"2011","Kingston upon Hull 004E","E01012906",1153,17,4,13,96,77,49,116,301,259,148,83,65,90
"2011","Kingston upon Hull 004F","E01012908",854,13,5,8,103,77,42,85,192,180,122,89,33,40
"2011","Kingston upon Hull 005A","E01012764",893,66,18,48,198,135,59,84,176,122,23,13,10,30
"2011","Kingston upon Hull 005B","E01012765",1123,81,20,61,196,162,92,116,208,161,29,12,17,78
"2011","Kingston upon Hull 005C","E01012768",1065,66,21,45,203,176,89,110,174,164,35,20,15,48
"2011","Kingston upon Hull 005D","E01012769",943,59,14,45,175,160,58,105,204,130,15,10,5,37
"2011","Kingston upon Hull 006A","E01012829",1240,70,25,45,200,189,78,153,264,188,29,19,10,69
"2011","Kingston upon Hull 006B","E01012830",1157,39,14,25,178,167,76,138,253,207,34,22,12,65
"2011","Kingston upon Hull 006C","E01012905",966,27,10,17,108,74,43,82,233,238,84,51,33,77
"2011","Kingston upon Hull 006D","E01012910",994,47,12,35,141,144,40,103,237,166,45,25,20,71
"2011","Kingston upon Hull 006E","E01012912",1386,72,24,48,228,200,99,154,279,232,42,27,15,80
"2011","Kingston upon Hull 007A","E01012822",1040,58,18,40,177,149,65,110,191,175,44,27,17,71
"2011","Kingston upon Hull 007B","E01012904",1085,92,24,68,239,180,77,84,166,123,48,30,18,76
"2011","Kingston upon Hull 007C","E01012907",1060,43,14,29,176,134,68,96,228,188,70,44,26,57
"2011","Kingston upon Hull 007D","E01012909",1048,72,21,51,237,190,74,133,160,120,18,10,8,44
"2011","Kingston upon Hull 007E","E01012911",963,90,35,55,206,186,63,87,147,107,15,9,6,62
"2011","Kingston upon Hull 008A","E01012873",1045,17,6,11,70,60,46,64,229,262,202,135,67,95
"2011","Kingston upon Hull 008B","E01012874",1055,16,3,13,96,85,51,89,216,260,173,119,54,69
"2011","Kingston upon Hull 008C","E01012880",1175,12,4,8,102,75,58,94,259,264,224,145,79,87
"2011","Kingston upon Hull 008D","E01012881",1066,20,3,17,92,92,61,77,222,249,171,106,65,82
"2011","Kingston upon Hull 008E","E01012915",1035,34,8,26,105,85,49,91,220,222,129,84,45,100
"2011","Kingston upon Hull 008F","E01012917",1120,39,7,32,109,110,68,93,208,232,151,79,72,110
"2011","Kingston upon Hull 008G","E01012918",1111,19,6,13,120,86,53,99,216,232,170,119,51,116
"2011","Kingston upon Hull 009A","E01012833",1029,26,6,20,95,102,59,94,227,212,133,78,55,81
"2011","Kingston upon Hull 009B","E01012835",889,47,17,30,162,155,68,85,153,149,23,11,12,47
"2011","Kingston upon Hull 009C","E01012836",1098,19,5,14,95,93,62,101,241,226,191,95,96,70
"2011","Kingston upon Hull 009D","E01012839",894,34,7,27,134,134,77,85,173,144,60,37,23,53
"2011","Kingston upon Hull 009E","E01012840",1039,18,9,9,93,88,66,87,251,236,126,76,50,74
"2011","Kingston upon Hull 010A","E01012824",1198,68,23,45,222,154,89,134,219,183,57,34,23,72
"2011","Kingston upon Hull 010B","E01012825",1094,68,15,53,201,157,91,110,195,154,55,36,19,63
"2011","Kingston upon Hull 010C","E01012834",1047,15,7,8,82,84,63,86,271,236,140,80,60,70
"2011","Kingston upon Hull 010D","E01012837",1085,30,4,26,104,105,71,95,228,261,113,73,40,78
"2011","Kingston upon Hull 010E","E01012838",984,18,4,14,98,92,63,71,214,244,121,63,58,63
"2011","Kingston upon Hull 011A","E01012821",865,37,12,25,152,119,62,69,163,147,44,23,21,72
"2011","Kingston upon Hull 011B","E01012823",960,30,10,20,91,97,51,86,199,212,109,64,45,85
"2011","Kingston upon Hull 011C","E01012826",1039,31,12,19,141,136,73,89,233,209,57,32,25,70
"2011","Kingston upon Hull 011D","E01012827",1089,41,9,32,167,132,94,98,218,187,72,51,21,80
"2011","Kingston upon Hull 011E","E01012828",1092,33,10,23,183,144,69,119,229,186,73,48,25,56
"2011","Kingston upon Hull 012A","E01012766",1145,69,17,52,257,162,101,102,160,132,41,19,22,121
"2011","Kingston upon Hull 012B","E01012767",1474,73,12,61,201,107,63,88,120,105,70,34,36,647
"2011","Kingston upon Hull 012C","E01012914",2023,37,7,30,77,31,22,26,65,49,17,11,6,1699
"2011","Kingston upon Hull 012D","E01012916",1215,131,24,107,237,129,97,68,150,109,47,32,15,247
"2011","Kingston upon Hull 013A","E01012812",1069,65,18,47,228,189,110,104,152,113,28,15,13,80
"2011","Kingston upon Hull 013B","E01012813",1369,86,33,53,271,255,93,146,211,187,19,6,13,101
"2011","Kingston upon Hull 013C","E01012814",1158,70,28,42,228,236,91,108,188,134,22,13,9,81
"2011","Kingston upon Hull 013D","E01012815",1216,59,19,40,252,194,81,139,212,193,14,7,7,72
"2011","Kingston upon Hull 013E","E01012818",952,53,25,28,182,134,74,101,182,128,31,16,15,67
"2011","Kingston upon Hull 014A","E01012791",1285,92,23,69,334,196,113,101,184,137,32,21,11,96
"2011","Kingston upon Hull 014B","E01012792",1149,108,27,81,278,162,74,115,164,102,21,13,8,125
"2011","Kingston upon Hull 014C","E01012793",1038,134,26,108,277,117,85,73,103,95,35,26,9,119
"2011","Kingston upon Hull 014D","E01012794",1234,71,23,48,239,211,103,121,184,148,38,19,19,119
"2011","Kingston upon Hull 014E","E01012913",1446,91,16,75,274,145,90,100,226,195,104,60,44,221
"2011","Kingston upon Hull 015A","E01012761",1396,67,7,60,193,79,79,94,206,221,151,96,55,306
"2011","Kingston upon Hull 015B","E01012868",1520,39,5,34,119,83,43,57,131,161,79,43,36,808
"2011","Kingston upon Hull 015C","E01012869",1546,32,2,30,98,81,58,74,156,217,81,56,25,749
"2011","Kingston upon Hull 015D","E01012871",1522,47,6,41,163,109,65,116,215,299,125,70,55,383
"2011","Kingston upon Hull 015E","E01012872",1661,38,6,32,102,54,42,55,112,155,78,49,29,1025
"2011","Kingston upon Hull 016A","E01012804",1167,71,24,47,202,168,87,129,207,205,49,25,24,49
"2011","Kingston upon Hull 016B","E01012806",1125,29,6,23,129,132,61,109,258,227,123,57,66,57
"2011","Kingston upon Hull 016C","E01012807",1021,61,20,41,179,152,92,101,172,150,58,32,26,56
"2011","Kingston upon Hull 016D","E01012817",1093,28,7,21,158,138,78,126,213,214,83,41,42,55
"2011","Kingston upon Hull 016E","E01012819",1113,50,14,36,176,148,82,126,236,195,33,13,20,67
"2011","Kingston upon Hull 017A","E01012841",1041,13,4,9,80,58,54,86,234,235,200,123,77,81
"2011","Kingston upon Hull 017B","E01012844",928,13,6,7,68,66,40,79,224,233,144,103,41,61
"2011","Kingston upon Hull 017C","E01012849",1054,27,7,20,100,89,53,80,269,232,124,66,58,80
"2011","Kingston upon Hull 017D","E01012895",1011,8,1,7,52,65,49,69,210,236,238,159,79,84
"2011","Kingston upon Hull 017E","E01012897",1037,13,3,10,68,43,47,70,188,285,260,174,86,63
"2011","Kingston upon Hull 017F","E01012898",895,25,8,17,104,87,47,76,204,190,110,77,33,52
"2011","Kingston upon Hull 018A","E01012758",1256,216,42,174,416,125,85,58,108,68,60,40,20,120
"2011","Kingston upon Hull 018B","E01012762",1284,143,25,118,342,111,63,46,119,107,55,24,31,298
"2011","Kingston upon Hull 018C","E01012763",1698,169,17,152,377,121,93,89,198,167,148,89,59,336
"2011","Kingston upon Hull 018D","E01012866",1311,78,6,72,183,120,32,82,193,179,80,45,35,364
"2011","Kingston upon Hull 018E","E01012870",1487,64,13,51,155,91,27,69,120,168,74,43,31,719
"2011","Kingston upon Hull 019A","E01012774",1144,48,14,34,181,139,82,109,230,213,54,34,20,88
"2011","Kingston upon Hull 019B","E01012795",1340,62,20,42,182,177,68,148,258,231,95,52,43,119
"2011","Kingston upon Hull 019C","E01012797",978,41,9,32,160,150,66,98,189,174,49,15,34,51
"2011","Kingston upon Hull 019D","E01012798",1052,34,12,22,121,122,69,95,219,244,74,44,30,74
"2011","Kingston upon Hull 019E","E01012801",1078,64,22,42,180,172,80,118,190,184,39,21,18,51
"2011","Kingston upon Hull 020A","E01012816",1024,51,16,35,181,157,93,91,173,149,40,19,21,89
"2011","Kingston upon Hull 020B","E01012848",1617,39,8,31,200,112,133,164,246,397,264,168,96,62
"2011","Kingston upon Hull 020C","E01012894",1167,28,12,16,95,110,54,120,251,280,137,86,51,92
"2011","Kingston upon Hull 020D","E01012896",1559,59,20,39,239,202,111,167,305,258,98,54,44,120
"2011","Kingston upon Hull 020E","E01012901",1073,39,14,25,168,149,81,125,205,190,47,23,24,69
"2011","Kingston upon Hull 021A","E01012842",1041,22,7,15,60,84,46,94,245,269,147,89,58,74
"2011","Kingston upon Hull 021B","E01012843",972,22,7,15,88,73,43,59,198,224,195,135,60,70
"2011","Kingston upon Hull 021C","E01012845",1036,10,5,5,71,59,44,97,233,268,177,102,75,77
"2011","Kingston upon Hull 021D","E01012846",983,18,7,11,72,67,36,89,225,287,134,84,50,55
"2011","Kingston upon Hull 021E","E01012847",862,11,5,6,60,56,42,79,199,219,136,81,55,60
"2011","Kingston upon Hull 022A","E01012820",1049,35,9,26,170,124,76,108,231,160,57,28,29,88
"2011","Kingston upon Hull 022B","E01012899",1146,40,13,27,165,148,58,112,263,229,84,48,36,47
"2011","Kingston upon Hull 022C","E01012900",1221,21,4,17,123,93,50,115,322,273,166,96,70,58
"2011","Kingston upon Hull 022D","E01012902",1215,42,19,23,201,193,75,137,247,193,47,24,23,80
"2011","Kingston upon Hull 022E","E01012903",1319,33,9,24,150,155,67,152,294,296,105,52,53,67
"2011","Kingston upon Hull 023A","E01012796",980,44,17,27,148,168,80,109,199,134,36,19,17,62
"2011","Kingston upon Hull 023B","E01012799",955,41,6,35,152,151,72,96,209,160,35,16,19,39
"2011","Kingston upon Hull 023C","E01012800",1151,52,19,33,218,186,74,129,220,163,51,24,27,58
"2011","Kingston upon Hull 023D","E01012802",1091,55,21,34,191,173,60,141,212,167,42,28,14,50
"2011","Kingston upon Hull 023E","E01012803",1075,38,11,27,189,177,78,119,190,177,42,15,27,65
"2011","Kingston upon Hull 024A","E01012850",1504,55,10,45,155,92,80,137,249,341,259,141,118,136
"2011","Kingston upon Hull 024B","E01012852",1307,32,9,23,156,92,59,125,252,270,213,145,68,108
"2011","Kingston upon Hull 024C","E01012856",1186,17,1,16,97,77,76,108,238,307,198,130,68,68
"2011","Kingston upon Hull 024D","E01012857",1206,30,7,23,106,82,66,98,209,304,213,139,74,98
"2011","Kingston upon Hull 024E","E01012867",1188,32,6,26,115,84,64,87,205,271,175,122,53,155
"2011","Kingston upon Hull 025A","E01012756",1202,98,28,70,304,160,79,88,183,134,44,22,22,112
"2011","Kingston upon Hull 025B","E01012757",1220,84,7,77,310,127,83,96,176,119,92,54,38,133
"2011","Kingston upon Hull 025C","E01012759",1298,104,17,87,237,159,88,111,214,199,91,53,38,95
"2011","Kingston upon Hull 025D","E01012760",1177,77,14,63,293,142,68,103,156,185,61,33,28,92
"2011","Kingston upon Hull 025E","E01012862",964,14,5,9,98,101,72,75,207,223,107,60,47,67
"2011","Kingston upon Hull 026A","E01012805",1068,26,5,21,122,90,48,85,241,266,132,66,66,58
"2011","Kingston upon Hull 026B","E01012808",1271,29,2,27,120,125,63,115,281,295,168,118,50,75
"2011","Kingston upon Hull 026C","E01012809",1431,54,8,46,177,156,118,119,249,287,187,101,86,84
"2011","Kingston upon Hull 026D","E01012810",1405,200,36,164,308,198,96,127,188,166,70,45,25,52
"2011","Kingston upon Hull 026E","E01012811",1323,241,41,200,332,169,103,85,117,118,89,63,26,69
"2011","Kingston upon Hull 027A","E01012773",1277,60,13,47,191,205,111,129,253,207,51,19,32,70
"2011","Kingston upon Hull 027B","E01012776",1124,49,11,38,214,159,68,113,224,199,41,19,22,57
"2011","Kingston upon Hull 027C","E01012863",1072,27,6,21,170,121,63,98,218,223,90,63,27,62
"2011","Kingston upon Hull 027D","E01012864",1272,33,5,28,164,119,70,112,257,263,135,65,70,119
"2011","Kingston upon Hull 027E","E01012865",1022,19,7,12,117,100,62,95,231,222,120,74,46,56
"2011","Kingston upon Hull 028A","E01012770",1127,119,40,79,279,195,94,118,123,103,27,10,17,69
"2011","Kingston upon Hull 028B","E01012771",1140,60,26,34,215,177,87,107,198,172,44,27,17,80
"2011","Kingston upon Hull 028C","E01012772",1104,65,24,41,189,166,97,97,204,149,58,24,34,79
"2011","Kingston upon Hull 028D","E01012775",1052,33,12,21,161,130,63,101,239,197,70,46,24,58
"2011","Kingston upon Hull 028E","E01012777",983,39,8,31,162,116,86,84,170,177,90,62,28,59
"2011","Kingston upon Hull 029A","E01012851",1927,120,13,107,229,154,110,174,315,353,278,183,95,194
"2011","Kingston upon Hull 029C","E01012854",1755,120,26,94,221,120,85,150,306,325,326,195,131,102
"2011","Kingston upon Hull 029D","E01012855",1337,28,9,19,119,75,63,120,265,309,268,168,100,90
"2011","Kingston upon Hull 029E","E01033104",1195,156,18,138,262,111,56,81,138,108,72,44,28,211
"2011","Kingston upon Hull 029F","E01033109",1117,128,18,110,213,99,73,89,145,136,144,90,54,90
"2011","Kingston upon Hull 030A","E01012859",1116,15,2,13,104,92,64,85,243,252,162,96,66,99
"2011","Kingston upon Hull 030B","E01012889",991,19,4,15,62,62,51,92,199,293,166,112,54,47
"2011","Kingston upon Hull 030C","E01012891",1720,60,16,44,166,91,99,127,336,426,291,146,145,124
"2011","Kingston upon Hull 030D","E01012892",1422,20,2,18,167,97,80,115,320,354,174,97,77,95
"2011","Kingston upon Hull 030E","E01012893",1092,13,4,9,75,65,63,82,250,293,181,110,71,70
"2011","Kingston upon Hull 031A","E01012858",1267,31,8,23,119,96,84,122,260,304,149,91,58,102
"2011","Kingston upon Hull 031B","E01012860",1214,38,14,24,162,115,70,137,275,220,105,74,31,92
"2011","Kingston upon Hull 031D","E01012886",1170,49,18,31,184,119,71,101,227,237,106,55,51,76
"2011","Kingston upon Hull 031E","E01012888",1176,17,5,12,119,80,48,130,243,289,183,109,74,67
"2011","Kingston upon Hull 031G","E01033110",1115,23,7,16,107,69,67,96,251,283,168,97,71,51
"2011","Kingston upon Hull 033A","E01012882",1215,65,23,42,221,172,96,128,249,181,46,24,22,57
"2011","Kingston upon Hull 033B","E01012883",1014,69,27,42,157,172,86,91,190,168,32,22,10,49
"2011","Kingston upon Hull 033C","E01012884",1261,46,16,30,158,128,66,125,255,299,105,70,35,79
"2011","Kingston upon Hull 033D","E01012887",1024,25,10,15,99,78,74,76,244,228,130,58,72,70
"2011","Kingston upon Hull 033E","E01032595",1218,29,6,23,137,133,72,113,264,256,108,68,40,106
"2011","North East Lincolnshire 001A","E01013174",952,9,3,6,95,66,32,93,212,238,130,80,50,77
"2011","North East Lincolnshire 001B","E01013175",1062,67,22,45,214,156,86,141,161,137,35,23,12,65
"2011","North East Lincolnshire 001C","E01013176",1055,30,8,22,158,132,62,161,203,211,44,26,18,54
"2011","North East Lincolnshire 001D","E01013177",1163,14,5,9,109,67,46,141,259,311,160,97,63,56
"2011","North East Lincolnshire 001E","E01013178",1080,50,16,34,148,122,64,156,218,211,38,22,16,73
"2011","North East Lincolnshire 001F","E01013179",1062,27,9,18,128,110,70,156,217,230,56,39,17,68
"2011","North East Lincolnshire 001G","E01013180",1101,35,12,23,159,139,74,176,189,187,74,56,18,68
"2011","North East Lincolnshire 002A","E01013136",1170,14,4,10,60,35,63,103,261,300,216,134,82,118
"2011","North East Lincolnshire 002B","E01013137",1151,12,5,7,39,36,65,109,311,284,235,133,102,60
"2011","North East Lincolnshire 002C","E01013139",878,10,6,4,57,50,58,67,223,217,149,86,63,47
"2011","North East Lincolnshire 002D","E01013142",1205,17,11,6,95,73,60,114,366,249,154,88,66,77
"2011","North East Lincolnshire 003A","E01013218",1011,22,10,12,87,63,40,105,262,251,119,54,65,62
"2011","North East Lincolnshire 003B","E01013219",1019,15,8,7,98,74,41,112,277,216,108,65,43,78
"2011","North East Lincolnshire 003C","E01013220",1185,25,8,17,133,95,77,118,290,241,124,68,56,82
"2011","North East Lincolnshire 003D","E01013221",1315,39,10,29,142,99,72,132,335,291,137,72,65,68
"2011","North East Lincolnshire 003E","E01013222",1152,22,6,16,136,94,76,103,288,229,122,58,64,82
"2011","North East Lincolnshire 004A","E01013144",1051,28,12,16,83,59,59,94,265,266,136,69,67,61
"2011","North East Lincolnshire 004B","E01013145",1005,54,15,39,177,132,61,118,190,178,34,19,15,61
"2011","North East Lincolnshire 004C","E01013146",1274,94,30,64,238,144,93,129,254,176,70,39,31,76
"2011","North East Lincolnshire 004D","E01013148",1149,88,29,59,232,165,77,137,205,131,31,14,17,83
"2011","North East Lincolnshire 005A","E01013195",1008,30,14,16,134,102,75,109,233,196,65,36,29,64
"2011","North East Lincolnshire 005B","E01013196",995,22,6,16,116,71,53,106,252,203,94,66,28,78
"2011","North East Lincolnshire 005C","E01013201",1119,20,5,15,118,74,56,116,282,262,108,68,40,83
"2011","North East Lincolnshire 005D","E01013202",1085,26,8,18,125,98,82,119,242,205,97,49,48,91
"2011","North East Lincolnshire 005E","E01013203",1208,21,8,13,115,76,76,97,323,264,153,96,57,83
"2011","North East Lincolnshire 006A","E01013138",980,7,4,3,57,45,48,89,229,223,220,134,86,62
"2011","North East Lincolnshire 006B","E01013140",1134,13,7,6,106,66,58,98,310,235,149,90,59,99
"2011","North East Lincolnshire 006C","E01013141",1157,15,9,6,108,83,57,120,307,253,119,72,47,95
"2011","North East Lincolnshire 006D","E01013143",982,21,11,10,116,95,63,115,234,203,72,34,38,63
"2011","North East Lincolnshire 007A","E01013173",921,67,27,40,187,138,84,97,139,140,31,22,9,38
"2011","North East Lincolnshire 007B","E01013223",2125,238,68,170,565,309,151,230,252,191,51,29,22,138
"2011","North East Lincolnshire 007C","E01013224",1343,118,40,78,290,173,114,142,207,181,41,27,14,77
"2011","North East Lincolnshire 007D","E01013226",1127,92,28,64,283,150,118,124,140,117,41,25,16,62
"2011","North East Lincolnshire 008A","E01013187",1028,62,10,52,162,112,67,109,186,151,84,44,40,95
"2011","North East Lincolnshire 008B","E01013188",1216,68,21,47,219,156,109,123,231,185,33,21,12,92
"2011","North East Lincolnshire 008C","E01013231",1209,28,8,20,169,135,63,143,295,227,64,28,36,85
"2011","North East Lincolnshire 008D","E01013233",1101,33,11,22,170,110,80,122,258,188,68,32,36,72
"2011","North East Lincolnshire 009A","E01013147",1004,16,6,10,87,63,43,106,278,268,67,36,31,76
"2011","North East Lincolnshire 009D","E01013234",981,47,15,32,167,127,75,131,218,124,35,19,16,57
"2011","North East Lincolnshire 009E","E01033414",1740,82,27,55,270,210,97,214,390,303,83,49,34,91
"2011","North East Lincolnshire 010A","E01013128",1096,34,12,22,136,117,94,130,229,174,108,74,34,74
"2011","North East Lincolnshire 010B","E01013198",1082,45,19,26,159,117,86,110,273,171,52,37,15,69
"2011","North East Lincolnshire 010C","E01013199",915,31,11,20,124,72,76,102,222,152,96,61,35,40
"2011","North East Lincolnshire 010D","E01013200",949,43,13,30,153,129,89,108,195,141,22,16,6,69
"2011","North East Lincolnshire 011A","E01013159",1081,16,6,10,100,76,48,87,295,242,140,72,68,77
"2011","North East Lincolnshire 011B","E01013161",998,21,6,15,119,84,66,86,257,177,106,48,58,82
"2011","North East Lincolnshire 011C","E01013162",1166,51,24,27,149,101,78,111,252,206,115,70,45,103
"2011","North East Lincolnshire 011D","E01013165",1000,19,5,14,66,62,71,102,254,212,154,83,71,60
"2011","North East Lincolnshire 012A","E01013158",1043,30,11,19,131,105,94,112,244,202,49,26,23,76
"2011","North East Lincolnshire 012B","E01013160",1146,49,11,38,195,158,109,127,235,184,36,21,15,53
"2011","North East Lincolnshire 012C","E01013163",986,63,27,36,203,133,96,116,181,122,28,15,13,44
"2011","North East Lincolnshire 012D","E01013164",1318,63,18,45,214,145,91,143,276,169,106,82,24,111
"2011","North East Lincolnshire 012E","E01013197",958,36,8,28,151,107,81,104,223,139,50,30,20,67
"2011","North East Lincolnshire 013A","E01013149",914,62,18,44,166,133,56,120,166,138,18,11,7,55
"2011","North East Lincolnshire 013B","E01013150",1053,55,20,35,169,140,72,141,222,161,23,15,8,70
"2011","North East Lincolnshire 013C","E01013227",1188,49,20,29,144,131,73,131,305,222,57,33,24,76
"2011","North East Lincolnshire 013D","E01013228",1234,68,19,49,274,154,84,146,213,173,41,15,26,81
"2011","North East Lincolnshire 013E","E01013229",1047,26,9,17,94,78,51,132,242,213,111,70,41,100
"2011","North East Lincolnshire 014A","E01013131",1119,50,12,38,191,110,72,109,262,193,83,47,36,49
"2011","North East Lincolnshire 014B","E01013132",1066,43,13,30,198,126,98,122,191,164,56,39,17,68
"2011","North East Lincolnshire 014C","E01013133",1171,61,16,45,241,139,93,118,236,156,64,32,32,63
"2011","North East Lincolnshire 014D","E01013134",997,36,9,27,141,119,71,108,248,154,66,39,27,54
"2011","North East Lincolnshire 015A","E01013206",971,20,8,12,113,74,48,91,220,224,110,71,39,71
"2011","North East Lincolnshire 015B","E01013207",999,23,5,18,148,101,70,103,224,200,67,35,32,63
"2011","North East Lincolnshire 015C","E01013211",1074,38,10,28,165,149,82,114,222,190,49,24,25,65
"2011","North East Lincolnshire 015D","E01013212",912,11,0,11,66,50,34,81,196,226,186,118,68,62
"2011","North East Lincolnshire 016A","E01013181",1093,41,9,32,162,83,78,104,221,192,115,59,56,97
"2011","North East Lincolnshire 016B","E01013182",1090,107,22,85,276,139,100,90,133,90,35,28,7,120
"2011","North East Lincolnshire 016C","E01013183",1126,85,31,54,251,123,91,123,195,142,27,11,16,89
"2011","North East Lincolnshire 016D","E01013184",1159,99,26,73,237,120,111,117,183,110,70,46,24,112
"2011","North East Lincolnshire 016E","E01013185",1187,122,16,106,226,137,88,117,160,127,56,40,16,154
"2011","North East Lincolnshire 016F","E01013186",971,128,38,90,266,146,82,83,111,65,17,8,9,73
"2011","North East Lincolnshire 017A","E01013129",1161,61,14,47,208,82,110,119,238,173,96,66,30,74
"2011","North East Lincolnshire 017B","E01013151",936,70,25,45,234,147,85,98,129,100,18,10,8,55
"2011","North East Lincolnshire 017C","E01013152",1030,107,37,70,255,145,126,107,130,74,21,15,6,65
"2011","North East Lincolnshire 017D","E01013155",1008,74,22,52,262,145,101,109,164,91,17,8,9,45
"2011","North East Lincolnshire 018A","E01013130",978,35,11,24,124,90,77,97,228,176,69,39,30,82
"2011","North East Lincolnshire 018B","E01013135",1010,32,11,21,147,111,70,103,251,207,50,24,26,39
"2011","North East Lincolnshire 018C","E01013154",1037,66,22,44,176,143,80,138,232,137,10,6,4,55
"2011","North East Lincolnshire 018D","E01013156",846,47,14,33,161,102,68,74,187,130,41,26,15,36
"2011","North East Lincolnshire 019A","E01013204",998,24,3,21,136,89,76,99,214,197,93,70,23,70
"2011","North East Lincolnshire 019B","E01013205",893,14,1,13,63,48,39,77,211,197,173,119,54,71
"2011","North East Lincolnshire 019C","E01013208",911,9,2,7,39,43,39,66,243,217,161,118,43,94
"2011","North East Lincolnshire 019D","E01013209",1010,18,5,13,57,67,56,94,250,234,166,105,61,68
"2011","North East Lincolnshire 019E","E01013210",919,3,1,2,81,40,43,75,227,208,165,107,58,77
"2011","North East Lincolnshire 020A","E01013153",993,72,22,50,217,130,119,111,169,126,20,16,4,29
"2011","North East Lincolnshire 020B","E01013157",1337,145,49,96,335,197,106,157,198,96,15,11,4,88
"2011","North East Lincolnshire 020C","E01013166",1156,77,27,50,220,169,116,133,206,137,44,28,16,54
"2011","North East Lincolnshire 020D","E01013167",1346,102,34,68,275,179,133,144,236,176,36,23,13,65
"2011","North East Lincolnshire 020E","E01013169",751,38,12,26,145,80,81,88,135,116,22,16,6,46
"2011","North East Lincolnshire 021A","E01013189",1058,58,12,46,194,170,65,121,207,151,30,23,7,62
"2011","North East Lincolnshire 021B","E01013190",2052,175,43,132,497,309,177,176,280,204,61,45,16,173
"2011","North East Lincolnshire 021C","E01013191",1122,98,27,71,272,183,89,117,158,106,24,17,7,75
"2011","North East Lincolnshire 021D","E01013192",1003,38,9,29,181,97,77,98,228,150,68,34,34,66
"2011","North East Lincolnshire 021E","E01013194",1025,65,16,49,224,134,77,110,185,139,38,28,10,53
"2011","North East Lincolnshire 022A","E01013168",1196,119,38,81,293,146,135,110,174,130,26,21,5,63
"2011","North East Lincolnshire 022B","E01013170",1070,70,25,45,246,135,106,137,175,122,19,10,9,60
"2011","North East Lincolnshire 022C","E01013171",1275,132,32,100,320,172,108,140,158,96,37,26,11,112
"2011","North East Lincolnshire 022D","E01013172",1093,82,31,51,251,167,109,110,167,124,30,16,14,53
"2011","North East Lincolnshire 022E","E01013193",1163,75,34,41,278,189,123,118,180,125,26,16,10,49
"2011","North East Lincolnshire 023A","E01013213",779,52,9,43,152,73,67,92,143,110,41,26,15,49
"2011","North East Lincolnshire 023B","E01013214",1076,110,29,81,259,179,114,96,143,88,23,16,7,64
"2011","North East Lincolnshire 023C","E01013215",1115,124,31,93,289,184,122,97,131,78,19,13,6,71
"2011","North East Lincolnshire 023D","E01013216",986,85,25,60,246,188,78,104,126,72,11,6,5,76
"2011","North East Lincolnshire 023E","E01013217",1068,84,19,65,257,144,94,121,154,120,27,19,8,67
"2011","North East Lincolnshire 023F","E01013225",810,115,26,89,205,117,108,43,83,53,43,39,4,43
"2011","North Lincolnshire 001A","E01013254",1262,56,18,38,217,119,97,138,248,231,93,53,40,63
"2011","North Lincolnshire 001B","E01013255",1249,101,27,74,228,160,114,140,196,197,61,28,33,52
"2011","North Lincolnshire 001C","E01013256",1838,165,53,112,423,232,139,201,283,209,81,52,29,105
"2011","North Lincolnshire 001D","E01013257",1332,132,29,103,320,178,102,154,202,149,33,20,13,62
"2011","North Lincolnshire 001E","E01013258",1164,65,22,43,173,98,65,125,278,219,74,49,25,67
"2011","North Lincolnshire 001F","E01013259",1178,64,24,40,185,147,87,109,228,182,102,60,42,74
"2011","North Lincolnshire 002A","E01013303",992,56,19,37,162,96,115,96,158,180,61,45,16,68
"2011","North Lincolnshire 002B","E01013304",1213,113,34,79,294,144,137,113,152,152,40,24,16,68
"2011","North Lincolnshire 002C","E01013305",1264,141,45,96,283,170,145,108,149,120,81,64,17,67
"2011","North Lincolnshire 002D","E01013307",1298,115,40,75,292,151,118,130,186,155,80,54,26,71
"2011","North Lincolnshire 003A","E01013288",1170,95,26,69,255,156,84,130,184,160,32,23,9,74
"2011","North Lincolnshire 003B","E01013291",1066,33,14,19,139,97,75,117,231,210,95,62,33,69
"2011","North Lincolnshire 003C","E01013292",1306,98,35,63,300,154,113,154,205,169,47,32,15,66
"2011","North Lincolnshire 003D","E01013294",1171,120,37,83,297,125,124,112,150,139,28,9,19,76
"2011","North Lincolnshire 004A","E01013270",1428,112,44,68,260,153,155,181,232,209,59,35,24,67
"2011","North Lincolnshire 004B","E01013306",1135,83,30,53,214,131,148,124,154,167,58,33,25,56
"2011","North Lincolnshire 004C","E01013308",1332,56,23,33,197,148,145,181,229,241,63,34,29,72
"2011","North Lincolnshire 004D","E01013309",1222,99,30,69,245,143,158,133,168,182,34,27,7,60
"2011","North Lincolnshire 005A","E01013286",1723,60,21,39,211,161,86,209,422,415,97,67,30,62
"2011","North Lincolnshire 005B","E01013287",1147,69,24,45,191,125,117,156,200,205,46,24,22,38
"2011","North Lincolnshire 005C","E01013289",1236,103,32,71,237,161,91,120,204,209,41,23,18,70
"2011","North Lincolnshire 005D","E01013290",1259,130,48,82,307,160,119,119,168,149,48,37,11,59
"2011","North Lincolnshire 005E","E01013293",1108,113,30,83,290,146,93,111,146,127,24,14,10,58
"2011","North Lincolnshire 006A","E01013245",1053,35,10,25,142,109,87,120,212,215,79,50,29,54
"2011","North Lincolnshire 006B","E01013246",1176,79,31,48,261,122,153,106,175,160,48,26,22,72
"2011","North Lincolnshire 006C","E01013247",1328,112,39,73,315,149,147,140,175,166,43,26,17,81
"2011","North Lincolnshire 006D","E01013248",1329,104,34,70,275,179,155,144,201,160,36,18,18,75
"2011","North Lincolnshire 006E","E01013249",1270,72,22,50,218,144,125,123,212,222,73,49,24,81
"2011","North Lincolnshire 007A","E01013297",1624,80,28,52,216,175,100,188,350,312,94,70,24,109
"2011","North Lincolnshire 007B","E01013300",1239,52,8,44,101,63,74,108,253,296,190,123,67,102
"2011","North Lincolnshire 007C","E01013302",1093,99,36,63,174,112,86,104,179,190,69,51,18,80
"2011","North Lincolnshire 007D","E01013331",1269,40,7,33,139,83,56,132,309,312,126,90,36,72
"2011","North Lincolnshire 008A","E01013296",1190,24,8,16,108,58,72,112,305,291,141,101,40,79
"2011","North Lincolnshire 008B","E01013298",1048,16,9,7,92,64,57,89,233,253,167,115,52,77
"2011","North Lincolnshire 008C","E01013299",1094,20,6,14,76,68,53,104,262,291,133,83,50,87
"2011","North Lincolnshire 008D","E01013330",1263,39,7,32,135,74,51,123,293,332,140,105,35,76
"2011","North Lincolnshire 008E","E01013332",1315,52,9,43,140,82,80,108,280,273,179,133,46,121
"2011","North Lincolnshire 009A","E01013295",1052,69,30,39,173,122,57,159,203,203,30,18,12,36
"2011","North Lincolnshire 009B","E01013301",1176,77,21,56,192,136,54,145,248,198,48,33,15,78
"2011","North Lincolnshire 009C","E01013333",1174,138,14,124,193,134,88,101,199,176,67,48,19,78
"2011","North Lincolnshire 009D","E01013334",1127,87,19,68,214,146,63,116,209,167,50,37,13,75
"2011","North Lincolnshire 010A","E01013310",1078,26,5,21,99,108,68,125,255,264,59,34,25,74
"2011","North Lincolnshire 010B","E01013312",1330,27,6,21,123,95,59,167,304,317,131,72,59,107
"2011","North Lincolnshire 010C","E01013313",1163,36,10,26,145,118,56,143,282,265,43,21,22,75
"2011","North Lincolnshire 010D","E01013314",1124,43,16,27,164,119,65,160,214,233,49,24,25,77
"2011","North Lincolnshire 011A","E01013267",919,123,41,82,233,116,93,64,113,87,42,26,16,48
"2011","North Lincolnshire 011B","E01013268",944,85,21,64,198,108,111,94,129,128,41,32,9,50
"2011","North Lincolnshire 011C","E01013269",1324,130,45,85,308,153,144,128,183,150,48,30,18,80
"2011","North Lincolnshire 011D","E01013271",1386,82,25,57,192,123,78,164,276,257,117,82,35,97
"2011","North Lincolnshire 011E","E01013272",1225,92,27,65,208,104,94,119,227,218,89,55,34,74
"2011","North Lincolnshire 011F","E01013273",1257,140,43,97,302,183,96,111,184,145,38,16,22,58
"2011","North Lincolnshire 012A","E01013279",1040,23,6,17,96,63,40,105,256,240,149,94,55,68
"2011","North Lincolnshire 012B","E01013285",993,54,18,36,181,118,70,122,190,175,34,26,8,49
"2011","North Lincolnshire 012C","E01013316",1038,117,31,86,284,123,94,91,131,98,27,20,7,73
"2011","North Lincolnshire 012D","E01013321",1253,111,29,82,296,183,74,127,171,147,58,43,15,86
"2011","North Lincolnshire 013A","E01013274",1564,134,33,101,354,175,165,150,216,200,86,72,14,84
"2011","North Lincolnshire 013B","E01013275",1161,94,34,60,250,135,96,146,194,159,23,13,10,64
"2011","North Lincolnshire 013C","E01013276",1147,67,24,43,185,140,105,130,252,185,41,24,17,42
"2011","North Lincolnshire 013D","E01013277",1117,76,32,44,202,160,91,123,194,176,23,9,14,72
"2011","North Lincolnshire 014A","E01013315",1008,32,8,24,121,97,46,115,255,222,73,51,22,47
"2011","North Lincolnshire 014B","E01013317",1001,60,22,38,154,114,66,124,193,159,40,30,10,91
"2011","North Lincolnshire 014C","E01013318",1093,59,25,34,153,127,55,140,225,207,38,23,15,89
"2011","North Lincolnshire 014D","E01013319",1548,47,14,33,179,149,78,158,358,356,117,62,55,106
"2011","North Lincolnshire 015A","E01013238",1233,33,9,24,133,111,87,134,277,284,97,60,37,77
"2011","North Lincolnshire 015B","E01013240",1711,66,27,39,239,132,88,205,359,357,155,104,51,110
"2011","North Lincolnshire 015C","E01013311",1221,29,11,18,81,94,34,120,266,330,193,144,49,74
"2011","North Lincolnshire 015D","E01013320",1087,35,10,25,129,104,68,132,250,227,59,36,23,83
"2011","North Lincolnshire 016A","E01013278",1052,20,5,15,76,70,39,106,257,254,165,105,60,65
"2011","North Lincolnshire 016B","E01013280",1115,63,15,48,150,130,62,130,242,212,72,52,20,54
"2011","North Lincolnshire 016C","E01013281",929,20,7,13,89,65,40,101,218,224,92,62,30,80
"2011","North Lincolnshire 016D","E01013283",1011,43,16,27,82,89,49,104,224,216,128,88,40,76
"2011","North Lincolnshire 017A","E01013236",1096,52,20,32,159,134,66,148,231,199,37,23,14,70
"2011","North Lincolnshire 017B","E01013239",1175,43,14,29,168,126,68,137,249,220,81,57,24,83
"2011","North Lincolnshire 017C","E01013282",1121,29,10,19,126,112,55,114,234,282,81,59,22,88
"2011","North Lincolnshire 017D","E01013284",1150,20,10,10,119,101,39,108,265,294,103,66,37,101
"2011","North Lincolnshire 018B","E01013237",1160,33,11,22,94,90,37,118,262,283,141,81,60,102
"2011","North Lincolnshire 018C","E01013261",1081,84,31,53,242,164,73,119,200,131,20,5,15,48
"2011","North Lincolnshire 018D","E01013262",1004,81,28,53,205,143,70,119,166,156,22,13,9,42
"2011","North Lincolnshire 018E","E01013263",1085,90,33,57,201,165,57,143,190,156,28,11,17,55
"2011","North Lincolnshire 018F","E01033296",1049,73,27,46,195,117,56,137,194,191,33,25,8,53
"2011","North Lincolnshire 018G","E01033297",1205,122,39,83,296,197,82,110,160,134,32,17,15,72
"2011","North Lincolnshire 019A","E01013260",1092,79,32,47,207,150,80,144,187,150,40,23,17,55
"2011","North Lincolnshire 019B","E01013264",1303,78,26,52,236,198,80,158,232,210,28,17,11,83
"2011","North Lincolnshire 019C","E01013265",1240,130,48,82,265,174,90,134,197,169,21,12,9,60
"2011","North Lincolnshire 019D","E01013266",1440,162,45,117,339,210,97,157,212,147,43,26,17,73
"2011","North Lincolnshire 020A","E01013241",1089,115,37,78,265,151,148,82,130,126,25,17,8,47
"2011","North Lincolnshire 020B","E01013242",1348,151,50,101,355,184,177,102,148,106,32,21,11,93
"2011","North Lincolnshire 020C","E01013243",1609,190,60,130,452,218,231,93,160,118,49,34,15,98
"2011","North Lincolnshire 020D","E01013244",1283,133,29,104,274,138,139,93,193,188,57,38,19,68
"2011","North Lincolnshire 021A","E01013324",1192,115,32,83,286,154,140,129,147,122,27,17,10,72
"2011","North Lincolnshire 021B","E01013326",1169,135,47,88,278,158,108,110,154,139,24,18,6,63
"2011","North Lincolnshire 021C","E01013327",1022,96,36,60,228,161,93,105,150,126,30,22,8,33
"2011","North Lincolnshire 021D","E01013328",948,109,46,63,241,134,64,100,121,100,19,9,10,60
"2011","North Lincolnshire 022A","E01013322",1444,133,52,81,356,188,144,112,162,189,69,53,16,91
"2011","North Lincolnshire 022B","E01013323",1302,134,64,70,300,182,104,121,185,171,44,30,14,61
"2011","North Lincolnshire 022C","E01013325",1158,120,48,72,249,141,160,120,159,114,33,18,15,62
"2011","North Lincolnshire 022D","E01013329",1334,97,28,69,256,145,123,141,221,207,64,45,19,80
"2011","North Lincolnshire 023A","E01013250",1194,128,38,90,250,120,187,80,168,142,47,28,19,72
"2011","North Lincolnshire 023B","E01013251",1402,157,51,106,348,194,216,114,135,121,41,27,14,76
"2011","North Lincolnshire 023C","E01013252",1236,151,48,103,305,179,172,73,159,94,35,21,14,68
"2011","North Lincolnshire 023D","E01013253",1413,119,47,72,317,149,211,109,206,180,56,37,19,66
"2011","York 001A","E01013436",1242,219,91,128,369,181,108,64,149,56,20,12,8,76
"2011","York 001B","E01013438",1277,141,44,97,289,174,126,103,189,126,46,36,10,83
"2011","York 001C","E01013439",1041,189,63,126,328,124,79,49,126,53,23,17,6,70
"2011","York 001D","E01013440",1397,170,40,130,338,238,132,115,203,91,16,9,7,94
"2011","York 002A","E01013370",1054,98,23,75,246,169,85,99,191,96,24,19,5,46
"2011","York 002B","E01013373",1028,133,33,100,247,141,71,76,170,119,23,17,6,48
"2011","York 002C","E01013375",969,111,34,77,250,164,77,64,175,78,11,6,5,39
"2011","York 002D","E01013376",1099,137,32,105,264,213,102,82,160,79,16,11,5,46
"2011","York 003A","E01013371",1122,138,48,90,319,196,95,67,163,65,10,7,3,69
"2011","York 003B","E01013372",1065,128,37,91,265,173,102,77,165,95,16,7,9,44
"2011","York 003C","E01013374",1122,156,36,120,288,177,99,79,162,84,11,5,6,66
"2011","York 003D","E01013377",1226,147,46,101,309,182,117,89,191,114,18,11,7,59
"2011","York 004A","E01013404",1089,91,28,63,198,138,114,75,188,135,60,43,17,90
"2011","York 004B","E01013407",963,125,28,97,223,156,113,59,151,67,22,15,7,47
"2011","York 004C","E01013408",947,97,25,72,187,153,83,87,179,95,17,14,3,49
"2011","York 004D","E01013410",999,50,12,38,153,108,87,79,234,162,48,31,17,78
"2011","York 005A","E01013405",1063,84,18,66,198,163,78,100,219,155,16,11,5,50
"2011","York 005B","E01013406",1513,116,22,94,338,224,99,126,265,194,45,33,12,106
"2011","York 005C","E01013409",1109,93,17,76,221,163,103,112,205,130,25,17,8,57
"2011","York 005D","E01013411",1061,71,17,54,205,148,91,111,225,135,13,9,4,62
"2011","York 006A","E01013428",1242,139,27,112,265,191,117,85,205,135,35,19,16,70
"2011","York 006B","E01013429",1507,201,52,149,426,213,122,99,212,118,32,16,16,84
"2011","York 006C","E01013430",1176,170,46,124,282,140,146,90,154,104,30,14,16,60
"2011","York 006D","E01013431",1152,160,34,126,314,178,95,87,151,91,19,16,3,57
"2011","York 006E","E01013435",1082,106,18,88,234,158,82,104,188,129,20,12,8,61
"2011","York 007A","E01013344",1259,231,47,184,375,104,136,43,109,64,22,5,17,175
"2011","York 007B","E01013346",1213,261,44,217,348,125,109,54,120,78,39,27,12,79
"2011","York 007C","E01013432",1449,187,44,143,388,219,117,103,218,119,30,16,14,68
"2011","York 007D","E01013433",1071,103,18,85,256,146,95,94,200,103,20,18,2,54
"2011","York 007E","E01013434",1044,162,42,120,257,145,84,67,167,81,24,15,9,57
"2011","York 008A","E01013379",1031,156,34,122,310,134,89,50,109,66,17,11,6,100
"2011","York 008B","E01013380",1422,166,28,138,281,109,97,71,146,82,29,13,16,441
"2011","York 008C","E01013385",1062,94,13,81,229,139,69,75,194,147,45,33,12,70
"2011","York 008D","E01013387",1019,185,38,147,275,164,104,56,98,62,20,7,13,55
"2011","York 008E","E01013388",774,69,18,51,169,113,87,54,150,80,8,4,4,44
"2011","York 008F","E01013389",866,90,21,69,191,135,66,68,154,92,13,8,5,57
"2011","York 008G","E01013437",937,98,14,84,219,119,146,54,124,97,23,18,5,57
"2011","York 009A","E01013343",1674,182,18,164,280,175,73,102,212,150,51,33,18,449
"2011","York 009B","E01013345",1382,151,23,128,292,153,79,106,206,150,31,15,16,214
"2011","York 009C","E01013347",1182,40,4,36,126,125,63,120,237,235,99,62,37,137
"2011","York 009D","E01013349",948,25,4,21,109,97,46,78,204,225,94,61,33,70
"2011","York 009E","E01013350",1221,65,10,55,179,106,84,98,220,242,72,47,25,155
"2011","York 010A","E01013348",1659,125,24,101,248,147,69,75,187,110,35,20,15,663
"2011","York 010B","E01013368",1942,211,21,190,364,156,102,98,191,138,42,24,18,640
"2011","York 010C","E01013382",1227,125,13,112,206,123,68,89,235,181,57,30,27,143
"2011","York 010D","E01013383",1889,145,17,128,297,170,123,167,281,203,81,40,41,422
"2011","York 010E","E01013386",1297,91,19,72,214,117,77,95,262,223,80,50,30,138
"2011","York 011A","E01013421",1196,183,44,139,262,122,134,55,99,82,45,29,16,214
"2011","York 011B","E01013422",1190,213,53,160,337,182,112,71,109,69,24,14,10,73
"2011","York 011C","E01013426",1142,222,47,175,305,138,143,47,136,77,18,10,8,56
"2011","York 011D","E01013427",945,207,52,155,259,145,91,39,90,39,14,9,5,61
"2011","York 012A","E01013335",1133,55,15,40,116,129,99,108,262,209,68,49,19,87
"2011","York 012B","E01013336",1088,91,25,66,213,138,105,111,209,135,30,18,12,56
"2011","York 012C","E01013337",1207,165,40,125,333,173,101,78,175,99,22,13,9,61
"2011","York 012D","E01013338",1613,157,29,128,384,214,152,149,262,168,40,26,14,87
"2011","York 012E","E01013339",1118,105,29,76,265,168,116,95,162,102,28,19,9,77
"2011","York 012F","E01013392",1161,111,20,91,288,163,88,94,185,140,26,9,17,66
"2011","York 013A","E01013366",1720,172,21,151,355,116,142,107,177,176,65,32,33,410
"2011","York 013C","E01013369",1511,244,31,213,337,142,88,82,160,115,61,33,28,282
"2011","York 013E","E01013416",1232,163,28,135,260,94,74,74,162,179,63,38,25,163
"2011","York 013F","E01033067",1120,123,9,114,186,113,52,79,166,140,75,47,28,186
"2011","York 013G","E01033068",1027,233,44,189,250,106,71,53,79,61,33,21,12,141
"2011","York 013H","E01033069",961,211,33,178,272,110,60,49,73,56,23,15,8,107
"2011","York 013I","E01033070",1425,159,22,137,242,98,61,62,95,70,40,25,15,598
"2011","York 014A","E01013381",1136,81,15,66,232,140,112,94,167,108,16,9,7,186
"2011","York 014B","E01013402",1411,142,16,126,188,143,76,79,146,73,19,9,10,545
"2011","York 014C","E01013419",1061,111,22,89,176,163,113,76,144,104,28,16,12,146
"2011","York 014D","E01013420",1485,152,30,122,286,196,141,102,199,128,26,21,5,255
"2011","York 015A","E01013384",1372,41,6,35,147,105,81,116,211,206,48,23,25,417
"2011","York 015B","E01013398",1285,53,14,39,140,81,51,91,163,149,52,31,21,505
"2011","York 015C","E01013399",1247,42,5,37,137,65,82,83,221,243,96,61,35,278
"2011","York 015D","E01013400",1750,173,15,158,242,128,51,75,158,94,46,26,20,783
"2011","York 015E","E01013401",1408,70,12,58,160,83,95,89,152,134,44,36,8,581
"2011","York 015F","E01013403",1621,84,3,81,150,94,79,69,123,120,26,15,11,876
"2011","York 016A","E01013393",1218,123,22,101,294,166,80,95,211,144,33,18,15,72
"2011","York 016B","E01013394",952,83,21,62,159,103,73,75,212,155,49,20,29,43
"2011","York 016C","E01013395",1095,172,27,145,324,136,74,67,169,77,15,7,8,61
"2011","York 016D","E01013396",1141,140,25,115,233,169,105,110,178,117,37,21,16,52
"2011","York 016E","E01013441",1178,101,17,84,257,174,100,107,219,134,42,24,18,44
"2011","York 016F","E01013445",1078,76,18,58,177,119,96,82,256,175,49,29,20,48
"2011","York 017A","E01013390",1318,123,6,117,330,179,94,135,210,150,38,20,18,59
"2011","York 017B","E01013391",1792,298,51,247,476,238,100,116,224,161,39,20,19,140
"2011","York 017C","E01013397",1124,139,27,112,259,144,99,94,183,121,18,11,7,67
"2011","York 017D","E01013413",1282,267,45,222,327,139,110,76,131,73,27,13,14,132
"2011","York 017E","E01013417",1514,356,73,283,386,153,126,74,114,90,55,32,23,160
"2011","York 018A","E01013442",974,76,16,60,208,111,90,85,184,138,38,17,21,44
"2011","York 018B","E01013443",1053,45,11,34,150,121,65,77,234,212,78,42,36,71
"2011","York 018C","E01013444",973,40,8,32,104,106,72,98,244,177,52,26,26,80
"2011","York 018D","E01013446",1207,83,22,61,221,157,93,102,228,195,49,25,24,79
"2011","York 018E","E01013447",1072,50,10,40,143,97,91,104,274,175,71,42,29,67
"2011","York 018F","E01013448",998,45,8,37,154,116,48,88,235,198,59,36,23,55
"2011","York 019A","E01013360",1314,132,19,113,283,150,85,85,165,91,45,32,13,278
"2011","York 019B","E01013361",1575,265,30,235,342,144,90,64,132,102,22,11,11,414
"2011","York 019C","E01013362",1526,208,42,166,374,235,79,122,147,120,27,17,10,214
"2011","York 019D","E01013363",1781,198,17,181,240,140,80,94,147,140,57,36,21,685
"2011","York 019E","E01013364",1773,168,20,148,244,102,89,72,152,112,47,20,27,787
"2011","York 019F","E01013418",1276,226,28,198,285,140,99,64,163,107,46,21,25,146
"2011","York 020A","E01013351",1326,219,50,169,373,200,137,74,154,84,15,11,4,70
"2011","York 020B","E01013352",1166,179,35,144,302,199,125,64,143,75,18,9,9,61
"2011","York 020C","E01013451",892,158,46,112,260,119,105,47,88,60,11,3,8,44
"2011","York 020D","E01013452",1109,218,57,161,333,139,108,57,118,48,11,5,6,77
"2011","York 021A","E01013357",1352,316,58,258,436,154,107,66,115,47,17,9,8,94
"2011","York 021B","E01013358",1174,221,48,173,368,167,97,57,119,58,22,15,7,65
"2011","York 021C","E01013412",1453,231,44,187,402,181,89,89,177,105,26,13,13,153
"2011","York 021D","E01013414",1317,222,31,191,343,138,100,77,147,102,27,16,11,161
"2011","York 022A","E01013353",1131,88,23,65,201,137,94,89,217,162,54,27,27,89
"2011","York 022B","E01013354",1146,156,33,123,337,203,88,77,160,61,9,5,4,55
"2011","York 022C","E01013355",1123,161,40,121,291,180,98,85,152,79,22,19,3,55
"2011","York 022D","E01013356",1095,99,22,77,207,177,98,94,197,141,21,15,6,61
"2011","York 022E","E01013359",1082,53,6,47,187,111,100,119,234,156,49,20,29,73
"2011","York 022F","E01013449",1245,108,20,88,258,209,85,115,204,142,42,25,17,82
"2011","York 023A","E01013365",1975,308,54,254,426,252,174,129,243,142,45,30,15,256
"2011","York 023B","E01013378",4515,175,23,152,149,74,72,30,62,46,39,32,7,3868
"2011","York 023C","E01013450",894,149,43,106,261,104,151,41,75,42,21,17,4,50
"2011","York 024A","E01013340",898,215,32,183,272,100,77,55,78,35,9,6,3,57
"2011","York 024B","E01013341",865,116,21,95,201,131,83,58,134,85,20,15,5,37
"2011","York 024C","E01013342",1071,144,30,114,280,156,127,63,151,83,13,10,3,54
"2011","York 024D","E01013423",937,178,45,133,307,137,80,52,86,45,8,5,3,44
"2011","York 024E","E01013424",1017,203,53,150,319,132,80,56,95,36,19,11,8,77
"2011","York 024F","E01013425",1114,166,37,129,313,145,138,67,135,75,9,6,3,66
"2011","Craven 001A","E01027558",1434,183,28,155,376,146,271,85,183,93,22,13,9,75
"2011","Craven 001B","E01027559",1257,100,28,72,241,136,185,98,234,175,33,24,9,55
"2011","Craven 001C","E01027569",1001,129,30,99,265,86,263,48,96,51,12,7,5,51
"2011","Craven 001D","E01027570",1837,128,30,98,380,188,392,151,256,197,41,24,17,104
"2011","Craven 002A","E01027562",1223,174,42,132,331,123,279,72,104,48,18,13,5,74
"2011","Craven 002B","E01027567",1111,136,37,99,295,109,232,71,135,72,18,11,7,43
"2011","Craven 002C","E01027585",1348,171,39,132,366,155,320,68,147,59,21,13,8,41
"2011","Craven 003A","E01027568",1606,154,42,112,413,191,247,134,229,135,31,17,14,72
"2011","Craven 003B","E01027571",1370,130,30,100,354,128,249,96,148,99,22,16,6,144
"2011","Craven 003C","E01027572",1509,120,21,99,361,145,220,153,222,167,41,26,15,80
"2011","Craven 003D","E01027573",1089,94,29,65,262,120,250,69,134,85,23,17,6,52
"2011","Craven 004A","E01027557",1213,190,48,142,306,108,304,79,94,42,19,14,5,71
"2011","Craven 004B","E01027561",1345,189,42,147,412,168,192,72,127,92,17,7,10,76
"2011","Craven 004C","E01027576",1104,253,43,210,345,128,101,51,88,45,16,11,5,77
"2011","Craven 005A","E01027574",1051,126,33,93,267,165,114,79,147,92,11,6,5,50
"2011","Craven 005B","E01027575",1379,119,30,89,296,180,153,135,225,169,23,15,8,79
"2011","Craven 005C","E01027577",1421,212,52,160,359,155,175,85,190,120,35,19,16,90
"2011","Craven 005D","E01027579",777,38,13,25,132,84,69,61,134,166,47,18,29,46
"2011","Craven 006A","E01027578",1135,100,18,82,245,144,106,93,219,154,28,15,13,46
"2011","Craven 006B","E01027580",782,40,5,35,107,79,63,67,158,163,52,29,23,53
"2011","Craven 006C","E01027581",1772,130,24,106,355,160,167,156,301,257,108,72,36,138
"2011","Craven 006D","E01027582",1104,96,22,74,245,140,98,91,182,155,25,11,14,72
"2011","Craven 007A","E01027556",1229,205,40,165,370,136,205,45,104,81,16,11,5,67
"2011","Craven 007B","E01027560",1722,194,60,134,468,227,233,131,194,162,34,14,20,79
"2011","Craven 007C","E01027563",990,105,30,75,277,109,152,67,138,76,22,12,10,44
"2011","Craven 007D","E01027586",1397,202,62,140,402,153,240,77,143,89,24,6,18,67
"2011","Craven 008A","E01027555",1388,239,78,161,383,205,183,74,126,78,21,11,10,79
"2011","Craven 008B","E01027564",811,61,20,41,163,81,84,83,153,106,35,18,17,45
"2011","Craven 008C","E01027565",1117,125,43,82,248,193,139,74,126,123,18,8,10,71
"2011","Craven 008D","E01027566",934,99,36,63,219,142,119,60,118,96,16,10,6,65
"2011","Craven 008E","E01027583",1433,146,38,108,328,205,156,108,206,149,26,10,16,109
"2011","Craven 008F","E01027584",1167,126,42,84,246,167,155,89,156,142,21,13,8,65
"2011","Hambleton 001A","E01027591",1282,247,84,163,362,148,200,64,104,72,18,15,3,67
"2011","Hambleton 001B","E01027597",1154,192,47,145,311,150,149,75,110,79,30,16,14,58
"2011","Hambleton 001C","E01027599",1177,85,21,64,241,91,130,110,190,196,57,37,20,77
"2011","Hambleton 001D","E01027623",877,150,33,117,268,125,64,43,81,65,16,10,6,65
"2011","Hambleton 001E","E01027625",1122,133,27,106,223,82,103,66,184,169,99,77,22,63
"2011","Hambleton 002A","E01027598",1283,188,41,147,383,182,153,84,116,79,26,18,8,72
"2011","Hambleton 002B","E01027618",1788,376,86,290,501,221,251,86,115,90,36,21,15,112
"2011","Hambleton 002C","E01027624",930,176,50,126,277,152,67,51,71,45,14,6,8,77
"2011","Hambleton 002D","E01027626",1007,185,35,150,270,109,126,56,97,71,37,25,12,56
"2011","Hambleton 002E","E01027627",1408,248,70,178,396,139,275,60,103,82,28,19,9,77
"2011","Hambleton 003A","E01027590",1567,151,43,108,346,203,189,131,237,180,51,27,24,79
"2011","Hambleton 003B","E01027592",1383,212,58,154,352,183,285,83,111,71,29,12,17,57
"2011","Hambleton 003C","E01027613",1303,206,49,157,328,140,306,65,112,67,23,16,7,56
"2011","Hambleton 003D","E01027617",857,140,37,103,222,85,151,50,83,53,20,14,6,53
"2011","Hambleton 004A","E01027605",1194,152,47,105,289,186,70,85,170,147,33,27,6,62
"2011","Hambleton 004B","E01027606",1051,126,30,96,293,173,104,61,148,76,19,16,3,51
"2011","Hambleton 004C","E01027608",1428,53,17,36,238,186,113,128,257,278,110,79,31,65
"2011","Hambleton 004D","E01027609",979,49,12,37,159,126,58,97,194,191,55,40,15,50
"2011","Hambleton 004E","E01027610",1245,78,18,60,274,203,87,107,203,184,48,34,14,61
"2011","Hambleton 004F","E01027611",1356,161,38,123,291,196,141,114,189,179,33,23,10,52
"2011","Hambleton 004G","E01027612",1174,51,8,43,179,134,69,106,250,260,73,39,34,52
"2011","Hambleton 004H","E01027616",1012,87,29,58,227,164,77,87,159,131,28,20,8,52
"2011","Hambleton 005A","E01027603",1423,150,40,110,364,160,208,100,194,126,43,25,18,78
"2011","Hambleton 005B","E01027604",1300,180,59,121,331,169,269,72,139,67,21,12,9,52
"2011","Hambleton 005C","E01027607",925,130,40,90,249,184,80,55,118,55,13,5,8,41
"2011","Hambleton 005D","E01027614",894,91,33,58,227,147,87,66,118,95,19,15,4,44
"2011","Hambleton 005E","E01027615",951,132,35,97,243,181,82,60,128,54,13,9,4,58
"2011","Hambleton 006A","E01027587",913,71,18,53,199,125,79,83,158,133,18,11,7,47
"2011","Hambleton 006B","E01027588",1096,99,30,69,274,174,120,111,142,93,21,8,13,62
"2011","Hambleton 006C","E01027589",1249,114,33,81,289,172,143,106,190,137,22,18,4,76
"2011","Hambleton 006D","E01027593",1318,161,42,119,302,148,282,85,144,110,20,12,8,66
"2011","Hambleton 007B","E01027628",1390,166,46,120,356,157,255,98,164,107,28,20,8,59
"2011","Hambleton 007C","E01027633",1388,212,57,155,416,162,237,69,126,90,19,15,4,57
"2011","Hambleton 007D","E01033065",891,119,69,50,215,118,109,53,132,85,19,15,4,41
"2011","Hambleton 007E","E01033066",1712,169,110,59,535,506,129,97,126,74,24,11,13,52
"2011","Hambleton 008A","E01027620",1364,136,31,105,315,171,153,106,230,163,31,21,10,59
"2011","Hambleton 008B","E01027630",1319,104,29,75,273,139,127,126,237,229,26,15,11,58
"2011","Hambleton 008C","E01027631",1015,118,37,81,241,136,89,69,150,134,15,10,5,63
"2011","Hambleton 008D","E01027632",1099,101,33,68,252,132,174,73,152,134,26,17,9,55
"2011","Hambleton 008E","E01027637",1416,240,61,179,333,173,291,78,126,96,20,15,5,59
"2011","Hambleton 009A","E01027621",1623,144,42,102,356,185,210,141,252,222,38,28,10,75
"2011","Hambleton 009B","E01027629",945,31,11,20,148,95,67,121,192,212,44,22,22,35
"2011","Hambleton 009C","E01027635",1949,220,117,103,530,302,254,147,208,166,30,24,6,92
"2011","Hambleton 009D","E01027636",1579,244,68,176,418,157,307,76,162,113,24,21,3,78
"2011","Hambleton 010A","E01027594",1039,63,17,46,180,96,139,92,217,158,45,36,9,49
"2011","Hambleton 010B","E01027595",1158,137,33,104,306,147,178,82,138,83,22,16,6,65
"2011","Hambleton 010C","E01027596",1048,175,38,137,309,118,137,54,132,66,12,7,5,45
"2011","Hambleton 010D","E01027601",1422,213,49,164,326,170,239,82,168,120,25,13,12,79
"2011","Hambleton 010E","E01027622",1399,214,58,156,358,147,269,54,153,95,29,23,6,80
"2011","Hambleton 011A","E01027600",1434,192,65,127,370,150,251,86,180,105,22,15,7,78
"2011","Hambleton 011B","E01027619",1904,322,164,158,523,244,217,144,194,131,30,19,11,99
"2011","Hambleton 011C","E01027634",1515,234,61,173,398,169,242,84,164,99,27,23,4,98
"2011","Harrogate 001A","E01027666",1238,152,41,111,319,126,305,66,118,76,13,11,2,63
"2011","Harrogate 001B","E01027667",1041,190,53,137,223,112,187,45,124,60,28,16,12,72
"2011","Harrogate 001C","E01027685",868,93,22,71,193,92,135,79,130,93,23,13,10,30
"2011","Harrogate 001D","E01027686",882,104,26,78,189,78,216,66,107,62,23,18,5,37
"2011","Harrogate 002A","E01027712",1351,127,42,85,357,359,105,103,120,93,16,10,6,71
"2011","Harrogate 002B","E01027713",1180,145,30,115,297,129,152,94,160,112,39,24,15,52
"2011","Harrogate 002C","E01027714",1141,171,43,128,307,134,128,60,148,111,36,25,11,46
"2011","Harrogate 002D","E01027715",765,74,35,39,221,113,60,63,89,66,15,8,7,64
"2011","Harrogate 003A","E01027643",1067,126,28,98,254,126,210,45,142,93,20,13,7,51
"2011","Harrogate 003B","E01027688",1161,165,50,115,325,148,174,60,130,86,15,6,9,58
"2011","Harrogate 003C","E01027736",1152,165,45,120,287,137,194,72,138,95,21,14,7,43
"2011","Harrogate 003D","E01027737",1329,167,77,90,395,206,164,97,145,84,23,11,12,48
"2011","Harrogate 004A","E01027705",1268,103,28,75,242,165,118,111,214,206,42,26,16,67
"2011","Harrogate 004B","E01027706",1354,101,24,77,252,151,108,141,266,232,51,29,22,52
"2011","Harrogate 004C","E01027707",1293,97,28,69,261,191,132,135,228,165,20,11,9,64
"2011","Harrogate 004D","E01027708",1022,76,21,55,241,169,105,86,161,117,34,20,14,33
"2011","Harrogate 004E","E01027709",883,82,25,57,207,124,115,76,121,98,16,11,5,44
"2011","Harrogate 004F","E01027710",718,34,11,23,130,70,65,61,157,147,20,14,6,34
"2011","Harrogate 004G","E01027711",944,33,13,20,153,104,80,117,177,195,29,17,12,56
"2011","Harrogate 005A","E01027644",1055,120,40,80,254,138,147,62,158,107,19,11,8,50
"2011","Harrogate 005B","E01027645",1155,113,26,87,260,151,137,86,157,147,39,20,19,65
"2011","Harrogate 005C","E01027647",1189,193,60,133,324,144,205,57,104,75,20,14,6,67
"2011","Harrogate 005D","E01027687",1122,138,46,92,263,142,191,65,134,100,15,11,4,74
"2011","Harrogate 006A","E01027681",1207,173,28,145,251,154,271,74,131,85,15,12,3,53
"2011","Harrogate 006B","E01027693",1341,207,49,158,347,171,276,70,121,54,23,13,10,72
"2011","Harrogate 006C","E01027701",1194,144,44,100,305,132,275,75,119,76,17,10,7,51
"2011","Harrogate 006D","E01027702",805,65,20,45,182,102,151,59,94,98,17,9,8,37
"2011","Harrogate 007A","E01027642",995,190,56,134,269,116,168,42,92,53,16,11,5,49
"2011","Harrogate 007B","E01027646",1116,177,47,130,310,130,199,48,111,65,19,12,7,57
"2011","Harrogate 007C","E01027674",945,201,59,142,290,143,106,33,76,29,8,2,6,59
"2011","Harrogate 007D","E01027675",1700,300,67,233,502,233,188,84,164,86,32,22,10,111
"2011","Harrogate 008A","E01027641",1006,154,36,118,294,153,106,51,107,55,12,8,4,74
"2011","Harrogate 008B","E01027664",1439,218,84,134,397,204,203,69,161,91,17,10,7,79
"2011","Harrogate 008C","E01027665",808,125,28,97,229,85,121,57,81,56,12,8,4,42
"2011","Harrogate 008D","E01027722",1031,148,43,105,312,190,102,47,101,60,11,6,5,60
"2011","Harrogate 009A","E01027668",1059,79,29,50,221,153,116,85,203,132,27,12,15,43
"2011","Harrogate 009B","E01027669",1285,108,25,83,274,184,132,113,198,174,38,28,10,64
"2011","Harrogate 009C","E01027673",1303,179,41,138,335,127,173,104,181,94,38,20,18,72
"2011","Harrogate 009D","E01027676",1269,83,19,64,217,150,113,119,259,216,41,18,23,71
"2011","Harrogate 010A","E01027638",1006,113,22,91,219,166,107,79,154,104,15,9,6,49
"2011","Harrogate 010B","E01027639",950,91,23,68,226,147,110,73,145,85,16,10,6,57
"2011","Harrogate 010C","E01027640",1065,87,22,65,236,149,134,95,160,124,24,16,8,56
"2011","Harrogate 010D","E01027690",1056,70,16,54,255,166,130,100,138,117,29,21,8,51
"2011","Harrogate 010E","E01027738",998,101,25,76,236,145,80,100,174,89,21,15,6,52
"2011","Harrogate 010F","E01027739",841,77,15,62,221,105,111,60,130,86,19,13,6,32
"2011","Harrogate 010G","E01027741",991,57,18,39,202,137,94,93,208,133,24,16,8,43
"2011","Harrogate 011A","E01027689",1056,71,17,54,235,136,105,108,178,122,44,15,29,57
"2011","Harrogate 011B","E01027691",1148,118,26,92,280,159,124,81,196,112,19,8,11,59
"2011","Harrogate 011C","E01027720",1098,90,23,67,222,163,102,97,186,137,35,14,21,66
"2011","Harrogate 011D","E01027721",1142,132,32,100,305,205,101,102,130,79,17,11,6,71
"2011","Harrogate 011E","E01027723",1134,93,15,78,242,122,113,108,190,155,50,23,27,61
"2011","Harrogate 012A","E01027670",1211,162,40,122,320,207,124,73,170,69,17,7,10,69
"2011","Harrogate 012B","E01027671",1146,202,44,158,310,192,116,48,131,66,14,9,5,67
"2011","Harrogate 012C","E01027672",1269,183,54,129,368,182,163,62,128,68,30,18,12,85
"2011","Harrogate 012D","E01027704",860,171,51,120,241,102,142,40,68,33,19,11,8,44
"2011","Harrogate 013A","E01027649",1265,127,32,95,314,164,107,105,166,120,86,62,24,76
"2011","Harrogate 013B","E01027651",1078,60,12,48,180,104,86,106,237,155,55,31,24,95
"2011","Harrogate 013C","E01027657",1016,136,34,102,251,125,98,74,143,96,33,16,17,60
"2011","Harrogate 013D","E01027658",1198,138,32,106,290,172,104,119,186,110,40,26,14,39
"2011","Harrogate 013E","E01027692",874,86,13,73,221,90,85,81,143,108,14,9,5,46
"2011","Harrogate 013F","E01027740",1097,49,16,33,169,130,99,110,226,208,73,48,25,33
"2011","Harrogate 014A","E01027648",1112,102,22,80,250,133,113,92,184,118,49,29,20,71
"2011","Harrogate 014B","E01027650",1096,114,25,89,258,138,112,77,181,108,33,16,17,75
"2011","Harrogate 014C","E01027726",1241,119,22,97,296,156,97,92,177,115,40,29,11,149
"2011","Harrogate 014D","E01027727",1160,107,21,86,288,164,115,85,183,126,24,17,7,68
"2011","Harrogate 014E","E01027728",952,69,14,55,202,137,100,86,174,120,16,8,8,48
"2011","Harrogate 014F","E01027729",1158,104,14,90,240,106,106,106,240,146,44,28,16,66
"2011","Harrogate 015A","E01027652",1128,221,42,179,363,145,107,43,97,52,47,37,10,53
"2011","Harrogate 015B","E01027655",1035,186,56,130,291,105,115,41,67,52,8,5,3,170
"2011","Harrogate 015C","E01027659",1447,180,40,140,409,178,131,121,185,140,57,36,21,46
"2011","Harrogate 015D","E01027677",1145,163,37,126,312,155,138,83,122,76,46,32,14,50
"2011","Harrogate 015E","E01027678",1428,153,31,122,341,161,147,129,220,150,66,29,37,61
"2011","Harrogate 015F","E01027680",993,183,43,140,267,113,121,67,121,69,16,11,5,36
"2011","Harrogate 016A","E01027683",1070,179,48,131,293,141,131,63,104,76,12,8,4,71
"2011","Harrogate 016B","E01027684",1088,165,49,116,262,151,172,57,101,82,17,9,8,81
"2011","Harrogate 016C","E01027695",1225,238,69,169,321,129,208,53,133,69,21,14,7,53
"2011","Harrogate 016D","E01027696",1393,204,54,150,262,126,178,71,107,60,24,18,6,361
"2011","Harrogate 016E","E01027703",1333,245,85,160,354,149,209,69,140,72,31,17,14,64
"2011","Harrogate 017A","E01027660",1044,158,38,120,309,164,114,59,102,45,26,19,7,67
"2011","Harrogate 017B","E01027661",1044,99,18,81,265,157,92,76,172,88,24,17,7,71
"2011","Harrogate 017C","E01027662",870,163,46,117,302,131,67,27,78,27,13,10,3,62
"2011","Harrogate 017D","E01027663",1007,104,26,78,260,164,95,75,153,86,23,9,14,47
"2011","Harrogate 017E","E01027697",1003,170,37,133,300,140,95,65,101,61,16,11,5,55
"2011","Harrogate 017F","E01027733",943,228,42,186,301,120,86,28,64,35,18,10,8,63
"2011","Harrogate 018A","E01027682",1186,176,57,119,319,164,254,49,108,51,15,12,3,50
"2011","Harrogate 018B","E01027694",952,132,41,91,257,165,138,54,95,52,16,14,2,43
"2011","Harrogate 018C","E01027734",1153,241,56,185,307,113,282,34,61,44,21,15,6,50
"2011","Harrogate 018D","E01027735",1183,230,67,163,342,123,219,42,92,55,15,9,6,65
"2011","Harrogate 019A","E01027656",1200,205,49,156,348,159,144,57,115,81,34,21,13,57
"2011","Harrogate 019B","E01027679",1101,202,36,166,323,141,111,52,115,74,31,25,6,52
"2011","Harrogate 019C","E01027730",1107,251,64,187,323,139,128,29,90,39,36,25,11,72
"2011","Harrogate 019D","E01027731",1038,220,40,180,341,122,98,26,86,50,23,14,9,72
"2011","Harrogate 019E","E01027732",880,225,49,176,287,103,76,27,72,22,17,14,3,51
"2011","Harrogate 020A","E01027653",945,179,44,135,273,107,89,34,104,56,39,30,9,64
"2011","Harrogate 020B","E01027654",845,209,49,160,254,114,87,23,75,24,14,9,5,45
"2011","Harrogate 020C","E01027698",1077,252,75,177,326,144,94,33,92,34,12,2,10,90
"2011","Harrogate 020D","E01027716",976,224,51,173,311,147,94,29,71,29,9,4,5,62
"2011","Harrogate 020E","E01027717",1039,184,34,150,350,137,107,40,90,54,17,5,12,60
"2011","Harrogate 020F","E01027718",1270,249,47,202,398,184,122,41,119,36,26,17,9,95
"2011","Harrogate 020G","E01027719",1009,144,31,113,293,169,82,34,124,51,14,7,7,98
"2011","Harrogate 021A","E01027699",910,221,55,166,286,128,93,28,45,13,19,13,6,77
"2011","Harrogate 021B","E01027700",850,197,62,135,256,114,85,29,71,33,19,10,9,46
"2011","Harrogate 021C","E01027724",1129,239,66,173,323,133,186,40,70,44,33,20,13,61
"2011","Harrogate 021D","E01027725",1093,207,59,148,286,122,183,37,113,55,25,15,10,65
"2011","Richmondshire 001A","E01027743",908,101,31,70,253,122,138,49,104,80,21,13,8,40
"2011","Richmondshire 001B","E01027751",947,147,42,105,255,116,173,42,78,68,16,11,5,52
"2011","Richmondshire 001C","E01027752",897,124,40,84,239,63,191,56,112,57,18,10,8,37
"2011","Richmondshire 001D","E01027759",1071,170,56,114,283,142,149,67,106,77,27,17,10,50
"2011","Richmondshire 001E","E01027761",820,113,43,70,236,91,145,49,63,60,23,18,5,40
"2011","Richmondshire 001F","E01027762",1026,120,43,77,276,109,226,50,102,83,18,12,6,42
"2011","Richmondshire 002A","E01027765",1168,94,28,66,273,139,116,110,167,158,33,17,16,78
"2011","Richmondshire 002B","E01027766",869,70,20,50,221,113,99,63,118,123,21,16,5,41
"2011","Richmondshire 002C","E01027767",1072,98,25,73,294,147,120,63,136,118,29,19,10,67
"2011","Richmondshire 002D","E01027768",831,117,37,80,244,129,77,49,86,66,10,7,3,53
"2011","Richmondshire 002E","E01027769",952,107,36,71,227,113,92,60,137,126,31,13,18,59
"2011","Richmondshire 002F","E01027770",1190,143,41,102,272,134,133,69,184,157,38,20,18,60
"2011","Richmondshire 003A","E01027745",1129,134,47,87,287,145,164,80,111,88,51,41,10,69
"2011","Richmondshire 003B","E01027746",1076,101,34,67,276,150,120,81,153,112,28,19,9,55
"2011","Richmondshire 003C","E01027747",1650,134,85,49,477,515,98,123,122,98,34,19,15,49
"2011","Richmondshire 003D","E01027748",838,42,12,30,204,124,93,80,125,115,20,14,6,35
"2011","Richmondshire 004A","E01027749",1386,45,17,28,168,121,76,174,301,324,97,59,38,80
"2011","Richmondshire 004B","E01027750",2202,145,83,62,513,436,113,191,332,278,82,48,34,112
"2011","Richmondshire 004C","E01027754",938,166,125,41,253,124,49,67,114,103,31,18,13,31
"2011","Richmondshire 004E","E01027771",2856,146,133,13,479,1693,30,108,173,120,64,43,21,43
"2011","Richmondshire 004F","E01027772",1008,53,17,36,240,146,90,111,167,117,33,22,11,51
"2011","Richmondshire 004G","E01033183",901,63,48,15,312,134,34,59,115,101,48,21,27,35
"2011","Richmondshire 004H","E01033184",2147,131,115,16,600,635,48,258,180,171,59,31,28,65
"2011","Richmondshire 005A","E01027742",986,99,23,76,233,87,243,71,130,76,10,4,6,37
"2011","Richmondshire 005B","E01027753",1035,75,18,57,173,86,251,92,178,115,23,14,9,42
"2011","Richmondshire 005C","E01027763",881,104,18,86,208,88,257,48,80,60,14,9,5,22
"2011","Richmondshire 005D","E01027764",914,96,19,77,200,106,227,75,91,61,15,11,4,43
"2011","Richmondshire 005E","E01027773",846,106,18,88,196,80,239,57,68,67,7,4,3,26
"2011","Richmondshire 006A","E01027744",953,118,27,91,254,89,214,65,98,80,19,11,8,16
"2011","Richmondshire 006B","E01027756",1307,143,53,90,363,174,173,94,170,99,31,16,15,60
"2011","Richmondshire 006D","E01027758",1045,127,33,94,260,117,232,57,114,75,19,14,5,44
"2011","Richmondshire 006E","E01027760",974,93,27,66,199,98,200,99,113,129,19,14,5,24
"2011","Richmondshire 006F","E01033185",901,54,18,36,190,94,161,62,157,138,21,12,9,24
"2011","Richmondshire 006G","E01033186",928,94,29,65,225,107,145,58,126,104,20,14,6,49
"2011","Ryedale 001A","E01027776",1121,137,45,92,247,107,298,62,125,71,26,16,10,48
"2011","Ryedale 001B","E01027777",1093,139,36,103,209,88,316,76,114,84,14,9,5,53
"2011","Ryedale 001C","E01027783",1297,127,47,80,288,132,243,105,183,141,22,14,8,56
"2011","Ryedale 001D","E01027784",1148,82,19,63,221,111,176,119,178,164,39,22,17,58
"2011","Ryedale 002A","E01027792",1277,117,27,90,294,155,218,99,177,130,29,21,8,58
"2011","Ryedale 002B","E01027793",1020,64,19,45,165,128,161,87,204,130,29,16,13,52
"2011","Ryedale 002C","E01027794",1418,132,41,91,314,177,209,106,231,144,35,23,12,70
"2011","Ryedale 002D","E01027795",1137,50,8,42,172,103,133,118,239,223,43,27,16,56
"2011","Ryedale 002E","E01027801",1122,113,28,85,247,133,209,81,153,112,17,10,7,57
"2011","Ryedale 002F","E01027802",1210,129,31,98,278,120,297,68,160,75,24,13,11,59
"2011","Ryedale 003A","E01027775",1460,160,27,133,321,87,227,78,101,98,41,33,8,347
"2011","Ryedale 003B","E01027780",1340,130,24,106,253,118,355,117,155,126,26,19,7,60
"2011","Ryedale 003C","E01027781",851,75,13,62,166,70,151,97,145,102,13,6,7,32
"2011","Ryedale 003D","E01027800",1252,163,55,108,329,113,273,75,137,80,34,23,11,48
"2011","Ryedale 004A","E01027779",852,84,16,68,168,97,152,58,149,75,21,14,7,48
"2011","Ryedale 004B","E01027796",1276,72,22,50,206,127,259,107,238,189,26,14,12,52
"2011","Ryedale 004C","E01027798",1464,114,33,81,242,155,253,129,260,184,49,28,21,78
"2011","Ryedale 004D","E01027803",1340,129,47,82,274,133,272,107,182,140,37,23,14,66
"2011","Ryedale 007A","E01027774",1509,173,38,135,308,155,293,123,216,142,17,10,7,82
"2011","Ryedale 007B","E01027778",1722,250,59,191,445,149,330,97,205,127,31,25,6,88
"2011","Ryedale 007C","E01027782",1245,163,37,126,272,134,227,81,173,112,20,12,8,63
"2011","Ryedale 007D","E01027797",1288,204,55,149,317,128,259,72,133,90,24,17,7,61
"2011","Ryedale 007E","E01027799",1287,188,31,157,327,135,258,58,138,89,24,17,7,70
"2011","Ryedale 008A","E01027785",1118,67,17,50,191,98,103,136,230,196,61,24,37,36
"2011","Ryedale 008B","E01027786",1142,180,40,140,309,138,137,64,138,85,28,19,9,63
"2011","Ryedale 008C","E01027787",1228,64,22,42,159,106,111,122,291,240,59,39,20,76
"2011","Ryedale 008D","E01027788",1061,28,8,20,173,120,93,115,251,211,25,16,9,45
"2011","Ryedale 008E","E01027789",1732,76,20,56,254,162,146,183,407,349,75,44,31,80
"2011","Ryedale 008F","E01027790",1452,96,25,71,251,146,166,135,303,235,51,30,21,69
"2011","Ryedale 008G","E01027791",1119,99,34,65,211,179,167,109,177,112,25,13,12,40
"2011","Scarborough 001A","E01027837",954,31,11,20,112,75,106,109,247,189,44,32,12,41
"2011","Scarborough 001B","E01027839",1184,67,30,37,208,126,145,126,246,167,34,19,15,65
"2011","Scarborough 001C","E01027869",910,38,10,28,153,59,179,89,164,128,77,51,26,23
"2011","Scarborough 001D","E01027870",992,69,16,53,202,66,182,100,180,125,35,18,17,33
"2011","Scarborough 001E","E01027871",1009,39,17,22,206,83,176,115,183,125,35,22,13,47
"2011","Scarborough 002A","E01027813",1571,182,41,141,380,152,327,106,147,124,57,49,8,96
"2011","Scarborough 002B","E01027822",1087,82,21,61,231,98,269,104,128,97,18,14,4,60
"2011","Scarborough 002C","E01027840",1567,122,33,89,288,136,254,159,257,193,70,46,24,88
"2011","Scarborough 002D","E01027841",1009,97,23,74,216,92,257,89,112,77,25,19,6,44
"2011","Scarborough 003A","E01027838",1166,80,31,49,250,125,190,118,181,138,28,20,8,56
"2011","Scarborough 003B","E01027864",1066,25,10,15,130,77,88,133,275,224,59,32,27,55
"2011","Scarborough 003C","E01027865",1256,52,9,43,220,99,166,145,243,207,65,38,27,59
"2011","Scarborough 003D","E01027866",1133,40,16,24,176,89,141,136,263,198,39,24,15,51
"2011","Scarborough 004A","E01027821",1054,134,28,106,225,74,273,106,112,73,14,9,5,43
"2011","Scarborough 004B","E01027823",997,73,20,53,206,105,181,85,162,98,36,16,20,51
"2011","Scarborough 004C","E01027831",782,61,15,46,174,90,173,59,92,88,19,14,5,26
"2011","Scarborough 004D","E01027832",789,51,13,38,175,74,202,52,74,66,26,25,1,69
"2011","Scarborough 004E","E01027836",1611,141,45,96,372,190,279,124,240,154,35,18,17,76
"2011","Scarborough 004F","E01027857",981,120,38,82,237,110,234,67,102,60,12,9,3,39
"2011","Scarborough 005A","E01027842",1178,62,11,51,285,148,139,103,193,139,41,31,10,68
"2011","Scarborough 005B","E01027843",952,47,12,35,189,134,135,89,172,99,26,18,8,61
"2011","Scarborough 005C","E01027844",1151,108,31,77,289,182,134,89,182,85,20,10,10,62
"2011","Scarborough 005D","E01027845",1243,102,27,75,275,196,158,106,184,127,24,10,14,71
"2011","Scarborough 005E","E01027855",1086,129,33,96,333,143,135,70,128,54,20,15,5,74
"2011","Scarborough 005F","E01027856",737,100,24,76,184,86,131,51,96,42,19,16,3,28
"2011","Scarborough 006A","E01027805",1126,68,18,50,209,95,153,112,168,168,68,37,31,85
"2011","Scarborough 006B","E01027806",1399,51,14,37,143,70,130,110,278,281,127,78,49,209
"2011","Scarborough 006C","E01027846",1419,45,11,34,221,127,222,169,280,186,73,38,35,96
"2011","Scarborough 006D","E01027847",1524,59,15,44,184,85,168,131,339,260,165,81,84,133
"2011","Scarborough 006E","E01027848",748,65,16,49,180,101,105,55,94,74,15,8,7,59
"2011","Scarborough 007A","E01027849",832,47,18,29,184,112,114,81,123,78,46,32,14,47
"2011","Scarborough 007B","E01027850",905,28,9,19,131,95,116,85,198,138,63,32,31,51
"2011","Scarborough 007C","E01027872",1039,28,8,20,150,65,116,104,231,192,73,53,20,80
"2011","Scarborough 007D","E01027874",1085,20,2,18,97,67,77,97,247,238,134,79,55,108
"2011","Scarborough 008A","E01027810",1213,40,19,21,197,103,126,117,279,183,60,33,27,108
"2011","Scarborough 008B","E01027811",1207,36,9,27,216,145,95,122,240,197,56,29,27,100
"2011","Scarborough 008C","E01027812",1275,38,9,29,191,93,127,123,275,222,86,52,34,120
"2011","Scarborough 008D","E01027851",1154,57,13,44,262,132,120,122,212,131,32,20,12,86
"2011","Scarborough 008E","E01027862",1204,51,11,40,224,122,133,108,230,178,74,48,26,84
"2011","Scarborough 009A","E01027824",994,85,19,66,208,106,107,60,167,148,51,32,19,62
"2011","Scarborough 009B","E01027825",1305,41,14,27,204,107,100,131,299,249,95,63,32,79
"2011","Scarborough 009C","E01027826",1103,70,23,47,222,120,97,101,213,138,58,35,23,84
"2011","Scarborough 009D","E01027861",945,59,16,43,185,91,93,95,188,125,54,29,25,55
"2011","Scarborough 009E","E01027863",992,86,23,63,240,129,129,91,162,91,19,10,9,45
"2011","Scarborough 009F","E01027873",1067,127,21,106,238,142,114,91,171,99,33,22,11,52
"2011","Scarborough 010A","E01027804",1268,55,12,43,202,72,156,107,214,203,99,47,52,160
"2011","Scarborough 010B","E01027852",1366,84,15,69,248,90,132,122,226,138,73,30,43,253
"2011","Scarborough 010C","E01027853",923,56,10,46,206,96,116,70,160,102,41,26,15,76
"2011","Scarborough 010D","E01027854",1199,92,18,74,206,94,112,107,200,133,49,28,21,206
"2011","Scarborough 010E","E01027868",1533,202,57,145,370,147,192,78,220,100,66,47,19,158
"2011","Scarborough 011A","E01027807",1072,72,30,42,206,120,160,107,209,120,30,17,13,48
"2011","Scarborough 011B","E01027808",1080,51,20,31,215,171,131,118,194,118,29,21,8,53
"2011","Scarborough 011C","E01027809",926,51,9,42,200,111,118,87,208,109,15,9,6,27
"2011","Scarborough 011D","E01027818",1020,24,9,15,143,114,78,138,253,180,30,19,11,60
"2011","Scarborough 011E","E01027867",1174,93,28,65,248,128,143,72,147,74,25,14,11,244
"2011","Scarborough 012A","E01027817",998,19,5,14,95,78,79,109,255,203,93,50,43,67
"2011","Scarborough 012B","E01027819",963,9,1,8,74,49,67,94,247,234,107,67,40,82
"2011","Scarborough 012C","E01027820",926,22,11,11,92,58,53,108,265,190,82,51,31,56
"2011","Scarborough 012D","E01027858",1017,65,24,41,204,149,122,107,188,110,27,18,9,45
"2011","Scarborough 012E","E01027860",1103,85,28,57,224,132,137,99,193,128,30,23,7,75
"2011","Scarborough 013A","E01027814",1110,101,28,73,260,128,193,81,167,93,18,11,7,69
"2011","Scarborough 013B","E01027815",1010,101,23,78,243,121,199,71,138,76,18,8,10,43
"2011","Scarborough 013C","E01027816",1138,86,31,55,254,169,143,100,182,102,42,28,14,60
"2011","Scarborough 013D","E01027859",1297,113,45,68,325,184,157,109,194,114,23,13,10,78
"2011","Scarborough 014A","E01027827",1200,90,37,53,204,113,190,94,214,180,66,46,20,49
"2011","Scarborough 014B","E01027828",1113,55,18,37,204,132,162,108,230,134,29,16,13,59
"2011","Scarborough 014C","E01027829",1032,44,17,27,200,129,147,103,201,126,32,15,17,50
"2011","Scarborough 014D","E01027830",1288,60,22,38,182,124,132,128,304,215,56,34,22,87
"2011","Scarborough 014E","E01027833",1201,65,18,47,255,114,259,105,195,125,29,25,4,54
"2011","Scarborough 014F","E01027834",1112,61,15,46,222,137,131,112,224,149,27,15,12,49
"2011","Scarborough 014G","E01027835",1323,84,27,57,259,135,253,117,232,140,34,17,17,69
"2011","Selby 001A","E01027918",1079,87,27,60,194,140,92,82,213,181,39,22,17,51
"2011","Selby 001B","E01027919",869,89,25,64,178,136,73,70,142,108,18,11,7,55
"2011","Selby 001C","E01027920",951,92,22,70,204,154,74,77,159,115,15,11,4,61
"2011","Selby 001D","E01027921",1230,129,29,100,260,194,90,83,200,160,38,19,19,76
"2011","Selby 001E","E01027922",1245,166,47,119,303,201,132,78,164,108,17,10,7,76
"2011","Selby 002A","E01027875",1357,259,60,199,362,163,230,51,128,58,23,14,9,83
"2011","Selby 002B","E01027886",1001,166,39,127,293,105,129,57,100,94,23,13,10,34
"2011","Selby 002C","E01027887",1192,178,44,134,337,172,140,72,130,90,14,9,5,59
"2011","Selby 002D","E01027888",1276,229,52,177,318,163,183,71,123,102,18,7,11,69
"2011","Selby 002E","E01027904",1695,322,72,250,487,208,210,89,143,95,33,21,12,108
"2011","Selby 003A","E01027876",1213,89,26,63,248,159,113,138,195,184,20,14,6,67
"2011","Selby 003B","E01027877",938,73,18,55,160,100,92,96,173,174,31,14,17,39
"2011","Selby 003C","E01027900",1414,217,48,169,422,192,196,87,153,75,19,9,10,53
"2011","Selby 003D","E01027901",1175,159,31,128,318,179,132,79,150,94,16,10,6,48
"2011","Selby 003E","E01027902",1090,143,45,98,257,138,139,68,161,94,22,9,13,68
"2011","Selby 003F","E01027903",810,143,36,107,235,80,85,43,64,37,15,12,3,108
"2011","Selby 004A","E01027898",1784,280,76,204,499,243,181,128,202,126,26,17,9,99
"2011","Selby 004B","E01027914",1278,169,40,129,317,196,128,103,164,114,19,15,4,68
"2011","Selby 004C","E01027915",1176,96,33,63,214,163,98,121,204,170,50,27,23,60
"2011","Selby 004D","E01027916",1117,77,25,52,152,135,68,121,208,237,48,30,18,71
"2011","Selby 004E","E01027917",1415,182,44,138,331,219,127,104,162,153,37,23,14,100
"2011","Selby 005A","E01027878",964,54,15,39,167,134,63,121,193,137,41,16,25,54
"2011","Selby 005B","E01027905",1446,80,29,51,231,147,97,162,303,283,80,37,43,63
"2011","Selby 005C","E01027907",953,23,6,17,84,68,41,92,244,243,101,61,40,57
"2011","Selby 005D","E01027908",1157,48,8,40,139,114,90,119,260,245,95,55,40,47
"2011","Selby 005E","E01027909",1568,80,16,64,249,163,104,153,352,299,96,45,51,72
"2011","Selby 005F","E01027910",1960,111,32,79,321,185,109,204,461,336,115,62,53,118
"2011","Selby 006A","E01027881",911,78,22,56,184,110,66,82,179,137,43,25,18,32
"2011","Selby 006B","E01027906",1052,60,13,47,163,96,86,109,212,187,55,35,20,84
"2011","Selby 006C","E01027911",986,69,16,53,203,122,104,107,192,103,32,22,10,54
"2011","Selby 006D","E01027912",768,79,26,53,132,111,66,71,147,114,16,12,4,32
"2011","Selby 006E","E01027913",849,88,24,64,180,121,89,79,147,78,18,11,7,49
"2011","Selby 007A","E01027879",1042,69,22,47,209,158,72,120,205,129,28,15,13,52
"2011","Selby 007B","E01027880",1190,183,42,141,289,176,122,76,145,101,15,12,3,83
"2011","Selby 007C","E01027882",1388,155,41,114,363,192,120,131,191,121,26,14,12,89
"2011","Selby 007D","E01027894",1407,138,44,94,282,213,127,132,234,165,36,20,16,80
"2011","Selby 007E","E01027895",1196,139,52,87,257,161,161,89,173,124,29,11,18,63
"2011","Selby 008A","E01027883",862,70,23,47,185,117,97,84,138,105,20,13,7,46
"2011","Selby 008B","E01027884",1198,96,27,69,218,150,123,143,180,155,45,28,17,88
"2011","Selby 008C","E01027885",1165,114,32,82,244,159,129,95,195,137,27,14,13,65
"2011","Selby 008D","E01027896",1480,148,44,104,370,171,195,121,202,149,37,23,14,87
"2011","Selby 008E","E01027897",1576,184,53,131,369,203,220,138,192,154,35,19,16,81
"2011","Selby 009A","E01027891",1280,146,38,108,316,186,160,114,175,112,23,15,8,48
"2011","Selby 009B","E01027892",1417,100,26,74,239,181,143,158,245,241,54,26,28,56
"2011","Selby 009C","E01027893",1388,193,51,142,374,208,124,97,182,120,22,7,15,68
"2011","Selby 009D","E01027899",1246,246,65,181,348,144,171,51,110,71,28,15,13,77
"2011","Selby 010A","E01027889",1279,110,37,73,211,152,108,141,242,220,38,22,16,57
"2011","Selby 010B","E01027890",1485,157,46,111,328,196,211,119,212,148,37,25,12,77
"2011","Selby 010C","E01027923",1688,213,67,146,396,190,238,134,214,175,38,22,16,90
"2011","Selby 010D","E01027924",1625,193,76,117,403,220,228,123,181,160,38,21,17,79
"2011","Barnsley 001A","E01007434",1406,89,38,51,282,156,117,129,231,244,75,52,23,83
"2011","Barnsley 001B","E01007435",1112,42,10,32,143,121,76,92,256,235,83,52,31,64
"2011","Barnsley 001C","E01007438",1132,87,27,60,258,153,84,97,178,163,44,32,12,68
"2011","Barnsley 001D","E01007439",943,91,30,61,184,128,106,78,149,135,23,15,8,49
"2011","Barnsley 002A","E01007433",1198,49,15,34,179,141,106,108,255,216,68,38,30,76
"2011","Barnsley 002B","E01007436",912,59,21,38,181,113,78,93,162,151,42,25,17,33
"2011","Barnsley 002C","E01007437",1136,75,25,50,166,127,92,103,235,201,75,43,32,62
"2011","Barnsley 002D","E01007440",1126,37,9,28,127,117,70,107,230,268,95,69,26,75
"2011","Barnsley 003A","E01007329",1112,52,17,35,157,148,120,117,212,194,51,37,14,61
"2011","Barnsley 003B","E01007331",1405,70,30,40,240,203,130,130,231,272,66,40,26,63
"2011","Barnsley 003C","E01007342",1039,60,17,43,178,138,84,102,195,173,52,38,14,57
"2011","Barnsley 003D","E01007343",977,45,20,25,113,110,71,132,193,216,54,38,16,43
"2011","Barnsley 004A","E01007356",1029,101,33,68,259,129,127,80,142,102,26,15,11,63
"2011","Barnsley 004B","E01007357",999,61,16,45,178,109,88,109,168,159,50,26,24,77
"2011","Barnsley 004C","E01007361",1235,85,27,58,255,155,119,97,215,185,55,34,21,69
"2011","Barnsley 004D","E01007362",1245,91,27,64,270,169,138,107,189,176,34,26,8,71
"2011","Barnsley 004E","E01007363",1151,62,22,40,170,113,100,125,225,225,77,51,26,54
"2011","Barnsley 005A","E01007355",1125,129,36,93,303,177,97,85,128,118,22,13,9,66
"2011","Barnsley 005B","E01007358",1139,118,30,88,253,169,91,71,177,156,33,20,13,71
"2011","Barnsley 005C","E01007359",1095,70,19,51,186,118,101,102,195,209,48,17,31,66
"2011","Barnsley 005D","E01007360",1151,91,16,75,215,149,85,90,187,212,55,39,16,67
"2011","Barnsley 005E","E01007386",1294,116,29,87,281,180,131,111,194,194,27,18,9,60
"2011","Barnsley 006A","E01007328",1376,57,21,36,160,127,113,131,265,323,133,103,30,67
"2011","Barnsley 006B","E01007330",1269,72,20,52,269,175,107,91,205,221,52,38,14,77
"2011","Barnsley 006C","E01007332",1646,63,17,46,236,154,113,150,330,365,165,126,39,70
"2011","Barnsley 006D","E01007333",929,17,7,10,83,72,51,76,208,263,105,70,35,54
"2011","Barnsley 007A","E01007323",1072,40,9,31,128,105,52,82,249,240,108,61,47,68
"2011","Barnsley 007B","E01007324",1223,31,10,21,137,95,92,128,272,291,111,72,39,66
"2011","Barnsley 007C","E01007325",1108,18,5,13,79,61,58,100,271,297,150,99,51,74
"2011","Barnsley 007D","E01007326",1107,28,4,24,111,97,107,99,225,282,90,64,26,68
"2011","Barnsley 007E","E01007327",1210,31,8,23,109,99,99,118,249,326,113,83,30,66
"2011","Barnsley 007F","E01007411",837,11,3,8,60,62,51,68,164,213,139,84,55,69
"2011","Barnsley 008A","E01007341",879,9,4,5,79,67,48,81,198,226,110,79,31,61
"2011","Barnsley 008B","E01007345",1169,48,9,39,165,132,87,103,271,242,62,38,24,59
"2011","Barnsley 008C","E01007346",1186,34,15,19,138,152,109,107,263,233,81,59,22,69
"2011","Barnsley 008D","E01007347",1186,84,24,60,214,159,122,116,188,183,52,23,29,68
"2011","Barnsley 009A","E01007334",1095,59,16,43,200,149,93,124,210,177,24,15,9,59
"2011","Barnsley 009B","E01007335",1123,78,30,48,198,156,98,105,216,159,43,30,13,70
"2011","Barnsley 009C","E01007400",1508,105,34,71,291,191,181,132,248,215,63,41,22,82
"2011","Barnsley 009D","E01007404",1017,60,21,39,188,133,86,136,180,161,30,21,9,43
"2011","Barnsley 009E","E01007406",1244,30,13,17,125,115,103,108,293,308,87,52,35,75
"2011","Barnsley 010C","E01007408",1096,80,22,58,231,172,90,80,166,145,58,34,24,74
"2011","Barnsley 010D","E01007409",1093,129,38,91,276,148,97,75,149,95,42,32,10,82
"2011","Barnsley 010E","E01007410",1270,56,17,39,179,142,85,114,199,292,127,88,39,76
"2011","Barnsley 010G","E01032550",2077,92,32,60,321,232,197,174,391,398,146,104,42,126
"2011","Barnsley 010H","E01032551",1890,166,39,127,431,257,192,148,243,241,83,58,25,129
"2011","Barnsley 011A","E01007344",1570,74,24,50,271,214,156,129,280,270,90,54,36,86
"2011","Barnsley 011B","E01007402",1184,32,11,21,115,95,83,95,242,291,159,113,46,72
"2011","Barnsley 011C","E01007403",1120,22,11,11,106,92,78,97,255,277,128,93,35,65
"2011","Barnsley 011D","E01007405",1046,53,21,32,134,103,84,108,201,202,109,80,29,52
"2011","Barnsley 012A","E01007379",1204,92,25,67,262,163,111,120,168,197,33,17,16,58
"2011","Barnsley 012B","E01007380",1341,161,41,120,365,191,160,82,142,118,23,15,8,99
"2011","Barnsley 012C","E01007381",1131,110,37,73,291,159,78,86,133,147,38,30,8,89
"2011","Barnsley 012D","E01007387",1073,86,24,62,237,137,102,100,151,159,45,22,23,56
"2011","Barnsley 012E","E01007442",980,120,35,85,284,148,96,71,94,82,25,19,6,60
"2011","Barnsley 012F","E01007444",1122,103,31,72,224,153,119,77,176,160,45,31,14,65
"2011","Barnsley 012G","E01007446",989,86,23,63,202,156,101,67,146,148,33,19,14,50
"2011","Barnsley 013A","E01007336",1232,74,13,61,202,132,96,111,203,230,97,74,23,87
"2011","Barnsley 013B","E01007340",1246,62,15,47,216,143,84,98,224,241,99,42,57,79
"2011","Barnsley 013C","E01007415",1097,70,23,47,210,120,119,96,186,170,66,38,28,60
"2011","Barnsley 013D","E01007417",1206,68,19,49,182,158,99,99,222,218,93,60,33,67
"2011","Barnsley 013E","E01007441",1191,57,20,37,215,172,93,109,194,204,63,43,20,84
"2011","Barnsley 013F","E01007443",1577,82,28,54,239,181,121,143,245,315,133,92,41,118
"2011","Barnsley 013G","E01007445",1095,46,13,33,201,161,81,94,205,218,56,30,26,33
"2011","Barnsley 014A","E01007372",867,29,8,21,87,94,57,85,174,187,101,77,24,53
"2011","Barnsley 014B","E01007373",1159,25,12,13,91,110,85,93,225,325,132,97,35,73
"2011","Barnsley 014C","E01007374",1105,57,22,35,168,147,98,105,181,245,47,36,11,57
"2011","Barnsley 014D","E01007375",1217,57,22,35,167,143,118,117,228,248,71,56,15,68
"2011","Barnsley 014E","E01007377",797,19,4,15,58,72,68,72,164,214,88,60,28,42
"2011","Barnsley 014F","E01007378",1122,25,5,20,82,116,68,93,210,324,149,105,44,55
"2011","Barnsley 015A","E01007319",1115,73,25,48,221,157,103,112,177,184,25,21,4,63
"2011","Barnsley 015B","E01007321",1113,87,32,55,245,171,104,100,165,160,18,9,9,63
"2011","Barnsley 015C","E01007322",1547,64,14,50,275,211,110,148,287,258,118,65,53,76
"2011","Barnsley 015D","E01007337",1392,62,13,49,218,195,106,128,269,246,88,56,32,80
"2011","Barnsley 016A","E01007418",948,186,64,122,282,103,136,38,86,65,10,6,4,42
"2011","Barnsley 016B","E01007419",1277,195,54,141,391,165,148,67,117,90,21,13,8,83
"2011","Barnsley 016C","E01007420",1059,164,48,116,290,144,104,67,116,82,30,16,14,62
"2011","Barnsley 016D","E01007425",1107,171,51,120,322,178,181,52,87,49,20,16,4,47
"2011","Barnsley 017A","E01007338",1089,32,9,23,100,83,85,92,229,317,105,68,37,46
"2011","Barnsley 017B","E01007339",1152,36,10,26,148,104,58,81,234,291,111,62,49,89
"2011","Barnsley 017C","E01007413",946,21,8,13,80,72,73,83,215,241,104,72,32,57
"2011","Barnsley 017D","E01007414",1191,47,18,29,169,131,87,103,215,243,115,84,31,81
"2011","Barnsley 018A","E01007317",1093,34,12,22,122,86,66,92,217,293,113,71,42,70
"2011","Barnsley 018B","E01007318",1095,39,8,31,151,102,69,89,225,233,133,88,45,54
"2011","Barnsley 018C","E01007320",1160,21,8,13,134,124,70,101,235,272,126,85,41,77
"2011","Barnsley 018D","E01007416",854,14,8,6,89,69,63,94,161,204,100,71,29,60
"2011","Barnsley 019A","E01007382",1097,58,18,40,179,142,86,107,191,215,44,30,14,75
"2011","Barnsley 019B","E01007383",1049,112,24,88,267,162,93,68,126,116,31,19,12,74
"2011","Barnsley 019C","E01007384",1222,132,32,100,299,167,122,81,157,167,32,20,12,65
"2011","Barnsley 019D","E01007385",1026,48,16,32,143,93,72,115,199,218,82,57,25,56
"2011","Barnsley 020A","E01007348",1021,34,11,23,145,108,76,91,191,198,122,94,28,56
"2011","Barnsley 020B","E01007349",1107,64,15,49,157,116,109,77,217,204,90,56,34,73
"2011","Barnsley 020C","E01007350",892,67,19,48,173,142,96,69,147,118,42,32,10,38
"2011","Barnsley 020D","E01007351",1036,66,23,43,193,141,99,85,180,155,68,46,22,49
"2011","Barnsley 020E","E01007352",1004,34,10,24,106,104,73,80,200,235,107,68,39,65
"2011","Barnsley 020F","E01007353",1186,73,17,56,237,153,108,111,183,169,76,58,18,76
"2011","Barnsley 020G","E01007354",1263,78,27,51,231,133,135,112,217,217,55,38,17,85
"2011","Barnsley 021A","E01007458",1132,48,14,34,170,120,129,100,210,209,77,57,20,69
"2011","Barnsley 021B","E01007459",1111,75,30,45,244,145,100,111,174,169,37,20,17,56
"2011","Barnsley 021C","E01007460",1093,63,26,37,196,153,106,89,183,164,66,49,17,73
"2011","Barnsley 021D","E01007461",1195,39,14,25,165,104,90,106,234,270,126,93,33,61
"2011","Barnsley 021E","E01007462",1106,45,7,38,126,90,94,101,212,229,137,92,45,72
"2011","Barnsley 021F","E01007463",1232,29,7,22,121,124,83,113,232,298,168,128,40,64
"2011","Barnsley 022A","E01007369",1106,44,12,32,121,135,92,91,184,247,143,104,39,49
"2011","Barnsley 022B","E01007370",1033,35,13,22,103,102,93,105,185,235,119,88,31,56
"2011","Barnsley 022C","E01007371",1452,67,23,44,211,192,98,151,241,310,92,63,29,90
"2011","Barnsley 022D","E01007376",1037,44,15,29,136,119,85,96,186,205,104,73,31,62
"2011","Barnsley 023A","E01007447",1062,32,16,16,122,130,76,105,227,245,71,41,30,54
"2011","Barnsley 023B","E01007448",1263,36,9,27,180,157,91,110,292,254,96,54,42,47
"2011","Barnsley 023C","E01007449",1389,62,21,41,191,182,129,133,272,275,85,47,38,60
"2011","Barnsley 023D","E01007450",1163,40,18,22,156,112,82,94,233,254,123,81,42,69
"2011","Barnsley 024A","E01007427",1157,163,46,117,299,141,109,78,132,133,41,26,15,61
"2011","Barnsley 024B","E01007428",1081,148,48,100,292,116,134,58,131,118,14,7,7,70
"2011","Barnsley 024C","E01007429",1008,65,14,51,168,98,81,92,187,195,52,23,29,70
"2011","Barnsley 024D","E01007430",1682,239,59,180,483,256,158,104,180,146,32,19,13,84
"2011","Barnsley 024E","E01007431",1052,71,24,47,238,135,95,91,184,150,27,12,15,61
"2011","Barnsley 024F","E01007432",1040,120,34,86,258,141,85,68,145,127,26,16,10,70
"2011","Barnsley 025A","E01007364",1014,23,7,16,101,127,74,100,227,228,64,44,20,70
"2011","Barnsley 025B","E01007365",871,31,9,22,97,113,60,73,143,205,95,76,19,54
"2011","Barnsley 025C","E01007366",1540,85,28,57,282,234,162,161,233,268,46,29,17,69
"2011","Barnsley 025D","E01007367",839,27,12,15,76,106,57,96,151,202,67,48,19,57
"2011","Barnsley 025E","E01007368",1194,50,16,34,156,188,104,101,220,222,87,61,26,66
"2011","Barnsley 026A","E01007451",1229,65,18,47,189,143,88,98,235,251,80,52,28,80
"2011","Barnsley 026B","E01007452",1156,90,29,61,227,171,117,98,190,153,47,35,12,63
"2011","Barnsley 026C","E01007453",1070,21,7,14,99,96,75,72,259,264,114,84,30,70
"2011","Barnsley 026E","E01007455",1064,70,21,49,204,158,79,100,191,168,38,23,15,56
"2011","Barnsley 026F","E01032924",1141,91,25,66,271,194,106,105,152,102,49,27,22,71
"2011","Barnsley 026G","E01032925",950,49,19,30,159,103,74,78,192,180,63,46,17,52
"2011","Barnsley 027A","E01007421",1056,168,52,116,282,115,176,58,95,61,22,11,11,79
"2011","Barnsley 027B","E01007422",1153,173,47,126,328,151,150,66,113,96,17,10,7,59
"2011","Barnsley 027C","E01007423",1214,151,47,104,281,148,169,103,131,132,32,21,11,67
"2011","Barnsley 027D","E01007426",1193,159,43,116,255,142,225,69,136,135,28,19,9,44
"2011","Barnsley 028A","E01007396",1178,70,18,52,188,175,96,106,195,216,51,28,23,81
"2011","Barnsley 028B","E01007397",1029,52,17,35,165,113,93,89,215,190,65,46,19,47
"2011","Barnsley 028C","E01007398",1183,83,29,54,227,163,107,118,191,194,50,32,18,50
"2011","Barnsley 028D","E01007399",1523,132,39,93,327,263,129,123,208,205,49,24,25,87
"2011","Barnsley 028E","E01007424",1236,149,40,109,299,167,128,103,161,124,35,20,15,70
"2011","Barnsley 029A","E01007388",1248,95,31,64,257,190,115,107,185,180,45,24,21,74
"2011","Barnsley 029B","E01007393",1310,76,20,56,256,150,100,118,207,247,77,54,23,79
"2011","Barnsley 029C","E01007394",991,44,11,33,119,114,58,86,188,219,89,53,36,74
"2011","Barnsley 029D","E01007456",1331,94,22,72,303,215,112,107,218,181,42,27,15,59
"2011","Barnsley 029E","E01007457",1204,57,15,42,187,132,107,108,211,222,111,67,44,69
"2011","Barnsley 030A","E01007389",1090,76,31,45,232,201,112,89,166,141,31,21,10,42
"2011","Barnsley 030B","E01007390",1146,54,14,40,215,163,96,117,198,201,40,31,9,62
"2011","Barnsley 030C","E01007391",1070,52,20,32,147,130,87,91,195,235,76,48,28,57
"2011","Barnsley 030D","E01007392",1092,37,13,24,108,93,78,96,231,249,124,81,43,76
"2011","Barnsley 030E","E01007395",1413,61,15,46,160,117,107,126,282,354,117,77,40,89
"2011","Doncaster 001A","E01007632",1177,43,17,26,135,107,105,117,247,258,96,65,31,69
"2011","Doncaster 001B","E01007633",942,25,12,13,77,73,63,119,258,201,76,49,27,50
"2011","Doncaster 001C","E01007634",1138,22,6,16,123,82,77,125,254,279,124,79,45,52
"2011","Doncaster 001D","E01007635",1049,45,15,30,147,124,81,114,216,209,78,61,17,35
"2011","Doncaster 002A","E01007487",1155,56,15,41,186,116,81,99,227,246,75,54,21,69
"2011","Doncaster 002B","E01007488",1321,103,37,66,277,142,208,108,182,178,64,54,10,59
"2011","Doncaster 002C","E01007489",1243,73,22,51,202,143,124,120,229,235,55,37,18,62
"2011","Doncaster 002D","E01007490",1143,91,36,55,231,101,162,68,197,176,53,35,18,64
"2011","Doncaster 002E","E01007491",1212,27,12,15,93,94,50,113,272,361,125,74,51,77
"2011","Doncaster 002F","E01007492",1058,24,7,17,120,101,91,95,209,254,93,56,37,71
"2011","Doncaster 002G","E01007493",1283,108,39,69,276,165,117,126,201,175,42,22,20,73
"2011","Doncaster 003A","E01007636",1059,36,15,21,113,89,75,101,237,245,99,67,32,64
"2011","Doncaster 003B","E01007637",1104,45,11,34,155,118,104,96,230,208,97,71,26,51
"2011","Doncaster 003C","E01007638",1131,24,11,13,109,114,61,123,292,263,76,50,26,69
"2011","Doncaster 003D","E01007639",1428,79,20,59,242,150,134,138,264,233,107,78,29,81
"2011","Doncaster 003E","E01007640",1236,88,31,57,250,166,115,118,227,181,36,27,9,55
"2011","Doncaster 003F","E01007641",1110,48,17,31,175,129,121,113,214,188,68,43,25,54
"2011","Doncaster 003G","E01007642",1100,28,13,15,108,86,57,110,280,256,103,71,32,72
"2011","Doncaster 004A","E01007625",1123,99,27,72,243,123,160,99,147,142,53,35,18,57
"2011","Doncaster 004B","E01007626",892,26,9,17,110,66,100,89,173,206,88,58,30,34
"2011","Doncaster 004C","E01007627",1174,16,4,12,126,121,80,130,237,264,135,89,46,65
"2011","Doncaster 004D","E01007628",1032,24,7,17,100,75,69,90,223,238,147,107,40,66
"2011","Doncaster 004E","E01007629",1109,14,3,11,74,74,59,90,244,298,194,136,58,62
"2011","Doncaster 005A","E01007468",965,73,24,49,206,137,89,113,180,117,14,9,5,36
"2011","Doncaster 005B","E01007469",977,70,25,45,163,100,92,90,165,176,67,44,23,54
"2011","Doncaster 005C","E01007470",1019,33,14,19,97,84,70,102,236,273,64,45,19,60
"2011","Doncaster 005D","E01007472",1120,24,4,20,103,87,81,106,251,261,130,88,42,77
"2011","Doncaster 005E","E01007473",1079,26,9,17,125,124,72,110,258,254,73,52,21,37
"2011","Doncaster 005F","E01007474",896,26,8,18,103,58,41,86,220,233,89,65,24,40
"2011","Doncaster 006A","E01007554",1240,79,21,58,227,162,102,126,219,228,42,28,14,55
"2011","Doncaster 006B","E01007555",1038,27,11,16,117,95,71,124,235,218,91,55,36,60
"2011","Doncaster 006C","E01007556",960,17,5,12,82,72,70,122,226,240,75,41,34,56
"2011","Doncaster 006D","E01007561",1035,85,34,51,238,161,78,112,163,108,30,21,9,60
"2011","Doncaster 006E","E01007562",1023,51,16,35,162,145,99,103,195,166,51,33,18,51
"2011","Doncaster 006F","E01007563",993,17,8,9,98,74,73,76,231,228,133,92,41,63
"2011","Doncaster 007A","E01007621",1052,58,20,38,238,159,73,93,182,146,17,8,9,86
"2011","Doncaster 007B","E01007622",1144,96,24,72,291,169,91,101,191,124,19,8,11,62
"2011","Doncaster 007C","E01007623",895,48,18,30,143,133,51,109,188,162,28,14,14,33
"2011","Doncaster 007D","E01007624",1358,123,45,78,377,207,109,114,185,118,30,20,10,95
"2011","Doncaster 007E","E01007630",974,61,18,43,195,121,117,99,173,137,31,18,13,40
"2011","Doncaster 007F","E01007631",910,87,34,53,210,184,78,78,131,93,10,4,6,39
"2011","Doncaster 008A","E01007553",1262,115,28,87,278,203,137,119,168,130,36,27,9,76
"2011","Doncaster 008B","E01007557",2513,87,33,54,227,149,271,200,331,611,562,486,76,75
"2011","Doncaster 008C","E01007558",1093,75,16,59,208,143,76,119,212,158,38,28,10,64
"2011","Doncaster 008D","E01007559",936,61,23,38,158,107,143,83,113,151,72,53,19,48
"2011","Doncaster 008E","E01007560",1122,75,26,49,255,169,113,99,187,128,38,26,12,58
"2011","Doncaster 009A","E01007464",1102,40,11,29,140,115,68,111,215,227,96,58,38,90
"2011","Doncaster 009B","E01007465",1041,40,13,27,131,110,86,87,212,229,80,56,24,66
"2011","Doncaster 009C","E01007466",1168,24,7,17,107,104,45,114,265,280,158,98,60,71
"2011","Doncaster 009D","E01007467",1088,23,8,15,138,101,67,110,270,260,59,42,17,60
"2011","Doncaster 009E","E01007471",1150,102,34,68,272,174,85,112,167,119,31,25,6,88
"2011","Doncaster 009F","E01007504",1147,33,8,25,123,98,82,149,238,281,69,42,27,74
"2011","Doncaster 009G","E01007507",940,28,10,18,69,61,61,78,177,251,139,85,54,76
"2011","Doncaster 010A","E01007506",1017,19,5,14,108,70,63,94,213,235,140,106,34,75
"2011","Doncaster 010B","E01007508",1161,19,7,12,96,99,71,97,251,299,159,102,57,70
"2011","Doncaster 010C","E01007509",1235,33,11,22,128,109,66,100,286,296,149,99,50,68
"2011","Doncaster 010D","E01007510",1128,52,19,33,175,150,86,112,216,188,81,47,34,68
"2011","Doncaster 010E","E01007511",1124,38,9,29,87,115,90,97,233,265,131,88,43,68
"2011","Doncaster 011A","E01007475",1175,121,33,88,313,186,81,118,171,92,18,15,3,75
"2011","Doncaster 011B","E01007476",1001,39,13,26,170,145,113,103,185,154,34,19,15,58
"2011","Doncaster 011C","E01007477",1040,59,13,46,198,165,85,112,191,141,22,12,10,67
"2011","Doncaster 011D","E01007478",1157,72,23,49,209,136,97,116,208,208,46,37,9,65
"2011","Doncaster 012A","E01007512",1191,47,9,38,205,161,98,134,239,210,34,21,13,63
"2011","Doncaster 012B","E01007513",994,44,18,26,119,152,91,98,187,200,43,26,17,60
"2011","Doncaster 012C","E01007515",1126,31,12,19,149,111,99,102,221,262,89,66,23,62
"2011","Doncaster 012D","E01007518",1097,84,28,56,243,133,111,79,181,152,41,31,10,73
"2011","Doncaster 012E","E01007519",938,33,11,22,131,102,82,92,199,169,53,34,19,77
"2011","Doncaster 013A","E01007505",1285,85,26,59,237,160,119,98,230,214,77,51,26,65
"2011","Doncaster 013B","E01007514",1119,37,16,21,168,139,86,112,202,231,93,53,40,51
"2011","Doncaster 013C","E01007516",996,43,16,27,156,132,67,118,200,167,38,25,13,75
"2011","Doncaster 013D","E01007517",1152,34,10,24,144,132,82,119,255,236,86,57,29,64
"2011","Doncaster 014A","E01007479",1146,48,14,34,161,120,107,139,233,234,59,39,20,45
"2011","Doncaster 014B","E01007480",1065,27,8,19,126,112,91,100,242,238,60,38,22,69
"2011","Doncaster 014D","E01007482",960,33,10,23,113,91,71,93,214,222,73,51,22,50
"2011","Doncaster 014E","E01033259",1190,109,26,83,324,171,82,102,176,147,36,26,10,43
"2011","Doncaster 014F","E01033260",1177,69,20,49,229,144,86,108,205,218,55,33,22,63
"2011","Doncaster 015A","E01007570",1031,94,24,70,226,154,91,87,153,122,50,38,12,54
"2011","Doncaster 015B","E01007650",1224,72,22,50,263,199,85,108,205,178,50,40,10,64
"2011","Doncaster 015C","E01007651",1250,49,18,31,136,111,80,121,236,298,123,92,31,96
"2011","Doncaster 015D","E01007652",1313,40,7,33,120,88,88,134,280,329,150,96,54,84
"2011","Doncaster 015E","E01007653",1199,49,9,40,216,144,85,110,224,218,74,49,25,79
"2011","Doncaster 015F","E01007656",1077,28,11,17,146,109,64,113,228,231,84,52,32,74
"2011","Doncaster 016A","E01007581",1159,119,39,80,276,169,104,92,163,125,26,14,12,85
"2011","Doncaster 016B","E01007582",1085,76,26,50,240,175,82,109,186,140,26,12,14,51
"2011","Doncaster 016C","E01007588",1196,58,22,36,205,160,101,111,221,203,60,46,14,77
"2011","Doncaster 016D","E01007589",1283,88,23,65,253,172,124,136,219,182,37,22,15,72
"2011","Doncaster 017A","E01007483",1078,74,19,55,235,162,93,104,174,147,32,14,18,57
"2011","Doncaster 017B","E01007484",1007,62,20,42,168,139,93,110,191,160,37,27,10,47
"2011","Doncaster 017C","E01007485",1107,84,24,60,246,192,89,94,175,149,19,10,9,59
"2011","Doncaster 017D","E01007486",1003,55,22,33,172,140,59,114,217,175,39,22,17,32
"2011","Doncaster 018A","E01007564",1034,24,10,14,110,82,67,103,218,230,109,74,35,91
"2011","Doncaster 018B","E01007565",1089,115,28,87,243,137,84,91,161,124,58,47,11,76
"2011","Doncaster 018C","E01007566",1155,35,10,25,121,99,69,125,233,270,133,84,49,70
"2011","Doncaster 018D","E01007567",980,73,13,60,156,94,86,74,172,176,71,40,31,78
"2011","Doncaster 018E","E01007568",1116,22,5,17,92,82,72,107,259,247,142,101,41,93
"2011","Doncaster 018F","E01007569",1136,24,4,20,145,119,66,102,247,249,89,62,27,95
"2011","Doncaster 019A","E01007644",1169,74,13,61,196,117,96,90,204,170,70,49,21,152
"2011","Doncaster 019B","E01007646",1100,110,27,83,282,91,116,89,133,149,65,49,16,65
"2011","Doncaster 019C","E01007647",1112,96,29,67,252,143,113,78,166,115,58,37,21,91
"2011","Doncaster 019D","E01007648",1503,66,13,53,234,118,115,107,237,356,186,109,77,84
"2011","Doncaster 019E","E01007649",1164,103,20,83,271,114,97,89,178,140,65,45,20,107
"2011","Doncaster 019F","E01007654",1167,57,11,46,160,115,95,122,203,224,128,93,35,63
"2011","Doncaster 020A","E01007583",1121,103,26,77,298,142,131,87,140,123,26,16,10,71
"2011","Doncaster 020B","E01007586",1184,109,29,80,279,186,157,95,130,112,53,39,14,63
"2011","Doncaster 020C","E01007587",1174,128,41,87,260,127,152,104,162,148,47,35,12,46
"2011","Doncaster 020D","E01007620",1245,114,31,83,267,210,131,106,182,142,34,26,8,59
"2011","Doncaster 021A","E01007584",1136,62,16,46,227,177,116,131,197,131,28,18,10,67
"2011","Doncaster 021B","E01007585",1152,52,15,37,251,164,106,105,204,152,49,32,17,69
"2011","Doncaster 021C","E01007617",1095,152,37,115,322,198,135,64,103,54,11,8,3,56
"2011","Doncaster 021D","E01007618",953,79,25,54,261,159,83,86,118,85,16,8,8,66
"2011","Doncaster 021E","E01007619",1296,237,78,159,408,201,139,50,98,64,16,9,7,83
"2011","Doncaster 022A","E01007529",1696,41,14,27,153,99,116,170,324,388,338,277,61,67
"2011","Doncaster 022B","E01007530",877,21,1,20,78,48,93,67,164,212,147,108,39,47
"2011","Doncaster 022C","E01007531",1183,40,6,34,163,125,82,109,271,227,109,74,35,57
"2011","Doncaster 022D","E01007643",1157,27,7,20,132,100,99,86,190,260,176,132,44,87
"2011","Doncaster 022E","E01007645",1589,63,15,48,178,114,122,125,230,377,258,186,72,122
"2011","Doncaster 022F","E01007655",1526,37,9,28,141,105,97,103,323,428,180,109,71,112
"2011","Doncaster 023A","E01007494",1187,43,12,31,198,162,93,116,197,237,90,71,19,51
"2011","Doncaster 023B","E01007532",1344,22,3,19,81,74,75,94,279,339,291,208,83,89
"2011","Doncaster 023C","E01007533",1053,38,9,29,140,116,73,91,221,238,64,46,18,72
"2011","Doncaster 023D","E01007535",1130,42,13,29,163,131,59,96,247,249,89,52,37,54
"2011","Doncaster 024A","E01007522",1041,46,10,36,152,128,72,90,197,184,100,64,36,72
"2011","Doncaster 024B","E01007525",1012,32,10,22,149,113,90,87,222,186,79,52,27,54
"2011","Doncaster 024C","E01007528",894,52,14,38,121,102,64,80,199,160,71,43,28,45
"2011","Doncaster 024D","E01007604",1076,110,28,82,268,156,99,93,136,104,47,29,18,63
"2011","Doncaster 025A","E01007521",1028,126,32,94,279,163,108,52,105,82,45,31,14,68
"2011","Doncaster 025B","E01007523",1098,145,26,119,285,165,95,72,127,93,39,30,9,77
"2011","Doncaster 025C","E01007524",1121,135,33,102,288,168,115,67,133,98,53,32,21,64
"2011","Doncaster 025D","E01007526",1154,165,32,133,288,151,127,61,163,80,41,28,13,78
"2011","Doncaster 025E","E01007607",1051,103,21,82,227,113,85,81,168,135,67,50,17,72
"2011","Doncaster 026A","E01007599",1318,146,45,101,337,212,134,79,170,119,24,18,6,97
"2011","Doncaster 026B","E01007600",1121,127,34,93,289,187,105,83,136,95,16,12,4,83
"2011","Doncaster 026C","E01007601",986,106,40,66,233,155,105,71,131,106,23,17,6,56
"2011","Doncaster 026D","E01007602",1116,102,41,61,300,173,125,81,134,99,23,12,11,79
"2011","Doncaster 026E","E01007603",1108,115,40,75,272,181,132,82,144,98,29,14,15,55
"2011","Doncaster 027A","E01007520",1033,125,32,93,301,167,102,67,125,53,36,28,8,57
"2011","Doncaster 027B","E01007527",1816,307,61,246,514,287,145,98,168,122,57,38,19,118
"2011","Doncaster 027C","E01007605",1093,134,31,103,260,175,124,62,138,86,36,25,11,78
"2011","Doncaster 027D","E01007606",1109,191,62,129,323,167,129,52,90,40,37,27,10,80
"2011","Doncaster 028A","E01007495",1360,55,10,45,163,135,88,118,292,277,156,101,55,76
"2011","Doncaster 028B","E01007500",873,21,5,16,104,88,51,75,195,188,82,63,19,69
"2011","Doncaster 028C","E01007502",2111,281,93,188,605,316,171,162,272,141,65,51,14,98
"2011","Doncaster 028D","E01007534",1543,50,12,38,143,126,71,110,324,378,258,191,67,83
"2011","Doncaster 029A","E01007496",1100,21,4,17,100,93,56,89,227,267,149,104,45,98
"2011","Doncaster 029B","E01007497",984,43,12,31,127,106,67,94,220,194,83,59,24,50
"2011","Doncaster 029C","E01007498",1173,36,8,28,157,137,91,97,248,228,100,63,37,79
"2011","Doncaster 029D","E01007499",1011,27,10,17,98,105,57,79,215,223,131,89,42,76
"2011","Doncaster 029E","E01007501",1051,61,19,42,203,135,99,112,175,173,34,22,12,59
"2011","Doncaster 029F","E01007503",1258,96,29,67,262,189,84,115,237,195,24,13,11,56
"2011","Doncaster 030A","E01007575",956,16,7,9,85,97,65,81,199,215,144,96,48,54
"2011","Doncaster 030B","E01007578",1206,41,12,29,144,152,110,98,239,256,88,51,37,78
"2011","Doncaster 030C","E01007579",1148,46,9,37,164,146,116,114,215,229,64,40,24,54
"2011","Doncaster 030D","E01007580",1071,51,19,32,172,155,97,102,183,187,62,46,16,62
"2011","Doncaster 031A","E01007571",1234,50,18,32,192,194,120,114,209,221,73,40,33,61
"2011","Doncaster 031B","E01007572",1074,54,16,38,155,147,87,117,170,192,80,53,27,72
"2011","Doncaster 031C","E01007573",1062,24,7,17,80,108,73,88,202,263,141,96,45,83
"2011","Doncaster 031D","E01007574",1158,26,6,20,124,135,69,93,240,254,144,96,48,73
"2011","Doncaster 031E","E01007576",1177,51,14,37,195,164,99,90,227,189,78,46,32,84
"2011","Doncaster 031F","E01007577",1115,24,7,17,90,123,74,82,237,267,159,99,60,59
"2011","Doncaster 032A","E01007536",1519,90,30,60,259,197,127,154,271,244,101,51,50,76
"2011","Doncaster 032B","E01007542",1275,41,14,27,132,120,85,95,282,301,153,108,45,66
"2011","Doncaster 032C","E01007543",1109,36,20,16,103,120,86,96,209,259,136,108,28,64
"2011","Doncaster 032D","E01007544",1182,22,8,14,92,82,55,84,230,318,218,172,46,81
"2011","Doncaster 033A","E01007546",1038,32,7,25,147,119,65,98,199,214,105,72,33,59
"2011","Doncaster 033B","E01007551",1228,104,40,64,312,193,99,100,186,134,33,19,14,67
"2011","Doncaster 033C","E01007552",1033,74,25,49,262,154,77,106,157,115,32,19,13,56
"2011","Doncaster 033D","E01007613",1223,135,47,88,302,159,206,89,120,99,27,18,9,86
"2011","Doncaster 034A","E01007545",1122,49,13,36,202,138,78,83,222,223,65,44,21,62
"2011","Doncaster 034B","E01007547",1119,23,4,19,98,75,56,109,284,289,121,71,50,64
"2011","Doncaster 034C","E01007548",751,11,5,6,65,61,40,61,186,200,85,51,34,42
"2011","Doncaster 034D","E01007549",1052,30,13,17,108,94,57,99,237,250,112,78,34,65
"2011","Doncaster 034E","E01007550",1191,41,17,24,131,129,62,108,274,300,76,58,18,70
"2011","Doncaster 035A","E01007537",1274,53,17,36,194,168,140,136,227,194,76,44,32,86
"2011","Doncaster 035B","E01007538",1094,31,10,21,112,116,92,115,216,246,89,64,25,77
"2011","Doncaster 035C","E01007539",1016,30,11,19,111,95,67,99,218,210,123,84,39,63
"2011","Doncaster 035D","E01007540",1188,50,16,34,171,129,103,142,222,223,75,51,24,73
"2011","Doncaster 035E","E01007541",1074,36,10,26,102,129,100,97,204,250,87,61,26,69
"2011","Doncaster 036A","E01007591",1033,42,16,26,134,121,52,116,250,198,61,40,21,59
"2011","Doncaster 036B","E01007594",1530,154,51,103,396,226,116,135,205,155,34,23,11,109
"2011","Doncaster 036C","E01007596",956,91,30,61,229,137,77,83,145,102,33,24,9,59
"2011","Doncaster 036D","E01007598",1198,82,25,57,207,151,93,142,244,186,35,22,13,58
"2011","Doncaster 037A","E01007590",904,26,14,12,82,87,59,102,214,199,64,43,21,71
"2011","Doncaster 037B","E01007592",1075,27,8,19,96,83,55,97,277,240,134,99,35,66
"2011","Doncaster 037C","E01007593",959,19,4,15,92,112,52,107,245,207,74,49,25,51
"2011","Doncaster 037D","E01007595",1060,30,7,23,112,115,71,110,245,221,79,56,23,77
"2011","Doncaster 037E","E01007597",1064,24,4,20,109,93,62,88,243,266,114,79,35,65
"2011","Doncaster 038A","E01007608",1228,88,32,56,253,166,92,111,189,158,52,34,18,119
"2011","Doncaster 038B","E01007609",1699,187,47,140,406,206,172,125,249,191,77,49,28,86
"2011","Doncaster 038C","E01007610",1295,197,60,137,378,187,109,86,153,82,36,25,11,67
"2011","Doncaster 039A","E01007611",971,93,19,74,216,136,102,80,155,108,36,24,12,45
"2011","Doncaster 039B","E01007612",1037,150,45,105,322,128,117,49,127,75,24,16,8,45
"2011","Doncaster 039C","E01007614",1013,162,47,115,320,126,111,44,84,45,73,66,7,48
"2011","Doncaster 039D","E01007615",852,134,36,98,247,97,99,45,110,71,20,12,8,29
"2011","Doncaster 039E","E01007616",907,94,34,60,210,116,85,75,164,107,22,14,8,34
"2011","Rotherham 001A","E01007693",1591,109,27,82,305,223,141,137,271,260,64,34,30,81
"2011","Rotherham 001B","E01007694",1250,33,13,20,146,151,96,94,267,268,101,73,28,94
"2011","Rotherham 001C","E01007695",1788,184,53,131,432,278,170,124,251,185,62,39,23,102
"2011","Rotherham 001D","E01007697",1095,35,8,27,133,107,66,109,248,247,75,47,28,75
"2011","Rotherham 001E","E01007698",1140,69,25,44,218,173,135,114,152,166,48,29,19,65
"2011","Rotherham 002A","E01007816",1196,99,28,71,224,181,94,77,159,192,86,67,19,84
"2011","Rotherham 002B","E01007817",1016,40,11,29,194,136,89,77,178,195,49,30,19,58
"2011","Rotherham 002C","E01007819",1063,94,30,64,228,155,93,81,137,158,57,42,15,60
"2011","Rotherham 002D","E01007820",1107,42,8,34,192,173,78,101,206,175,81,54,27,59
"2011","Rotherham 002E","E01007821",1111,62,12,50,188,158,100,82,206,181,67,44,23,67
"2011","Rotherham 002F","E01007822",1097,44,12,32,159,133,93,89,219,192,119,79,40,49
"2011","Rotherham 003A","E01007796",754,18,8,10,83,119,64,63,149,159,64,36,28,35
"2011","Rotherham 003B","E01007797",1026,40,15,25,155,166,72,103,186,174,65,43,22,65
"2011","Rotherham 003C","E01007798",972,59,24,35,195,162,80,94,178,139,19,12,7,46
"2011","Rotherham 003D","E01007799",1011,53,15,38,165,170,81,85,183,154,60,40,20,60
"2011","Rotherham 003E","E01007800",1114,58,19,39,183,153,83,109,192,210,80,53,27,46
"2011","Rotherham 003F","E01007818",1178,112,40,72,282,173,123,108,142,131,31,20,11,76
"2011","Rotherham 004A","E01007777",1156,64,19,45,169,152,85,107,236,209,78,50,28,56
"2011","Rotherham 004B","E01007793",1028,38,11,27,158,156,79,113,191,176,46,29,17,71
"2011","Rotherham 004C","E01007794",995,44,16,28,148,124,64,80,202,153,114,83,31,66
"2011","Rotherham 004D","E01007795",1175,94,29,65,266,195,90,110,182,146,38,27,11,54
"2011","Rotherham 005A","E01007778",1151,112,42,70,232,185,93,75,176,135,36,21,15,107
"2011","Rotherham 005B","E01007779",909,26,10,16,111,114,72,77,195,191,90,54,36,33
"2011","Rotherham 005C","E01007780",1060,30,10,20,157,164,81,98,236,183,57,34,23,54
"2011","Rotherham 005D","E01007781",1075,45,18,27,143,122,75,108,241,186,69,49,20,86
"2011","Rotherham 005E","E01007782",1077,31,9,22,118,118,76,96,226,217,108,73,35,87
"2011","Rotherham 006A","E01007771",1064,43,15,28,183,175,87,116,216,176,29,20,9,39
"2011","Rotherham 006B","E01007772",992,34,10,24,127,133,65,94,208,215,67,43,24,49
"2011","Rotherham 006C","E01007773",998,38,14,24,111,130,60,90,225,213,74,41,33,57
"2011","Rotherham 006D","E01007774",1099,32,9,23,132,141,83,103,233,210,102,65,37,63
"2011","Rotherham 007A","E01007696",1111,125,34,91,298,132,165,76,159,80,30,20,10,46
"2011","Rotherham 007B","E01007801",1148,125,43,82,289,192,121,81,155,89,20,12,8,76
"2011","Rotherham 007C","E01007802",1070,106,29,77,279,159,106,85,147,102,16,11,5,70
"2011","Rotherham 007D","E01007803",1001,57,22,35,193,149,100,89,180,130,39,23,16,64
"2011","Rotherham 007E","E01007808",1193,131,45,86,322,204,110,104,140,77,27,18,9,78
"2011","Rotherham 008A","E01007775",911,19,7,12,74,81,54,74,216,203,133,97,36,57
"2011","Rotherham 008B","E01007776",1109,49,15,34,173,148,87,100,192,207,86,61,25,67
"2011","Rotherham 008C","E01007783",1220,51,15,36,173,166,70,104,248,236,119,87,32,53
"2011","Rotherham 008D","E01007784",1300,62,16,46,197,171,111,103,250,172,169,110,59,65
"2011","Rotherham 009A","E01007728",844,37,13,24,133,115,81,72,159,151,47,36,11,49
"2011","Rotherham 009B","E01007729",1267,36,13,23,144,150,79,95,273,289,147,91,56,54
"2011","Rotherham 009C","E01007730",1065,30,16,14,137,108,64,103,233,236,99,67,32,55
"2011","Rotherham 009D","E01007731",927,55,18,37,165,133,106,95,155,133,35,21,14,50
"2011","Rotherham 009E","E01007732",1104,34,12,22,116,123,74,97,259,234,111,78,33,56
"2011","Rotherham 009F","E01007733",996,26,8,18,137,127,63,92,233,199,77,55,22,42
"2011","Rotherham 010A","E01007719",882,27,11,16,68,80,54,68,204,220,117,77,40,44
"2011","Rotherham 010B","E01007720",1094,82,24,58,200,133,124,91,183,159,75,56,19,47
"2011","Rotherham 010C","E01007721",1135,35,15,20,132,91,82,103,239,250,135,95,40,68
"2011","Rotherham 010D","E01007727",1120,15,4,11,114,100,97,105,250,266,107,73,34,66
"2011","Rotherham 011A","E01007740",1077,28,12,16,129,119,58,108,233,229,86,55,31,87
"2011","Rotherham 011B","E01007804",1016,27,8,19,122,121,61,79,237,212,80,51,29,77
"2011","Rotherham 011C","E01007805",1006,13,1,12,115,117,55,95,237,211,105,65,40,58
"2011","Rotherham 011D","E01007806",896,16,5,11,99,107,45,89,202,187,85,48,37,66
"2011","Rotherham 011E","E01007807",1014,40,18,22,152,136,52,96,239,160,60,32,28,79
"2011","Rotherham 012A","E01007681",1004,84,21,63,202,150,81,109,154,142,37,28,9,45
"2011","Rotherham 012B","E01007691",1541,158,36,122,418,245,167,106,204,149,31,22,9,63
"2011","Rotherham 012C","E01007692",1137,133,37,96,281,149,101,102,169,140,23,13,10,39
"2011","Rotherham 012E","E01032926",1236,142,36,106,352,187,104,81,167,107,32,25,7,64
"2011","Rotherham 012F","E01032927",1099,72,26,46,209,145,84,106,182,170,45,27,18,86
"2011","Rotherham 013A","E01007723",989,22,4,18,97,93,74,88,226,234,89,57,32,66
"2011","Rotherham 013B","E01007735",979,21,7,14,67,62,62,88,220,232,158,122,36,69
"2011","Rotherham 013C","E01007737",1064,18,8,10,72,85,43,75,255,242,189,134,55,85
"2011","Rotherham 013D","E01007738",1058,21,8,13,104,81,58,90,231,224,155,121,34,94
"2011","Rotherham 013E","E01007739",1091,28,6,22,96,85,62,88,225,253,171,142,29,83
"2011","Rotherham 014A","E01007736",1104,19,5,14,71,86,72,77,211,248,237,189,48,83
"2011","Rotherham 014B","E01007765",1167,46,10,36,196,142,94,114,212,201,81,56,25,81
"2011","Rotherham 014C","E01007766",1057,20,8,12,89,95,77,105,213,244,122,95,27,92
"2011","Rotherham 014D","E01007768",1327,22,5,17,110,106,100,95,258,242,279,222,57,115
"2011","Rotherham 014E","E01007770",1258,31,7,24,140,106,97,92,242,251,194,155,39,105
"2011","Rotherham 015A","E01007741",1204,78,26,52,215,190,85,127,231,189,32,18,14,57
"2011","Rotherham 015B","E01007742",1035,62,25,37,168,148,94,84,181,170,47,35,12,81
"2011","Rotherham 015C","E01007743",1049,58,20,38,202,171,77,114,188,135,33,15,18,71
"2011","Rotherham 015D","E01007744",1182,58,18,40,226,165,91,103,220,186,73,58,15,60
"2011","Rotherham 015E","E01007745",1086,37,8,29,140,144,87,92,240,201,81,61,20,64
"2011","Rotherham 015F","E01007746",1151,53,14,39,172,157,87,122,215,196,61,38,23,88
"2011","Rotherham 016A","E01007715",1183,28,8,20,106,75,114,67,217,216,267,214,53,93
"2011","Rotherham 016B","E01007716",1355,24,3,21,113,120,107,93,248,231,282,213,69,137
"2011","Rotherham 016C","E01007717",1407,66,15,51,219,181,105,130,223,238,146,100,46,99
"2011","Rotherham 016D","E01007718",1089,35,6,29,127,130,88,76,228,215,136,90,46,54
"2011","Rotherham 017A","E01007677",984,40,10,30,117,77,50,54,175,223,191,147,44,57
"2011","Rotherham 017B","E01007714",1523,61,11,50,183,125,135,116,276,257,256,213,43,114
"2011","Rotherham 017C","E01007767",1180,92,26,66,214,133,103,74,178,162,145,109,36,79
"2011","Rotherham 017D","E01007769",1185,33,9,24,72,51,105,52,236,219,316,277,39,101
"2011","Rotherham 018A","E01007685",1094,88,26,62,238,180,110,102,178,129,21,16,5,48
"2011","Rotherham 018B","E01007754",1088,90,27,63,230,175,112,83,157,115,54,43,11,72
"2011","Rotherham 018C","E01007755",1092,77,22,55,225,180,89,113,197,124,30,18,12,57
"2011","Rotherham 018D","E01007756",1142,96,32,64,260,184,101,106,186,113,25,19,6,71
"2011","Rotherham 018E","E01007761",1148,45,15,30,164,139,97,119,209,227,72,38,34,76
"2011","Rotherham 018F","E01007762",1004,69,20,49,177,147,100,95,159,149,44,25,19,64
"2011","Rotherham 019A","E01007682",1039,48,11,37,156,163,81,88,203,189,47,27,20,64
"2011","Rotherham 019B","E01007683",1120,88,24,64,214,174,93,104,178,167,30,19,11,72
"2011","Rotherham 019C","E01007686",997,106,32,74,253,182,70,83,141,85,28,20,8,49
"2011","Rotherham 019D","E01007688",1050,83,30,53,227,173,101,89,161,116,38,15,23,62
"2011","Rotherham 019E","E01007725",944,79,20,59,219,138,68,80,140,120,27,15,12,73
"2011","Rotherham 019F","E01007726",1091,41,12,29,144,129,59,94,219,252,104,71,33,49
"2011","Rotherham 020A","E01007757",1265,55,15,40,197,173,87,141,237,234,75,51,24,66
"2011","Rotherham 020B","E01007758",953,35,13,22,124,112,78,95,188,193,72,51,21,56
"2011","Rotherham 020C","E01007759",1109,33,14,19,122,123,73,112,212,273,95,70,25,66
"2011","Rotherham 020D","E01007760",1291,24,5,19,133,102,87,124,267,311,159,96,63,84
"2011","Rotherham 020E","E01007763",1078,30,10,20,149,108,72,108,205,243,103,60,43,60
"2011","Rotherham 020F","E01007764",1155,39,16,23,90,88,80,112,230,260,177,105,72,79
"2011","Rotherham 021A","E01007708",1155,36,16,20,146,97,86,100,260,241,104,81,23,85
"2011","Rotherham 021B","E01007709",1033,100,28,72,287,161,93,82,142,85,20,13,7,63
"2011","Rotherham 021C","E01007710",1142,111,40,71,244,222,110,102,156,103,24,16,8,70
"2011","Rotherham 021D","E01007711",1238,137,36,101,271,211,129,99,153,103,47,31,16,88
"2011","Rotherham 021E","E01007724",1038,103,32,71,274,163,103,71,140,108,22,11,11,54
"2011","Rotherham 021F","E01007734",1229,28,7,21,127,108,91,111,281,213,173,127,46,97
"2011","Rotherham 022A","E01007684",1238,98,21,77,248,212,94,121,192,154,44,37,7,75
"2011","Rotherham 022B","E01007687",1022,113,30,83,244,130,97,70,153,118,36,18,18,61
"2011","Rotherham 022C","E01007689",1107,128,36,92,309,172,70,99,141,94,24,13,11,70
"2011","Rotherham 022D","E01007690",1209,196,62,134,345,178,148,59,115,69,25,18,7,74
"2011","Rotherham 023A","E01007675",1294,121,18,103,259,154,128,70,153,138,172,154,18,99
"2011","Rotherham 023B","E01007678",1197,251,40,211,326,140,107,43,107,56,87,74,13,80
"2011","Rotherham 023C","E01007679",1292,118,22,96,225,144,128,88,170,160,133,104,29,126
"2011","Rotherham 023D","E01007680",1284,89,20,69,194,107,129,76,202,131,220,195,25,136
"2011","Rotherham 023E","E01007712",1409,182,53,129,361,212,137,82,139,115,92,71,21,89
"2011","Rotherham 023F","E01007713",1161,195,36,159,288,186,105,62,124,64,48,44,4,89
"2011","Rotherham 024A","E01007811",972,70,21,49,225,172,81,75,149,105,30,23,7,65
"2011","Rotherham 024B","E01007812",913,56,14,42,105,111,77,79,192,157,71,51,20,65
"2011","Rotherham 024C","E01007813",985,67,16,51,225,147,90,91,148,120,38,21,17,59
"2011","Rotherham 024D","E01007814",829,109,27,82,190,123,133,54,96,64,13,9,4,47
"2011","Rotherham 025A","E01007676",1215,60,18,42,184,148,98,120,248,207,83,59,24,67
"2011","Rotherham 025B","E01007702",1166,64,24,40,145,129,82,121,241,211,96,67,29,77
"2011","Rotherham 025C","E01007703",893,54,20,34,142,145,86,93,173,111,36,24,12,53
"2011","Rotherham 025D","E01007704",1028,40,12,28,172,147,87,102,188,178,62,42,20,52
"2011","Rotherham 025E","E01007705",1127,55,22,33,221,186,92,116,216,143,31,19,12,67
"2011","Rotherham 025F","E01007707",1180,59,14,45,195,174,111,112,251,172,46,27,19,60
"2011","Rotherham 026A","E01007666",1102,103,33,70,243,176,115,95,147,120,30,18,12,73
"2011","Rotherham 026B","E01007809",1086,41,14,27,119,101,87,115,232,209,119,76,43,63
"2011","Rotherham 026C","E01007810",1382,103,41,62,233,172,132,119,241,219,64,41,23,99
"2011","Rotherham 026D","E01007815",1254,52,12,40,179,130,109,128,269,202,117,73,44,68
"2011","Rotherham 027A","E01007665",1351,106,33,73,260,174,129,135,240,178,48,40,8,81
"2011","Rotherham 027B","E01007699",1363,78,18,60,256,172,104,125,265,214,78,48,30,71
"2011","Rotherham 027C","E01007700",1324,141,29,112,319,199,95,94,204,128,69,42,27,75
"2011","Rotherham 027D","E01007701",1189,49,12,37,194,134,93,100,262,198,103,69,34,56
"2011","Rotherham 027E","E01007706",1148,69,21,48,190,157,77,107,241,188,55,34,21,64
"2011","Rotherham 028A","E01007787",2121,228,68,160,524,280,252,173,268,193,100,72,28,103
"2011","Rotherham 028B","E01007788",1125,121,39,82,260,128,127,89,145,157,50,30,20,48
"2011","Rotherham 028C","E01007789",1147,60,16,44,173,115,102,116,218,210,101,68,33,52
"2011","Rotherham 028D","E01007792",1037,115,38,77,279,156,75,86,124,72,23,19,4,107
"2011","Rotherham 029A","E01007657",1090,76,25,51,227,158,81,109,219,124,29,22,7,67
"2011","Rotherham 029B","E01007659",857,77,21,56,178,137,68,85,147,104,17,11,6,44
"2011","Rotherham 029C","E01007785",1002,75,23,52,180,146,100,60,182,130,59,42,17,70
"2011","Rotherham 029D","E01007786",835,79,18,61,176,124,64,78,137,99,44,37,7,34
"2011","Rotherham 029E","E01007790",1054,40,8,32,129,83,69,93,222,233,135,87,48,50
"2011","Rotherham 029F","E01007791",1002,33,9,24,108,75,69,97,219,239,107,66,41,55
"2011","Rotherham 030A","E01007667",1010,36,14,22,133,157,67,69,218,192,61,40,21,77
"2011","Rotherham 030B","E01007668",1093,33,6,27,92,101,63,113,275,241,109,78,31,66
"2011","Rotherham 030C","E01007669",1133,86,25,61,228,179,102,99,207,143,39,27,12,50
"2011","Rotherham 030D","E01007670",1138,111,31,80,302,207,113,76,137,108,20,11,9,64
"2011","Rotherham 030E","E01007672",1101,101,27,74,247,190,87,83,193,129,25,15,10,46
"2011","Rotherham 030F","E01007673",1031,48,14,34,140,144,82,106,214,174,80,58,22,43
"2011","Rotherham 031A","E01007671",1580,164,49,115,310,255,138,148,243,179,38,22,16,105
"2011","Rotherham 031B","E01007674",1463,142,40,102,354,272,125,124,223,135,32,16,16,56
"2011","Rotherham 031C","E01007747",942,28,9,19,128,109,74,92,188,197,62,39,23,64
"2011","Rotherham 031D","E01007750",1123,133,42,91,227,152,112,87,192,122,37,26,11,61
"2011","Rotherham 032A","E01007658",1069,112,28,84,244,140,127,84,166,111,31,19,12,54
"2011","Rotherham 032B","E01007660",948,73,24,49,236,163,88,79,130,97,33,23,10,49
"2011","Rotherham 032C","E01007661",1064,145,47,98,247,150,110,77,138,89,34,22,12,74
"2011","Rotherham 032D","E01007662",703,28,7,21,96,63,49,58,147,150,70,41,29,42
"2011","Rotherham 032E","E01007663",1112,143,42,101,296,193,96,77,157,81,18,13,5,51
"2011","Rotherham 032F","E01007664",1394,132,52,80,335,210,138,104,222,148,28,17,11,77
"2011","Rotherham 033A","E01007748",1095,121,39,82,233,180,133,92,131,117,30,22,8,58
"2011","Rotherham 033B","E01007749",1309,160,43,117,320,187,120,96,180,150,29,17,12,67
"2011","Rotherham 033C","E01007751",1421,158,46,112,325,181,143,93,214,171,60,39,21,76
"2011","Rotherham 033D","E01007752",1124,139,42,97,260,189,130,91,140,102,26,18,8,47
"2011","Rotherham 033E","E01007753",1103,118,48,70,237,138,135,69,178,122,34,23,11,72
"2011","Sheffield 001A","E01008144",1196,90,20,70,220,197,111,116,204,161,54,26,28,43
"2011","Sheffield 001B","E01008145",1069,56,16,40,148,135,85,95,222,206,66,41,25,56
"2011","Sheffield 001C","E01008148",1079,75,21,54,176,137,71,97,224,163,74,43,31,62
"2011","Sheffield 001D","E01008149",1147,81,32,49,227,173,110,114,177,174,18,9,9,73
"2011","Sheffield 001E","E01008150",998,53,17,36,178,170,65,103,172,165,44,25,19,48
"2011","Sheffield 002A","E01008142",1044,64,15,49,185,135,89,92,199,154,53,34,19,73
"2011","Sheffield 002B","E01008143",1225,97,29,68,278,188,138,94,182,150,43,22,21,55
"2011","Sheffield 002C","E01008146",1002,122,36,86,257,174,86,101,109,86,18,11,7,49
"2011","Sheffield 002D","E01008147",1089,140,44,96,255,177,113,85,140,104,17,11,6,58
"2011","Sheffield 003A","E01007888",1110,95,20,75,218,195,102,91,187,138,25,19,6,59
"2011","Sheffield 003B","E01007892",1041,28,8,20,123,103,63,93,228,210,109,80,29,84
"2011","Sheffield 003C","E01007893",1152,109,37,72,263,209,106,100,160,114,28,17,11,63
"2011","Sheffield 003D","E01007898",1140,111,29,82,286,199,100,88,163,100,17,5,12,76
"2011","Sheffield 003E","E01007899",1113,123,35,88,256,186,115,98,166,95,23,19,4,51
"2011","Sheffield 003F","E01007900",1242,71,24,47,188,161,88,116,245,224,71,46,25,78
"2011","Sheffield 003G","E01007901",1007,38,15,23,151,110,78,74,237,181,79,42,37,59
"2011","Sheffield 004A","E01007887",1017,80,20,60,223,161,81,92,177,116,38,25,13,49
"2011","Sheffield 004B","E01007889",1926,223,55,168,463,313,175,156,269,179,34,18,16,114
"2011","Sheffield 004C","E01007890",1084,107,23,84,234,176,140,99,164,103,19,13,6,42
"2011","Sheffield 004D","E01007891",1162,124,37,87,285,185,122,99,151,105,15,10,5,76
"2011","Sheffield 004E","E01007894",1075,90,20,70,251,144,98,85,196,119,36,20,16,56
"2011","Sheffield 004F","E01007895",1045,51,18,33,174,138,93,92,192,161,73,55,18,71
"2011","Sheffield 004G","E01007896",1001,84,20,64,235,195,85,91,164,92,9,5,4,46
"2011","Sheffield 005A","E01007897",1077,99,33,66,244,161,87,107,203,100,20,14,6,56
"2011","Sheffield 005B","E01008134",967,135,30,105,200,146,121,57,125,89,34,17,17,60
"2011","Sheffield 005C","E01008135",1336,166,49,117,295,215,147,104,186,102,35,26,9,86
"2011","Sheffield 005D","E01008137",1083,130,34,96,304,189,115,67,116,86,13,6,7,63
"2011","Sheffield 005E","E01008141",1168,165,47,118,292,186,148,73,151,77,21,15,6,55
"2011","Sheffield 006A","E01008053",924,27,8,19,136,108,55,72,202,186,82,64,18,56
"2011","Sheffield 006B","E01008056",1068,27,7,20,118,122,83,101,240,238,77,45,32,62
"2011","Sheffield 006C","E01008058",1104,63,11,52,197,143,117,75,222,155,69,48,21,63
"2011","Sheffield 006D","E01008138",891,64,21,43,138,127,70,73,160,164,50,34,16,45
"2011","Sheffield 006E","E01008139",1173,80,24,56,237,169,96,97,221,163,55,33,22,55
"2011","Sheffield 007A","E01007856",925,29,5,24,107,98,63,99,201,174,74,49,25,80
"2011","Sheffield 007B","E01008054",914,21,4,17,103,81,58,76,188,190,122,91,31,75
"2011","Sheffield 007C","E01008055",1027,21,10,11,97,129,48,81,228,218,125,87,38,80
"2011","Sheffield 007D","E01008057",999,19,1,18,115,108,83,82,229,200,108,87,21,55
"2011","Sheffield 008A","E01008126",1152,152,44,108,277,197,129,90,123,85,23,11,12,76
"2011","Sheffield 008C","E01008128",1306,225,64,161,357,167,218,64,122,71,25,15,10,57
"2011","Sheffield 008D","E01008136",991,110,27,83,220,131,95,69,149,128,42,27,15,47
"2011","Sheffield 008E","E01008140",1316,169,42,127,322,194,146,75,165,134,37,23,14,74
"2011","Sheffield 008F","E01033275",1194,230,35,195,333,158,100,55,117,66,39,26,13,96
"2011","Sheffield 008G","E01033280",1221,178,41,137,359,164,112,75,109,67,70,60,10,87
"2011","Sheffield 009A","E01008085",980,37,16,21,88,98,62,98,242,191,98,64,34,66
"2011","Sheffield 009B","E01008086",949,23,10,13,115,94,55,68,216,230,93,67,26,55
"2011","Sheffield 009C","E01008116",939,20,5,15,74,91,58,82,228,211,109,73,36,66
"2011","Sheffield 009D","E01008117",884,16,2,14,83,89,55,79,201,198,106,62,44,57
"2011","Sheffield 009E","E01008118",993,23,9,14,109,102,46,89,232,229,101,57,44,62
"2011","Sheffield 009F","E01008119",840,18,4,14,79,75,59,87,192,186,80,52,28,64
"2011","Sheffield 009G","E01008125",1041,46,19,27,115,112,101,101,225,212,78,54,24,51
"2011","Sheffield 010A","E01007849",1471,64,14,50,209,182,85,116,300,202,159,118,41,154
"2011","Sheffield 010B","E01007857",1070,31,7,24,119,112,53,80,265,240,105,74,31,65
"2011","Sheffield 010C","E01008059",1035,23,4,19,99,112,68,105,225,222,119,78,41,62
"2011","Sheffield 010D","E01008060",952,23,9,14,113,125,53,74,216,188,96,55,41,64
"2011","Sheffield 011A","E01008061",1060,32,7,25,112,125,77,79,231,206,120,76,44,78
"2011","Sheffield 011B","E01008063",1136,47,7,40,195,159,86,84,240,163,96,66,30,66
"2011","Sheffield 011E","E01033277",1606,20,3,17,142,147,86,142,337,384,232,153,79,116
"2011","Sheffield 012A","E01008087",1177,76,15,61,216,185,114,84,254,144,32,18,14,72
"2011","Sheffield 012B","E01008088",1100,71,28,43,190,157,76,107,222,172,46,28,18,59
"2011","Sheffield 012C","E01008090",1161,35,13,22,120,125,88,94,263,238,130,77,53,68
"2011","Sheffield 012D","E01008092",1021,31,7,24,118,118,62,73,246,193,130,82,48,50
"2011","Sheffield 012E","E01008122",908,15,5,10,69,82,40,80,221,218,124,87,37,59
"2011","Sheffield 012F","E01008124",1029,25,6,19,95,100,54,80,273,200,137,83,54,65
"2011","Sheffield 013A","E01007848",1180,25,3,22,139,124,57,84,229,246,178,143,35,98
"2011","Sheffield 013B","E01007851",1005,33,7,26,112,100,76,69,185,148,170,124,46,112
"2011","Sheffield 013C","E01007947",1099,30,5,25,79,93,74,81,251,225,183,129,54,83
"2011","Sheffield 013D","E01007948",1091,20,4,16,132,91,63,66,195,203,191,157,34,130
"2011","Sheffield 013E","E01008062",1064,24,8,16,95,109,57,52,223,181,201,166,35,122
"2011","Sheffield 014A","E01007847",972,38,10,28,150,113,66,95,200,174,90,59,31,46
"2011","Sheffield 014B","E01007850",1211,61,23,38,171,189,97,109,256,187,54,34,20,87
"2011","Sheffield 014C","E01007852",1175,72,24,48,193,157,107,131,220,173,51,26,25,71
"2011","Sheffield 014D","E01007853",1185,38,4,34,196,189,71,125,237,197,51,34,17,81
"2011","Sheffield 014E","E01007854",1156,49,15,34,145,144,92,72,228,184,148,131,17,94
"2011","Sheffield 014F","E01007855",1471,68,19,49,242,180,99,124,290,210,167,124,43,91
"2011","Sheffield 015A","E01007941",1101,46,14,32,131,122,66,78,255,206,117,81,36,80
"2011","Sheffield 015B","E01007945",1254,30,4,26,157,124,83,87,310,232,140,99,41,91
"2011","Sheffield 015C","E01007946",1071,33,9,24,92,128,61,79,271,209,149,100,49,49
"2011","Sheffield 015D","E01007950",1009,29,7,22,102,109,51,98,250,207,95,71,24,68
"2011","Sheffield 015E","E01008123",891,23,9,14,79,93,58,84,218,186,92,62,30,58
"2011","Sheffield 016A","E01007987",1118,165,32,133,294,166,80,57,122,102,36,19,17,96
"2011","Sheffield 016B","E01007988",1102,134,28,106,276,183,95,79,173,66,25,11,14,71
"2011","Sheffield 016C","E01007989",1110,131,23,108,276,179,86,75,162,102,31,18,13,68
"2011","Sheffield 016D","E01007991",1065,63,12,51,192,140,88,83,198,147,56,33,23,98
"2011","Sheffield 017A","E01007995",1186,140,16,124,279,190,97,76,168,124,38,27,11,74
"2011","Sheffield 017B","E01008089",1135,73,19,54,176,126,68,80,215,175,104,75,29,118
"2011","Sheffield 017C","E01008091",1190,115,28,87,260,196,86,97,187,140,25,9,16,84
"2011","Sheffield 017D","E01008093",1157,101,19,82,282,164,70,96,176,157,43,30,13,68
"2011","Sheffield 018A","E01007903",1114,40,5,35,109,119,130,71,217,134,168,134,34,126
"2011","Sheffield 018B","E01007904",1117,26,2,24,77,94,63,73,227,211,223,195,28,123
"2011","Sheffield 018C","E01007913",946,30,1,29,90,62,96,65,120,100,277,231,46,106
"2011","Sheffield 018D","E01007914",978,37,7,30,69,79,88,60,153,134,225,191,34,133
"2011","Sheffield 019A","E01007870",1350,79,14,65,207,132,96,78,196,175,224,189,35,163
"2011","Sheffield 019B","E01007871",1284,66,9,57,175,121,108,95,236,240,143,101,42,100
"2011","Sheffield 019C","E01007943",1156,29,9,20,115,103,76,104,273,252,144,101,43,60
"2011","Sheffield 019D","E01008094",790,20,5,15,92,71,58,52,195,171,90,71,19,41
"2011","Sheffield 020A","E01007869",1131,53,6,47,163,117,103,38,142,106,244,210,34,165
"2011","Sheffield 020B","E01007872",1177,77,12,65,220,118,112,60,178,105,188,160,28,119
"2011","Sheffield 020C","E01007873",1191,42,4,38,108,93,112,69,199,145,248,201,47,175
"2011","Sheffield 020D","E01007942",1232,89,9,80,114,86,143,71,156,99,301,270,31,173
"2011","Sheffield 020E","E01007949",1029,48,7,41,126,96,109,56,176,103,197,163,34,118
"2011","Sheffield 021A","E01007990",1072,86,25,61,232,161,121,85,164,118,54,31,23,51
"2011","Sheffield 021B","E01007992",1218,142,24,118,313,190,70,87,178,115,45,30,15,78
"2011","Sheffield 021C","E01007993",1181,70,17,53,211,156,77,107,227,182,68,39,29,83
"2011","Sheffield 021D","E01007994",1109,139,19,120,308,162,91,67,161,98,17,10,7,66
"2011","Sheffield 021E","E01007996",1105,107,17,90,261,143,114,79,179,126,37,28,9,59
"2011","Sheffield 022A","E01007874",1170,28,7,21,119,94,77,61,193,154,261,216,45,183
"2011","Sheffield 022B","E01007875",1162,33,6,27,121,72,80,53,137,138,282,234,48,246
"2011","Sheffield 022D","E01007877",861,43,5,38,83,75,83,81,128,95,168,155,13,105
"2011","Sheffield 022E","E01007940",1084,43,9,34,119,88,70,52,166,144,246,218,28,156
"2011","Sheffield 022F","E01007944",1260,22,3,19,136,98,108,42,211,132,353,302,51,158
"2011","Sheffield 022G","E01033269",1220,21,9,12,111,69,70,72,171,166,349,297,52,191
"2011","Sheffield 022H","E01033270",1236,152,10,142,243,111,41,52,123,106,167,140,27,241
"2011","Sheffield 023A","E01008129",1029,137,28,109,270,126,157,61,108,72,25,10,15,73
"2011","Sheffield 023B","E01008130",1119,127,31,96,260,163,111,71,166,119,33,24,9,69
"2011","Sheffield 023C","E01008131",1159,129,28,101,271,217,123,71,140,96,26,16,10,86
"2011","Sheffield 023D","E01008132",1049,178,37,141,306,163,81,60,122,49,13,7,6,77
"2011","Sheffield 023E","E01008133",1050,126,31,95,218,158,124,79,149,112,25,17,8,59
"2011","Sheffield 024A","E01008151",1314,192,19,173,370,112,98,52,100,79,43,25,18,268
"2011","Sheffield 024B","E01008153",1338,253,32,221,369,154,72,56,140,116,53,30,23,125
"2011","Sheffield 024C","E01008154",1288,230,18,212,324,144,108,78,150,115,39,28,11,100
"2011","Sheffield 024D","E01008155",1278,187,11,176,323,136,71,57,136,114,48,35,13,206
"2011","Sheffield 024E","E01008156",1172,181,27,154,333,184,116,79,113,73,23,13,10,70
"2011","Sheffield 024F","E01008160",1068,123,18,105,269,151,66,68,175,114,34,20,14,68
"2011","Sheffield 025A","E01007997",1049,104,32,72,212,187,98,76,181,96,29,19,10,66
"2011","Sheffield 025B","E01007998",1121,58,17,41,143,155,93,98,225,208,97,54,43,44
"2011","Sheffield 025C","E01008152",1001,127,24,103,226,134,108,81,154,90,30,23,7,51
"2011","Sheffield 025D","E01008158",1129,85,13,72,226,156,88,76,185,183,63,49,14,67
"2011","Sheffield 026A","E01008065",1390,57,12,45,135,92,82,78,230,204,239,183,56,273
"2011","Sheffield 026B","E01008068",2407,94,10,84,118,87,35,77,137,167,186,146,40,1506
"2011","Sheffield 026C","E01008072",1120,106,8,98,177,102,81,53,153,125,138,111,27,185
"2011","Sheffield 026D","E01008157",1167,64,13,51,156,95,71,100,221,279,89,58,31,92
"2011","Sheffield 026E","E01008161",1332,149,26,123,285,173,104,110,219,152,62,35,27,78
"2011","Sheffield 027A","E01007883",848,19,4,15,63,61,54,56,130,126,211,194,17,128
"2011","Sheffield 027B","E01007902",1198,25,5,20,87,87,122,97,235,233,221,177,44,91
"2011","Sheffield 027C","E01007905",1147,53,16,37,91,132,88,50,133,99,337,299,38,164
"2011","Sheffield 027D","E01007906",1313,45,10,35,121,111,115,73,197,187,291,260,31,173
"2011","Sheffield 028A","E01008064",1492,173,11,162,241,97,54,44,73,49,31,19,12,730
"2011","Sheffield 028B","E01008066",1488,91,9,82,102,60,26,27,58,32,24,13,11,1068
"2011","Sheffield 028C","E01008069",1469,128,7,121,193,75,32,35,74,54,30,18,12,848
"2011","Sheffield 028D","E01008074",1268,194,16,178,274,113,45,32,59,40,21,14,7,490
"2011","Sheffield 029A","E01007951",1149,211,30,181,325,134,78,47,103,48,19,12,7,184
"2011","Sheffield 029B","E01007960",1278,197,19,178,298,135,67,67,119,62,27,14,13,306
"2011","Sheffield 029C","E01007962",1202,161,13,148,216,92,38,37,72,62,39,26,13,485
"2011","Sheffield 029D","E01008159",1223,258,18,240,339,163,80,45,93,70,26,16,10,149
"2011","Sheffield 030A","E01007866",1514,194,9,185,191,70,49,29,55,22,22,12,10,882
"2011","Sheffield 030B","E01007867",1881,120,6,114,150,68,33,18,77,32,31,22,9,1352
"2011","Sheffield 030C","E01007868",869,220,11,209,187,71,40,19,49,15,28,23,5,240
"2011","Sheffield 030D","E01008067",1577,53,3,50,90,37,24,10,45,28,36,30,6,1254
"2011","Sheffield 030E","E01008073",1469,162,15,147,203,91,76,39,107,82,123,87,36,586
"2011","Sheffield 032A","E01007907",1166,72,21,51,156,126,117,85,174,166,138,125,13,132
"2011","Sheffield 032B","E01007908",1154,61,11,50,203,185,104,110,234,138,50,32,18,69
"2011","Sheffield 032C","E01007909",1499,111,21,90,310,236,129,129,251,171,67,50,17,95
"2011","Sheffield 032D","E01007911",1042,83,26,57,197,187,74,108,189,127,20,14,6,57
"2011","Sheffield 032E","E01008014",1057,40,15,25,114,102,97,99,228,187,119,95,24,71
"2011","Sheffield 032F","E01008016",1056,38,7,31,126,106,84,106,221,212,68,52,16,95
"2011","Sheffield 033A","E01007952",1107,259,37,222,310,151,126,36,80,36,22,14,8,87
"2011","Sheffield 033B","E01007953",1079,209,32,177,270,144,118,54,114,81,33,19,14,56
"2011","Sheffield 033C","E01007954",1172,279,49,230,349,155,79,57,88,44,16,10,6,105
"2011","Sheffield 033D","E01007961",1066,232,43,189,319,132,89,44,82,46,27,16,11,95
"2011","Sheffield 036A","E01007859",1499,171,13,158,183,48,45,17,30,21,12,9,3,972
"2011","Sheffield 036B","E01007860",1296,239,12,227,177,57,35,23,52,30,39,25,14,644
"2011","Sheffield 036C","E01007863",1579,279,43,236,269,108,62,32,66,36,25,16,9,702
"2011","Sheffield 036D","E01007864",1823,72,6,66,135,61,20,26,57,28,12,10,2,1412
"2011","Sheffield 036E","E01008104",1275,166,23,143,159,52,55,29,67,40,57,41,16,650
"2011","Sheffield 037A","E01007910",1146,72,19,53,165,148,102,104,221,171,91,72,19,72
"2011","Sheffield 037B","E01007912",1115,65,22,43,190,182,114,101,195,153,45,27,18,70
"2011","Sheffield 037C","E01007971",963,60,18,42,146,142,77,94,176,167,41,25,16,60
"2011","Sheffield 037D","E01007973",1070,81,23,58,199,184,104,93,197,124,32,22,10,56
"2011","Sheffield 038A","E01007858",1051,307,36,271,332,88,110,20,50,36,26,13,13,82
"2011","Sheffield 038B","E01007861",1096,362,54,308,330,119,87,24,48,17,18,11,7,91
"2011","Sheffield 038C","E01007862",3905,233,23,210,163,62,51,18,51,19,33,27,6,3275
"2011","Sheffield 038D","E01007865",1220,354,51,303,402,112,113,30,60,37,24,13,11,88
"2011","Sheffield 039A","E01008011",1091,23,6,17,111,78,46,77,232,257,188,136,52,79
"2011","Sheffield 039B","E01008012",1537,87,11,76,189,148,66,98,284,308,223,156,67,134
"2011","Sheffield 039C","E01008013",837,26,5,21,100,81,45,63,183,189,100,77,23,50
"2011","Sheffield 039D","E01008015",1157,29,13,16,97,98,76,87,263,305,125,85,40,77
"2011","Sheffield 039E","E01008017",1145,22,7,15,99,108,65,86,253,250,161,122,39,101
"2011","Sheffield 039F","E01008018",907,21,8,13,93,84,41,67,213,227,111,87,24,50
"2011","Sheffield 040A","E01008105",3030,117,17,100,207,120,111,65,135,88,136,105,31,2051
"2011","Sheffield 040C","E01008107",1191,72,13,59,187,77,74,81,142,118,153,109,44,287
"2011","Sheffield 040D","E01008111",1482,145,17,128,194,69,64,37,96,58,50,36,14,769
"2011","Sheffield 040E","E01033271",1059,63,10,53,122,58,78,52,155,122,200,162,38,209
"2011","Sheffield 040F","E01033272",980,168,16,152,187,88,38,47,86,81,109,78,31,176
"2011","Sheffield 041A","E01007955",961,272,43,229,290,119,64,26,53,39,21,13,8,77
"2011","Sheffield 041B","E01007956",1477,448,69,379,440,156,130,44,79,38,30,26,4,112
"2011","Sheffield 041C","E01007957",1123,293,28,265,360,122,94,36,76,40,23,17,6,79
"2011","Sheffield 041D","E01007958",1000,325,53,272,305,98,83,14,60,31,23,14,9,61
"2011","Sheffield 041E","E01007959",1024,297,49,248,329,123,79,25,54,27,18,13,5,72
"2011","Sheffield 042A","E01008108",1659,109,7,102,211,139,73,92,166,105,131,110,21,633
"2011","Sheffield 042B","E01008109",1641,76,6,70,184,116,95,80,164,139,137,109,28,650
"2011","Sheffield 042D","E01008112",1288,84,9,75,179,97,122,65,171,95,192,171,21,283
"2011","Sheffield 042E","E01008113",1317,168,24,144,304,116,123,45,143,61,140,113,27,217
"2011","Sheffield 042F","E01033273",2232,62,7,55,107,70,33,55,143,95,104,84,20,1563
"2011","Sheffield 042G","E01033274",2353,85,10,75,147,81,20,27,57,25,34,24,10,1877
"2011","Sheffield 043A","E01008095",1289,99,10,89,197,106,46,52,157,147,126,82,44,359
"2011","Sheffield 043B","E01008096",1578,88,11,77,179,177,65,114,267,271,189,141,48,228
"2011","Sheffield 043C","E01008097",1146,23,6,17,109,128,61,89,248,250,156,113,43,82
"2011","Sheffield 043D","E01008101",1341,110,17,93,200,121,77,90,286,258,124,93,31,75
"2011","Sheffield 044A","E01007965",1217,52,14,38,157,149,110,103,272,210,89,65,24,75
"2011","Sheffield 044B","E01007969",1151,72,22,50,203,161,119,84,197,159,94,62,32,62
"2011","Sheffield 044C","E01007972",1103,64,18,46,185,216,90,104,224,141,23,14,9,56
"2011","Sheffield 044D","E01007974",1101,73,21,52,238,198,104,82,159,127,35,19,16,85
"2011","Sheffield 045A","E01007963",1094,69,26,43,189,142,126,82,213,142,80,46,34,51
"2011","Sheffield 045B","E01007967",1155,43,14,29,161,142,87,108,238,223,92,65,27,61
"2011","Sheffield 045C","E01007999",1092,63,13,50,194,207,101,106,189,152,23,18,5,57
"2011","Sheffield 045D","E01008008",1157,43,9,34,130,119,79,88,271,238,107,73,34,82
"2011","Sheffield 045E","E01008009",1011,23,7,16,78,105,39,74,237,219,162,105,57,74
"2011","Sheffield 046A","E01008043",1249,295,37,258,386,120,126,33,96,43,58,50,8,92
"2011","Sheffield 046B","E01008044",1053,203,37,166,313,117,94,38,75,48,52,48,4,113
"2011","Sheffield 046C","E01008047",1369,155,13,142,327,114,62,52,95,40,14,7,7,510
"2011","Sheffield 046D","E01008048",1326,172,17,155,320,105,52,50,86,40,29,24,5,472
"2011","Sheffield 046E","E01008050",1238,205,19,186,371,112,67,48,93,45,31,14,17,266
"2011","Sheffield 047A","E01007931",1119,286,43,243,400,118,98,25,65,26,26,14,12,75
"2011","Sheffield 047B","E01007934",1031,224,35,189,341,134,83,44,74,49,28,19,9,54
"2011","Sheffield 047C","E01007935",1130,243,31,212,331,122,71,40,69,25,20,8,12,209
"2011","Sheffield 047D","E01007936",1240,246,44,202,404,157,91,45,94,47,24,13,11,132
"2011","Sheffield 047E","E01007937",1004,227,43,184,328,126,69,34,70,35,23,19,4,92
"2011","Sheffield 047F","E01007938",1057,245,43,202,335,145,84,38,67,54,17,15,2,72
"2011","Sheffield 048A","E01008098",1091,14,3,11,86,107,57,67,250,264,135,89,46,111
"2011","Sheffield 048B","E01008100",890,29,13,16,66,85,54,55,184,219,127,83,44,71
"2011","Sheffield 048C","E01008102",778,15,2,13,69,62,47,68,171,170,92,63,29,84
"2011","Sheffield 048D","E01008103",988,12,5,7,89,70,57,75,213,229,164,116,48,79
"2011","Sheffield 049A","E01007964",1133,69,20,49,181,179,101,102,221,166,67,37,30,47
"2011","Sheffield 049B","E01007966",1207,79,11,68,201,142,80,107,249,192,61,44,17,96
"2011","Sheffield 049C","E01007968",984,46,15,31,129,125,68,79,229,164,66,45,21,78
"2011","Sheffield 049D","E01007970",1141,41,10,31,95,108,96,92,284,230,151,103,48,44
"2011","Sheffield 050A","E01008042",1200,177,23,154,312,128,123,37,100,71,141,119,22,111
"2011","Sheffield 050B","E01008045",1035,190,29,161,285,90,108,33,85,38,98,84,14,108
"2011","Sheffield 050C","E01008046",1250,178,23,155,342,143,109,40,152,88,87,73,14,111
"2011","Sheffield 050D","E01008049",1177,249,40,209,348,115,102,44,86,42,31,19,12,160
"2011","Sheffield 050E","E01008051",1346,219,24,195,360,128,136,43,101,69,154,139,15,136
"2011","Sheffield 050F","E01008052",1472,371,36,335,477,150,98,45,111,48,61,45,16,111
"2011","Sheffield 051A","E01007975",1218,70,8,62,235,130,111,88,216,180,112,83,29,76
"2011","Sheffield 051B","E01007976",1108,100,16,84,258,116,103,91,170,131,80,59,21,59
"2011","Sheffield 051C","E01007977",1091,27,4,23,139,110,69,89,231,210,131,87,44,85
"2011","Sheffield 051D","E01007979",1103,23,7,16,89,92,53,67,226,170,192,143,49,191
"2011","Sheffield 051E","E01008099",1232,99,15,84,304,158,79,90,184,113,53,36,17,152
"2011","Sheffield 052A","E01008000",1112,39,9,30,165,176,107,109,207,182,57,48,9,70
"2011","Sheffield 052B","E01008001",1062,44,13,31,190,148,89,99,212,177,41,31,10,62
"2011","Sheffield 052C","E01008004",1124,53,16,37,167,142,70,103,244,222,54,30,24,69
"2011","Sheffield 052D","E01008005",1135,69,19,50,231,196,113,89,192,145,37,25,12,63
"2011","Sheffield 052E","E01008010",1012,31,9,22,131,130,65,86,229,193,74,45,29,73
"2011","Sheffield 053A","E01007978",1323,192,35,157,368,153,95,54,164,99,73,44,29,125
"2011","Sheffield 053B","E01007980",1192,132,25,107,384,144,101,61,144,86,61,39,22,79
"2011","Sheffield 053C","E01007981",1098,170,25,145,303,140,94,63,122,69,53,40,13,84
"2011","Sheffield 053D","E01007983",1152,161,21,140,310,166,88,61,156,92,36,18,18,82
"2011","Sheffield 053E","E01007985",1118,136,15,121,289,180,94,86,144,80,37,22,15,72
"2011","Sheffield 054A","E01007982",1318,90,23,67,243,145,91,108,226,180,122,72,50,113
"2011","Sheffield 054B","E01008002",1174,135,25,110,241,208,114,90,167,116,55,44,11,48
"2011","Sheffield 054C","E01008003",1079,72,14,58,217,158,106,101,192,134,31,16,15,68
"2011","Sheffield 054D","E01008006",1001,79,26,53,197,163,83,98,186,113,38,20,18,44
"2011","Sheffield 055A","E01007927",1130,340,51,289,327,144,107,27,56,19,28,12,16,82
"2011","Sheffield 055B","E01007928",1244,351,58,293,384,149,123,24,67,28,23,10,13,95
"2011","Sheffield 055C","E01007929",1181,312,44,268,378,134,96,42,67,40,23,13,10,89
"2011","Sheffield 055D","E01007930",1003,271,60,211,303,111,97,29,56,13,35,28,7,88
"2011","Sheffield 055E","E01007932",991,217,35,182,335,137,95,28,55,29,16,8,8,79
"2011","Sheffield 055F","E01007939",1055,243,55,188,380,115,95,29,69,34,18,6,12,72
"2011","Sheffield 056A","E01008028",1167,62,21,41,167,131,140,96,246,208,50,24,26,67
"2011","Sheffield 056B","E01008029",1053,36,11,25,137,97,88,97,251,219,61,30,31,67
"2011","Sheffield 056C","E01008032",1017,46,14,32,134,130,90,110,232,171,59,38,21,45
"2011","Sheffield 056D","E01008034",1298,137,35,102,239,177,91,99,227,137,62,40,22,129
"2011","Sheffield 059A","E01007828",1208,116,19,97,288,157,87,91,197,137,55,36,19,80
"2011","Sheffield 059B","E01007829",1216,150,32,118,334,178,105,75,171,98,41,22,19,64
"2011","Sheffield 059C","E01007831",1139,181,30,151,304,159,105,70,136,75,33,20,13,76
"2011","Sheffield 059D","E01007832",1152,134,24,110,313,204,104,82,137,83,30,16,14,65
"2011","Sheffield 059E","E01007986",1088,123,25,98,287,156,77,84,163,125,20,15,5,53
"2011","Sheffield 060A","E01008007",1148,40,13,27,130,141,89,88,253,219,113,72,41,75
"2011","Sheffield 060B","E01008075",992,28,7,21,102,113,50,82,206,150,150,108,42,111
"2011","Sheffield 060C","E01008076",919,22,5,17,101,110,55,58,223,196,95,60,35,59
"2011","Sheffield 060D","E01008077",1060,42,5,37,146,120,89,92,240,188,78,41,37,65
"2011","Sheffield 061A","E01008031",1074,75,23,52,193,143,79,114,202,161,38,26,12,69
"2011","Sheffield 061B","E01008033",1046,86,21,65,214,178,111,81,168,115,33,24,9,60
"2011","Sheffield 061C","E01008038",1153,95,24,71,240,220,107,97,184,128,20,14,6,62
"2011","Sheffield 061D","E01008040",1303,141,31,110,309,212,108,75,197,133,50,34,16,78
"2011","Sheffield 062A","E01007835",995,76,17,59,183,174,96,77,180,119,24,15,9,66
"2011","Sheffield 062B","E01007836",1124,105,28,77,219,190,103,87,162,138,39,28,11,81
"2011","Sheffield 062C","E01007843",1092,42,12,30,152,144,97,97,231,193,78,43,35,58
"2011","Sheffield 062D","E01007846",1083,100,26,74,203,194,95,91,173,117,23,11,12,87
"2011","Sheffield 063A","E01008030",1017,108,29,79,216,155,102,91,152,105,34,19,15,54
"2011","Sheffield 063B","E01008035",927,117,35,82,218,162,81,79,120,69,11,8,3,70
"2011","Sheffield 063C","E01008036",1129,119,26,93,259,209,93,69,181,99,20,11,9,80
"2011","Sheffield 063D","E01008041",1144,124,32,92,263,184,96,101,174,85,27,17,10,90
"2011","Sheffield 064A","E01007827",1173,162,31,131,309,164,113,86,177,90,21,7,14,51
"2011","Sheffield 064B","E01007830",1067,96,20,76,219,197,118,64,172,103,34,20,14,64
"2011","Sheffield 064C","E01007833",1159,141,29,112,314,179,131,62,134,89,31,19,12,78
"2011","Sheffield 064D","E01007984",1062,108,25,83,252,164,116,73,180,95,10,3,7,64
"2011","Sheffield 064E","E01008078",1000,129,41,88,273,153,123,38,115,74,28,22,6,67
"2011","Sheffield 064F","E01008079",883,134,34,100,222,158,95,60,91,53,18,12,6,52
"2011","Sheffield 065A","E01008019",1397,91,28,63,262,178,99,126,252,213,89,49,40,87
"2011","Sheffield 065B","E01008020",1121,72,15,57,188,194,82,115,218,161,37,25,12,54
"2011","Sheffield 065C","E01008022",1131,22,9,13,116,105,72,123,252,222,151,84,67,68
"2011","Sheffield 065D","E01008027",1085,81,25,56,178,157,87,93,221,155,61,37,24,52
"2011","Sheffield 065E","E01008037",1029,34,5,29,153,126,75,87,245,191,69,36,33,49
"2011","Sheffield 065F","E01008039",1020,102,29,73,217,190,68,89,146,132,18,11,7,58
"2011","Sheffield 066A","E01007824",991,149,33,116,319,142,111,47,99,39,18,9,9,67
"2011","Sheffield 066B","E01007825",1024,172,36,136,333,151,112,43,107,36,21,15,6,49
"2011","Sheffield 066C","E01007826",1082,166,36,130,338,170,106,45,107,46,19,12,7,85
"2011","Sheffield 066D","E01007834",1133,166,36,130,307,165,100,49,146,108,28,23,5,64
"2011","Sheffield 068A","E01007920",1139,306,64,242,342,160,108,19,72,21,27,19,8,84
"2011","Sheffield 068B","E01007921",1070,228,52,176,349,136,89,34,88,37,39,32,7,70
"2011","Sheffield 068C","E01007923",1257,271,48,223,366,182,132,41,104,58,28,20,8,75
"2011","Sheffield 068D","E01007925",1120,208,41,167,326,145,136,56,92,65,29,20,9,63
"2011","Sheffield 068E","E01007926",1187,298,74,224,360,137,168,34,66,29,23,15,8,72
"2011","Sheffield 068F","E01007933",1180,324,78,246,349,144,133,16,47,30,22,15,7,115
"2011","Sheffield 069A","E01007823",1191,116,27,89,252,191,112,82,196,121,49,29,20,72
"2011","Sheffield 069B","E01007916",1023,24,7,17,132,109,83,74,231,196,128,83,45,46
"2011","Sheffield 069C","E01007919",1097,33,8,25,127,111,93,88,271,167,127,69,58,80
"2011","Sheffield 069D","E01008080",1079,99,20,79,252,129,110,68,180,108,42,21,21,91
"2011","Sheffield 070A","E01008081",1133,36,8,28,143,134,90,113,279,173,98,50,48,67
"2011","Sheffield 070B","E01008082",1023,20,2,18,127,120,53,93,262,192,106,64,42,50
"2011","Sheffield 070C","E01008083",1027,32,8,24,97,100,70,94,279,179,104,63,41,72
"2011","Sheffield 070D","E01008084",1159,25,9,16,118,91,66,101,286,228,168,106,62,76
"2011","Sheffield 071A","E01007915",962,225,37,188,280,146,92,36,83,33,13,8,5,54
"2011","Sheffield 071B","E01007917",996,139,25,114,251,148,107,44,129,77,43,30,13,58
"2011","Sheffield 071C","E01007918",1149,259,48,211,368,139,94,27,100,50,41,22,19,71
"2011","Sheffield 071D","E01007922",1063,207,46,161,358,159,92,36,82,30,22,14,8,77
"2011","Sheffield 071E","E01007924",1106,165,35,130,309,149,97,65,134,79,53,39,14,55
"2011","Sheffield 072A","E01008021",1133,163,38,125,297,198,120,80,102,64,16,7,9,93
"2011","Sheffield 072B","E01008023",1620,233,70,163,455,289,122,121,188,99,28,15,13,85
"2011","Sheffield 072C","E01008024",1298,98,27,71,243,209,123,120,217,189,39,18,21,60
"2011","Sheffield 072D","E01008025",1474,157,39,118,338,216,183,104,201,143,61,32,29,71
"2011","Sheffield 072E","E01032585",1093,114,28,86,254,210,103,76,168,105,21,12,9,42
"2011","Sheffield 073A","E01033261",1712,125,8,117,94,46,9,11,45,21,52,37,15,1309
"2011","Sheffield 073B","E01033262",1709,132,9,123,199,97,27,30,72,32,23,14,9,1097
"2011","Sheffield 073C","E01033263",1174,171,8,163,246,89,26,32,67,30,62,49,13,451
"2011","Sheffield 073D","E01033264",1448,202,9,193,210,101,29,28,57,21,24,18,6,776
"2011","Sheffield 073E","E01033276",2881,70,0,70,80,51,6,14,40,19,36,24,12,2565
"2011","Sheffield 074A","E01008114",2214,67,5,62,136,71,41,36,124,104,254,213,41,1381
"2011","Sheffield 074B","E01008115",1623,99,14,85,106,40,28,23,61,49,88,71,17,1129
"2011","Sheffield 074C","E01033265",1279,142,4,138,134,62,26,27,50,35,60,48,12,743
"2011","Sheffield 074D","E01033266",1529,135,12,123,96,54,22,14,31,23,55,45,10,1099
"2011","Sheffield 074E","E01033267",1362,103,3,100,89,42,10,8,40,20,21,15,6,1029
"2011","Sheffield 075A","E01007878",1307,70,8,62,149,133,73,68,291,318,112,79,33,93
"2011","Sheffield 075B","E01007879",1246,89,6,83,199,133,83,61,153,114,91,66,25,323
"2011","Sheffield 075C","E01007881",1183,43,6,37,148,131,88,106,233,224,92,66,26,118
"2011","Sheffield 075D","E01007882",1316,118,13,105,202,128,94,63,199,114,93,69,24,305
"2011","Sheffield 075E","E01007885",1171,59,14,45,140,104,67,67,237,201,176,133,43,120
"2011","Sheffield 075F","E01007886",1096,14,4,10,98,84,74,85,246,287,130,95,35,78
"2011","Sheffield 075G","E01033268",1837,75,10,65,230,118,63,72,238,237,157,108,49,647
"2011","Sheffield 076A","E01007838",1130,55,17,38,191,166,105,119,225,175,35,21,14,59
"2011","Sheffield 076B","E01007839",1216,59,20,39,245,233,106,111,218,150,27,13,14,67
"2011","Sheffield 076C","E01007841",1194,81,22,59,198,205,128,118,196,162,31,15,16,75
"2011","Sheffield 076D","E01007842",1132,49,17,32,185,149,93,95,231,190,50,32,18,90
"2011","Sheffield 076E","E01033278",1691,58,10,48,211,185,143,151,381,345,133,84,49,84
"2011","Sheffield 076F","E01033279",1660,48,10,38,186,180,110,159,363,365,160,107,53,89
"2011","Bradford 001A","E01010646",911,170,42,128,278,126,143,30,76,40,10,6,4,38
"2011","Bradford 001B","E01010647",778,111,28,83,238,106,115,40,77,43,8,6,2,40
"2011","Bradford 001C","E01010648",939,178,44,134,276,125,135,40,97,37,9,4,5,42
"2011","Bradford 001D","E01010692",1297,348,62,286,420,154,116,31,77,47,21,12,9,83
"2011","Bradford 002A","E01010691",1024,272,59,213,346,134,98,13,53,22,9,3,6,77
"2011","Bradford 002B","E01010693",1010,242,49,193,329,126,99,34,74,27,14,7,7,65
"2011","Bradford 002C","E01010694",1065,263,65,198,342,126,122,30,69,22,21,17,4,70
"2011","Bradford 002D","E01010695",1052,254,43,211,305,104,109,42,90,58,27,17,10,63
"2011","Bradford 002E","E01010696",1046,248,65,183,310,124,97,47,87,44,16,7,9,73
"2011","Bradford 002F","E01010697",963,261,42,219,334,102,89,14,61,17,19,11,8,66
"2011","Bradford 002G","E01010698",1314,215,39,176,398,152,132,78,151,86,21,11,10,81
"2011","Bradford 002H","E01010699",1180,122,19,103,277,118,152,85,176,124,50,28,22,76
"2011","Bradford 003A","E01010767",950,147,36,111,257,116,95,59,102,75,33,23,10,66
"2011","Bradford 003B","E01010768",1162,253,72,181,369,168,107,50,76,53,10,6,4,76
"2011","Bradford 003C","E01010769",1131,203,38,165,335,162,118,63,130,56,16,10,6,48
"2011","Bradford 003D","E01010771",894,186,44,142,287,121,89,31,81,40,14,10,4,45
"2011","Bradford 004A","E01010638",1144,121,33,88,274,160,151,84,165,102,23,18,5,64
"2011","Bradford 004B","E01010639",1278,117,31,86,305,184,130,90,195,173,23,13,10,61
"2011","Bradford 004C","E01010640",1292,85,21,64,270,195,136,121,202,182,30,18,12,71
"2011","Bradford 004D","E01010641",1101,91,30,61,258,169,133,82,156,126,21,13,8,65
"2011","Bradford 004E","E01010642",1315,178,52,126,324,182,179,72,158,125,15,13,2,82
"2011","Bradford 004F","E01010643",1078,116,27,89,256,151,121,83,144,119,29,16,13,59
"2011","Bradford 004G","E01010644",1151,130,34,96,262,137,135,87,123,157,38,27,11,82
"2011","Bradford 004H","E01010645",990,123,30,93,262,156,92,71,115,83,32,28,4,56
"2011","Bradford 005A","E01010770",1182,290,76,214,380,162,129,34,69,38,4,2,2,76
"2011","Bradford 005B","E01010772",865,189,37,152,273,124,98,25,60,30,11,8,3,55
"2011","Bradford 005C","E01010773",981,197,39,158,297,139,102,31,86,50,9,5,4,70
"2011","Bradford 005D","E01010774",1128,185,34,151,353,160,114,62,111,61,19,11,8,63
"2011","Bradford 006A","E01010706",1206,210,56,154,348,171,140,67,108,75,25,11,14,62
"2011","Bradford 006B","E01010707",1282,188,52,136,323,204,164,68,129,111,32,23,9,63
"2011","Bradford 006C","E01010708",1169,73,18,55,217,155,131,88,194,159,78,54,24,74
"2011","Bradford 006D","E01010709",1886,219,62,157,518,302,190,116,201,145,68,48,20,127
"2011","Bradford 007A","E01010719",1080,30,5,25,99,79,121,59,148,181,249,210,39,114
"2011","Bradford 007B","E01010727",1311,139,41,98,316,192,135,80,139,152,72,51,21,86
"2011","Bradford 007C","E01010728",1194,67,12,55,148,103,123,62,181,139,245,204,41,126
"2011","Bradford 007D","E01010729",999,157,39,118,192,126,140,42,100,65,101,95,6,76
"2011","Bradford 008A","E01010700",997,37,6,31,89,67,104,46,131,158,247,219,28,118
"2011","Bradford 008B","E01010701",908,20,6,14,52,65,81,52,124,153,267,225,42,94
"2011","Bradford 008C","E01010702",1330,23,2,21,100,77,167,46,183,171,389,353,36,174
"2011","Bradford 008D","E01010703",1162,65,21,44,190,157,121,88,201,188,84,62,22,68
"2011","Bradford 008E","E01010704",1071,66,21,45,175,153,110,85,196,158,49,29,20,79
"2011","Bradford 008F","E01010705",1238,83,30,53,250,191,127,96,191,164,45,32,13,91
"2011","Bradford 008G","E01010710",1510,43,14,29,112,83,118,82,235,306,362,261,101,169
"2011","Bradford 009A","E01010712",1069,23,8,15,108,87,101,94,151,171,239,196,43,95
"2011","Bradford 009B","E01010720",1027,24,5,19,102,80,75,88,256,236,102,58,44,64
"2011","Bradford 009C","E01010721",1028,48,14,34,106,114,77,76,206,233,101,52,49,67
"2011","Bradford 009D","E01010723",1004,24,4,20,77,73,98,72,175,167,208,173,35,110
"2011","Bradford 009E","E01010724",1004,30,11,19,136,121,71,80,179,208,93,68,25,86
"2011","Bradford 009F","E01010725",1071,39,10,29,160,147,67,95,242,191,76,49,27,54
"2011","Bradford 010A","E01010579",1113,226,56,170,351,188,119,34,72,38,11,8,3,74
"2011","Bradford 010B","E01010580",1784,290,72,218,598,311,196,79,105,68,36,28,8,101
"2011","Bradford 010C","E01010764",1215,192,43,149,380,183,170,55,83,53,20,15,5,79
"2011","Bradford 010D","E01010765",1661,178,46,132,358,248,153,124,235,224,57,30,27,84
"2011","Bradford 010E","E01010766",952,152,47,105,303,199,79,49,78,41,10,7,3,41
"2011","Bradford 011A","E01010711",1003,22,6,16,85,49,85,117,179,201,183,134,49,82
"2011","Bradford 011B","E01010713",973,32,10,22,131,93,80,89,208,200,71,35,36,69
"2011","Bradford 011C","E01010714",992,30,9,21,125,140,70,95,209,182,62,41,21,79
"2011","Bradford 011D","E01010716",1366,77,24,53,227,168,124,130,237,225,97,59,38,81
"2011","Bradford 012A","E01010715",802,34,12,22,112,92,64,76,167,131,63,36,27,63
"2011","Bradford 012B","E01010717",1107,32,8,24,167,163,68,104,221,209,62,46,16,81
"2011","Bradford 012C","E01010718",1136,37,12,25,133,108,74,104,248,253,99,58,41,80
"2011","Bradford 012D","E01010726",1138,95,28,67,207,199,98,109,187,140,25,18,7,78
"2011","Bradford 012E","E01010859",1265,99,32,67,253,206,115,116,199,179,25,12,13,73
"2011","Bradford 013A","E01010573",1344,201,57,144,308,233,173,87,147,92,29,18,11,74
"2011","Bradford 013B","E01010574",1034,179,35,144,308,167,93,55,97,49,26,14,12,60
"2011","Bradford 013C","E01010575",1166,139,37,102,331,184,132,75,128,94,27,16,11,56
"2011","Bradford 013D","E01010577",1154,174,35,139,361,186,114,78,105,57,14,6,8,65
"2011","Bradford 014A","E01010722",1112,64,18,46,189,118,105,90,196,168,97,59,38,85
"2011","Bradford 014B","E01010860",1196,134,40,94,279,164,182,76,157,109,23,13,10,72
"2011","Bradford 014C","E01010862",1279,136,35,101,314,188,147,100,165,120,42,28,14,67
"2011","Bradford 014D","E01010863",1138,116,33,83,263,179,143,88,147,120,22,13,9,60
"2011","Bradford 015A","E01010578",1209,193,47,146,304,167,122,75,119,95,61,40,21,73
"2011","Bradford 015B","E01010581",1203,147,29,118,288,216,104,77,146,126,44,16,28,55
"2011","Bradford 015C","E01010582",1250,177,22,155,331,199,93,78,136,115,54,38,16,67
"2011","Bradford 015D","E01010584",1322,113,26,87,269,181,84,118,210,195,65,31,34,87
"2011","Bradford 015E","E01010585",1327,153,33,120,321,222,90,91,163,121,33,13,20,133
"2011","Bradford 016A","E01010568",1324,187,43,144,367,210,126,81,162,92,32,17,15,67
"2011","Bradford 016B","E01010569",1240,72,15,57,213,166,136,122,237,168,52,28,24,74
"2011","Bradford 016C","E01010571",1258,116,23,93,285,220,97,97,175,148,71,35,36,49
"2011","Bradford 016D","E01010572",1055,86,21,65,240,199,124,70,142,107,30,18,12,57
"2011","Bradford 016E","E01010576",1134,201,59,142,280,196,132,53,118,62,26,17,9,66
"2011","Bradford 017A","E01010683",1290,203,49,154,367,197,123,77,115,88,24,11,13,96
"2011","Bradford 017B","E01010684",1156,139,41,98,266,196,107,96,148,109,24,11,13,71
"2011","Bradford 017C","E01010685",1279,149,44,105,327,199,141,94,147,124,31,16,15,67
"2011","Bradford 017D","E01010686",1187,126,42,84,292,232,125,90,150,95,26,17,9,51
"2011","Bradford 018A","E01010570",1046,178,50,128,347,163,121,38,76,36,21,16,5,66
"2011","Bradford 018B","E01010583",1195,107,30,77,181,166,108,71,204,180,86,46,40,92
"2011","Bradford 018C","E01010784",1250,144,16,128,317,157,95,87,167,148,57,29,28,78
"2011","Bradford 018D","E01010785",1128,211,30,181,365,155,80,57,104,57,39,21,18,60
"2011","Bradford 018E","E01010786",1074,230,42,188,310,119,92,35,76,48,70,66,4,94
"2011","Bradford 018F","E01010790",1037,158,35,123,309,199,101,42,81,51,29,23,6,67
"2011","Bradford 019A","E01010680",1313,64,22,42,207,138,93,113,249,253,140,73,67,56
"2011","Bradford 019B","E01010681",1032,150,54,96,264,162,130,70,103,58,24,18,6,71
"2011","Bradford 019C","E01010682",1037,57,15,42,170,136,73,101,183,167,80,52,28,70
"2011","Bradford 019D","E01010687",1394,193,56,137,380,257,118,99,167,77,26,10,16,77
"2011","Bradford 019E","E01010688",1418,130,29,101,354,239,138,111,198,127,51,33,18,70
"2011","Bradford 019F","E01010689",1293,188,45,143,338,187,136,68,157,107,41,19,22,71
"2011","Bradford 019G","E01010690",1398,148,36,112,340,241,109,103,169,133,65,49,16,90
"2011","Bradford 020B","E01010782",1333,79,16,63,220,173,84,116,235,232,121,74,47,73
"2011","Bradford 020C","E01010787",1122,149,36,113,291,190,94,66,121,76,48,35,13,87
"2011","Bradford 020D","E01010788",1047,140,25,115,294,161,74,65,111,69,54,37,17,79
"2011","Bradford 020E","E01033689",1005,169,32,137,273,112,46,59,136,86,71,36,35,53
"2011","Bradford 020F","E01033694",832,140,26,114,234,135,39,47,102,60,27,15,12,48
"2011","Bradford 021A","E01010776",1197,56,22,34,193,161,68,113,212,202,109,67,42,83
"2011","Bradford 021B","E01010777",1079,35,8,27,99,115,74,76,256,209,144,82,62,71
"2011","Bradford 021C","E01010779",1029,52,17,35,160,129,71,99,169,202,93,51,42,54
"2011","Bradford 021D","E01010781",1074,66,15,51,165,161,83,84,196,170,64,31,33,85
"2011","Bradford 021E","E01010783",1118,62,27,35,180,174,107,111,210,165,42,25,17,67
"2011","Bradford 022A","E01010586",1186,198,50,148,388,181,127,55,90,54,17,9,8,76
"2011","Bradford 022B","E01010587",1414,204,56,148,370,241,168,76,146,88,33,20,13,88
"2011","Bradford 022C","E01010588",1224,152,33,119,313,188,101,73,155,114,47,31,16,81
"2011","Bradford 022D","E01010589",1151,137,42,95,327,197,119,75,121,72,27,18,9,76
"2011","Bradford 022E","E01010591",1102,87,19,68,175,167,73,113,219,152,50,35,15,66
"2011","Bradford 022F","E01010593",1232,120,35,85,345,193,113,90,156,123,22,15,7,70
"2011","Bradford 022G","E01010596",1072,144,22,122,301,203,99,57,111,63,26,18,8,68
"2011","Bradford 023A","E01010854",1328,124,36,88,304,177,165,83,174,165,66,44,22,70
"2011","Bradford 023B","E01010855",1288,175,51,124,301,148,211,81,140,133,32,23,9,67
"2011","Bradford 023C","E01010856",1207,118,28,90,295,140,180,87,155,117,63,34,29,52
"2011","Bradford 023D","E01010857",1255,159,53,106,333,168,218,85,122,82,28,14,14,60
"2011","Bradford 023E","E01010858",1180,174,44,130,326,150,147,55,135,83,36,28,8,74
"2011","Bradford 023F","E01010861",1383,133,36,97,342,217,155,108,196,141,27,18,9,64
"2011","Bradford 024A","E01010603",1186,71,20,51,245,191,98,90,205,159,46,26,20,81
"2011","Bradford 024B","E01010604",1321,91,35,56,261,223,121,113,200,161,53,38,15,98
"2011","Bradford 024C","E01010605",1092,42,14,28,130,131,65,90,211,224,100,68,32,99
"2011","Bradford 024D","E01010775",1335,112,35,77,246,247,98,124,232,139,39,32,7,98
"2011","Bradford 024E","E01010778",1347,86,23,63,196,180,119,99,240,244,93,65,28,90
"2011","Bradford 025A","E01010789",1248,96,22,74,247,172,92,92,182,133,126,98,28,108
"2011","Bradford 025B","E01010791",1153,98,19,79,224,134,130,50,112,85,188,158,30,132
"2011","Bradford 025C","E01010792",1276,66,7,59,149,135,94,80,161,159,249,218,31,183
"2011","Bradford 025D","E01010793",1319,105,22,83,189,136,129,66,115,109,219,196,23,251
"2011","Bradford 026A","E01010652",1142,68,16,52,222,210,74,101,194,157,39,22,17,77
"2011","Bradford 026B","E01010653",1103,40,10,30,167,142,87,103,207,198,80,45,35,79
"2011","Bradford 026C","E01010655",953,28,10,18,110,112,67,80,199,178,96,61,35,83
"2011","Bradford 026D","E01010656",1078,70,21,49,195,209,94,90,168,131,42,27,15,79
"2011","Bradford 026E","E01010657",1134,76,17,59,222,195,89,102,195,145,48,31,17,62
"2011","Bradford 027A","E01010649",1012,46,19,27,153,154,77,111,198,171,56,37,19,46
"2011","Bradford 027B","E01010650",1057,20,5,15,106,81,60,90,221,226,154,102,52,99
"2011","Bradford 027C","E01010654",955,32,7,25,97,102,61,70,208,217,117,85,32,51
"2011","Bradford 027D","E01010826",962,22,5,17,87,78,82,71,157,189,188,144,44,88
"2011","Bradford 028A","E01010597",1052,50,14,36,179,157,88,78,188,136,83,54,29,93
"2011","Bradford 028B","E01010598",1281,81,22,59,226,223,135,88,183,152,74,49,25,119
"2011","Bradford 028C","E01010599",981,59,18,41,176,148,77,80,127,116,91,69,22,107
"2011","Bradford 028D","E01010600",991,66,14,52,144,145,76,87,149,139,99,68,31,86
"2011","Bradford 028E","E01010602",1076,64,13,51,185,171,95,69,200,115,96,71,25,81
"2011","Bradford 029A","E01010670",1196,126,18,108,243,91,132,46,94,82,241,217,24,141
"2011","Bradford 029B","E01010671",1105,101,11,90,157,129,124,42,102,113,187,169,18,150
"2011","Bradford 029C","E01010673",1171,63,9,54,141,117,116,53,130,123,288,254,34,140
"2011","Bradford 029D","E01010675",1350,156,26,130,258,134,148,54,117,74,237,216,21,172
"2011","Bradford 030A","E01010669",1226,75,12,63,195,155,134,71,159,134,171,143,28,132
"2011","Bradford 030B","E01010674",997,29,3,26,114,90,102,47,159,152,191,157,34,113
"2011","Bradford 030C","E01010677",1243,37,9,28,144,122,89,72,188,193,275,223,52,123
"2011","Bradford 030D","E01010805",1095,96,15,81,194,121,133,36,119,104,186,167,19,106
"2011","Bradford 031A","E01010590",1356,153,37,116,351,198,214,68,159,80,31,16,15,102
"2011","Bradford 031B","E01010592",1099,109,25,84,253,197,106,84,125,122,35,21,14,68
"2011","Bradford 031C","E01010594",1273,109,44,65,300,191,135,108,168,140,39,22,17,83
"2011","Bradford 031D","E01010595",1311,99,26,73,264,203,152,93,193,159,61,36,25,87
"2011","Bradford 032A","E01010601",1235,78,18,60,231,227,99,111,208,142,73,45,28,66
"2011","Bradford 032B","E01010651",1118,75,19,56,228,218,81,90,178,124,49,34,15,75
"2011","Bradford 032C","E01010825",972,58,9,49,188,148,89,91,143,149,49,32,17,57
"2011","Bradford 032D","E01010827",904,50,16,34,142,145,86,76,172,96,71,52,19,66
"2011","Bradford 033A","E01010804",1625,69,17,52,117,132,196,67,172,172,440,401,39,260
"2011","Bradford 033B","E01010806",1049,64,6,58,138,87,123,43,126,97,242,213,29,129
"2011","Bradford 033C","E01010807",1496,93,13,80,140,103,102,67,174,178,381,343,38,258
"2011","Bradford 033D","E01010808",1408,26,5,21,106,98,125,71,193,189,411,373,38,189
"2011","Bradford 033E","E01010809",1506,48,5,43,129,122,136,52,172,171,445,402,43,231
"2011","Bradford 034A","E01010676",1551,44,6,38,112,119,173,60,175,187,484,447,37,197
"2011","Bradford 034B","E01010679",1224,46,8,38,106,90,114,50,136,149,356,319,37,177
"2011","Bradford 034C","E01010824",1277,60,2,58,131,91,97,81,188,206,281,221,60,142
"2011","Bradford 034D","E01010840",1088,19,2,17,67,64,78,52,150,168,363,336,27,127
"2011","Bradford 034E","E01010841",1233,40,9,31,68,108,105,60,142,143,438,401,37,129
"2011","Bradford 035A","E01010828",1134,58,16,42,160,152,114,85,187,168,126,84,42,84
"2011","Bradford 035B","E01010829",1107,62,21,41,146,109,82,80,171,138,217,159,58,102
"2011","Bradford 035C","E01010830",1195,49,13,36,129,114,98,98,193,179,206,176,30,129
"2011","Bradford 035D","E01010831",1268,44,7,37,118,111,115,73,169,164,305,270,35,169
"2011","Bradford 035E","E01010832",1059,27,2,25,109,114,117,63,142,109,257,219,38,121
"2011","Bradford 036A","E01010672",964,108,36,72,260,158,88,57,122,86,28,21,7,57
"2011","Bradford 036B","E01010678",997,116,29,87,238,157,93,61,114,88,59,47,12,71
"2011","Bradford 036C","E01010799",1087,60,21,39,193,167,85,87,180,159,88,62,26,68
"2011","Bradford 036D","E01010800",1111,40,12,28,121,123,62,80,233,195,160,103,57,97
"2011","Bradford 036E","E01010801",1218,66,7,59,222,155,117,63,157,155,167,126,41,116
"2011","Bradford 036F","E01010802",1115,28,5,23,160,117,78,102,223,185,126,74,52,96
"2011","Bradford 037A","E01010803",1199,30,6,24,80,79,118,82,159,225,289,247,42,137
"2011","Bradford 037B","E01010810",1269,68,9,59,136,106,141,56,144,146,313,274,39,159
"2011","Bradford 037C","E01010811",1354,34,7,27,143,108,122,56,194,169,355,305,50,173
"2011","Bradford 037D","E01010813",1125,20,3,17,81,82,117,56,139,198,301,263,38,131
"2011","Bradford 038A","E01010618",1098,12,4,8,87,80,97,70,148,171,279,245,34,154
"2011","Bradford 038B","E01010619",1488,51,12,39,130,110,142,67,189,213,367,328,39,219
"2011","Bradford 038C","E01010625",1095,24,5,19,81,74,84,71,154,169,291,251,40,147
"2011","Bradford 038D","E01010626",1235,26,4,22,119,97,131,65,162,167,305,260,45,163
"2011","Bradford 038E","E01010627",1107,39,7,32,100,110,109,67,197,172,186,156,30,127
"2011","Bradford 039A","E01010606",1272,25,6,19,82,67,91,96,171,192,372,321,51,176
"2011","Bradford 039B","E01010607",1315,44,10,34,84,100,124,67,147,173,351,326,25,225
"2011","Bradford 039C","E01010617",940,29,8,21,67,85,57,69,169,154,205,159,46,105
"2011","Bradford 039E","E01010842",1273,27,7,20,70,64,100,62,147,201,389,337,52,213
"2011","Bradford 039G","E01033690",1036,94,7,87,133,88,28,57,119,102,78,54,24,337
"2011","Bradford 039H","E01033691",1126,38,5,33,95,74,64,68,146,182,231,199,32,228
"2011","Bradford 039I","E01033692",889,71,9,62,131,90,46,44,79,106,95,71,24,227
"2011","Bradford 039J","E01033693",1590,58,8,50,145,104,82,102,176,192,469,427,42,262
"2011","Bradford 040A","E01010628",1169,53,15,38,181,158,73,106,193,207,112,86,26,86
"2011","Bradford 040B","E01010629",1251,71,11,60,198,166,131,62,177,144,166,138,28,136
"2011","Bradford 040C","E01010630",1002,47,15,32,140,135,73,65,173,176,109,89,20,84
"2011","Bradford 040D","E01010631",994,23,6,17,156,102,43,67,177,183,152,113,39,91
"2011","Bradford 040E","E01010632",904,30,10,20,125,87,36,64,175,188,135,102,33,64
"2011","Bradford 041A","E01010658",1326,51,13,38,145,147,110,67,200,210,251,218,33,145
"2011","Bradford 041B","E01010812",1317,48,2,46,99,85,98,80,175,227,348,299,49,157
"2011","Bradford 041C","E01010833",1144,29,3,26,72,64,87,53,135,157,317,275,42,230
"2011","Bradford 041D","E01010843",1319,26,3,23,68,59,105,76,146,166,485,446,39,188
"2011","Bradford 042A","E01010620",1157,27,8,19,93,103,96,51,161,172,295,257,38,159
"2011","Bradford 042B","E01010621",1437,33,8,25,102,104,134,76,156,169,439,407,32,224
"2011","Bradford 042C","E01010622",1526,30,9,21,90,80,128,80,195,222,486,433,53,215
"2011","Bradford 042D","E01010623",1135,17,4,13,99,81,88,51,164,166,320,280,40,149
"2011","Bradford 042E","E01010624",1435,40,4,36,59,100,130,85,188,171,474,432,42,188
"2011","Bradford 043A","E01010794",1256,74,18,56,225,186,101,75,237,188,83,67,16,87
"2011","Bradford 043B","E01010795",1367,110,28,82,310,224,151,119,162,159,52,36,16,80
"2011","Bradford 043C","E01010796",1184,78,13,65,206,163,121,95,186,186,77,49,28,72
"2011","Bradford 043D","E01010797",1105,130,31,99,308,159,155,56,111,84,45,30,15,57
"2011","Bradford 043E","E01010798",1166,104,30,74,256,168,100,90,166,132,80,53,27,70
"2011","Bradford 044A","E01010834",3431,47,3,44,96,78,52,53,101,149,228,192,36,2627
"2011","Bradford 044B","E01010835",2128,50,5,45,161,131,181,93,245,278,512,459,53,477
"2011","Bradford 044C","E01010836",1793,40,3,37,77,77,87,45,122,132,279,255,24,934
"2011","Bradford 044D","E01010837",1455,33,4,29,110,130,171,54,154,162,393,358,35,248
"2011","Bradford 044E","E01010838",1211,30,3,27,68,85,108,71,142,202,291,272,19,214
"2011","Bradford 044F","E01010839",1109,25,3,22,75,70,93,57,121,162,273,232,41,233
"2011","Bradford 045A","E01010608",1135,19,4,15,77,68,77,69,155,155,353,307,46,162
"2011","Bradford 045B","E01010613",1043,23,6,17,131,128,67,72,182,231,143,108,35,66
"2011","Bradford 045C","E01010730",1201,11,4,7,73,65,55,82,188,242,374,307,67,111
"2011","Bradford 045D","E01010734",1028,26,8,18,83,94,69,63,178,236,168,121,47,111
"2011","Bradford 046A","E01010609",1081,25,7,18,124,115,84,106,219,231,100,66,34,77
"2011","Bradford 046B","E01010610",1064,30,9,21,79,113,72,65,221,226,167,113,54,91
"2011","Bradford 046C","E01010611",1507,92,23,69,173,163,98,116,284,262,208,169,39,111
"2011","Bradford 046D","E01010614",1037,38,12,26,119,93,56,94,191,217,120,82,38,109
"2011","Bradford 047A","E01010633",1165,104,17,87,259,164,118,90,157,137,55,33,22,81
"2011","Bradford 047B","E01010634",1061,87,29,58,223,188,122,86,155,115,22,15,7,63
"2011","Bradford 047C","E01010635",1003,33,10,23,127,123,64,71,197,205,108,64,44,75
"2011","Bradford 047D","E01010636",1272,141,39,102,299,225,126,87,155,122,40,26,14,77
"2011","Bradford 047E","E01010637",1177,68,12,56,225,160,93,82,145,105,65,47,18,234
"2011","Bradford 048A","E01010731",1334,36,9,27,110,78,55,53,152,207,271,228,43,372
"2011","Bradford 048B","E01010732",1415,42,8,34,126,94,74,72,199,245,382,317,65,181
"2011","Bradford 048C","E01010733",1299,43,10,33,91,79,75,73,179,256,357,298,59,146
"2011","Bradford 048D","E01010736",1360,38,15,23,87,78,107,89,205,308,296,250,46,152
"2011","Bradford 048E","E01010737",1126,29,5,24,83,66,73,52,103,200,363,321,42,157
"2011","Bradford 049A","E01010659",1197,27,6,21,109,103,84,68,192,239,251,204,47,124
"2011","Bradford 049D","E01010662",1007,73,14,59,163,145,102,69,145,144,91,75,16,75
"2011","Bradford 049E","E01010664",1063,64,12,52,174,152,94,66,168,139,95,76,19,111
"2011","Bradford 049G","E01010761",1141,80,20,60,215,184,121,96,163,135,76,56,20,71
"2011","Bradford 049H","E01033695",1379,136,33,103,307,229,105,93,165,133,108,92,16,103
"2011","Bradford 049I","E01033696",1121,99,28,71,247,214,103,79,146,110,46,27,19,77
"2011","Bradford 049J","E01033697",1863,65,7,58,138,174,153,100,255,312,430,371,59,236
"2011","Bradford 050A","E01010663",1136,36,8,28,104,102,79,69,211,187,216,173,43,132
"2011","Bradford 050B","E01010665",1157,68,16,52,172,140,107,64,194,177,132,111,21,103
"2011","Bradford 050C","E01010666",1007,21,6,15,106,96,73,76,172,186,182,119,63,95
"2011","Bradford 050D","E01010667",1069,45,5,40,127,109,115,65,171,191,142,117,25,104
"2011","Bradford 051A","E01010735",1046,22,3,19,65,65,62,62,153,218,283,247,36,116
"2011","Bradford 051B","E01010738",1257,37,9,28,84,106,93,69,186,219,314,269,45,149
"2011","Bradford 051C","E01010739",1096,29,3,26,65,63,64,69,206,217,277,231,46,106
"2011","Bradford 051D","E01010740",1197,42,6,36,94,114,100,52,164,188,291,257,34,152
"2011","Bradford 051E","E01010744",1143,31,2,29,90,120,107,71,164,145,280,248,32,135
"2011","Bradford 052A","E01010612",923,24,7,17,85,74,38,69,196,207,164,97,67,66
"2011","Bradford 052B","E01010819",996,13,6,7,74,58,36,79,182,265,199,143,56,90
"2011","Bradford 052C","E01010820",997,16,2,14,75,67,42,73,207,291,154,99,55,72
"2011","Bradford 052D","E01010821",1366,46,9,37,160,144,67,121,243,301,194,131,63,90
"2011","Bradford 052E","E01010822",945,17,4,13,83,69,34,93,184,233,164,118,46,68
"2011","Bradford 053A","E01010615",1014,57,19,38,148,137,82,80,186,168,66,48,18,90
"2011","Bradford 053B","E01010616",1237,31,7,24,126,97,83,89,218,214,238,185,53,141
"2011","Bradford 053C","E01010742",1246,28,3,25,95,106,123,61,192,212,296,258,38,133
"2011","Bradford 053D","E01010743",1221,37,7,30,101,113,88,86,183,210,304,254,50,99
"2011","Bradford 054A","E01010847",1116,67,26,41,183,208,114,100,156,146,70,49,21,72
"2011","Bradford 054B","E01010848",1095,76,25,51,209,206,100,73,158,118,70,45,25,85
"2011","Bradford 054C","E01010852",1014,44,11,33,137,133,76,101,191,180,94,64,30,58
"2011","Bradford 054D","E01010853",946,66,16,50,190,161,82,70,120,116,58,46,12,83
"2011","Bradford 055A","E01010668",973,71,15,56,161,155,101,84,144,114,67,59,8,76
"2011","Bradford 055B","E01010755",1129,36,12,24,135,133,72,77,234,196,162,111,51,84
"2011","Bradford 055C","E01010762",1106,62,19,43,194,167,78,92,165,148,85,67,18,115
"2011","Bradford 055D","E01010763",1079,56,24,32,196,167,84,101,193,167,47,27,20,68
"2011","Bradford 055E","E01010846",1536,93,18,75,238,227,132,133,247,246,100,75,25,120
"2011","Bradford 056A","E01010745",1101,35,5,30,134,139,73,72,176,201,170,126,44,101
"2011","Bradford 056B","E01010747",1107,61,15,46,144,145,113,87,168,179,108,83,25,102
"2011","Bradford 056C","E01010748",1055,36,9,27,117,144,64,87,209,221,90,54,36,87
"2011","Bradford 056D","E01010749",986,36,7,29,131,152,88,81,190,200,67,45,22,41
"2011","Bradford 057A","E01010814",1221,47,12,35,153,164,95,110,218,264,105,63,42,65
"2011","Bradford 057B","E01010815",1682,107,14,93,259,204,118,134,276,281,154,118,36,149
"2011","Bradford 057C","E01010816",1373,176,51,125,316,190,175,104,159,142,43,27,16,68
"2011","Bradford 057D","E01010817",1497,59,11,48,173,163,71,133,308,360,150,105,45,80
"2011","Bradford 057E","E01010818",1348,128,36,92,260,205,120,107,195,168,72,54,18,93
"2011","Bradford 058A","E01010752",1338,102,30,72,279,214,133,102,185,182,60,36,24,81
"2011","Bradford 058B","E01010753",1114,78,27,51,221,201,115,104,187,117,23,12,11,68
"2011","Bradford 058C","E01010754",1153,89,26,63,254,189,121,101,173,115,30,12,18,81
"2011","Bradford 058D","E01010756",1122,107,22,85,216,163,115,110,165,121,48,27,21,77
"2011","Bradford 058E","E01010758",1001,135,32,103,275,162,82,82,90,65,29,21,8,81
"2011","Bradford 058F","E01010759",1128,82,28,54,177,164,110,96,188,156,71,51,20,84
"2011","Bradford 058G","E01010760",1166,136,42,94,254,195,110,85,159,122,36,23,13,69
"2011","Bradford 059A","E01010741",1121,76,20,56,207,185,110,94,170,154,55,36,19,70
"2011","Bradford 059B","E01010845",1370,50,13,37,170,138,80,91,287,291,178,131,47,85
"2011","Bradford 059C","E01010849",1049,61,18,43,212,184,109,94,177,125,31,21,10,56
"2011","Bradford 059D","E01010850",946,26,7,19,114,87,56,63,193,203,124,75,49,80
"2011","Bradford 059E","E01010851",1196,67,19,48,226,184,97,106,226,155,74,55,19,61
"2011","Bradford 059F","E01010864",909,45,12,33,150,119,36,88,168,164,85,49,36,54
"2011","Bradford 059G","E01010867",1014,44,13,31,147,139,80,89,184,176,77,42,35,78
"2011","Bradford 059H","E01010874",818,27,13,14,99,79,44,78,152,204,93,57,36,42
"2011","Bradford 060A","E01010746",1233,78,25,53,224,218,105,89,188,168,76,54,22,87
"2011","Bradford 060B","E01010750",1196,58,24,34,204,207,107,123,204,179,43,29,14,71
"2011","Bradford 060C","E01010751",1109,59,18,41,155,174,92,110,211,188,58,33,25,62
"2011","Bradford 060D","E01010865",1221,74,23,51,246,224,110,106,184,180,47,26,21,50
"2011","Bradford 060E","E01010866",1025,67,19,48,185,180,100,90,146,127,59,35,24,71
"2011","Bradford 061A","E01010868",1186,47,15,32,155,132,108,121,198,212,127,79,48,86
"2011","Bradford 061B","E01010869",1254,60,20,40,186,182,103,127,228,211,77,41,36,80
"2011","Bradford 061C","E01010870",1179,109,38,71,222,199,105,110,188,144,34,23,11,68
"2011","Bradford 061D","E01010871",1284,88,24,64,260,172,120,100,188,189,76,50,26,91
"2011","Bradford 061E","E01010872",1132,51,19,32,155,123,74,107,229,223,98,61,37,72
"2011","Bradford 061F","E01010873",904,83,29,54,167,155,83,80,133,112,31,17,14,60
"2011","Calderdale 001A","E01010911",1318,110,26,84,323,221,156,100,179,125,27,19,8,77
"2011","Calderdale 001B","E01010912",1079,44,15,29,159,151,70,87,248,179,62,35,27,79
"2011","Calderdale 001C","E01010913",984,84,21,63,201,157,83,92,176,127,12,10,2,52
"2011","Calderdale 001D","E01010915",1061,96,20,76,206,149,96,101,168,134,49,29,20,62
"2011","Calderdale 002A","E01010914",1321,64,28,36,227,173,97,101,240,238,92,46,46,89
"2011","Calderdale 002B","E01010924",927,24,10,14,81,85,55,70,193,223,142,71,71,54
"2011","Calderdale 002C","E01010925",1008,54,15,39,120,102,84,71,224,180,84,48,36,89
"2011","Calderdale 002D","E01010926",779,23,8,15,72,64,41,60,145,143,139,81,58,92
"2011","Calderdale 003A","E01010931",1022,117,42,75,261,158,98,75,112,91,24,13,11,86
"2011","Calderdale 003B","E01010932",1197,110,40,70,290,197,142,93,143,120,39,25,14,63
"2011","Calderdale 003C","E01010933",1197,134,44,90,280,221,152,84,129,100,28,18,10,69
"2011","Calderdale 003D","E01010935",1172,111,35,76,322,249,128,80,133,76,10,6,4,63
"2011","Calderdale 003E","E01010936",1372,216,56,160,381,226,162,76,125,80,26,14,12,80
"2011","Calderdale 003F","E01010937",1139,126,19,107,290,200,126,65,138,115,20,11,9,59
"2011","Calderdale 004A","E01010881",1227,214,39,175,357,111,147,52,125,108,32,20,12,81
"2011","Calderdale 004B","E01010882",1026,166,32,134,317,98,97,57,121,78,30,17,13,62
"2011","Calderdale 004C","E01010883",1143,211,34,177,321,129,183,59,93,48,25,12,13,74
"2011","Calderdale 004D","E01010887",1227,225,59,166,385,125,166,48,121,60,21,13,8,76
"2011","Calderdale 004E","E01010888",1200,180,37,143,425,115,132,54,111,80,36,14,22,67
"2011","Calderdale 004F","E01010923",1212,191,38,153,406,108,143,47,107,92,41,20,21,77
"2011","Calderdale 005A","E01010916",1003,33,15,18,137,110,66,68,221,199,96,57,39,73
"2011","Calderdale 005B","E01010939",1328,114,36,78,292,214,129,104,204,134,50,32,18,87
"2011","Calderdale 005C","E01010941",959,26,10,16,112,105,60,78,205,219,85,40,45,69
"2011","Calderdale 005D","E01010942",1193,36,8,28,163,172,72,100,229,235,96,55,41,90
"2011","Calderdale 005E","E01010944",964,17,4,13,91,89,49,78,242,211,115,65,50,72
"2011","Calderdale 006A","E01010938",990,28,8,20,114,107,58,82,198,238,103,61,42,62
"2011","Calderdale 006B","E01010940",1068,65,17,48,174,146,94,102,203,173,37,17,20,74
"2011","Calderdale 006C","E01010943",1077,29,10,19,78,89,60,92,225,280,133,78,55,91
"2011","Calderdale 006D","E01010961",879,35,17,18,130,115,59,78,188,172,57,22,35,45
"2011","Calderdale 007A","E01010917",1343,189,48,141,342,175,165,89,150,126,25,15,10,82
"2011","Calderdale 007B","E01010918",1228,196,61,135,330,152,150,65,117,100,37,25,12,81
"2011","Calderdale 007C","E01010919",1092,108,23,85,251,125,122,69,152,146,51,30,21,68
"2011","Calderdale 007D","E01010920",1318,228,54,174,341,160,188,67,127,105,27,11,16,75
"2011","Calderdale 007E","E01010921",1176,132,31,101,275,132,116,70,163,148,58,24,34,82
"2011","Calderdale 008A","E01010934",1530,146,44,102,305,231,147,123,256,193,54,36,18,75
"2011","Calderdale 008D","E01010967",1085,47,11,36,169,123,79,90,208,202,117,60,57,50
"2011","Calderdale 008E","E01010994",1333,149,14,135,206,129,103,81,217,240,137,83,54,71
"2011","Calderdale 008F","E01032923",1738,68,17,51,246,225,117,160,380,306,135,66,69,101
"2011","Calderdale 009A","E01010927",1223,123,28,95,273,223,148,87,176,116,21,15,6,56
"2011","Calderdale 009B","E01010928",1005,45,15,30,124,104,53,86,199,205,104,55,49,85
"2011","Calderdale 009C","E01010997",1097,116,37,79,257,189,108,84,138,87,36,24,12,82
"2011","Calderdale 009D","E01010999",1119,93,23,70,241,201,91,81,187,134,36,27,9,55
"2011","Calderdale 010A","E01010929",1552,60,14,46,218,171,131,114,297,264,193,127,66,104
"2011","Calderdale 010B","E01010930",1081,37,9,28,145,121,49,100,259,220,82,44,38,68
"2011","Calderdale 010C","E01010998",1111,75,24,51,189,158,85,90,189,164,74,56,18,87
"2011","Calderdale 010D","E01011000",1287,48,11,37,122,124,129,75,192,187,267,232,35,143
"2011","Calderdale 011A","E01010904",1064,103,24,79,280,190,103,59,145,101,16,8,8,67
"2011","Calderdale 011B","E01010906",1008,207,54,153,318,137,109,38,85,42,19,12,7,53
"2011","Calderdale 011C","E01010907",1068,141,50,91,277,176,123,66,112,81,25,16,9,67
"2011","Calderdale 011D","E01010909",1085,138,34,104,257,182,107,68,151,112,25,19,6,45
"2011","Calderdale 012A","E01010960",1051,33,4,29,85,98,102,47,147,184,234,212,22,121
"2011","Calderdale 012B","E01010964",1071,15,4,11,49,66,69,65,165,187,311,257,54,144
"2011","Calderdale 012C","E01010965",1009,36,4,32,80,65,67,55,160,155,271,240,31,120
"2011","Calderdale 012D","E01010966",1073,42,8,34,79,73,85,48,144,152,315,274,41,135
"2011","Calderdale 012E","E01010995",940,42,6,36,90,69,64,44,138,146,231,206,25,116
"2011","Calderdale 013A","E01010982",1001,95,17,78,245,117,106,63,158,103,53,37,16,61
"2011","Calderdale 013B","E01010983",1171,94,27,67,272,111,113,93,189,139,94,65,29,66
"2011","Calderdale 013C","E01010985",1098,97,20,77,260,116,126,84,170,139,50,31,19,56
"2011","Calderdale 013D","E01010986",1266,91,23,68,251,130,131,97,232,179,72,38,34,83
"2011","Calderdale 013E","E01010987",1252,117,23,94,285,140,148,90,190,139,56,26,30,87
"2011","Calderdale 013F","E01010988",1097,104,28,76,212,102,95,79,188,164,82,61,21,71
"2011","Calderdale 014A","E01010996",1033,30,4,26,68,72,100,42,144,156,249,219,30,172
"2011","Calderdale 014B","E01011001",1073,24,5,19,86,89,92,43,152,184,244,203,41,159
"2011","Calderdale 014C","E01011002",1221,67,10,57,167,150,112,74,208,137,175,137,38,131
"2011","Calderdale 014D","E01011003",853,39,7,32,94,84,82,57,160,140,126,104,22,71
"2011","Calderdale 015A","E01010878",1322,111,24,87,259,181,122,111,214,197,50,20,30,77
"2011","Calderdale 015B","E01010879",1406,236,83,153,364,191,131,94,161,121,29,15,14,79
"2011","Calderdale 015C","E01010905",1338,216,50,166,371,218,128,84,133,87,27,18,9,74
"2011","Calderdale 015D","E01010908",1542,174,56,118,385,210,152,115,205,174,40,21,19,87
"2011","Calderdale 015E","E01010910",912,83,20,63,166,113,72,65,136,166,63,35,28,48
"2011","Calderdale 016A","E01010969",1282,194,39,155,355,172,89,77,140,111,64,48,16,80
"2011","Calderdale 016B","E01010970",1341,229,42,187,336,189,98,57,163,107,55,43,12,107
"2011","Calderdale 016C","E01010974",1051,76,16,60,173,126,107,49,158,136,128,104,24,98
"2011","Calderdale 016D","E01010977",1165,98,23,75,266,205,105,116,167,113,23,11,12,72
"2011","Calderdale 017A","E01010975",1074,79,20,59,212,179,102,80,191,136,35,24,11,60
"2011","Calderdale 017B","E01010976",1358,192,41,151,320,206,129,109,164,128,35,23,12,75
"2011","Calderdale 017C","E01010978",995,81,24,57,167,125,103,82,155,166,54,36,18,62
"2011","Calderdale 017D","E01010979",1218,95,23,72,232,162,99,93,195,175,78,48,30,89
"2011","Calderdale 017E","E01010980",1116,69,13,56,186,148,103,84,230,175,61,37,24,60
"2011","Calderdale 017F","E01010981",1141,78,14,64,238,158,78,99,209,156,52,30,22,73
"2011","Calderdale 018A","E01010989",1137,138,22,116,245,159,82,81,173,147,42,27,15,70
"2011","Calderdale 018B","E01010990",1221,99,38,61,251,168,124,96,196,159,58,32,26,70
"2011","Calderdale 018C","E01010991",1157,82,18,64,247,171,124,112,196,148,26,13,13,51
"2011","Calderdale 018D","E01010992",1228,90,25,65,225,174,131,125,202,177,50,30,20,54
"2011","Calderdale 018E","E01010993",1234,76,20,56,186,151,79,117,243,210,73,45,28,99
"2011","Calderdale 019A","E01010875",1203,152,47,105,335,180,115,100,161,83,15,5,10,62
"2011","Calderdale 019B","E01010876",1192,135,39,96,276,184,116,103,166,111,23,10,13,78
"2011","Calderdale 019C","E01010877",1126,89,20,69,222,183,96,88,189,159,34,19,15,66
"2011","Calderdale 019D","E01010880",1083,51,17,34,144,113,73,72,202,232,122,75,47,74
"2011","Calderdale 019E","E01010949",1163,105,20,85,251,184,92,107,154,153,62,42,20,55
"2011","Calderdale 020A","E01010922",1441,136,35,101,350,184,166,87,218,158,46,27,19,96
"2011","Calderdale 020B","E01010956",1223,172,37,135,333,152,169,71,99,119,30,20,10,78
"2011","Calderdale 020C","E01010958",1010,47,10,37,143,97,82,79,192,230,82,46,36,58
"2011","Calderdale 020D","E01010959",1305,97,26,71,245,135,107,116,245,190,99,65,34,71
"2011","Calderdale 021A","E01010968",1305,278,56,222,384,176,95,44,126,88,38,25,13,76
"2011","Calderdale 021B","E01010971",1335,229,51,178,397,187,133,79,129,70,36,18,18,75
"2011","Calderdale 021C","E01010972",1114,200,36,164,287,169,93,45,131,72,34,27,7,83
"2011","Calderdale 021D","E01010973",1220,171,45,126,296,197,98,68,171,116,37,21,16,66
"2011","Calderdale 022A","E01010884",1144,143,36,107,269,120,137,92,162,116,54,30,24,51
"2011","Calderdale 022B","E01010885",1075,111,32,79,260,152,128,65,158,125,25,17,8,51
"2011","Calderdale 022C","E01010886",821,78,22,56,167,98,126,62,115,91,33,20,13,51
"2011","Calderdale 022D","E01010984",969,66,21,45,181,97,99,86,183,133,64,34,30,60
"2011","Calderdale 023A","E01010946",1002,183,50,133,302,154,94,37,104,45,12,10,2,71
"2011","Calderdale 023B","E01010947",1113,137,41,96,297,173,105,83,141,88,20,14,6,69
"2011","Calderdale 023C","E01010950",1109,91,28,63,220,155,87,91,175,175,53,36,17,62
"2011","Calderdale 023D","E01010951",1105,101,33,68,250,146,90,106,167,141,50,29,21,54
"2011","Calderdale 024A","E01010891",1275,86,23,63,218,155,104,113,224,210,94,56,38,71
"2011","Calderdale 024B","E01010892",1407,140,35,105,315,233,108,125,207,144,47,33,14,88
"2011","Calderdale 024C","E01010895",1056,90,15,75,192,124,69,84,175,189,70,38,32,63
"2011","Calderdale 024D","E01010945",1232,139,35,104,289,183,103,90,173,144,44,31,13,67
"2011","Calderdale 024E","E01010948",1016,80,12,68,233,143,86,80,167,118,45,31,14,64
"2011","Calderdale 025A","E01010889",1278,80,22,58,192,151,113,93,221,227,118,67,51,83
"2011","Calderdale 025B","E01010890",1389,98,22,76,246,187,122,121,233,225,77,40,37,80
"2011","Calderdale 025C","E01010893",1011,51,15,36,167,142,94,70,187,180,63,39,24,57
"2011","Calderdale 025D","E01010894",1169,48,11,37,154,143,85,107,215,252,97,55,42,68
"2011","Calderdale 025E","E01010901",1206,126,31,95,298,202,115,94,162,113,34,22,12,62
"2011","Calderdale 025F","E01010903",1173,150,36,114,287,182,119,80,129,116,38,21,17,72
"2011","Calderdale 026A","E01010896",1233,189,63,126,360,142,139,94,124,89,25,10,15,71
"2011","Calderdale 026B","E01010897",1313,198,55,143,370,165,167,81,120,105,34,16,18,73
"2011","Calderdale 026C","E01010898",1252,111,29,82,243,175,135,105,195,175,45,18,27,68
"2011","Calderdale 026D","E01010899",1013,92,27,65,245,152,104,83,138,93,37,23,14,69
"2011","Calderdale 026E","E01010900",1210,193,57,136,285,201,158,71,142,76,18,11,7,66
"2011","Calderdale 026F","E01010902",1114,116,33,83,214,134,96,80,190,132,67,38,29,85
"2011","Calderdale 027A","E01010952",1164,161,43,118,303,157,163,63,132,98,25,17,8,62
"2011","Calderdale 027B","E01010953",1088,193,68,125,312,136,148,56,88,80,17,4,13,58
"2011","Calderdale 027C","E01010954",1723,345,78,267,581,191,198,71,125,93,31,12,19,88
"2011","Calderdale 027D","E01010955",1156,155,44,111,326,132,166,45,113,63,32,12,20,124
"2011","Calderdale 027E","E01010957",1168,158,45,113,316,145,159,92,136,87,27,13,14,48
"2011","Kirklees 001A","E01011051",1186,123,34,89,264,228,118,82,137,120,30,19,11,84
"2011","Kirklees 001B","E01011055",935,124,43,81,232,149,107,50,105,80,27,21,6,61
"2011","Kirklees 001C","E01011056",1151,145,31,114,302,182,124,67,133,125,23,11,12,50
"2011","Kirklees 001D","E01011057",1014,139,36,103,249,152,129,71,90,93,35,20,15,56
"2011","Kirklees 001E","E01011058",858,85,35,50,187,140,91,53,114,107,32,26,6,49
"2011","Kirklees 002A","E01011048",1234,71,24,47,203,175,129,98,193,256,56,35,21,53
"2011","Kirklees 002B","E01011049",1214,88,31,57,256,187,109,79,177,185,57,32,25,76
"2011","Kirklees 002C","E01011050",1168,107,31,76,251,201,92,117,167,138,29,16,13,66
"2011","Kirklees 002D","E01011052",1226,97,34,63,224,171,105,90,221,211,41,30,11,66
"2011","Kirklees 002E","E01011053",1154,99,26,73,227,169,100,115,197,170,23,12,11,54
"2011","Kirklees 002F","E01011059",1021,30,8,22,96,103,49,88,198,262,130,67,63,65
"2011","Kirklees 003A","E01011062",1273,143,40,103,299,183,142,88,164,138,50,22,28,66
"2011","Kirklees 003B","E01011064",1050,82,25,57,185,114,117,96,164,170,63,36,27,59
"2011","Kirklees 003C","E01011068",1243,116,28,88,285,176,153,101,181,138,24,12,12,69
"2011","Kirklees 003D","E01011069",1016,101,33,68,230,151,100,86,148,124,25,11,14,51
"2011","Kirklees 004A","E01011241",1222,195,56,139,344,206,123,79,115,72,20,13,7,68
"2011","Kirklees 004B","E01011242",1149,64,22,42,197,129,105,100,233,197,68,35,33,56
"2011","Kirklees 004C","E01011243",1261,132,42,90,305,197,142,106,156,134,27,17,10,62
"2011","Kirklees 004D","E01011244",1509,184,61,123,358,216,125,138,208,148,30,19,11,102
"2011","Kirklees 005A","E01011060",1275,97,30,67,216,175,90,117,219,231,68,36,32,62
"2011","Kirklees 005B","E01011061",1267,69,23,46,209,144,121,110,218,232,94,55,39,70
"2011","Kirklees 005C","E01011063",1498,120,24,96,317,223,119,131,248,207,57,28,29,76
"2011","Kirklees 005D","E01011065",1231,82,33,49,236,189,123,113,183,181,40,23,17,84
"2011","Kirklees 005E","E01011066",1112,107,37,70,255,189,95,101,159,95,43,26,17,68
"2011","Kirklees 006A","E01011027",921,47,22,25,154,133,76,81,158,157,63,42,21,52
"2011","Kirklees 006B","E01011028",1077,62,19,43,194,152,71,83,194,200,55,34,21,66
"2011","Kirklees 006C","E01011030",1042,37,10,27,126,102,54,97,216,238,114,76,38,58
"2011","Kirklees 006D","E01011031",1217,81,20,61,228,180,117,115,196,160,64,50,14,76
"2011","Kirklees 006E","E01011054",1055,140,34,106,282,161,124,55,108,96,32,19,13,57
"2011","Kirklees 007A","E01011013",1058,84,18,66,213,166,146,81,147,138,36,26,10,47
"2011","Kirklees 007B","E01011014",1113,64,18,46,132,131,83,64,204,189,154,124,30,92
"2011","Kirklees 007C","E01011023",1187,85,23,62,216,134,93,78,190,189,119,96,23,83
"2011","Kirklees 007D","E01011024",1213,91,21,70,172,126,100,91,191,207,143,107,36,92
"2011","Kirklees 008A","E01011067",1198,134,41,93,275,181,133,83,158,122,40,22,18,72
"2011","Kirklees 008B","E01011247",1200,117,38,79,243,215,99,115,196,135,28,12,16,52
"2011","Kirklees 008C","E01011249",1129,89,33,56,191,130,113,82,199,182,82,54,28,61
"2011","Kirklees 008D","E01011251",1143,40,15,25,147,105,78,85,259,234,120,72,48,75
"2011","Kirklees 009A","E01011245",1156,109,49,60,198,162,105,67,174,187,71,42,29,83
"2011","Kirklees 009B","E01011246",1074,55,6,49,131,106,72,87,225,218,90,50,40,90
"2011","Kirklees 009C","E01011248",1096,83,35,48,215,147,96,98,187,174,42,27,15,54
"2011","Kirklees 009D","E01011250",1258,67,15,52,193,157,80,145,260,232,70,34,36,54
"2011","Kirklees 010A","E01011015",1066,34,7,27,90,109,94,58,142,200,237,211,26,102
"2011","Kirklees 010B","E01011029",1002,27,5,22,116,76,66,90,174,238,144,100,44,71
"2011","Kirklees 010C","E01011032",1008,44,13,31,116,112,67,61,170,209,134,100,34,95
"2011","Kirklees 010D","E01011034",1088,45,14,31,83,77,86,59,161,183,268,239,29,126
"2011","Kirklees 011A","E01011157",1170,63,20,43,165,111,134,79,167,163,180,147,33,108
"2011","Kirklees 011B","E01011161",975,82,34,48,195,146,76,98,154,137,29,19,10,58
"2011","Kirklees 011C","E01011163",937,44,13,31,135,93,66,57,196,189,86,58,28,71
"2011","Kirklees 011D","E01011164",1224,84,19,65,186,184,102,120,214,217,52,34,18,65
"2011","Kirklees 011E","E01011165",1271,71,10,61,171,153,156,79,164,149,197,168,29,131
"2011","Kirklees 011F","E01011166",1179,70,21,49,170,111,112,104,185,189,145,118,27,93
"2011","Kirklees 011G","E01011167",1287,53,10,43,149,131,158,96,181,206,219,183,36,94
"2011","Kirklees 012A","E01011033",1245,71,20,51,185,159,111,107,201,239,83,68,15,89
"2011","Kirklees 012B","E01011035",1116,59,13,46,87,94,117,58,130,193,243,214,29,135
"2011","Kirklees 012C","E01011036",1096,28,6,22,82,90,113,74,163,262,206,163,43,78
"2011","Kirklees 012D","E01011037",1462,90,20,70,232,172,157,114,243,213,144,118,26,97
"2011","Kirklees 013A","E01011016",1154,40,5,35,136,102,91,70,210,175,223,200,23,107
"2011","Kirklees 013B","E01011017",1186,37,7,30,89,104,96,38,170,186,311,293,18,155
"2011","Kirklees 013C","E01011018",1018,41,7,34,84,88,86,64,145,150,250,230,20,110
"2011","Kirklees 013D","E01011019",1278,67,19,48,174,128,111,63,194,174,249,229,20,118
"2011","Kirklees 013E","E01011020",898,30,5,25,69,56,67,44,145,167,231,206,25,89
"2011","Kirklees 014A","E01011021",1243,102,25,77,270,213,117,117,161,162,32,23,9,69
"2011","Kirklees 014B","E01011022",1068,84,29,55,238,157,96,86,142,137,54,43,11,74
"2011","Kirklees 014C","E01011126",1149,54,16,38,149,153,117,76,219,242,84,44,40,55
"2011","Kirklees 014D","E01011127",1042,67,27,40,199,170,91,111,177,141,33,21,12,53
"2011","Kirklees 015A","E01011156",1124,102,42,60,228,173,119,110,170,132,32,16,16,58
"2011","Kirklees 015B","E01011158",1312,81,25,56,228,182,111,115,240,198,74,55,19,83
"2011","Kirklees 015C","E01011159",1287,174,55,119,331,172,165,94,154,87,29,16,13,81
"2011","Kirklees 015D","E01011160",1052,108,32,76,250,177,123,72,120,103,17,10,7,82
"2011","Kirklees 015E","E01011162",1088,86,20,66,246,151,126,109,156,132,24,14,10,58
"2011","Kirklees 016A","E01011025",1093,47,17,30,144,88,92,99,206,205,139,91,48,73
"2011","Kirklees 016B","E01011026",1049,100,14,86,155,117,108,52,155,137,136,115,21,89
"2011","Kirklees 016C","E01011136",1002,62,22,40,151,98,72,98,165,153,129,94,35,74
"2011","Kirklees 016D","E01011137",1106,58,18,40,189,114,80,102,186,225,67,40,27,85
"2011","Kirklees 017A","E01011128",1426,86,10,76,185,129,142,97,185,251,235,212,23,116
"2011","Kirklees 017B","E01011130",1435,84,20,64,181,125,104,87,230,298,214,154,60,112
"2011","Kirklees 017E","E01033542",2049,193,36,157,349,202,223,117,225,251,287,236,51,202
"2011","Kirklees 018A","E01011121",1106,43,13,30,131,120,83,103,198,277,74,37,37,77
"2011","Kirklees 018B","E01011122",940,8,2,6,72,61,51,76,207,276,110,65,45,79
"2011","Kirklees 018C","E01011123",1138,63,13,50,174,145,113,107,154,201,96,75,21,85
"2011","Kirklees 018D","E01011124",1410,102,26,76,263,207,116,130,229,249,49,26,23,65
"2011","Kirklees 018E","E01011125",1106,59,20,39,177,140,79,91,190,226,59,34,25,85
"2011","Kirklees 018F","E01011129",986,68,24,44,174,130,74,111,160,137,59,41,18,73
"2011","Kirklees 019A","E01011138",1130,34,7,27,92,99,87,77,160,257,204,170,34,120
"2011","Kirklees 019B","E01011139",1014,30,9,21,112,88,93,73,177,201,156,136,20,84
"2011","Kirklees 019C","E01011140",997,16,3,13,71,76,99,59,109,216,249,218,31,102
"2011","Kirklees 019D","E01011141",1172,73,14,59,114,101,113,74,165,193,207,188,19,132
"2011","Kirklees 020A","E01011132",1055,193,62,131,281,160,100,61,89,54,31,21,10,86
"2011","Kirklees 020B","E01011142",1177,95,25,70,314,169,108,111,139,132,15,7,8,94
"2011","Kirklees 020C","E01011217",1203,124,40,84,251,223,128,89,185,137,24,15,9,42
"2011","Kirklees 020D","E01011218",1180,102,29,73,215,159,124,110,175,181,46,30,16,68
"2011","Kirklees 021A","E01011216",1052,136,41,95,300,144,95,75,114,82,23,19,4,83
"2011","Kirklees 021B","E01011219",1223,125,37,88,313,199,126,104,142,113,35,27,8,66
"2011","Kirklees 021C","E01011220",1270,69,21,48,179,140,84,120,224,253,111,52,59,90
"2011","Kirklees 021D","E01011221",1272,132,38,94,312,203,94,112,174,120,34,15,19,91
"2011","Kirklees 022A","E01011046",993,194,56,138,299,131,112,49,58,44,30,22,8,76
"2011","Kirklees 022B","E01011100",1078,66,28,38,178,126,68,97,196,195,67,45,22,85
"2011","Kirklees 022C","E01011102",1043,136,35,101,286,130,96,69,116,82,47,33,14,81
"2011","Kirklees 022D","E01011108",1129,105,19,86,227,168,122,84,154,136,51,32,19,82
"2011","Kirklees 023A","E01011133",926,17,2,15,67,53,97,69,126,221,190,166,24,86
"2011","Kirklees 023B","E01011134",1206,32,6,26,95,88,129,50,145,255,284,254,30,128
"2011","Kirklees 023C","E01011143",1032,21,6,15,59,80,139,48,124,216,247,210,37,98
"2011","Kirklees 023D","E01011144",970,22,3,19,46,66,104,44,127,217,254,228,26,90
"2011","Kirklees 023E","E01011260",924,39,10,29,120,112,58,85,179,178,87,56,31,66
"2011","Kirklees 024A","E01011257",1553,46,8,38,128,155,172,45,182,171,455,428,27,199
"2011","Kirklees 024B","E01011258",1514,58,14,44,120,109,192,59,119,151,352,328,24,354
"2011","Kirklees 024C","E01011259",1179,39,8,31,125,96,123,57,156,217,233,212,21,133
"2011","Kirklees 024D","E01011261",847,29,4,25,65,74,117,39,139,141,172,152,20,71
"2011","Kirklees 024E","E01011262",1043,34,8,26,104,90,67,74,138,198,211,186,25,127
"2011","Kirklees 024F","E01011263",1165,74,21,53,207,139,122,90,175,167,101,88,13,90
"2011","Kirklees 025A","E01011101",1184,37,11,26,118,105,63,75,242,220,190,128,62,134
"2011","Kirklees 025B","E01011103",988,31,16,15,125,95,67,90,179,212,104,63,41,85
"2011","Kirklees 025C","E01011104",1150,66,12,54,186,122,56,96,209,215,114,74,40,86
"2011","Kirklees 025D","E01011105",1375,107,20,87,214,148,76,96,202,246,146,109,37,140
"2011","Kirklees 026A","E01011212",1125,71,25,46,206,150,103,106,190,186,48,32,16,65
"2011","Kirklees 026B","E01011213",1147,156,37,119,296,176,123,62,149,100,19,13,6,66
"2011","Kirklees 026C","E01011214",1161,173,45,128,303,180,122,68,119,105,26,14,12,65
"2011","Kirklees 026D","E01011215",1542,170,38,132,372,234,171,109,178,148,72,57,15,88
"2011","Kirklees 027A","E01011039",1278,78,21,57,221,126,135,74,170,211,131,104,27,132
"2011","Kirklees 027B","E01011042",1176,182,41,141,300,141,115,49,124,98,67,49,18,100
"2011","Kirklees 027C","E01011047",1120,198,56,142,328,136,120,55,101,66,35,23,12,81
"2011","Kirklees 027D","E01011210",1437,287,58,229,377,173,127,73,138,91,57,39,18,114
"2011","Kirklees 028A","E01011252",924,158,53,105,264,95,136,41,82,65,16,11,5,67
"2011","Kirklees 028B","E01011253",919,24,5,19,113,83,61,80,178,235,78,60,18,67
"2011","Kirklees 028C","E01011254",1137,114,30,84,255,187,123,98,159,112,28,19,9,61
"2011","Kirklees 028D","E01011255",1041,29,11,18,100,97,77,94,203,257,101,54,47,83
"2011","Kirklees 028E","E01011256",987,41,12,29,126,94,71,81,206,240,72,45,27,56
"2011","Kirklees 029A","E01011038",1080,28,5,23,96,69,49,80,174,227,199,149,50,158
"2011","Kirklees 029B","E01011041",1090,68,14,54,158,102,78,65,163,200,148,104,44,108
"2011","Kirklees 029C","E01011106",1053,42,9,33,133,93,44,77,185,219,148,91,57,112
"2011","Kirklees 029D","E01011107",1424,31,6,25,124,63,62,82,179,226,211,157,54,446
"2011","Kirklees 030A","E01011201",1228,126,30,96,315,170,99,96,161,124,56,29,27,81
"2011","Kirklees 030B","E01011203",1282,176,41,135,348,199,111,91,138,88,35,24,11,96
"2011","Kirklees 030C","E01011209",1096,141,31,110,265,166,88,97,132,102,21,11,10,84
"2011","Kirklees 030D","E01011211",1164,154,49,105,309,187,108,79,131,97,30,18,12,69
"2011","Kirklees 031A","E01011040",1350,110,19,91,213,112,106,69,135,170,204,166,38,231
"2011","Kirklees 031B","E01011043",1759,102,14,88,268,142,159,93,169,215,243,202,41,368
"2011","Kirklees 031C","E01011044",1088,110,18,92,174,117,111,50,132,125,131,111,20,138
"2011","Kirklees 031D","E01011045",1348,34,5,29,128,65,133,60,186,282,277,235,42,183
"2011","Kirklees 032A","E01011089",936,54,18,36,186,151,92,78,154,135,32,17,15,54
"2011","Kirklees 032B","E01011091",1085,127,48,79,239,178,127,93,138,112,19,15,4,52
"2011","Kirklees 032C","E01011092",985,136,39,97,275,145,126,64,109,74,12,9,3,44
"2011","Kirklees 032D","E01011200",1748,258,87,171,515,216,187,115,174,116,48,29,19,119
"2011","Kirklees 033A","E01011204",1039,245,69,176,260,128,109,36,75,54,44,40,4,88
"2011","Kirklees 033B","E01011206",1211,131,28,103,291,164,97,76,172,128,63,44,19,89
"2011","Kirklees 033C","E01011208",1191,121,27,94,243,156,104,98,166,156,74,40,34,73
"2011","Kirklees 033D","E01011240",1227,103,29,74,256,150,107,82,200,140,89,63,26,100
"2011","Kirklees 034A","E01011231",1145,93,24,69,238,141,90,76,183,150,50,26,24,124
"2011","Kirklees 034B","E01011236",1446,66,10,56,179,103,89,81,131,161,164,141,23,472
"2011","Kirklees 034C","E01011238",1238,159,28,131,261,122,105,76,126,100,92,63,29,197
"2011","Kirklees 034D","E01011239",1212,168,33,135,282,133,99,49,129,87,90,60,30,175
"2011","Kirklees 035A","E01011093",1030,37,8,29,110,92,66,73,185,253,132,88,44,82
"2011","Kirklees 035B","E01011094",1035,22,6,16,110,77,59,78,217,226,115,76,39,131
"2011","Kirklees 035C","E01011096",1129,58,13,45,179,152,87,114,183,170,86,62,24,100
"2011","Kirklees 035D","E01011098",1201,66,17,49,173,142,92,94,168,153,89,44,45,224
"2011","Kirklees 036A","E01011146",1205,106,33,73,286,181,122,114,161,129,26,15,11,80
"2011","Kirklees 036B","E01011151",1233,186,55,131,336,179,151,75,127,82,19,10,9,78
"2011","Kirklees 036C","E01011202",1129,103,25,78,222,151,94,91,180,145,61,46,15,82
"2011","Kirklees 036D","E01011205",1246,158,52,106,341,171,146,98,130,109,19,9,10,74
"2011","Kirklees 037A","E01011090",1145,56,14,42,191,147,106,121,202,180,51,32,19,91
"2011","Kirklees 037B","E01011095",1040,89,24,65,218,142,77,93,175,135,54,37,17,57
"2011","Kirklees 037C","E01011097",1166,70,15,55,176,140,87,100,217,194,80,54,26,102
"2011","Kirklees 037D","E01011099",1091,61,17,44,182,138,92,105,195,211,42,26,16,65
"2011","Kirklees 038A","E01011150",1217,102,28,74,288,168,101,106,163,159,43,25,18,87
"2011","Kirklees 038B","E01011155",1451,193,53,140,405,198,148,115,174,136,35,17,18,47
"2011","Kirklees 038C","E01011207",1062,88,26,62,259,156,68,78,170,144,33,22,11,66
"2011","Kirklees 038D","E01011234",1108,66,22,44,167,128,74,94,221,181,91,57,34,86
"2011","Kirklees 039A","E01011232",1201,100,14,86,152,83,104,68,154,154,187,155,32,199
"2011","Kirklees 039B","E01011233",1154,172,38,134,240,155,89,69,157,112,76,69,7,84
"2011","Kirklees 039C","E01011235",1469,67,10,57,159,62,104,79,158,208,187,144,43,445
"2011","Kirklees 039D","E01011237",1141,55,11,44,136,101,95,79,194,189,146,132,14,146
"2011","Kirklees 040A","E01011004",956,25,7,18,117,100,63,74,186,233,85,53,32,73
"2011","Kirklees 040B","E01011006",1109,83,26,57,226,131,84,95,173,155,50,34,16,112
"2011","Kirklees 040C","E01011008",1192,71,12,59,227,125,76,85,176,137,67,37,30,228
"2011","Kirklees 040D","E01011012",1227,78,15,63,209,162,72,94,240,151,72,52,20,149
"2011","Kirklees 041A","E01011145",1131,84,22,62,220,147,109,95,193,166,31,19,12,86
"2011","Kirklees 041B","E01011147",1153,120,20,100,240,145,88,107,171,158,54,28,26,70
"2011","Kirklees 041C","E01011148",1188,53,16,37,140,117,73,99,231,255,126,81,45,94
"2011","Kirklees 041D","E01011152",1319,154,35,119,367,185,113,90,150,136,48,19,29,76
"2011","Kirklees 042A","E01011007",1177,110,25,85,254,149,74,73,128,83,60,41,19,246
"2011","Kirklees 042B","E01011223",1422,65,9,56,216,104,77,97,186,181,155,98,57,341
"2011","Kirklees 042C","E01011225",1379,60,10,50,176,103,54,75,214,201,104,77,27,392
"2011","Kirklees 042D","E01011229",2600,81,12,69,163,90,85,75,172,196,180,128,52,1558
"2011","Kirklees 043A","E01011080",1344,44,9,35,132,138,129,95,196,230,228,195,33,152
"2011","Kirklees 043B","E01011081",1307,68,7,61,168,119,122,79,165,208,232,188,44,146
"2011","Kirklees 043C","E01011082",1226,42,8,34,60,61,102,66,129,162,373,338,35,231
"2011","Kirklees 043D","E01011230",1333,46,2,44,98,72,103,67,119,203,339,308,31,286
"2011","Kirklees 044A","E01011005",1098,95,31,64,199,165,85,115,195,141,42,29,13,61
"2011","Kirklees 044B","E01011009",972,135,46,89,229,123,87,58,133,86,52,30,22,69
"2011","Kirklees 044C","E01011010",1079,63,18,45,160,94,61,82,212,212,108,70,38,87
"2011","Kirklees 044D","E01011011",1140,179,54,125,334,154,123,81,92,70,24,13,11,83
"2011","Kirklees 045A","E01011077",1224,101,30,71,243,176,114,113,176,153,50,26,24,98
"2011","Kirklees 045B","E01011149",1461,80,18,62,287,158,101,123,272,238,126,78,48,76
"2011","Kirklees 045C","E01011153",1284,79,18,61,260,160,102,111,251,185,71,38,33,65
"2011","Kirklees 045D","E01011154",1107,60,16,44,192,147,81,105,178,184,82,56,26,78
"2011","Kirklees 046A","E01011191",1151,98,20,78,231,168,147,101,171,125,31,12,19,79
"2011","Kirklees 046B","E01011192",1127,108,29,79,239,134,116,91,172,155,44,26,18,68
"2011","Kirklees 046C","E01011193",1426,210,61,149,353,179,178,92,153,156,39,16,23,66
"2011","Kirklees 046D","E01011194",1034,127,33,94,261,150,114,76,147,99,7,1,6,53
"2011","Kirklees 047A","E01011079",1381,79,17,62,193,167,121,118,231,231,139,97,42,102
"2011","Kirklees 047B","E01011083",1222,92,21,71,250,160,142,103,169,139,81,63,18,86
"2011","Kirklees 047C","E01011084",1176,38,12,26,106,109,72,66,192,219,244,197,47,130
"2011","Kirklees 047D","E01011085",1098,94,20,74,178,132,108,72,179,146,108,91,17,81
"2011","Kirklees 048A","E01011224",1269,51,10,41,166,119,68,113,222,222,123,80,43,185
"2011","Kirklees 048B","E01011226",1151,99,17,82,213,165,106,102,173,152,45,29,16,96
"2011","Kirklees 048C","E01011227",1181,50,15,35,163,136,75,94,223,227,99,61,38,114
"2011","Kirklees 048D","E01011228",1158,109,25,84,256,146,89,73,182,157,57,41,16,89
"2011","Kirklees 049A","E01011071",1246,111,30,81,295,144,146,116,185,144,34,24,10,71
"2011","Kirklees 049B","E01011072",1198,105,28,77,253,158,142,113,174,152,30,17,13,71
"2011","Kirklees 049C","E01011073",1098,80,22,58,220,114,104,102,179,162,66,35,31,71
"2011","Kirklees 049D","E01011078",1268,139,23,116,268,157,128,138,163,176,43,11,32,56
"2011","Kirklees 050A","E01011086",1189,163,39,124,328,154,127,65,143,107,38,30,8,64
"2011","Kirklees 050B","E01011087",1162,123,36,87,239,140,124,89,174,139,68,37,31,66
"2011","Kirklees 050C","E01011088",1042,119,34,85,282,177,102,65,137,75,18,9,9,67
"2011","Kirklees 050D","E01011222",1439,120,30,90,277,179,135,93,212,187,142,85,57,94
"2011","Kirklees 051A","E01011190",1244,197,63,134,368,154,163,67,120,82,28,16,12,65
"2011","Kirklees 051B","E01011195",1953,155,46,109,213,100,98,38,76,49,18,9,9,1206
"2011","Kirklees 051C","E01011196",1365,226,54,172,379,178,116,103,141,114,16,7,9,92
"2011","Kirklees 051D","E01011197",1161,115,39,76,256,123,141,98,161,154,43,27,16,70
"2011","Kirklees 052A","E01011070",1185,183,43,140,305,128,170,65,128,110,31,19,12,65
"2011","Kirklees 052B","E01011074",1418,165,32,133,366,159,156,110,186,178,42,30,12,56
"2011","Kirklees 052C","E01011075",1079,120,24,96,240,123,159,89,144,116,48,26,22,40
"2011","Kirklees 052D","E01011076",1109,128,19,109,262,119,92,91,159,152,35,19,16,71
"2011","Kirklees 053A","E01011169",1095,197,49,148,316,167,112,63,91,68,27,12,15,54
"2011","Kirklees 053B","E01011170",1356,228,85,143,364,191,154,82,141,97,32,21,11,67
"2011","Kirklees 053C","E01011171",1060,184,55,129,293,122,115,55,110,92,29,16,13,60
"2011","Kirklees 053D","E01011172",667,47,10,37,117,71,70,59,123,115,23,12,11,42
"2011","Kirklees 053E","E01011173",917,136,47,89,226,146,90,56,105,85,15,10,5,58
"2011","Kirklees 053F","E01011176",1066,157,31,126,259,143,143,66,114,94,28,18,10,62
"2011","Kirklees 054A","E01011109",1339,165,55,110,320,165,189,90,173,120,30,18,12,87
"2011","Kirklees 054B","E01011113",1282,161,41,120,334,173,115,114,171,124,20,8,12,70
"2011","Kirklees 054C","E01011114",1092,83,30,53,224,121,98,97,193,164,56,38,18,56
"2011","Kirklees 054D","E01011119",1096,140,42,98,282,146,125,69,125,121,30,14,16,58
"2011","Kirklees 055A","E01011168",1186,139,43,96,282,185,109,88,164,114,27,19,8,78
"2011","Kirklees 055B","E01011174",1333,203,59,144,403,177,145,84,129,88,26,14,12,78
"2011","Kirklees 055C","E01011175",1019,62,20,42,172,99,84,92,181,172,77,53,24,80
"2011","Kirklees 055D","E01011177",1297,193,53,140,321,193,136,102,148,94,28,21,7,82
"2011","Kirklees 055E","E01011178",1346,137,37,100,266,160,141,96,217,187,43,25,18,99
"2011","Kirklees 056A","E01011118",1149,174,55,119,315,147,152,72,118,92,24,15,9,55
"2011","Kirklees 056B","E01011120",1158,201,52,149,345,174,97,65,101,71,22,8,14,82
"2011","Kirklees 056C","E01011198",1152,211,63,148,332,131,143,60,104,87,22,12,10,62
"2011","Kirklees 056D","E01011199",1084,155,42,113,298,144,104,79,105,93,26,14,12,80
"2011","Kirklees 057A","E01011110",1027,147,56,91,287,119,111,80,114,92,23,17,6,54
"2011","Kirklees 057B","E01011111",1171,146,34,112,274,137,119,89,153,151,31,21,10,71
"2011","Kirklees 057C","E01011112",1183,168,41,127,284,118,152,91,147,143,28,16,12,52
"2011","Kirklees 057D","E01011115",1352,207,43,164,361,158,188,93,125,120,41,29,12,59
"2011","Kirklees 057E","E01011116",1269,183,43,140,329,169,101,91,169,119,32,23,9,76
"2011","Kirklees 057F","E01011117",1315,218,64,154,321,191,158,95,136,109,17,11,6,70
"2011","Kirklees 058A","E01011180",1452,252,70,182,381,169,158,86,171,117,32,14,18,86
"2011","Kirklees 058B","E01011182",1286,206,49,157,388,129,184,70,116,112,22,12,10,59
"2011","Kirklees 058C","E01011186",1168,195,57,138,330,161,129,65,122,62,31,21,10,73
"2011","Kirklees 058D","E01011188",1224,181,57,124,339,148,127,64,127,117,38,27,11,83
"2011","Kirklees 059A","E01011179",1355,234,61,173,403,152,176,62,125,101,24,15,9,78
"2011","Kirklees 059B","E01011181",1376,230,43,187,410,142,184,67,144,97,26,8,18,76
"2011","Kirklees 059C","E01011183",1501,240,66,174,396,173,222,100,143,99,26,10,16,102
"2011","Kirklees 059D","E01011184",1031,103,34,69,205,126,106,70,134,155,51,30,21,81
"2011","Kirklees 059E","E01011185",1141,156,49,107,309,129,129,80,129,115,33,16,17,61
"2011","Kirklees 059F","E01011187",1291,166,43,123,353,165,132,88,134,114,40,26,14,99
"2011","Kirklees 059G","E01011189",1209,218,59,159,350,148,155,64,119,80,15,12,3,60
"2011","Leeds 001A","E01011698",1130,160,45,115,260,195,101,69,160,99,23,17,6,63
"2011","Leeds 001B","E01011699",1021,176,46,130,268,185,79,64,113,65,16,15,1,55
"2011","Leeds 001C","E01011701",916,162,32,130,235,156,75,50,88,66,15,8,7,69
"2011","Leeds 001D","E01011702",855,232,75,157,249,110,98,19,50,25,13,5,8,59
"2011","Leeds 001E","E01011703",954,216,54,162,293,173,72,21,77,31,8,6,2,63
"2011","Leeds 002A","E01011697",1749,160,50,110,276,141,205,139,204,302,262,243,19,60
"2011","Leeds 002B","E01011700",1031,126,32,94,207,152,69,47,98,80,155,149,6,97
"2011","Leeds 002C","E01011704",1245,165,47,118,302,180,108,94,194,129,37,22,15,36
"2011","Leeds 002D","E01011705",947,66,19,47,174,124,78,79,176,165,42,22,20,43
"2011","Leeds 003A","E01011581",1055,114,28,86,252,155,118,77,161,94,28,15,13,56
"2011","Leeds 003B","E01011582",1121,60,11,49,163,129,127,100,246,181,56,30,26,59
"2011","Leeds 003C","E01011583",1082,105,20,85,242,152,121,84,172,107,23,15,8,76
"2011","Leeds 003D","E01011584",896,133,31,102,244,116,97,55,124,48,18,9,9,61
"2011","Leeds 004A","E01011569",1259,183,28,155,390,162,142,52,150,85,24,9,15,71
"2011","Leeds 004B","E01011571",1182,172,31,141,297,148,124,86,165,99,31,18,13,60
"2011","Leeds 004C","E01011572",1346,188,46,142,391,192,131,79,186,93,20,7,13,66
"2011","Leeds 004D","E01011573",1003,118,24,94,200,146,109,84,144,106,24,11,13,72
"2011","Leeds 004E","E01011574",984,184,35,149,247,115,99,49,139,92,23,13,10,36
"2011","Leeds 005A","E01011707",961,127,32,95,230,147,91,49,139,104,21,14,7,53
"2011","Leeds 005B","E01011709",1085,234,53,181,321,156,107,33,98,56,14,11,3,66
"2011","Leeds 005C","E01011710",1030,253,59,194,289,130,118,48,78,56,13,8,5,45
"2011","Leeds 005D","E01011711",990,207,49,158,277,132,125,42,80,66,15,7,8,46
"2011","Leeds 005E","E01011712",1036,200,46,154,260,120,125,54,128,83,18,16,2,48
"2011","Leeds 006A","E01011561",915,192,55,137,260,107,113,40,68,42,23,15,8,70
"2011","Leeds 006B","E01011696",1011,219,64,155,294,121,127,43,87,46,15,5,10,59
"2011","Leeds 006C","E01011706",1054,270,79,191,318,141,135,23,64,36,15,9,6,52
"2011","Leeds 006D","E01011708",1105,245,47,198,301,118,140,51,99,52,16,8,8,83
"2011","Leeds 006E","E01011713",1336,283,68,215,406,161,179,42,101,46,41,25,16,77
"2011","Leeds 007A","E01011570",1580,309,78,231,481,174,227,69,132,83,24,16,8,81
"2011","Leeds 007C","E01011576",1012,266,60,206,288,124,120,30,56,24,15,10,5,89
"2011","Leeds 007E","E01032503",1046,217,54,163,308,122,138,52,86,49,17,15,2,57
"2011","Leeds 007F","E01032504",1078,266,54,212,313,154,132,32,72,27,18,14,4,64
"2011","Leeds 008A","E01011266",1574,314,67,247,498,253,172,64,103,46,16,10,6,108
"2011","Leeds 008B","E01011270",1154,275,72,203,347,146,145,30,74,58,13,8,5,66
"2011","Leeds 008C","E01011279",932,141,25,116,266,124,97,57,90,75,27,13,14,55
"2011","Leeds 008D","E01011280",1294,210,53,157,335,209,141,75,145,85,22,9,13,72
"2011","Leeds 009A","E01011265",1114,165,29,136,315,163,116,66,120,76,34,14,20,59
"2011","Leeds 009B","E01011267",1022,117,20,97,206,143,87,93,172,112,37,17,20,55
"2011","Leeds 009C","E01011271",1560,301,64,237,451,233,153,81,152,69,26,14,12,94
"2011","Leeds 009D","E01011272",1115,174,34,140,262,199,101,86,125,86,20,13,7,62
"2011","Leeds 010A","E01011268",983,59,13,46,139,122,80,93,236,155,46,25,21,53
"2011","Leeds 010B","E01011273",1106,151,34,117,251,177,101,79,160,94,29,16,13,64
"2011","Leeds 010C","E01011274",1003,56,14,42,168,123,81,65,205,174,78,49,29,53
"2011","Leeds 010D","E01011275",976,86,18,68,217,154,79,75,169,100,35,24,11,61
"2011","Leeds 011A","E01011264",950,62,15,47,187,142,93,95,172,113,32,19,13,54
"2011","Leeds 011B","E01011269",1122,80,19,61,247,168,113,98,193,135,36,23,13,52
"2011","Leeds 011C","E01011276",1029,139,34,105,288,182,103,73,109,62,17,10,7,56
"2011","Leeds 011D","E01011578",1008,103,26,77,257,150,92,95,145,91,17,13,4,58
"2011","Leeds 012A","E01011554",1022,234,52,182,290,139,116,39,74,32,31,19,12,67
"2011","Leeds 012B","E01011562",1159,254,54,200,304,130,156,33,76,56,42,33,9,108
"2011","Leeds 012C","E01011563",1006,241,44,197,296,128,120,24,70,32,23,19,4,72
"2011","Leeds 012D","E01011564",1053,254,39,215,314,159,94,41,63,31,19,9,10,78
"2011","Leeds 012E","E01011567",1002,195,30,165,282,142,96,47,87,44,27,16,11,82
"2011","Leeds 013A","E01011376",1103,187,40,147,335,201,93,48,109,45,19,9,10,66
"2011","Leeds 013B","E01011377",973,147,34,113,272,200,86,40,85,49,14,10,4,80
"2011","Leeds 013C","E01011378",1044,66,11,55,171,157,82,76,205,112,99,64,35,76
"2011","Leeds 013D","E01011382",1062,145,30,115,272,213,85,78,122,68,17,9,8,62
"2011","Leeds 014A","E01011277",1121,161,38,123,306,166,103,86,149,74,22,11,11,54
"2011","Leeds 014B","E01011278",1215,205,44,161,327,196,138,62,123,85,24,12,12,55
"2011","Leeds 014C","E01011579",919,98,24,74,206,141,114,61,140,83,20,9,11,56
"2011","Leeds 014D","E01011580",964,157,43,114,267,152,116,39,111,54,14,13,1,54
"2011","Leeds 015A","E01011556",1122,207,23,184,338,164,70,38,132,47,60,39,21,66
"2011","Leeds 015B","E01011557",1097,236,30,206,300,142,122,35,95,38,29,25,4,100
"2011","Leeds 015C","E01011565",1017,189,31,158,283,163,115,38,96,38,30,22,8,65
"2011","Leeds 015D","E01011566",954,196,32,164,239,147,83,40,85,49,49,36,13,66
"2011","Leeds 015E","E01011568",1363,292,46,246,373,188,150,46,114,49,46,35,11,105
"2011","Leeds 016A","E01011380",1117,287,47,240,351,137,105,28,71,37,32,18,14,69
"2011","Leeds 016B","E01011381",942,174,43,131,268,153,87,31,83,36,28,18,10,82
"2011","Leeds 016C","E01011385",880,212,36,176,246,119,76,38,63,39,30,24,6,57
"2011","Leeds 016D","E01011386",1033,288,38,250,290,118,95,29,72,38,34,25,9,69
"2011","Leeds 017A","E01011379",1040,89,13,76,186,143,95,81,196,118,63,39,24,69
"2011","Leeds 017B","E01011384",1113,138,24,114,258,158,113,79,147,93,48,32,16,79
"2011","Leeds 017E","E01032501",853,122,31,91,236,129,92,61,87,62,12,7,5,52
"2011","Leeds 017F","E01032502",1300,99,16,83,222,162,90,95,240,171,122,86,36,99
"2011","Leeds 018A","E01011555",1049,182,27,155,277,191,91,44,102,40,44,26,18,78
"2011","Leeds 018B","E01011558",1073,93,10,83,192,148,82,76,167,111,110,73,37,94
"2011","Leeds 018C","E01011559",864,53,3,50,98,103,72,75,150,114,108,77,31,91
"2011","Leeds 018D","E01011560",1287,64,10,54,188,158,122,77,239,194,148,98,50,97
"2011","Leeds 019A","E01011383",1096,160,30,130,284,150,104,69,127,67,52,35,17,83
"2011","Leeds 019B","E01011388",982,135,26,109,239,154,82,51,123,72,48,35,13,78
"2011","Leeds 019C","E01011684",1121,173,35,138,274,157,88,57,115,86,62,48,14,109
"2011","Leeds 019D","E01011695",1056,76,17,59,170,139,68,86,195,122,116,74,42,84
"2011","Leeds 020A","E01011650",1052,279,51,228,308,102,118,30,78,34,32,26,6,71
"2011","Leeds 020B","E01011651",1059,221,49,172,300,134,91,50,116,44,39,25,14,64
"2011","Leeds 020C","E01011653",1016,236,34,202,309,123,80,38,81,37,39,21,18,73
"2011","Leeds 020D","E01011655",983,300,46,254,307,98,78,25,54,27,41,27,14,53
"2011","Leeds 021A","E01011455",1059,168,33,135,246,146,85,33,78,42,11,7,4,250
"2011","Leeds 021B","E01011456",1219,227,52,175,308,205,113,62,86,42,21,14,7,155
"2011","Leeds 021C","E01011459",1146,222,30,192,343,146,97,52,93,72,53,42,11,68
"2011","Leeds 021D","E01011461",1089,235,53,182,307,181,100,47,92,41,12,5,7,74
"2011","Leeds 022A","E01011311",881,225,55,170,236,97,151,33,54,24,16,12,4,45
"2011","Leeds 022B","E01011649",1067,243,45,198,335,150,107,28,69,43,18,11,7,74
"2011","Leeds 022C","E01011715",958,113,32,81,243,184,97,56,110,61,26,19,7,68
"2011","Leeds 022D","E01011719",1006,125,28,97,276,186,102,70,112,64,17,12,5,54
"2011","Leeds 023A","E01011509",956,177,29,148,258,141,92,46,90,57,31,19,12,64
"2011","Leeds 023B","E01011511",918,166,22,144,237,128,86,35,91,56,43,35,8,76
"2011","Leeds 023C","E01011512",1156,232,33,199,305,127,101,54,129,46,70,51,19,92
"2011","Leeds 023D","E01011515",1099,248,40,208,335,139,90,34,79,45,40,25,15,89
"2011","Leeds 023E","E01011516",1266,241,41,200,359,168,104,62,110,66,47,32,15,109
"2011","Leeds 024A","E01011508",1025,215,40,175,303,121,84,33,75,36,56,39,17,102
"2011","Leeds 024B","E01011517",1211,219,34,185,344,150,91,61,121,66,66,47,19,93
"2011","Leeds 024C","E01011652",1006,212,34,178,318,120,74,29,84,38,45,39,6,86
"2011","Leeds 024D","E01011654",1007,309,53,256,321,104,65,28,45,33,31,15,16,71
"2011","Leeds 025A","E01011505",1134,146,30,116,260,173,98,62,132,99,68,46,22,96
"2011","Leeds 025B","E01011506",1008,165,25,140,237,132,98,59,93,59,83,65,18,82
"2011","Leeds 025C","E01011507",1167,192,30,162,299,181,111,73,129,68,38,25,13,76
"2011","Leeds 025D","E01011510",1052,83,14,69,168,139,95,63,178,148,96,60,36,82
"2011","Leeds 025E","E01011514",1212,272,38,234,324,149,111,40,108,49,73,60,13,86
"2011","Leeds 027A","E01011452",1116,242,49,193,329,171,96,59,87,49,16,5,11,67
"2011","Leeds 027B","E01011454",1146,232,40,192,395,170,76,57,93,47,14,9,5,62
"2011","Leeds 027C","E01011457",1115,231,59,172,327,138,145,37,63,40,16,13,3,118
"2011","Leeds 027D","E01011458",990,202,56,146,312,136,116,42,76,38,13,9,4,55
"2011","Leeds 027E","E01011465",1119,193,37,156,301,161,77,62,131,93,46,30,16,55
"2011","Leeds 028A","E01011453",1090,204,33,171,346,154,105,47,97,60,14,8,6,63
"2011","Leeds 028B","E01011460",1053,186,23,163,307,149,83,48,101,69,34,21,13,76
"2011","Leeds 028C","E01011462",1213,137,19,118,268,166,95,74,186,131,56,27,29,100
"2011","Leeds 028D","E01011463",1162,110,21,89,254,151,98,89,174,151,61,39,22,74
"2011","Leeds 028E","E01011464",1368,269,50,219,412,207,100,66,129,92,17,9,8,76
"2011","Leeds 029A","E01011714",1088,87,30,57,236,187,92,80,176,121,31,15,16,78
"2011","Leeds 029B","E01011716",1114,139,35,104,283,152,131,70,134,71,39,24,15,95
"2011","Leeds 029C","E01011717",1081,81,22,59,186,182,103,105,197,125,48,33,15,54
"2011","Leeds 029D","E01011718",1017,54,11,43,150,155,76,91,206,155,61,39,22,69
"2011","Leeds 029E","E01011720",1086,37,10,27,135,142,74,101,249,227,56,32,24,65
"2011","Leeds 030A","E01011296",1191,174,47,127,348,208,111,76,131,71,23,12,11,49
"2011","Leeds 030B","E01011297",1159,171,40,131,313,168,136,72,122,90,25,15,10,62
"2011","Leeds 030C","E01011309",1104,163,46,117,299,148,151,54,115,74,44,21,23,56
"2011","Leeds 030D","E01011310",1175,258,53,205,321,156,129,47,106,62,25,14,11,71
"2011","Leeds 031A","E01011513",1629,430,48,382,461,207,139,48,146,54,36,24,12,108
"2011","Leeds 031B","E01011688",1110,217,24,193,298,154,66,50,117,54,68,46,22,86
"2011","Leeds 031C","E01011689",1148,185,26,159,313,143,85,68,128,98,42,28,14,86
"2011","Leeds 031D","E01011691",1086,121,14,107,218,133,47,52,146,125,93,51,42,151
"2011","Leeds 032A","E01011504",1015,63,7,56,185,125,70,65,181,124,106,78,28,96
"2011","Leeds 032B","E01011641",1081,296,50,246,361,118,70,26,65,34,34,21,13,77
"2011","Leeds 032C","E01011642",945,189,36,153,259,100,74,37,85,44,60,47,13,97
"2011","Leeds 032D","E01011645",1043,245,42,203,305,106,93,35,83,36,54,38,16,86
"2011","Leeds 033A","E01011484",1061,63,12,51,117,97,84,81,222,192,124,81,43,81
"2011","Leeds 033B","E01011485",1138,93,12,81,217,145,73,85,168,143,122,83,39,92
"2011","Leeds 033E","E01011686",1086,55,6,49,140,152,84,72,243,163,99,55,44,78
"2011","Leeds 033F","E01032493",1036,142,17,125,258,169,70,75,129,103,29,17,12,61
"2011","Leeds 033G","E01032494",1258,62,10,52,180,134,74,102,242,221,128,85,43,115
"2011","Leeds 034A","E01011350",1252,256,34,222,383,151,122,57,89,65,44,31,13,85
"2011","Leeds 034B","E01011351",1406,417,44,373,445,147,84,43,95,55,54,38,16,66
"2011","Leeds 034C","E01011352",1455,356,43,313,500,151,77,50,119,72,58,34,24,72
"2011","Leeds 034D","E01011353",1461,346,52,294,513,177,87,48,109,66,34,24,10,81
"2011","Leeds 035A","E01011656",1021,38,8,30,124,121,44,97,215,187,108,67,41,87
"2011","Leeds 035B","E01011657",959,34,10,24,129,123,63,73,228,160,91,50,41,58
"2011","Leeds 035C","E01011659",1009,22,5,17,107,117,49,119,219,197,116,72,44,63
"2011","Leeds 035D","E01011661",1084,40,14,26,115,117,58,94,252,230,111,79,32,67
"2011","Leeds 037A","E01011643",957,249,32,217,273,98,109,29,68,42,40,35,5,49
"2011","Leeds 037B","E01011644",845,182,25,157,202,104,71,38,90,48,49,28,21,61
"2011","Leeds 037C","E01011646",1165,167,29,138,285,160,124,63,115,98,65,49,16,88
"2011","Leeds 037D","E01011647",1160,100,12,88,167,127,124,54,143,93,209,180,29,143
"2011","Leeds 037E","E01011648",1181,93,19,74,226,179,140,70,140,85,117,104,13,131
"2011","Leeds 038A","E01011354",1006,40,7,33,135,106,46,77,203,158,131,84,47,110
"2011","Leeds 038B","E01011355",992,72,13,59,176,119,66,56,189,134,92,66,26,88
"2011","Leeds 038C","E01011357",1337,62,12,50,163,133,91,74,249,192,230,156,74,143
"2011","Leeds 038D","E01011450",925,134,12,122,160,94,52,55,136,113,91,68,23,90
"2011","Leeds 039A","E01011588",1239,196,35,161,348,162,130,80,115,85,47,28,19,76
"2011","Leeds 039B","E01011589",1129,267,54,213,350,151,100,56,78,48,15,11,4,64
"2011","Leeds 039C","E01011590",1144,189,42,147,313,196,131,73,105,52,30,21,9,55
"2011","Leeds 039D","E01011592",1099,160,38,122,291,175,79,82,161,94,18,9,9,39
"2011","Leeds 039E","E01011593",1360,223,49,174,343,225,124,103,137,109,19,14,5,77
"2011","Leeds 040A","E01011421",1036,58,7,51,135,134,95,60,215,160,90,65,25,89
"2011","Leeds 040B","E01011425",1160,119,20,99,229,158,92,77,183,140,55,39,16,107
"2011","Leeds 040C","E01011658",890,22,7,15,94,92,53,70,206,186,102,62,40,65
"2011","Leeds 040D","E01011660",922,27,8,19,98,100,59,73,211,198,102,59,43,54
"2011","Leeds 040E","E01011662",823,20,7,13,70,78,43,69,169,173,134,90,44,67
"2011","Leeds 041A","E01011721",1052,29,9,20,126,142,61,93,236,212,87,58,29,66
"2011","Leeds 041B","E01011722",1342,72,19,53,207,188,86,131,247,217,93,61,32,101
"2011","Leeds 041C","E01011723",947,34,8,26,120,137,42,76,217,179,76,52,24,66
"2011","Leeds 041D","E01011724",1283,45,10,35,176,176,82,127,259,232,98,53,45,88
"2011","Leeds 042A","E01011356",1528,241,29,212,392,205,118,68,148,130,101,63,38,125
"2011","Leeds 042B","E01011358",1046,60,9,51,173,117,75,72,193,162,106,79,27,88
"2011","Leeds 042C","E01011359",1299,175,24,151,317,125,90,61,132,102,137,101,36,160
"2011","Leeds 042D","E01011360",1344,44,3,41,164,144,98,81,179,141,299,252,47,194
"2011","Leeds 042E","E01011361",1720,60,5,55,208,174,88,104,246,240,324,227,97,276
"2011","Leeds 044A","E01011435",1738,70,4,66,143,75,23,24,54,38,25,11,14,1286
"2011","Leeds 044D","E01011440",1536,126,18,108,188,86,37,24,67,42,33,14,19,933
"2011","Leeds 044E","E01011441",1808,122,9,113,172,103,45,51,99,75,101,62,39,1040
"2011","Leeds 044F","E01032945",3036,111,10,101,202,109,61,56,108,74,65,50,15,2250
"2011","Leeds 045A","E01011477",1497,133,21,112,240,156,94,83,181,159,142,93,49,309
"2011","Leeds 045B","E01011480",1247,121,19,102,253,153,79,78,168,119,44,30,14,232
"2011","Leeds 045C","E01011488",1199,173,25,148,306,175,49,61,136,105,66,39,27,128
"2011","Leeds 045D","E01011489",1327,144,18,126,303,154,80,69,182,143,67,44,23,185
"2011","Leeds 046A","E01011324",1848,32,7,25,71,69,27,52,156,164,118,88,30,1159
"2011","Leeds 046B","E01011325",1097,110,24,86,243,143,88,71,180,137,53,35,18,72
"2011","Leeds 046C","E01011326",955,50,16,34,118,149,47,83,175,185,96,67,29,52
"2011","Leeds 046D","E01011332",915,53,13,40,133,123,57,81,175,136,87,62,25,70
"2011","Leeds 047A","E01011423",1069,50,12,38,149,120,78,68,218,172,141,108,33,73
"2011","Leeds 047B","E01011424",996,40,7,33,123,112,87,65,163,147,148,120,28,111
"2011","Leeds 047C","E01011427",1116,23,5,18,82,81,103,71,198,170,248,208,40,140
"2011","Leeds 047D","E01011431",1222,29,4,25,114,122,62,98,231,233,197,133,64,136
"2011","Leeds 048A","E01011422",1039,57,5,52,120,97,95,67,130,103,227,194,33,143
"2011","Leeds 048B","E01011426",1067,36,5,31,89,101,80,77,116,106,296,252,44,166
"2011","Leeds 048C","E01011428",1277,48,7,41,114,96,153,67,175,158,283,244,39,183
"2011","Leeds 048D","E01011429",1340,27,7,20,110,106,93,73,208,127,381,312,69,215
"2011","Leeds 050A","E01011663",782,26,1,25,74,83,38,55,163,135,144,106,38,64
"2011","Leeds 050B","E01011664",771,25,8,17,74,92,42,58,167,169,83,53,30,61
"2011","Leeds 050C","E01011665",1048,42,11,31,139,132,64,91,234,180,90,49,41,76
"2011","Leeds 050D","E01011667",877,11,2,9,65,66,39,69,193,179,169,111,58,86
"2011","Leeds 051A","E01011323",895,52,13,39,164,139,65,73,163,145,41,26,15,53
"2011","Leeds 051B","E01011329",1152,113,27,86,252,224,104,89,164,112,18,7,11,76
"2011","Leeds 051C","E01011330",925,65,16,49,172,141,87,78,171,123,34,21,13,54
"2011","Leeds 051D","E01011333",927,57,18,39,149,128,70,90,183,162,40,26,14,48
"2011","Leeds 052A","E01011327",1036,93,23,70,188,147,84,75,181,125,66,40,26,77
"2011","Leeds 052B","E01011328",1065,76,18,58,187,151,84,93,195,154,64,32,32,61
"2011","Leeds 052C","E01011335",1282,106,22,84,274,186,109,112,191,174,59,32,27,71
"2011","Leeds 052D","E01011591",1317,232,47,185,423,191,102,85,136,80,21,10,11,47
"2011","Leeds 053A","E01011430",986,24,2,22,58,84,118,42,167,111,250,218,32,132
"2011","Leeds 053B","E01011432",1019,51,9,42,108,89,108,55,141,152,202,157,45,113
"2011","Leeds 053C","E01011433",1064,26,6,20,111,72,91,68,185,194,211,176,35,106
"2011","Leeds 053D","E01011434",967,29,4,25,94,97,78,70,162,140,198,151,47,99
"2011","Leeds 054A","E01011445",1640,22,2,20,64,37,17,27,52,21,29,19,10,1371
"2011","Leeds 054B","E01011446",1484,37,2,35,93,66,28,38,78,46,58,47,11,1040
"2011","Leeds 054C","E01011447",1338,29,1,28,79,64,21,34,66,55,61,46,15,929
"2011","Leeds 054D","E01011448",1409,28,3,25,58,71,47,25,67,49,86,66,20,978
"2011","Leeds 054E","E01011449",1205,56,5,51,123,102,34,32,102,80,81,57,24,595
"2011","Leeds 055A","E01011670",2232,53,4,49,129,131,47,91,194,174,169,125,44,1244
"2011","Leeds 055B","E01011671",1098,30,4,26,113,92,35,78,171,156,178,118,60,245
"2011","Leeds 055F","E01033002",1069,110,6,104,151,76,36,60,96,101,99,80,19,340
"2011","Leeds 055G","E01033003",1506,120,11,109,196,151,62,118,183,195,180,131,49,301
"2011","Leeds 055H","E01033005",3249,70,6,64,140,102,57,77,129,125,169,126,43,2380
"2011","Leeds 056A","E01011478",1466,137,12,125,286,168,45,75,133,107,79,41,38,436
"2011","Leeds 056B","E01011479",1410,74,4,70,195,112,40,56,79,51,41,20,21,762
"2011","Leeds 056C","E01011481",1319,71,5,66,195,93,54,50,110,96,112,82,30,538
"2011","Leeds 056D","E01011482",1441,165,20,145,330,230,81,77,161,104,60,34,26,233
"2011","Leeds 056E","E01011483",1259,58,9,49,117,110,53,56,158,126,147,113,34,434
"2011","Leeds 057A","E01011406",1021,91,23,68,242,178,95,75,133,118,29,16,13,60
"2011","Leeds 057B","E01011407",1018,54,13,41,203,187,99,92,183,113,38,17,21,49
"2011","Leeds 057C","E01011408",1007,97,22,75,205,209,63,107,158,110,16,9,7,42
"2011","Leeds 057D","E01011409",1077,113,25,88,264,175,89,91,161,88,32,19,13,64
"2011","Leeds 057E","E01011410",991,103,26,77,241,182,76,97,152,83,15,7,8,42
"2011","Leeds 057F","E01011412",968,73,15,58,238,185,73,80,146,104,16,6,10,53
"2011","Leeds 058A","E01011331",931,109,21,88,196,158,58,61,142,127,33,24,9,47
"2011","Leeds 058B","E01011334",1023,76,10,66,211,126,75,86,185,147,66,33,33,51
"2011","Leeds 058C","E01011336",1078,40,4,36,135,150,62,116,226,202,96,64,32,51
"2011","Leeds 058D","E01011337",893,42,9,33,69,76,42,57,185,207,126,84,42,89
"2011","Leeds 059A","E01011281",1403,170,23,147,275,178,96,82,214,185,115,74,41,88
"2011","Leeds 059B","E01011282",1001,46,3,43,160,145,68,85,204,166,67,40,27,60
"2011","Leeds 059C","E01011283",911,46,8,38,90,91,72,78,160,183,119,71,48,72
"2011","Leeds 059D","E01011286",958,78,11,67,194,151,70,86,149,136,33,21,12,61
"2011","Leeds 059E","E01011295",1135,64,9,55,165,143,66,93,227,205,99,58,41,73
"2011","Leeds 060A","E01011339",1269,49,13,36,149,130,84,91,267,253,151,109,42,95
"2011","Leeds 060B","E01011340",1104,28,4,24,137,103,51,87,216,218,157,101,56,107
"2011","Leeds 060C","E01011342",941,23,6,17,98,75,52,58,202,216,122,87,35,95
"2011","Leeds 060D","E01011346",1208,57,12,45,125,135,84,105,240,249,126,84,42,87
"2011","Leeds 061A","E01011341",1062,57,13,44,158,169,83,85,206,178,57,32,25,69
"2011","Leeds 061B","E01011343",1300,75,17,58,254,192,106,103,224,195,84,55,29,67
"2011","Leeds 061C","E01011345",987,50,8,42,138,126,67,88,185,175,91,64,27,67
"2011","Leeds 061D","E01011666",1104,72,21,51,213,175,94,112,180,143,29,17,12,86
"2011","Leeds 062A","E01011585",1031,70,11,59,173,155,86,83,197,169,47,26,21,51
"2011","Leeds 062B","E01011587",1310,155,31,124,327,217,113,105,159,134,30,19,11,70
"2011","Leeds 062C","E01011594",1043,69,15,54,161,144,81,85,188,184,68,48,20,63
"2011","Leeds 062D","E01011596",1306,150,43,107,337,253,131,107,149,104,18,10,8,57
"2011","Leeds 062E","E01011598",1189,180,33,147,308,201,106,91,149,95,16,8,8,43
"2011","Leeds 063B","E01011678",4015,97,6,91,134,89,34,32,98,78,72,55,17,3381
"2011","Leeds 063D","E01011681",1473,63,7,56,120,95,63,60,139,120,142,113,29,671
"2011","Leeds 063E","E01033006",3213,133,8,125,201,124,35,43,126,80,101,83,18,2370
"2011","Leeds 064A","E01011338",1113,20,4,16,106,88,42,86,188,222,198,141,57,163
"2011","Leeds 064B","E01011673",1233,47,5,42,147,102,81,83,197,177,253,188,65,146
"2011","Leeds 064D","E01011677",1128,56,6,50,115,93,78,66,193,237,200,137,63,90
"2011","Leeds 064E","E01033031",1098,95,6,89,196,117,55,81,168,151,106,71,35,129
"2011","Leeds 064F","E01033035",1048,20,2,18,89,43,61,67,184,231,255,180,75,98
"2011","Leeds 065A","E01011344",1273,43,7,36,179,135,62,86,217,254,209,148,61,88
"2011","Leeds 065B","E01011347",1188,32,7,25,146,120,54,67,215,242,204,126,78,108
"2011","Leeds 065C","E01011348",1073,18,4,14,97,95,57,75,205,238,182,149,33,106
"2011","Leeds 065D","E01011349",1301,33,4,29,123,134,76,105,273,301,171,127,44,85
"2011","Leeds 066A","E01011586",1045,97,24,73,238,152,67,69,165,128,51,35,16,78
"2011","Leeds 066B","E01011595",1255,159,31,128,317,173,153,53,126,103,66,57,9,105
"2011","Leeds 066C","E01011597",1070,89,20,69,191,134,120,59,147,135,92,77,15,103
"2011","Leeds 066D","E01011599",1099,117,23,94,246,188,94,93,156,94,41,24,17,70
"2011","Leeds 067B","E01011287",1013,62,19,43,207,166,62,98,182,141,37,26,11,58
"2011","Leeds 067G","E01032499",1306,134,26,108,297,223,103,104,165,136,36,25,11,108
"2011","Leeds 067H","E01032500",899,69,12,57,158,112,60,67,125,161,92,50,42,55
"2011","Leeds 067I","E01032606",1492,108,25,83,218,254,109,130,270,239,83,36,47,81
"2011","Leeds 067J","E01032607",818,66,10,56,171,106,58,73,124,130,45,28,17,45
"2011","Leeds 067K","E01032608",893,80,17,63,206,131,58,57,119,109,57,40,17,76
"2011","Leeds 068A","E01011608",1009,58,16,42,162,143,77,87,192,174,56,37,19,60
"2011","Leeds 068B","E01011609",1056,46,16,30,163,158,85,108,216,178,49,25,24,53
"2011","Leeds 068C","E01011610",1067,111,25,86,240,184,117,64,137,107,36,28,8,71
"2011","Leeds 068D","E01011611",950,32,8,24,128,140,75,71,180,183,79,41,38,62
"2011","Leeds 068E","E01011614",1394,151,22,129,322,227,133,104,207,152,37,23,14,61
"2011","Leeds 069A","E01011413",1134,114,38,76,275,222,78,91,144,98,33,15,18,79
"2011","Leeds 069B","E01011415",1200,93,17,76,270,221,122,115,150,124,37,21,16,68
"2011","Leeds 069C","E01011416",1077,85,26,59,263,170,112,75,144,112,33,18,15,83
"2011","Leeds 069D","E01011417",1078,70,19,51,205,197,107,93,172,143,37,24,13,54
"2011","Leeds 069E","E01011420",940,88,21,67,231,187,100,62,108,98,22,13,9,44
"2011","Leeds 070A","E01011615",1094,44,11,33,183,171,82,91,200,196,54,36,18,73
"2011","Leeds 070B","E01011617",1119,26,6,20,151,159,53,91,216,210,127,94,33,86
"2011","Leeds 070C","E01011618",1144,50,14,36,192,199,33,81,222,188,92,57,35,87
"2011","Leeds 070D","E01011621",1025,36,5,31,105,99,58,83,221,229,104,70,34,90
"2011","Leeds 071A","E01011284",1405,99,19,80,255,176,88,134,220,241,105,69,36,87
"2011","Leeds 071B","E01011292",1200,40,6,34,134,104,75,93,256,259,158,104,54,81
"2011","Leeds 071C","E01011293",1247,66,7,59,153,103,109,88,226,243,147,98,49,112
"2011","Leeds 071D","E01011294",1203,43,7,36,114,89,105,105,204,280,218,177,41,45
"2011","Leeds 071E","E01011363",1116,30,10,20,125,109,46,82,202,251,181,128,53,90
"2011","Leeds 072A","E01011616",1027,34,10,24,118,138,74,80,206,202,93,60,33,82
"2011","Leeds 072B","E01011620",872,33,12,21,92,96,64,67,170,154,120,86,34,76
"2011","Leeds 072C","E01011622",1136,23,3,20,92,96,51,73,238,247,195,129,66,121
"2011","Leeds 072D","E01011624",1183,24,5,19,111,86,51,99,231,297,170,136,34,114
"2011","Leeds 073A","E01011411",1160,143,34,109,319,212,106,88,115,79,20,15,5,78
"2011","Leeds 073B","E01011414",1122,131,35,96,271,214,87,92,133,85,27,7,20,82
"2011","Leeds 073C","E01011418",1124,161,37,124,300,179,101,83,151,57,16,9,7,76
"2011","Leeds 073D","E01011419",952,142,38,104,264,169,82,66,100,59,16,10,6,54
"2011","Leeds 074A","E01011396",1360,124,26,98,322,193,99,97,173,146,42,21,21,164
"2011","Leeds 074B","E01011399",1064,96,30,66,223,177,96,95,159,111,27,16,11,80
"2011","Leeds 074C","E01011400",1048,78,9,69,220,184,79,84,168,128,34,22,12,73
"2011","Leeds 074D","E01011403",913,108,27,81,213,165,81,64,136,65,17,11,6,64
"2011","Leeds 075B","E01011623",1076,39,10,29,119,109,44,71,202,236,181,109,72,75
"2011","Leeds 075C","E01011625",1082,50,11,39,122,136,65,77,204,208,148,91,57,72
"2011","Leeds 075D","E01011626",1375,114,10,104,202,156,52,95,219,253,147,102,45,137
"2011","Leeds 075E","E01033021",942,65,6,59,133,124,48,73,151,137,119,85,34,92
"2011","Leeds 075F","E01033033",1486,232,18,214,274,120,46,49,78,80,37,22,15,570
"2011","Leeds 075G","E01033034",998,258,31,227,324,148,26,25,50,24,18,12,6,125
"2011","Leeds 076A","E01011602",1063,98,30,68,249,185,102,77,156,121,29,15,14,46
"2011","Leeds 076B","E01011603",1116,120,35,85,283,188,103,71,125,99,34,17,17,93
"2011","Leeds 076C","E01011605",1092,121,34,87,260,198,106,89,145,101,14,7,7,58
"2011","Leeds 076D","E01011606",1140,77,20,57,182,180,107,112,188,170,47,30,17,77
"2011","Leeds 076E","E01011613",914,79,22,57,185,149,86,53,135,111,55,32,23,61
"2011","Leeds 077A","E01011397",1132,93,21,72,283,225,83,85,165,100,13,10,3,85
"2011","Leeds 077B","E01011398",990,134,46,88,244,177,69,74,122,91,10,6,4,69
"2011","Leeds 077C","E01011401",1094,136,33,103,260,221,92,86,145,83,18,10,8,53
"2011","Leeds 077D","E01011404",980,113,26,87,230,165,79,74,150,88,18,15,3,63
"2011","Leeds 077E","E01011405",1060,117,39,78,257,202,94,85,155,79,17,11,6,54
"2011","Leeds 078A","E01011725",1059,25,8,17,99,122,47,90,217,240,122,59,63,97
"2011","Leeds 078B","E01011729",1149,56,9,47,192,137,53,93,219,201,127,75,52,71
"2011","Leeds 078C","E01011730",1097,44,16,28,155,175,72,77,216,190,97,52,45,71
"2011","Leeds 078D","E01011735",1169,32,8,24,126,139,72,101,235,255,112,63,49,97
"2011","Leeds 079A","E01011600",1138,134,39,95,293,206,87,91,155,88,27,14,13,57
"2011","Leeds 079B","E01011601",1083,93,27,66,199,130,104,76,189,177,57,39,18,58
"2011","Leeds 079C","E01011604",981,157,26,131,257,157,83,57,118,77,22,13,9,53
"2011","Leeds 079D","E01011607",1184,117,26,91,249,195,105,97,201,123,42,27,15,55
"2011","Leeds 079E","E01011612",863,66,17,49,174,142,66,63,150,139,38,19,19,25
"2011","Leeds 080A","E01011726",1037,44,11,33,141,130,63,84,211,197,88,50,38,79
"2011","Leeds 080B","E01011727",1158,98,30,68,258,216,124,104,145,129,38,26,12,46
"2011","Leeds 080C","E01011728",1018,83,25,58,183,166,138,90,148,114,23,13,10,73
"2011","Leeds 080D","E01011739",1127,33,9,24,136,133,72,118,236,215,117,66,51,67
"2011","Leeds 081A","E01011362",1431,100,18,82,241,218,108,109,208,245,131,78,53,71
"2011","Leeds 081B","E01011731",1079,71,14,57,205,197,100,112,172,129,35,23,12,58
"2011","Leeds 081C","E01011732",1355,107,33,74,259,243,108,119,210,182,55,47,8,72
"2011","Leeds 081D","E01011733",1100,85,21,64,219,192,89,104,183,124,35,16,19,69
"2011","Leeds 082A","E01011366",1159,32,3,29,147,107,72,83,240,221,161,113,48,96
"2011","Leeds 082C","E01011368",970,27,7,20,115,80,65,55,172,193,181,108,73,82
"2011","Leeds 082D","E01011370",1270,70,16,54,162,124,106,122,196,201,188,131,57,101
"2011","Leeds 082E","E01033013",993,131,13,118,168,105,34,49,140,139,88,67,21,139
"2011","Leeds 082F","E01033032",1164,275,12,263,296,145,36,49,104,86,65,52,13,108
"2011","Leeds 083A","E01011734",1737,201,34,167,436,302,134,106,224,182,60,42,18,92
"2011","Leeds 083B","E01011736",1126,91,26,65,224,169,102,94,184,162,36,19,17,64
"2011","Leeds 083C","E01011737",1156,72,14,58,172,176,74,107,208,207,72,41,31,68
"2011","Leeds 083D","E01011738",1094,138,48,90,246,189,81,95,140,108,33,20,13,64
"2011","Leeds 085A","E01011364",1216,68,11,57,146,124,63,89,213,229,158,109,49,126
"2011","Leeds 085B","E01011371",997,30,11,19,73,97,44,79,218,234,152,109,43,70
"2011","Leeds 085C","E01011373",965,20,7,13,85,102,51,73,181,190,168,116,52,95
"2011","Leeds 085D","E01011374",933,31,7,24,118,108,53,94,208,180,92,59,33,49
"2011","Leeds 086A","E01011312",1101,35,5,30,110,90,87,59,181,193,247,169,78,99
"2011","Leeds 086B","E01011316",1196,41,4,37,135,113,107,82,176,213,251,180,71,78
"2011","Leeds 086C","E01011372",913,19,1,18,60,66,92,60,134,162,205,153,52,115
"2011","Leeds 086D","E01011375",1239,17,2,15,88,80,107,64,203,218,295,227,68,167
"2011","Leeds 087A","E01011390",1039,58,18,40,163,135,64,122,213,174,40,26,14,70
"2011","Leeds 087B","E01011391",1205,68,21,47,223,172,110,122,214,180,42,29,13,74
"2011","Leeds 087C","E01011392",1101,87,30,57,222,171,85,98,213,143,38,21,17,44
"2011","Leeds 087D","E01011402",1271,121,38,83,279,200,140,115,210,117,34,23,11,55
"2011","Leeds 088A","E01011298",1106,107,26,81,232,136,75,113,190,155,52,29,23,46
"2011","Leeds 088B","E01011299",1655,166,37,129,365,233,205,142,242,186,34,15,19,82
"2011","Leeds 088C","E01011302",1106,83,24,59,227,205,110,105,161,141,25,21,4,49
"2011","Leeds 088D","E01011303",823,63,20,43,145,143,71,78,138,118,32,21,11,35
"2011","Leeds 089A","E01011300",1032,79,28,51,194,161,78,82,184,148,43,26,17,63
"2011","Leeds 089B","E01011301",1027,99,31,68,225,209,69,106,153,109,14,10,4,43
"2011","Leeds 089C","E01011304",1115,60,19,41,213,165,88,102,210,157,57,39,18,63
"2011","Leeds 089D","E01011305",1130,90,20,70,242,183,106,114,160,150,23,17,6,62
"2011","Leeds 089E","E01011306",1033,93,23,70,240,193,75,107,147,97,13,5,8,68
"2011","Leeds 090A","E01011315",1125,71,14,57,189,176,93,100,187,156,82,58,24,71
"2011","Leeds 090B","E01011317",1195,41,10,31,134,138,68,95,254,247,133,88,45,85
"2011","Leeds 090C","E01011318",1039,30,4,26,119,116,49,88,197,221,133,85,48,86
"2011","Leeds 090D","E01011321",1066,39,14,25,135,124,53,71,206,211,116,68,48,111
"2011","Leeds 090E","E01011369",1100,49,13,36,132,176,81,96,233,213,74,51,23,46
"2011","Leeds 091A","E01011313",1125,70,17,53,176,177,83,77,189,177,94,57,37,82
"2011","Leeds 091B","E01011314",1095,71,15,56,206,171,80,97,158,171,78,55,23,63
"2011","Leeds 091C","E01011319",1081,67,12,55,165,132,107,103,181,154,98,71,27,74
"2011","Leeds 091D","E01011320",1212,81,17,64,164,216,111,100,194,156,75,53,22,115
"2011","Leeds 091E","E01011322",1115,72,23,49,203,173,76,96,179,166,67,51,16,83
"2011","Leeds 092A","E01011471",1011,33,9,24,112,126,44,79,217,222,102,70,32,76
"2011","Leeds 092B","E01011472",1043,22,4,18,102,120,43,76,221,243,130,80,50,86
"2011","Leeds 092C","E01011473",1006,13,1,12,82,91,51,72,225,218,147,101,46,107
"2011","Leeds 092D","E01011474",1035,26,6,20,109,111,62,95,209,211,121,84,37,91
"2011","Leeds 093A","E01011518",1648,212,51,161,359,297,128,125,211,175,43,21,22,98
"2011","Leeds 093B","E01011524",960,93,21,72,211,157,99,94,134,94,22,12,10,56
"2011","Leeds 093C","E01011526",984,133,28,105,271,155,82,73,115,65,17,12,5,73
"2011","Leeds 093D","E01011531",1072,90,20,70,196,225,84,90,183,135,19,10,9,50
"2011","Leeds 094A","E01011466",1070,38,18,20,110,136,79,85,249,218,83,51,32,72
"2011","Leeds 094B","E01011469",1128,67,22,45,180,193,94,109,183,184,63,36,27,55
"2011","Leeds 094C","E01011475",1088,36,10,26,109,114,75,97,247,232,101,55,46,77
"2011","Leeds 094D","E01011476",814,16,3,13,82,93,43,69,196,178,81,55,26,56
"2011","Leeds 095A","E01011519",1065,78,18,60,199,173,84,97,162,160,52,33,19,60
"2011","Leeds 095B","E01011522",1061,132,46,86,291,179,104,82,115,92,10,3,7,56
"2011","Leeds 095C","E01011525",1181,131,25,106,251,222,63,112,182,135,39,28,11,46
"2011","Leeds 095D","E01011528",1191,197,48,149,316,200,115,74,133,74,12,6,6,70
"2011","Leeds 095E","E01011532",1123,70,17,53,196,163,74,100,211,198,49,22,27,62
"2011","Leeds 096A","E01011520",1100,122,28,94,251,169,94,88,175,112,33,21,12,56
"2011","Leeds 096B","E01011521",1505,148,43,105,362,256,193,116,195,143,36,11,25,56
"2011","Leeds 096C","E01011523",1248,149,38,111,275,209,107,81,152,160,60,39,21,55
"2011","Leeds 096D","E01011527",1359,131,47,84,341,241,112,111,154,149,42,25,17,78
"2011","Leeds 096E","E01011529",1029,69,16,53,183,157,84,97,166,159,51,28,23,63
"2011","Leeds 097B","E01011635",1149,179,49,130,292,171,117,69,129,98,29,15,14,65
"2011","Leeds 097C","E01011637",1326,178,41,137,327,226,96,104,167,122,25,15,10,81
"2011","Leeds 097D","E01011638",1051,120,33,87,214,198,90,91,163,96,19,10,9,60
"2011","Leeds 097F","E01032487",700,48,14,34,92,106,60,56,119,131,45,28,17,43
"2011","Leeds 097G","E01032488",1353,206,49,157,336,232,137,106,137,77,44,39,5,78
"2011","Leeds 098A","E01011627",1008,96,22,74,201,132,79,82,178,136,41,26,15,63
"2011","Leeds 098B","E01011628",961,84,23,61,200,196,66,107,141,105,15,10,5,47
"2011","Leeds 098C","E01011629",964,80,19,61,195,171,82,88,154,109,34,16,18,51
"2011","Leeds 098D","E01011632",903,51,16,35,135,146,52,72,174,151,58,33,25,64
"2011","Leeds 098E","E01011633",1096,110,31,79,265,190,88,88,171,109,19,13,6,56
"2011","Leeds 099A","E01011490",1962,210,47,163,437,326,116,177,293,233,76,45,31,94
"2011","Leeds 099C","E01011502",931,23,12,11,117,128,64,87,213,210,45,27,18,44
"2011","Leeds 099E","E01032497",1023,48,9,39,128,120,53,86,231,172,119,74,45,66
"2011","Leeds 099F","E01032498",1115,68,22,46,173,194,114,100,201,161,49,38,11,55
"2011","Leeds 100A","E01011496",1134,160,32,128,301,203,101,84,123,78,19,13,6,65
"2011","Leeds 100B","E01011630",1585,236,57,179,415,255,118,123,176,154,41,25,16,67
"2011","Leeds 100C","E01011634",1083,87,30,57,253,169,105,77,153,123,54,35,19,62
"2011","Leeds 100D","E01011636",1161,126,40,86,246,201,126,70,160,122,30,22,8,80
"2011","Leeds 100E","E01011639",1066,67,20,47,178,131,72,86,227,161,73,53,20,71
"2011","Leeds 101A","E01011491",956,20,4,16,84,112,48,79,200,245,97,53,44,71
"2011","Leeds 101B","E01011492",903,20,5,15,64,75,42,69,208,185,150,95,55,90
"2011","Leeds 101C","E01011493",1054,18,3,15,100,127,63,90,229,246,98,59,39,83
"2011","Leeds 101D","E01011494",923,33,13,20,114,106,39,77,192,211,90,62,28,61
"2011","Leeds 101E","E01011497",1113,36,13,23,113,111,43,107,225,251,147,101,46,80
"2011","Leeds 102B","E01011540",1009,50,9,41,139,120,77,89,211,201,73,49,24,49
"2011","Leeds 102F","E01032489",1523,170,37,133,345,264,93,127,211,195,48,27,21,70
"2011","Leeds 102G","E01032490",1048,148,29,119,263,204,53,81,119,104,29,16,13,47
"2011","Leeds 102H","E01032491",931,124,25,99,245,157,60,68,117,98,14,9,5,48
"2011","Leeds 102I","E01032492",1512,107,18,89,255,182,93,136,283,271,105,68,37,80
"2011","Leeds 103A","E01011307",1094,46,16,30,163,152,90,117,200,206,53,33,20,67
"2011","Leeds 103B","E01011308",1078,67,26,41,176,164,91,127,195,172,28,14,14,58
"2011","Leeds 103C","E01011393",1199,154,41,113,278,197,112,90,152,121,27,18,9,68
"2011","Leeds 103D","E01011394",892,87,21,66,202,124,82,75,121,112,35,25,10,54
"2011","Leeds 103E","E01011395",860,108,27,81,221,127,68,60,109,95,30,18,12,42
"2011","Leeds 104A","E01011533",1006,111,21,90,223,169,79,77,154,117,36,19,17,40
"2011","Leeds 104B","E01011541",1270,121,27,94,248,180,78,118,226,188,66,47,19,45
"2011","Leeds 104C","E01011545",1066,81,16,65,193,177,77,89,197,163,36,17,19,53
"2011","Leeds 104D","E01011547",1326,97,18,79,244,235,93,98,225,204,62,33,29,68
"2011","Leeds 105C","E01011499",1919,190,38,152,459,301,148,136,277,228,76,51,25,104
"2011","Leeds 105D","E01011500",1172,89,20,69,255,196,122,98,157,143,46,31,15,66
"2011","Leeds 105E","E01032495",1722,200,49,151,403,228,131,116,247,192,94,51,43,111
"2011","Leeds 105F","E01032496",1528,192,55,137,362,242,144,122,209,146,31,19,12,80
"2011","Leeds 106A","E01011530",1105,132,37,95,247,191,100,80,150,126,34,19,15,45
"2011","Leeds 106B","E01011534",1058,113,17,96,250,192,102,69,152,108,23,14,9,49
"2011","Leeds 106C","E01011546",1251,121,34,87,243,216,110,90,189,159,57,30,27,66
"2011","Leeds 106D","E01011548",1039,95,23,72,237,167,111,92,125,116,33,17,16,63
"2011","Leeds 106E","E01011550",1045,115,33,82,266,178,85,79,132,96,19,10,9,75
"2011","Leeds 107A","E01011537",1549,131,38,93,305,234,142,107,254,224,78,60,18,74
"2011","Leeds 107B","E01011538",1086,69,23,46,156,156,109,88,182,182,77,58,19,67
"2011","Leeds 107C","E01011551",1190,116,28,88,286,206,88,84,154,142,42,22,20,72
"2011","Leeds 107D","E01011552",1008,38,10,28,126,120,72,80,213,206,91,55,36,62
"2011","Leeds 108A","E01011535",1227,168,50,118,329,199,144,78,131,85,24,17,7,69
"2011","Leeds 108B","E01011536",1185,117,25,92,240,193,118,95,168,146,35,18,17,73
"2011","Leeds 108C","E01011549",1179,184,50,134,303,234,90,65,103,79,19,12,7,102
"2011","Leeds 108D","E01011553",1112,85,23,62,236,213,108,104,145,102,35,19,16,84
"2011","Leeds 109A","E01011685",1815,361,42,319,442,132,98,30,83,27,36,24,12,606
"2011","Leeds 109B","E01011687",1094,225,31,194,298,129,98,48,83,46,57,44,13,110
"2011","Leeds 109C","E01011690",1059,259,33,226,290,88,60,34,63,25,33,19,14,207
"2011","Leeds 109D","E01011692",1134,274,33,241,352,111,67,25,60,35,27,15,12,183
"2011","Leeds 109E","E01011693",1359,232,21,211,388,136,63,55,96,62,60,44,16,267
"2011","Leeds 109F","E01011694",1492,225,18,207,316,112,75,42,64,37,43,34,9,578
"2011","Leeds 109G","E01032876",2393,258,35,223,235,109,71,33,45,30,23,19,4,1589
"2011","Leeds 110A","E01011442",1550,79,2,77,151,78,37,34,65,50,48,31,17,1008
"2011","Leeds 110B","E01011443",1310,87,10,77,110,75,22,23,49,32,39,32,7,873
"2011","Leeds 110C","E01011444",1770,40,4,36,88,56,28,23,68,38,77,51,26,1352
"2011","Leeds 110D","E01011451",1963,151,11,140,203,88,32,16,45,15,30,16,14,1383
"2011","Leeds 110E","E01011668",1511,57,3,54,124,74,52,32,95,50,64,44,20,963
"2011","Leeds 110F","E01011669",1337,73,9,64,174,82,31,37,77,57,47,24,23,759
"2011","Leeds 110G","E01032946",2193,187,17,170,219,109,54,46,76,48,70,49,21,1384
"2011","Leeds 111A","E01033008",1079,281,25,256,283,113,31,30,44,37,29,15,14,231
"2011","Leeds 111B","E01033010",2778,209,22,187,241,92,34,44,44,19,68,49,19,2027
"2011","Leeds 111C","E01033011",1351,261,20,241,356,128,40,59,65,37,34,19,15,371
"2011","Leeds 111D","E01033015",1133,314,30,284,364,151,31,33,30,20,14,6,8,176
"2011","Leeds 111E","E01033016",994,322,36,286,284,120,44,38,40,24,19,12,7,103
"2011","Leeds 112A","E01011467",1067,87,13,74,167,134,40,77,188,166,147,117,30,61
"2011","Leeds 112B","E01011468",1096,23,9,14,108,84,71,80,239,268,141,105,36,82
"2011","Leeds 112C","E01011470",968,30,10,20,133,147,64,99,183,198,54,29,25,60
"2011","Leeds 112D","E01033018",1104,304,25,279,345,142,18,39,43,27,30,19,11,156
"2011","Leeds 112E","E01033019",1663,364,33,331,344,143,39,45,49,22,15,10,5,642
"2011","Wakefield 001A","E01011740",1059,18,2,16,91,91,28,106,256,316,98,66,32,55
"2011","Wakefield 001B","E01011741",1115,58,19,39,156,141,93,115,226,223,45,24,21,58
"2011","Wakefield 001C","E01011742",1139,29,9,20,96,85,66,114,250,342,99,69,30,58
"2011","Wakefield 001D","E01011745",1185,15,2,13,96,99,32,128,279,325,159,106,53,52
"2011","Wakefield 001E","E01011746",1073,28,9,19,85,76,56,92,220,307,162,124,38,47
"2011","Wakefield 002A","E01011752",1185,46,17,29,158,136,55,137,282,257,51,37,14,63
"2011","Wakefield 002B","E01011753",1047,42,14,28,158,143,65,102,218,214,55,38,17,50
"2011","Wakefield 002C","E01011756",1089,31,13,18,106,86,55,109,277,297,83,62,21,45
"2011","Wakefield 002D","E01011760",1308,45,11,34,172,168,72,116,276,341,66,35,31,52
"2011","Wakefield 002E","E01011762",1219,46,8,38,168,165,68,130,288,261,42,24,18,51
"2011","Wakefield 003A","E01011743",1148,95,32,63,203,197,102,128,167,174,23,12,11,59
"2011","Wakefield 003B","E01011744",1197,87,25,62,227,181,95,137,204,174,33,21,12,59
"2011","Wakefield 003C","E01011747",1155,35,12,23,119,96,55,111,264,283,144,95,49,48
"2011","Wakefield 003D","E01011750",1044,19,5,14,77,63,51,84,212,301,184,135,49,53
"2011","Wakefield 003E","E01011754",1058,27,10,17,138,100,68,108,242,260,75,55,20,40
"2011","Wakefield 004A","E01011757",1328,82,26,56,221,184,105,123,250,246,58,25,33,59
"2011","Wakefield 004B","E01011759",1451,31,6,25,170,157,88,131,305,381,105,73,32,83
"2011","Wakefield 004C","E01011761",1411,75,16,59,210,190,80,142,252,333,63,45,18,66
"2011","Wakefield 004D","E01011763",1041,34,6,28,121,127,62,100,229,266,63,33,30,39
"2011","Wakefield 004E","E01011764",1101,30,8,22,132,131,58,94,216,303,90,55,35,47
"2011","Wakefield 005A","E01011748",1257,72,20,52,211,161,116,143,229,202,57,38,19,66
"2011","Wakefield 005B","E01011749",1661,92,34,58,287,216,95,160,333,326,75,46,29,77
"2011","Wakefield 005C","E01011751",1020,76,21,55,177,145,91,109,166,160,30,19,11,66
"2011","Wakefield 005D","E01011755",1286,85,24,61,288,205,87,158,193,156,35,28,7,79
"2011","Wakefield 006A","E01011873",1222,111,29,82,310,213,104,108,159,139,21,11,10,57
"2011","Wakefield 006B","E01011877",1194,98,23,75,266,189,102,86,162,157,70,64,6,64
"2011","Wakefield 006C","E01011894",1071,117,34,83,269,170,98,90,124,111,21,13,8,71
"2011","Wakefield 006D","E01011895",1138,95,33,62,235,164,97,100,166,156,35,22,13,90
"2011","Wakefield 007A","E01011875",1020,67,25,42,193,150,79,88,159,195,39,20,19,50
"2011","Wakefield 007B","E01011876",1025,81,21,60,203,134,101,84,138,176,52,31,21,56
"2011","Wakefield 007C","E01011878",1227,112,23,89,274,196,113,106,170,130,38,25,13,88
"2011","Wakefield 007D","E01011880",1160,154,44,110,297,183,96,108,136,115,27,16,11,44
"2011","Wakefield 008A","E01011881",1124,73,31,42,207,179,114,97,187,183,44,27,17,40
"2011","Wakefield 008B","E01011887",902,80,21,59,212,141,114,72,120,85,19,12,7,59
"2011","Wakefield 008C","E01011893",1080,105,37,68,253,162,105,84,144,122,34,21,13,71
"2011","Wakefield 008D","E01011896",1006,67,17,50,169,153,88,87,171,188,36,24,12,47
"2011","Wakefield 008E","E01011897",1005,41,16,25,178,135,65,75,196,207,55,34,21,53
"2011","Wakefield 009A","E01011874",1232,118,40,78,303,228,82,93,146,161,27,20,7,74
"2011","Wakefield 009B","E01011879",1123,89,25,64,226,181,93,117,153,181,30,21,9,53
"2011","Wakefield 009C","E01011882",1119,58,19,39,236,185,98,95,145,212,21,15,6,69
"2011","Wakefield 009D","E01011883",1044,82,25,57,217,139,100,95,164,147,22,16,6,78
"2011","Wakefield 010A","E01011805",1066,33,9,24,117,100,55,147,248,250,68,44,24,48
"2011","Wakefield 010B","E01011807",1066,23,10,13,125,109,45,158,258,228,68,45,23,52
"2011","Wakefield 010C","E01011808",1267,53,18,35,181,138,76,161,294,252,53,29,24,59
"2011","Wakefield 010D","E01011810",1148,50,29,21,142,107,85,174,251,218,51,29,22,70
"2011","Wakefield 011A","E01011803",1011,16,6,10,95,84,50,120,231,235,118,78,40,62
"2011","Wakefield 011B","E01011804",1188,41,17,24,161,143,67,157,298,219,50,31,19,52
"2011","Wakefield 011C","E01011806",1178,60,28,32,158,138,66,141,277,211,68,50,18,59
"2011","Wakefield 011D","E01011809",1102,36,13,23,128,104,53,131,246,265,84,51,33,55
"2011","Wakefield 011E","E01011811",1130,22,7,15,107,88,46,130,258,287,135,98,37,57
"2011","Wakefield 012A","E01011835",1161,76,21,55,206,174,92,139,221,188,24,13,11,41
"2011","Wakefield 012B","E01011836",1076,70,25,45,236,136,73,127,193,154,37,25,12,50
"2011","Wakefield 012C","E01011839",1208,56,18,38,188,151,73,126,256,232,59,31,28,67
"2011","Wakefield 012D","E01011843",1163,56,13,43,148,140,79,127,256,234,66,49,17,57
"2011","Wakefield 012E","E01011844",1408,133,42,91,376,250,100,128,200,120,28,17,11,73
"2011","Wakefield 013A","E01011758",1036,41,9,32,127,118,70,101,183,278,68,46,22,50
"2011","Wakefield 013B","E01011812",1960,195,50,145,496,323,167,148,245,225,32,24,8,129
"2011","Wakefield 013C","E01011820",1104,52,12,40,193,151,78,98,191,254,42,31,11,45
"2011","Wakefield 013D","E01011821",981,49,13,36,192,121,74,91,163,191,37,26,11,63
"2011","Wakefield 014A","E01011885",1092,119,42,77,259,191,101,83,113,100,69,58,11,57
"2011","Wakefield 014B","E01011886",1122,103,23,80,306,172,90,82,162,124,23,11,12,60
"2011","Wakefield 014C","E01011888",1108,137,47,90,289,221,96,63,134,86,29,21,8,53
"2011","Wakefield 014D","E01011890",963,122,35,87,234,150,78,64,109,119,27,16,11,60
"2011","Wakefield 014E","E01011891",1095,77,21,56,238,157,93,82,182,172,44,25,19,50
"2011","Wakefield 015A","E01011834",1112,61,19,42,174,133,84,102,221,225,58,43,15,54
"2011","Wakefield 015B","E01011837",1131,54,14,40,197,95,78,91,228,228,103,73,30,57
"2011","Wakefield 015C","E01011838",1529,89,21,68,249,159,69,148,312,319,117,69,48,67
"2011","Wakefield 015D","E01011841",1153,75,22,53,241,160,89,97,219,166,52,34,18,54
"2011","Wakefield 015E","E01011842",1006,25,10,15,116,78,59,93,252,227,102,70,32,54
"2011","Wakefield 016A","E01011813",1098,35,15,20,145,100,74,104,217,279,78,54,24,66
"2011","Wakefield 016B","E01011814",1288,52,15,37,166,120,78,93,249,348,109,65,44,73
"2011","Wakefield 016C","E01011815",1122,76,25,51,183,136,93,86,199,226,61,47,14,62
"2011","Wakefield 016D","E01011816",985,22,12,10,93,107,55,100,201,289,76,51,25,42
"2011","Wakefield 016E","E01011819",1238,83,20,63,217,197,99,97,191,254,41,21,20,59
"2011","Wakefield 016F","E01011822",1056,35,9,26,171,128,76,99,177,246,65,41,24,59
"2011","Wakefield 017A","E01011884",1753,290,45,245,475,236,123,103,191,176,56,38,18,103
"2011","Wakefield 017B","E01011912",1171,59,8,51,140,83,113,81,158,273,172,131,41,92
"2011","Wakefield 017C","E01011913",1189,36,6,30,116,88,139,69,200,226,196,171,25,119
"2011","Wakefield 017D","E01011916",1667,89,14,75,225,153,113,151,268,418,168,112,56,82
"2011","Wakefield 018A","E01011840",1108,44,16,28,138,114,68,109,271,238,77,55,22,49
"2011","Wakefield 018B","E01011850",1073,25,9,16,89,110,56,103,252,284,90,59,31,64
"2011","Wakefield 018C","E01011852",1089,58,20,38,147,87,79,95,223,242,96,53,43,62
"2011","Wakefield 018D","E01011853",1019,47,17,30,127,113,69,111,201,208,70,40,30,73
"2011","Wakefield 019A","E01011920",1947,120,26,94,282,200,160,145,244,434,254,220,34,108
"2011","Wakefield 019B","E01011923",1262,195,40,155,349,185,110,72,132,108,33,24,9,78
"2011","Wakefield 019C","E01011924",1162,61,15,46,259,156,100,85,168,196,69,58,11,68
"2011","Wakefield 019D","E01011925",1151,44,19,25,142,116,63,102,220,275,127,80,47,62
"2011","Wakefield 020A","E01011909",1078,94,26,68,218,148,70,68,152,179,81,58,23,68
"2011","Wakefield 020B","E01011910",1043,38,7,31,119,100,71,80,216,245,124,89,35,50
"2011","Wakefield 020C","E01011911",1047,28,4,24,114,94,63,87,211,265,131,81,50,54
"2011","Wakefield 020D","E01011914",1117,33,8,25,126,93,80,89,248,254,110,62,48,84
"2011","Wakefield 020E","E01011915",1175,57,14,43,140,137,105,76,204,247,125,95,30,84
"2011","Wakefield 021A","E01011823",1046,70,19,51,214,161,117,92,167,151,34,22,12,40
"2011","Wakefield 021B","E01011824",1042,50,12,38,152,133,81,90,183,216,85,43,42,52
"2011","Wakefield 021C","E01011825",1321,125,42,83,310,219,149,91,183,151,40,18,22,53
"2011","Wakefield 021D","E01011826",1026,141,38,103,253,141,86,82,138,95,25,14,11,65
"2011","Wakefield 021E","E01011827",903,78,26,52,168,151,74,84,154,122,22,12,10,50
"2011","Wakefield 021F","E01011828",1079,68,24,44,227,185,102,108,157,157,23,6,17,52
"2011","Wakefield 022A","E01011889",946,109,41,68,237,157,103,67,100,102,18,13,5,53
"2011","Wakefield 022B","E01011892",1291,88,20,68,264,172,103,106,223,189,58,40,18,88
"2011","Wakefield 022C","E01011919",1373,61,14,47,204,174,110,124,244,294,85,56,29,77
"2011","Wakefield 022D","E01011921",1081,80,28,52,202,152,89,93,188,163,50,34,16,64
"2011","Wakefield 022E","E01011926",1163,41,9,32,106,107,94,105,215,287,130,100,30,78
"2011","Wakefield 022F","E01011927",953,33,9,24,139,94,58,86,188,241,57,44,13,57
"2011","Wakefield 023A","E01011845",1039,125,36,89,271,179,75,96,148,80,21,11,10,44
"2011","Wakefield 023B","E01011846",1003,119,28,91,251,143,79,79,133,116,29,14,15,54
"2011","Wakefield 023C","E01011847",1066,113,32,81,279,171,77,87,149,115,19,9,10,56
"2011","Wakefield 023D","E01011848",1016,129,33,96,277,162,73,73,130,77,30,12,18,65
"2011","Wakefield 023E","E01011851",1043,75,19,56,182,131,82,96,178,189,58,42,16,52
"2011","Wakefield 024A","E01011775",2155,221,56,165,523,299,205,183,280,249,73,51,22,122
"2011","Wakefield 024B","E01011776",1138,51,15,36,150,117,94,97,208,268,90,61,29,63
"2011","Wakefield 024C","E01011777",1000,54,15,39,168,123,90,89,171,219,41,27,14,45
"2011","Wakefield 024D","E01011778",1169,55,18,37,157,141,69,120,255,262,69,45,24,41
"2011","Wakefield 024E","E01011817",975,37,8,29,144,113,75,87,177,219,59,36,23,64
"2011","Wakefield 024F","E01011818",1013,70,19,51,182,128,100,90,169,192,33,16,17,49
"2011","Wakefield 025A","E01011829",1078,92,27,65,246,175,91,86,166,131,33,16,17,58
"2011","Wakefield 025B","E01011830",894,67,18,49,184,132,90,76,149,125,25,11,14,46
"2011","Wakefield 025C","E01011831",1305,108,39,69,277,164,111,131,196,190,62,36,26,66
"2011","Wakefield 025D","E01011832",1038,68,18,50,170,145,93,93,171,186,58,36,22,54
"2011","Wakefield 025E","E01011833",1162,111,34,77,269,174,125,74,162,153,37,23,14,57
"2011","Wakefield 026A","E01011899",1029,22,10,12,101,93,67,93,214,232,104,75,29,103
"2011","Wakefield 026B","E01011900",1089,40,12,28,143,119,75,98,228,214,111,57,54,61
"2011","Wakefield 026C","E01011901",1091,22,8,14,108,76,49,86,240,269,128,96,32,113
"2011","Wakefield 026D","E01011904",922,21,7,14,102,74,35,78,201,214,134,88,46,63
"2011","Wakefield 026E","E01011918",1066,41,15,26,127,105,66,109,214,233,110,63,47,61
"2011","Wakefield 026F","E01011922",1051,32,13,19,147,97,66,83,197,227,120,84,36,82
"2011","Wakefield 027A","E01011779",1113,55,17,38,150,123,75,108,226,236,75,54,21,65
"2011","Wakefield 027B","E01011780",1258,21,11,10,93,79,59,108,312,374,151,120,31,61
"2011","Wakefield 027C","E01011781",1262,38,13,25,172,129,85,117,279,285,98,57,41,59
"2011","Wakefield 027D","E01011782",1107,56,15,41,165,138,77,90,249,226,42,25,17,64
"2011","Wakefield 027E","E01011783",1026,36,16,20,130,102,55,130,201,256,69,48,21,47
"2011","Wakefield 028A","E01011902",1061,68,22,46,220,157,100,92,190,158,27,13,14,49
"2011","Wakefield 028B","E01011903",931,85,20,65,181,145,71,61,145,128,59,35,24,56
"2011","Wakefield 028C","E01011905",1153,125,40,85,326,168,111,82,128,111,22,15,7,80
"2011","Wakefield 028D","E01011907",1364,78,16,62,207,150,128,110,233,282,102,70,32,74
"2011","Wakefield 029A","E01011793",1234,104,31,73,220,187,117,98,205,202,40,21,19,61
"2011","Wakefield 029B","E01011794",1051,51,14,37,207,139,100,83,176,181,49,25,24,65
"2011","Wakefield 029C","E01011795",953,59,20,39,186,153,84,77,146,172,42,30,12,34
"2011","Wakefield 029D","E01011796",1082,102,25,77,249,178,105,85,147,132,29,22,7,55
"2011","Wakefield 029E","E01011799",1094,90,20,70,221,154,96,78,190,163,41,25,16,61
"2011","Wakefield 029F","E01011800",1218,122,26,96,298,198,138,90,159,119,37,22,15,57
"2011","Wakefield 030A","E01011898",1162,73,17,56,218,150,78,91,198,211,94,60,34,49
"2011","Wakefield 030B","E01011906",1074,15,1,14,88,72,75,82,221,296,158,115,43,67
"2011","Wakefield 030C","E01011908",1638,102,24,78,313,170,116,112,253,295,158,121,37,119
"2011","Wakefield 030D","E01011917",1184,40,10,30,114,104,89,90,229,298,158,121,37,62
"2011","Wakefield 030E","E01011944",1045,74,19,55,176,121,81,85,182,194,72,44,28,60
"2011","Wakefield 031A","E01011797",1238,186,44,142,379,204,99,67,128,80,22,8,14,73
"2011","Wakefield 031B","E01011798",1015,104,30,74,246,156,106,61,141,115,37,26,11,49
"2011","Wakefield 031C","E01011801",1151,84,23,61,212,161,104,86,192,198,56,29,27,58
"2011","Wakefield 031D","E01011802",1106,114,38,76,251,163,93,89,156,141,35,20,15,64
"2011","Wakefield 032A","E01011765",1170,73,21,52,224,138,88,114,239,199,29,15,14,66
"2011","Wakefield 032B","E01011766",1113,84,17,67,251,164,80,90,159,177,33,20,13,75
"2011","Wakefield 032C","E01011773",1170,102,40,62,261,187,111,116,171,131,13,10,3,78
"2011","Wakefield 032D","E01011774",1054,76,22,54,198,142,93,87,184,182,34,19,15,58
"2011","Wakefield 033A","E01011939",1077,239,65,174,316,171,99,42,71,55,29,19,10,55
"2011","Wakefield 033B","E01011945",1052,235,56,179,299,134,78,48,84,87,23,17,6,64
"2011","Wakefield 033C","E01011947",1189,233,43,190,394,176,107,46,89,45,29,17,12,70
"2011","Wakefield 033D","E01011948",1181,259,67,192,385,173,119,41,67,39,26,21,5,72
"2011","Wakefield 034A","E01011767",1308,187,56,131,380,186,134,79,124,113,27,20,7,78
"2011","Wakefield 034B","E01011768",1046,133,41,92,257,127,98,79,151,123,17,9,8,61
"2011","Wakefield 034C","E01011769",1645,174,44,130,459,266,160,130,185,176,32,19,13,63
"2011","Wakefield 034D","E01011770",1384,127,29,98,276,177,102,121,216,218,35,24,11,112
"2011","Wakefield 034E","E01011849",1174,172,61,111,308,173,143,73,135,84,35,22,13,51
"2011","Wakefield 034F","E01011857",1249,185,41,144,355,161,160,86,115,104,25,18,7,58
"2011","Wakefield 035A","E01011928",1019,70,23,47,162,155,91,86,174,196,41,17,24,44
"2011","Wakefield 035B","E01011931",1120,105,28,77,260,171,97,105,159,151,30,13,17,42
"2011","Wakefield 035C","E01011932",1102,151,40,111,302,153,124,73,106,105,19,13,6,69
"2011","Wakefield 035D","E01011938",1347,155,57,98,285,140,168,67,157,162,153,135,18,60
"2011","Wakefield 036A","E01011929",1268,93,33,60,302,193,128,128,168,186,18,10,8,52
"2011","Wakefield 036B","E01011930",1286,124,37,87,343,184,129,90,169,142,36,23,13,69
"2011","Wakefield 036C","E01011933",1197,90,19,71,243,168,105,84,204,186,48,25,23,69
"2011","Wakefield 036D","E01011937",1095,131,38,93,267,183,89,82,150,97,22,12,10,74
"2011","Wakefield 037A","E01011934",1145,152,49,103,262,157,130,60,143,118,37,24,13,86
"2011","Wakefield 037B","E01011936",1054,69,17,52,158,108,78,93,195,229,61,30,31,63
"2011","Wakefield 037C","E01011940",1064,51,10,41,141,119,80,81,210,233,76,46,30,73
"2011","Wakefield 037D","E01011943",1180,61,16,45,175,139,70,100,222,262,85,43,42,66
"2011","Wakefield 038A","E01011935",1358,279,76,203,441,176,154,55,107,63,18,12,6,65
"2011","Wakefield 038B","E01011941",1048,145,35,110,244,144,90,78,136,117,31,23,8,63
"2011","Wakefield 038C","E01011942",920,161,56,105,261,142,110,43,77,64,18,15,3,44
"2011","Wakefield 038D","E01011946",1142,158,34,124,300,163,91,87,134,103,18,11,7,88
"2011","Wakefield 039A","E01011785",1134,48,21,27,144,106,78,109,223,257,94,61,33,75
"2011","Wakefield 039B","E01011789",907,28,8,20,103,86,60,67,170,260,75,54,21,58
"2011","Wakefield 039C","E01011791",1067,24,5,19,103,107,58,84,225,309,95,71,24,62
"2011","Wakefield 039D","E01011792",1065,13,3,10,81,63,60,82,205,327,163,132,31,71
"2011","Wakefield 040A","E01011771",908,48,15,33,109,90,72,74,194,214,58,38,20,49
"2011","Wakefield 040B","E01011772",1218,65,15,50,216,128,118,108,225,240,52,32,20,66
"2011","Wakefield 040C","E01011784",1338,87,23,64,234,152,131,98,229,265,74,44,30,68
"2011","Wakefield 040D","E01011786",1173,52,25,27,161,126,90,104,263,230,80,52,28,67
"2011","Wakefield 041A","E01011854",910,21,6,15,96,79,54,93,146,292,85,59,26,44
"2011","Wakefield 041B","E01011855",1170,53,19,34,189,134,123,115,194,249,62,38,24,51
"2011","Wakefield 041C","E01011856",1082,39,11,28,140,113,106,103,152,323,60,40,20,46
"2011","Wakefield 041D","E01011858",1128,77,22,55,231,113,95,86,168,224,62,43,19,72
"2011","Wakefield 042A","E01011787",1294,78,18,60,251,157,98,106,207,272,47,33,14,78
"2011","Wakefield 042B","E01011788",1307,79,32,47,234,196,115,133,209,245,26,17,9,70
"2011","Wakefield 042C","E01011790",1227,50,16,34,152,138,69,109,214,343,89,59,30,63
"2011","Wakefield 042D","E01011865",1199,34,8,26,126,125,68,101,241,329,106,86,20,69
"2011","Wakefield 042E","E01011867",1219,42,17,25,152,132,94,110,227,312,78,56,22,72
"2011","Wakefield 043A","E01011859",1018,28,10,18,116,75,58,101,172,317,77,54,23,74
"2011","Wakefield 043B","E01011869",1079,25,4,21,106,99,60,68,194,401,82,49,33,44
"2011","Wakefield 043C","E01011870",1115,53,16,37,172,152,55,120,188,278,52,30,22,45
"2011","Wakefield 043D","E01011871",1169,40,13,27,161,142,100,102,202,305,56,35,21,61
"2011","Wakefield 044A","E01011860",1124,55,17,38,184,150,87,107,162,262,43,28,15,74
"2011","Wakefield 044B","E01011861",1459,92,34,58,266,190,117,128,191,342,54,33,21,79
"2011","Wakefield 044C","E01011862",1052,53,11,42,149,96,77,97,147,298,73,53,20,62
"2011","Wakefield 044D","E01011863",936,16,8,8,72,63,48,78,189,325,91,60,31,54
"2011","Wakefield 045A","E01011864",1169,31,8,23,118,83,81,99,228,342,111,76,35,76
"2011","Wakefield 045B","E01011866",1136,45,12,33,148,108,77,90,179,311,98,80,18,80
"2011","Wakefield 045C","E01011868",1348,67,23,44,228,154,79,118,196,341,96,72,24,69
"2011","Wakefield 045D","E01011872",1132,31,13,18,132,103,57,99,205,361,72,41,31,72
"2011","Derby 001A","E01013461",1190,243,53,190,318,184,99,59,127,61,20,11,9,79
"2011","Derby 001B","E01013462",1041,150,34,116,320,136,68,74,123,89,19,12,7,62
"2011","Derby 001C","E01013463",1110,212,56,156,351,172,94,53,91,40,19,11,8,78
"2011","Derby 001D","E01013464",972,126,29,97,263,158,85,77,118,68,20,10,10,57
"2011","Derby 002A","E01013465",1098,174,38,136,311,167,92,65,121,65,23,13,10,80
"2011","Derby 002B","E01013466",1075,191,41,150,319,161,91,62,116,50,13,8,5,72
"2011","Derby 002C","E01013467",943,130,30,100,255,141,67,76,138,62,17,11,6,57
"2011","Derby 002D","E01013468",1082,175,35,140,279,173,86,79,130,64,21,8,13,75
"2011","Derby 002E","E01013469",842,117,32,85,215,132,58,70,107,51,32,18,14,60
"2011","Derby 003A","E01013574",1053,164,45,119,303,166,84,79,119,47,12,9,3,79
"2011","Derby 003B","E01013575",1068,130,22,108,291,157,90,89,157,75,20,14,6,59
"2011","Derby 003C","E01013576",1144,169,49,120,291,206,66,88,133,74,23,10,13,94
"2011","Derby 003D","E01013577",1168,199,53,146,330,190,85,81,127,60,8,6,2,88
"2011","Derby 003E","E01013578",1047,195,40,155,280,172,59,78,120,60,14,9,5,69
"2011","Derby 003F","E01013579",1089,136,32,104,272,200,75,93,159,85,20,9,11,49
"2011","Derby 003G","E01013580",1144,124,32,92,296,211,84,115,163,92,18,12,6,41
"2011","Derby 004A","E01013530",1082,74,17,57,209,156,81,96,191,162,41,29,12,72
"2011","Derby 004B","E01013531",964,40,10,30,138,105,58,114,220,168,65,41,24,56
"2011","Derby 004C","E01013532",1005,20,6,14,145,107,56,104,235,209,62,38,24,67
"2011","Derby 004D","E01013581",1037,32,12,20,148,124,71,91,231,181,78,50,28,81
"2011","Derby 005A","E01013526",1180,259,63,196,335,155,89,74,106,65,19,11,8,78
"2011","Derby 005B","E01013527",1045,242,63,179,338,135,85,35,74,42,20,13,7,74
"2011","Derby 005C","E01013528",1199,235,44,191,305,133,85,56,106,89,44,29,15,146
"2011","Derby 005D","E01013529",1679,294,57,237,437,175,94,91,169,72,46,31,15,301
"2011","Derby 006A","E01013505",1095,57,16,41,219,164,81,135,208,135,35,22,13,61
"2011","Derby 006B","E01013506",1127,76,23,53,179,156,92,122,210,157,58,42,16,77
"2011","Derby 006C","E01013513",896,29,8,21,119,105,50,97,201,163,62,45,17,70
"2011","Derby 006D","E01013534",1156,56,19,37,178,158,91,153,221,189,45,28,17,65
"2011","Derby 006E","E01013582",1133,68,16,52,220,158,63,119,230,176,53,42,11,46
"2011","Derby 007A","E01013533",1116,23,11,12,95,73,60,92,263,307,129,87,42,74
"2011","Derby 007B","E01013535",1005,20,7,13,92,66,40,70,204,253,156,103,53,104
"2011","Derby 007C","E01013536",1139,30,8,22,122,105,42,90,234,280,169,120,49,67
"2011","Derby 007D","E01013537",1179,42,6,36,195,153,87,124,236,211,69,51,18,62
"2011","Derby 007E","E01013538",1122,39,10,29,149,120,77,114,221,243,89,60,29,70
"2011","Derby 008A","E01013522",1431,98,17,81,233,122,83,111,183,185,100,55,45,316
"2011","Derby 008B","E01013523",1310,137,21,116,219,133,75,82,145,162,96,54,42,261
"2011","Derby 008C","E01013524",2373,131,16,115,197,105,46,81,144,122,62,35,27,1485
"2011","Derby 008D","E01013525",1669,289,59,230,453,218,89,121,186,138,67,40,27,108
"2011","Derby 009A","E01013548",1036,54,14,40,160,132,73,106,209,166,45,32,13,91
"2011","Derby 009B","E01013549",966,41,11,30,131,126,80,100,201,158,80,57,23,49
"2011","Derby 009C","E01013552",1093,42,11,31,164,126,68,96,233,198,75,47,28,91
"2011","Derby 009D","E01013553",1003,37,13,24,148,124,73,90,229,167,63,40,23,72
"2011","Derby 009E","E01013555",1054,57,13,44,164,116,61,119,209,193,42,25,17,93
"2011","Derby 010A","E01013592",1065,112,19,93,233,150,95,99,196,110,22,12,10,48
"2011","Derby 010B","E01013594",985,105,22,83,208,186,66,102,158,97,15,5,10,48
"2011","Derby 010C","E01013596",1138,156,39,117,305,176,81,96,120,116,22,14,8,66
"2011","Derby 010D","E01013599",1078,115,32,83,246,187,69,118,169,90,19,12,7,65
"2011","Derby 011A","E01013547",1499,133,17,116,266,143,66,106,149,144,65,39,26,427
"2011","Derby 011B","E01013550",918,53,11,42,121,71,62,88,177,172,84,51,33,90
"2011","Derby 011C","E01013551",1669,99,15,84,221,110,57,86,158,117,46,28,18,775
"2011","Derby 011D","E01013554",1349,99,15,84,215,159,59,85,189,148,81,48,33,314
"2011","Derby 012A","E01013507",1129,78,23,55,221,172,93,115,196,147,33,21,12,74
"2011","Derby 012B","E01013508",869,32,9,23,114,95,47,99,200,156,68,46,22,58
"2011","Derby 012C","E01013509",1243,75,17,58,241,179,122,132,227,161,42,24,18,64
"2011","Derby 012D","E01013510",1023,44,9,35,137,138,81,96,196,199,68,47,21,64
"2011","Derby 012E","E01013511",1151,77,17,60,216,209,92,124,195,142,28,19,9,68
"2011","Derby 012F","E01013512",1082,42,16,26,144,117,74,107,271,179,75,41,34,73
"2011","Derby 013A","E01013453",1984,147,19,128,326,216,86,134,268,188,108,63,45,511
"2011","Derby 013B","E01013454",1236,50,17,33,153,91,57,73,166,141,77,46,31,428
"2011","Derby 013C","E01013456",1628,69,12,57,224,136,68,117,288,306,178,115,63,242
"2011","Derby 013D","E01013457",1438,102,15,87,239,198,79,94,251,213,85,60,25,177
"2011","Derby 013E","E01013460",1751,106,12,94,268,143,60,110,208,183,80,48,32,593
"2011","Derby 013F","E01013479",1811,118,23,95,209,131,93,142,269,252,184,99,85,413
"2011","Derby 014A","E01013593",1050,80,23,57,209,163,63,130,196,131,23,14,9,55
"2011","Derby 014B","E01013595",1610,176,41,135,298,238,119,166,247,206,74,42,32,86
"2011","Derby 014C","E01013597",1038,61,12,49,172,115,76,103,223,180,63,44,19,45
"2011","Derby 014D","E01013598",1109,59,15,44,179,137,83,92,230,197,56,37,19,76
"2011","Derby 015A","E01013556",1068,120,25,95,263,184,73,105,154,83,23,13,10,63
"2011","Derby 015B","E01013557",950,141,32,109,254,147,64,70,127,78,14,9,5,55
"2011","Derby 015C","E01013558",1415,169,31,138,407,215,88,97,148,110,61,38,23,120
"2011","Derby 015D","E01013559",1021,119,27,92,251,168,63,94,147,99,18,13,5,62
"2011","Derby 015E","E01013564",1484,223,62,161,414,238,99,117,176,83,30,17,13,104
"2011","Derby 016A","E01013480",1660,78,10,68,193,106,91,134,262,294,239,174,65,263
"2011","Derby 016B","E01013483",1487,96,12,84,225,102,116,84,212,196,270,224,46,186
"2011","Derby 016C","E01013485",1371,65,16,49,137,105,104,98,189,243,289,237,52,141
"2011","Derby 016D","E01013565",1108,35,3,32,104,93,106,83,139,190,228,187,41,130
"2011","Derby 016E","E01013566",1369,43,6,37,106,75,129,90,217,250,323,268,55,136
"2011","Derby 017A","E01013455",1400,137,28,109,254,172,120,107,217,184,76,52,24,133
"2011","Derby 017B","E01013458",1148,147,26,121,215,129,144,62,144,97,104,86,18,106
"2011","Derby 017C","E01013542",1203,184,22,162,306,128,98,60,157,115,58,44,14,97
"2011","Derby 017D","E01013546",1167,196,48,148,302,144,91,71,127,91,50,39,11,95
"2011","Derby 018A","E01013481",1264,38,6,32,107,100,99,71,193,205,299,265,34,152
"2011","Derby 018C","E01013484",1289,19,6,13,95,79,108,78,188,237,350,293,57,135
"2011","Derby 018D","E01013486",1305,49,16,33,82,93,110,67,193,252,293,248,45,166
"2011","Derby 018E","E01013487",1518,47,2,45,132,133,116,84,241,281,348,289,59,136
"2011","Derby 018F","E01033166",873,65,10,55,103,76,44,61,145,179,134,84,50,66
"2011","Derby 018G","E01033167",887,66,5,61,103,60,68,70,144,145,158,121,37,73
"2011","Derby 019A","E01013540",1136,133,34,99,323,153,89,76,144,81,47,34,13,90
"2011","Derby 019B","E01013560",1142,198,48,150,282,177,64,80,151,74,30,21,9,86
"2011","Derby 019C","E01013561",1103,134,30,104,320,159,86,86,160,79,26,19,7,53
"2011","Derby 019D","E01013562",905,142,28,114,247,131,81,58,95,74,23,18,5,54
"2011","Derby 019E","E01013563",1076,110,24,86,287,189,66,112,160,75,19,12,7,58
"2011","Derby 020A","E01013459",1329,105,23,82,201,137,129,74,153,150,190,174,16,190
"2011","Derby 020B","E01013567",1360,56,10,46,120,105,120,75,220,219,293,245,48,152
"2011","Derby 020C","E01013568",1400,38,4,34,133,91,129,102,237,213,309,250,59,148
"2011","Derby 020D","E01013569",1041,33,6,27,109,89,81,76,189,208,176,138,38,80
"2011","Derby 021A","E01013539",1738,387,64,323,394,226,157,89,131,108,48,37,11,198
"2011","Derby 021B","E01013541",1133,170,31,139,263,176,73,77,138,85,45,27,18,106
"2011","Derby 021C","E01013543",1267,207,39,168,336,187,102,68,143,71,38,30,8,115
"2011","Derby 021D","E01013544",1354,282,56,226,383,190,112,74,98,74,37,28,9,104
"2011","Derby 021E","E01013545",1162,200,39,161,268,144,98,73,131,83,74,48,26,91
"2011","Derby 022A","E01013488",1142,126,31,95,232,145,96,87,187,118,39,31,8,112
"2011","Derby 022B","E01013489",1106,127,24,103,244,171,107,89,148,94,48,36,12,78
"2011","Derby 022C","E01013490",1104,122,37,85,240,154,80,85,167,122,39,28,11,95
"2011","Derby 022D","E01013491",1114,109,26,83,233,136,103,64,159,127,75,63,12,108
"2011","Derby 023A","E01013570",1325,46,7,39,130,91,93,96,227,245,244,190,54,153
"2011","Derby 023B","E01013571",1220,42,10,32,152,91,84,95,219,257,170,128,42,110
"2011","Derby 023C","E01013572",1161,69,19,50,185,129,95,108,209,190,99,77,22,77
"2011","Derby 023D","E01013573",1421,38,7,31,159,129,80,102,282,279,224,164,60,128
"2011","Derby 024A","E01013470",1027,84,11,73,163,153,67,111,187,152,54,41,13,56
"2011","Derby 024B","E01013474",1110,89,20,69,177,151,83,126,205,178,49,30,19,52
"2011","Derby 024C","E01013476",1165,99,25,74,253,175,83,138,210,138,27,20,7,42
"2011","Derby 024E","E01033171",1078,122,22,100,216,155,48,90,175,168,38,23,15,66
"2011","Derby 024F","E01033172",1242,110,15,95,251,167,58,96,209,160,108,67,41,83
"2011","Derby 025A","E01013471",1361,84,9,75,248,153,90,121,286,194,107,60,47,78
"2011","Derby 025B","E01013473",1086,58,13,45,145,106,68,110,221,203,93,59,34,82
"2011","Derby 025C","E01013475",1096,37,10,27,115,96,57,103,213,223,142,98,44,110
"2011","Derby 025D","E01013477",1326,62,12,50,203,151,90,159,265,233,95,66,29,68
"2011","Derby 025E","E01013502",1008,59,17,42,146,136,67,101,183,173,59,40,19,84
"2011","Derby 025F","E01013503",1103,56,16,40,199,150,91,121,208,162,49,27,22,67
"2011","Derby 026A","E01013472",1429,59,14,45,181,102,50,127,301,303,207,145,62,99
"2011","Derby 026B","E01013497",1044,40,12,28,138,109,64,111,207,183,89,58,31,103
"2011","Derby 026C","E01013504",1311,57,13,44,155,121,66,150,251,262,135,84,51,114
"2011","Derby 026D","E01013583",1092,26,6,20,108,93,45,85,209,262,168,122,46,96
"2011","Derby 026E","E01013590",1161,24,4,20,94,82,59,91,226,279,194,143,51,112
"2011","Derby 026F","E01013591",1406,36,4,32,156,120,76,130,284,282,210,144,66,112
"2011","Derby 027A","E01013492",1116,109,28,81,256,158,87,83,156,119,54,37,17,94
"2011","Derby 027B","E01013493",1070,89,14,75,196,122,60,93,202,164,67,48,19,77
"2011","Derby 027C","E01013494",1264,78,17,61,181,184,93,125,252,185,70,45,25,96
"2011","Derby 027D","E01013495",1257,94,24,70,231,164,100,129,219,170,67,43,24,83
"2011","Derby 028A","E01013496",1046,57,18,39,138,132,53,116,213,155,102,68,34,80
"2011","Derby 028B","E01013498",1092,57,13,44,187,144,62,134,202,174,55,42,13,77
"2011","Derby 028C","E01013499",995,41,15,26,141,115,67,111,191,197,77,51,26,55
"2011","Derby 028D","E01013500",1239,57,12,45,200,183,86,154,249,187,50,34,16,73
"2011","Derby 028E","E01013501",1038,65,20,45,187,136,75,126,191,157,37,29,8,64
"2011","Derby 029A","E01013584",1205,28,6,22,107,77,77,113,236,260,179,122,57,128
"2011","Derby 029B","E01013585",1201,44,8,36,150,114,72,100,247,234,139,99,40,101
"2011","Derby 029C","E01013586",1042,37,11,26,139,131,47,89,233,168,109,82,27,89
"2011","Derby 029D","E01013587",1134,72,14,58,212,119,61,116,227,174,68,49,19,85
"2011","Derby 029E","E01013588",1100,40,9,31,136,143,75,106,240,200,93,62,31,67
"2011","Derby 029F","E01013589",1098,67,10,57,193,139,71,97,215,153,77,57,20,86
"2011","Derby 030B","E01013517",998,73,22,51,179,103,72,133,185,146,47,31,16,60
"2011","Derby 030C","E01013518",1011,77,15,62,226,136,79,119,164,108,34,25,9,68
"2011","Derby 030D","E01013521",966,54,7,47,158,103,58,97,187,167,77,47,30,65
"2011","Derby 030E","E01033168",905,152,31,121,260,145,81,66,72,61,23,15,8,45
"2011","Derby 030F","E01033169",1154,270,62,208,321,165,76,65,91,59,31,23,8,76
"2011","Derby 030G","E01033170",889,131,26,105,233,117,59,76,123,81,23,15,8,46
"2011","Derby 031A","E01013514",1179,187,43,144,290,178,81,103,143,104,24,16,8,69
"2011","Derby 031B","E01013515",1262,130,41,89,247,180,92,99,195,149,64,38,26,106
"2011","Derby 031C","E01013519",1113,174,36,138,258,138,62,97,154,86,60,35,25,84
"2011","Derby 031D","E01013520",1133,181,47,134,276,197,74,95,145,64,21,15,6,80
"2011","Leicester 001A","E01013615",1180,136,23,113,257,196,88,87,161,121,36,28,8,98
"2011","Leicester 001B","E01013616",1179,83,21,62,212,181,63,96,203,175,74,52,22,92
"2011","Leicester 001C","E01013618",1188,60,10,50,220,147,87,113,190,195,89,66,23,87
"2011","Leicester 001D","E01013619",1195,27,7,20,133,80,54,77,247,219,192,144,48,166
"2011","Leicester 002A","E01013733",1165,80,22,58,205,173,86,96,185,164,88,67,21,88
"2011","Leicester 002B","E01013734",1140,76,15,61,150,163,107,83,187,181,98,77,21,95
"2011","Leicester 002C","E01013735",1071,61,8,53,138,145,82,67,218,162,95,68,27,103
"2011","Leicester 002D","E01013736",1230,92,31,61,186,199,120,93,216,182,70,39,31,72
"2011","Leicester 002E","E01013737",1109,70,11,59,135,168,84,45,225,198,91,73,18,93
"2011","Leicester 003A","E01013600",1242,23,5,18,116,105,69,100,281,271,161,116,45,116
"2011","Leicester 003B","E01013601",1132,22,6,16,98,97,66,110,264,250,120,89,31,105
"2011","Leicester 003C","E01013602",1294,44,15,29,129,110,86,113,263,269,178,120,58,102
"2011","Leicester 003D","E01013603",1222,26,7,19,111,129,75,79,241,261,188,138,50,112
"2011","Leicester 003E","E01013604",1133,22,7,15,104,108,56,100,211,280,152,114,38,100
"2011","Leicester 003F","E01013605",1261,50,11,39,157,152,92,94,271,215,114,77,37,116
"2011","Leicester 004A","E01013617",1951,269,24,245,332,249,140,118,260,251,164,118,46,168
"2011","Leicester 004B","E01013620",1194,25,3,22,112,88,48,75,236,244,220,158,62,146
"2011","Leicester 004C","E01013621",1276,22,5,17,88,111,62,92,250,266,220,146,74,165
"2011","Leicester 004D","E01013622",1187,27,6,21,166,106,54,72,234,226,194,132,62,108
"2011","Leicester 004E","E01013623",1634,144,20,124,301,212,111,124,304,227,85,50,35,126
"2011","Leicester 005A","E01013732",1493,52,14,38,171,194,118,119,291,258,143,120,23,147
"2011","Leicester 005B","E01013739",1110,47,7,40,123,136,73,84,225,195,114,88,26,113
"2011","Leicester 005C","E01013740",1142,63,11,52,124,150,77,85,230,198,102,80,22,113
"2011","Leicester 005D","E01013741",1245,56,13,43,140,132,118,73,271,199,106,78,28,150
"2011","Leicester 006A","E01013625",1406,49,8,41,122,115,78,70,292,237,225,191,34,218
"2011","Leicester 006B","E01013628",1136,40,7,33,130,104,54,71,219,201,195,160,35,122
"2011","Leicester 006C","E01013715",1044,25,1,24,87,90,35,68,233,228,150,119,31,128
"2011","Leicester 006D","E01013716",1393,45,3,42,94,103,65,95,319,325,183,145,38,164
"2011","Leicester 006E","E01013738",1165,86,16,70,133,130,119,83,204,198,99,75,24,113
"2011","Leicester 007A","E01013624",1052,27,6,21,106,89,69,68,222,232,117,89,28,122
"2011","Leicester 007B","E01013626",1372,41,6,35,109,111,51,83,304,298,197,160,37,178
"2011","Leicester 007C","E01013627",1036,57,5,52,104,110,49,72,222,211,89,72,17,122
"2011","Leicester 007D","E01013629",1286,43,6,37,117,125,78,72,267,228,184,153,31,172
"2011","Leicester 007E","E01013630",1340,36,4,32,95,111,57,80,290,300,216,184,32,155
"2011","Leicester 008A","E01013606",1224,65,15,50,185,168,75,106,232,235,65,42,23,93
"2011","Leicester 008B","E01013607",2074,181,34,147,360,263,144,130,308,279,131,97,34,278
"2011","Leicester 008C","E01013680",1574,98,27,71,267,212,138,104,251,321,66,46,20,117
"2011","Leicester 008D","E01013685",1105,70,15,55,213,151,89,115,169,198,28,10,18,72
"2011","Leicester 008E","E01013686",1379,91,24,67,228,208,99,112,235,232,38,26,12,136
"2011","Leicester 009A","E01013696",1699,174,26,148,282,242,137,103,256,214,132,93,39,159
"2011","Leicester 009B","E01013697",1871,210,34,176,321,264,148,114,253,190,191,146,45,180
"2011","Leicester 009C","E01013699",1266,118,23,95,226,175,111,78,193,178,72,53,19,115
"2011","Leicester 009E","E01032862",1363,146,30,116,277,229,86,60,185,118,116,89,27,146
"2011","Leicester 009F","E01032863",1242,138,20,118,243,201,71,51,185,126,98,70,28,129
"2011","Leicester 009G","E01032865",1530,164,27,137,283,257,124,82,239,158,76,58,18,147
"2011","Leicester 010A","E01013713",1212,47,8,39,88,89,57,72,247,297,163,133,30,152
"2011","Leicester 010B","E01013714",1306,64,17,47,107,124,80,65,265,273,170,140,30,158
"2011","Leicester 010C","E01013717",1137,44,9,35,105,112,68,70,241,221,139,112,27,137
"2011","Leicester 010D","E01013718",1183,35,6,29,86,94,44,62,242,307,165,147,18,148
"2011","Leicester 010E","E01013719",1231,33,5,28,69,100,45,75,294,269,194,164,30,152
"2011","Leicester 010F","E01013720",976,28,2,26,57,76,31,45,199,244,196,165,31,100
"2011","Leicester 011A","E01013651",1193,16,2,14,111,105,57,95,236,268,192,149,43,113
"2011","Leicester 011B","E01013652",1161,30,10,20,88,107,53,82,238,236,188,143,45,139
"2011","Leicester 011C","E01013653",1321,27,8,19,100,109,77,101,217,303,231,178,53,156
"2011","Leicester 011D","E01013655",1456,42,8,34,136,126,77,97,288,305,228,176,52,157
"2011","Leicester 012A","E01013721",1104,66,16,50,147,131,83,97,191,223,75,51,24,91
"2011","Leicester 012B","E01013723",891,28,9,19,79,74,63,69,176,208,100,71,29,94
"2011","Leicester 012C","E01013725",887,15,7,8,67,57,49,62,195,215,140,88,52,87
"2011","Leicester 012D","E01013726",1151,23,9,14,90,97,50,61,230,301,196,133,63,103
"2011","Leicester 012E","E01013728",1059,29,9,20,101,90,59,77,212,218,128,95,33,145
"2011","Leicester 013A","E01013694",1099,50,10,40,161,148,85,70,216,181,105,73,32,83
"2011","Leicester 013B","E01013700",1059,65,13,52,172,174,101,74,164,159,82,63,19,68
"2011","Leicester 013C","E01013770",975,66,11,55,155,119,90,52,187,170,58,44,14,78
"2011","Leicester 013D","E01013771",1176,74,12,62,197,169,121,69,183,162,93,60,33,108
"2011","Leicester 013E","E01013773",1033,48,10,38,139,129,93,77,182,202,69,42,27,94
"2011","Leicester 016A","E01013681",1404,59,15,44,192,146,76,89,277,318,128,82,46,119
"2011","Leicester 016B","E01013682",1336,52,11,41,215,155,72,106,225,301,117,79,38,93
"2011","Leicester 016C","E01013683",1646,79,22,57,292,177,85,113,287,289,140,97,43,184
"2011","Leicester 016D","E01013684",1538,73,14,59,176,160,85,104,264,301,150,108,42,225
"2011","Leicester 017A","E01013654",1476,32,5,27,114,115,70,77,288,295,334,291,43,151
"2011","Leicester 017B","E01013656",1335,28,2,26,83,106,69,53,256,317,242,211,31,181
"2011","Leicester 017C","E01013657",1255,38,8,30,83,110,72,57,220,236,267,230,37,172
"2011","Leicester 017D","E01013658",1345,36,7,29,81,90,80,73,240,350,232,203,29,163
"2011","Leicester 017E","E01013659",1373,48,11,37,89,112,79,60,222,273,316,284,32,174
"2011","Leicester 017F","E01013743",1224,24,6,18,72,95,54,46,198,293,270,241,29,172
"2011","Leicester 017G","E01013745",1176,49,11,38,77,119,72,43,172,228,234,201,33,182
"2011","Leicester 018A","E01013742",1302,35,2,33,82,99,63,54,195,300,288,253,35,186
"2011","Leicester 018B","E01013744",1407,28,3,25,86,136,82,66,201,316,301,272,29,191
"2011","Leicester 018C","E01013746",1356,16,3,13,79,104,62,60,195,332,366,324,42,142
"2011","Leicester 018D","E01013748",1448,36,6,30,78,104,73,56,217,259,382,340,42,243
"2011","Leicester 018E","E01013754",1201,24,7,17,76,90,53,55,172,271,299,246,53,161
"2011","Leicester 018F","E01013755",1268,23,2,21,75,75,50,67,179,307,334,264,70,158
"2011","Leicester 019A","E01013660",1273,50,13,37,143,145,84,74,219,256,143,96,47,159
"2011","Leicester 019B","E01013661",1166,33,9,24,110,107,66,60,204,272,187,133,54,127
"2011","Leicester 019C","E01013664",1352,27,11,16,117,144,91,77,252,321,202,135,67,121
"2011","Leicester 019D","E01013665",1326,49,4,45,165,144,95,81,223,271,156,121,35,142
"2011","Leicester 019E","E01013667",1079,51,6,45,153,137,74,70,181,189,103,80,23,121
"2011","Leicester 019F","E01013668",1066,80,8,72,231,124,79,50,151,156,95,71,24,100
"2011","Leicester 020A","E01013729",942,50,19,31,136,137,91,87,170,183,42,31,11,46
"2011","Leicester 020B","E01013780",1110,152,41,111,303,142,109,66,103,118,36,22,14,81
"2011","Leicester 020C","E01013783",1143,139,22,117,303,151,94,61,157,110,48,35,13,80
"2011","Leicester 020D","E01013785",1083,150,29,121,308,150,106,57,97,92,42,33,9,81
"2011","Leicester 020E","E01013786",1180,96,16,80,247,152,91,92,189,171,58,38,20,84
"2011","Leicester 021A","E01013662",1320,53,16,37,114,102,80,72,220,328,173,147,26,178
"2011","Leicester 021B","E01013663",1262,50,6,44,110,126,90,57,223,297,147,113,34,162
"2011","Leicester 021C","E01013747",1324,55,7,48,123,118,68,62,212,283,211,176,35,192
"2011","Leicester 021D","E01013749",1101,32,7,25,115,145,104,51,154,203,137,113,24,160
"2011","Leicester 021E","E01013750",1049,39,8,31,104,95,77,46,152,225,162,142,20,149
"2011","Leicester 021F","E01013758",1137,54,9,45,95,121,77,54,136,194,182,161,21,224
"2011","Leicester 022A","E01013751",1383,47,11,36,100,131,74,55,203,246,271,241,30,256
"2011","Leicester 022B","E01013752",1094,50,13,37,92,134,62,39,156,197,201,166,35,163
"2011","Leicester 022C","E01013753",1188,34,6,28,68,117,69,59,170,193,271,230,41,207
"2011","Leicester 022D","E01013760",1578,71,6,65,138,89,45,64,146,191,227,176,51,607
"2011","Leicester 022E","E01013761",1341,37,4,33,92,99,81,68,173,248,287,224,63,256
"2011","Leicester 022F","E01013762",1346,53,11,42,110,120,91,59,158,197,244,209,35,314
"2011","Leicester 023A","E01013774",1506,65,9,56,214,102,58,84,162,224,103,68,35,494
"2011","Leicester 023B","E01013776",1483,74,7,67,186,107,63,72,192,186,96,63,33,507
"2011","Leicester 023C","E01013778",2150,88,11,77,204,146,73,110,181,216,147,114,33,985
"2011","Leicester 023D","E01013779",1699,110,20,90,251,164,73,94,181,202,112,71,41,512
"2011","Leicester 023E","E01013781",1393,124,20,104,211,119,84,90,149,196,127,76,51,293
"2011","Leicester 023F","E01013782",1114,117,10,107,246,120,80,72,140,180,52,43,9,107
"2011","Leicester 023G","E01013784",1146,119,12,107,228,111,57,55,128,123,54,38,16,271
"2011","Leicester 025A","E01013666",1134,121,23,98,223,158,105,54,173,144,52,40,12,104
"2011","Leicester 025B","E01013669",1018,101,16,85,171,141,92,58,164,148,50,38,12,93
"2011","Leicester 025C","E01013670",1286,150,14,136,259,169,142,59,157,157,97,69,28,96
"2011","Leicester 025D","E01013671",1237,95,23,72,200,168,122,76,173,160,106,80,26,137
"2011","Leicester 025E","E01013672",920,100,18,82,179,136,93,52,114,89,72,52,20,85
"2011","Leicester 026A","E01013631",1038,22,7,15,121,117,41,83,213,248,117,88,29,76
"2011","Leicester 026B","E01013632",1248,19,6,13,84,73,65,93,254,298,242,175,67,120
"2011","Leicester 026C","E01013638",1127,19,12,7,76,84,72,89,222,294,152,121,31,119
"2011","Leicester 026D","E01013640",1182,16,4,12,78,83,47,80,253,290,176,122,54,159
"2011","Leicester 027A","E01013756",1430,134,16,118,181,145,112,48,154,169,176,136,40,311
"2011","Leicester 027B","E01013757",1186,137,33,104,177,171,114,43,131,119,143,124,19,151
"2011","Leicester 027C","E01013759",1370,126,16,110,188,171,129,50,171,196,148,107,41,191
"2011","Leicester 027D","E01013763",1671,91,7,84,166,93,66,56,157,190,187,148,39,665
"2011","Leicester 027E","E01013764",1199,94,13,81,153,142,81,52,192,175,135,105,30,175
"2011","Leicester 027F","E01013765",1348,60,11,49,110,92,58,67,155,149,180,149,31,477
"2011","Leicester 027G","E01013766",1307,137,17,120,181,149,92,65,137,159,164,131,33,223
"2011","Leicester 028A","E01013633",1145,25,5,20,113,113,80,110,233,237,119,89,30,115
"2011","Leicester 028B","E01013634",1066,23,6,17,115,98,51,92,208,277,98,79,19,104
"2011","Leicester 028C","E01013637",1297,25,11,14,109,115,78,132,264,295,158,105,53,121
"2011","Leicester 028D","E01013639",986,41,6,35,152,109,46,75,184,202,86,56,30,91
"2011","Leicester 028E","E01013641",1267,74,13,61,176,120,79,86,206,232,92,69,23,202
"2011","Leicester 029A","E01013635",1180,89,11,78,209,126,84,75,193,205,82,59,23,117
"2011","Leicester 029B","E01013636",1069,98,20,78,232,145,112,62,139,131,53,41,12,97
"2011","Leicester 029C","E01013775",1838,219,26,193,306,198,67,83,207,198,104,75,29,456
"2011","Leicester 029D","E01013777",1283,93,22,71,238,174,71,96,178,212,89,58,31,132
"2011","Leicester 030A","E01013642",1507,243,33,210,306,132,75,36,85,82,50,24,26,498
"2011","Leicester 030B","E01013643",1567,207,31,176,283,119,59,39,81,67,39,24,15,673
"2011","Leicester 030C","E01013649",1363,216,24,192,233,109,50,23,69,51,49,41,8,563
"2011","Leicester 030D","E01013650",1639,220,22,198,297,120,44,35,78,44,16,9,7,785
"2011","Leicester 030E","E01013702",1191,206,23,183,259,131,94,38,102,67,42,32,10,252
"2011","Leicester 030F","E01013710",1090,263,25,238,264,109,89,47,79,69,45,33,12,125
"2011","Leicester 030G","E01013711",1189,234,34,200,254,135,98,35,103,86,93,72,21,151
"2011","Leicester 031A","E01013613",1256,96,12,84,244,153,90,104,181,224,82,55,27,82
"2011","Leicester 031B","E01013614",1167,72,19,53,243,157,93,87,197,186,61,35,26,71
"2011","Leicester 031C","E01013687",1273,102,19,83,247,169,75,84,184,166,102,77,25,144
"2011","Leicester 031D","E01013688",1138,69,14,55,163,142,61,96,181,189,82,42,40,155
"2011","Leicester 032A","E01013703",939,249,32,217,251,99,84,25,67,48,35,24,11,81
"2011","Leicester 032B","E01013704",1047,280,42,238,303,127,97,32,60,45,30,22,8,73
"2011","Leicester 032C","E01013706",1176,302,50,252,350,149,114,24,61,41,25,18,7,110
"2011","Leicester 032D","E01013707",1120,210,34,176,309,146,82,50,110,77,29,17,12,107
"2011","Leicester 032E","E01013712",1096,216,24,192,211,96,84,29,84,51,43,33,10,282
"2011","Leicester 034A","E01013608",1131,68,21,47,201,128,124,117,189,179,50,25,25,75
"2011","Leicester 034B","E01013609",1173,106,29,77,273,176,116,110,149,139,36,20,16,68
"2011","Leicester 034C","E01013610",1216,81,19,62,205,136,90,93,237,189,108,72,36,77
"2011","Leicester 034D","E01013611",1078,67,13,54,215,127,98,80,164,171,78,54,24,78
"2011","Leicester 034E","E01013612",1090,100,27,73,234,161,97,77,155,134,45,27,18,87
"2011","Leicester 035A","E01013678",1118,31,4,27,163,149,93,87,211,199,88,58,30,97
"2011","Leicester 035B","E01013679",1015,18,5,13,95,78,55,82,190,201,158,114,44,138
"2011","Leicester 035C","E01013691",1084,22,7,15,80,88,53,76,213,251,175,113,62,126
"2011","Leicester 035D","E01013692",886,14,3,11,71,63,35,79,167,211,152,119,33,94
"2011","Leicester 035E","E01013693",970,15,4,11,75,53,45,65,206,223,154,123,31,134
"2011","Leicester 036A","E01013673",1018,30,8,22,98,112,57,86,221,232,105,76,29,77
"2011","Leicester 036B","E01013674",1064,26,6,20,108,110,58,89,258,245,101,61,40,69
"2011","Leicester 036C","E01013675",1128,20,7,13,129,135,81,105,218,258,82,53,29,100
"2011","Leicester 036D","E01013676",1336,36,15,21,158,162,71,118,279,293,115,72,43,104
"2011","Leicester 036E","E01013677",1094,25,6,19,130,127,62,92,225,241,110,66,44,82
"2011","Leicester 037A","E01013695",992,21,9,12,104,103,71,74,205,211,105,74,31,98
"2011","Leicester 037B","E01013698",1022,43,13,30,155,115,88,77,186,179,71,38,33,108
"2011","Leicester 037C","E01013767",1060,71,16,55,166,150,92,69,185,165,65,45,20,97
"2011","Leicester 037D","E01013768",1010,48,18,30,153,122,90,79,193,163,93,67,26,69
"2011","Leicester 037E","E01013772",1050,25,3,22,107,110,82,84,223,225,114,82,32,80
"2011","Leicester 037F","E01032597",953,21,4,17,118,94,64,76,204,196,98,60,38,82
"2011","Leicester 038A","E01013689",1680,87,12,75,120,81,47,52,106,89,55,39,16,1043
"2011","Leicester 038B","E01013690",1203,101,18,83,201,114,62,83,184,196,96,68,28,166
"2011","Leicester 038C","E01013705",1149,171,20,151,215,164,93,60,156,113,75,48,27,102
"2011","Leicester 038D","E01013709",1132,111,12,99,224,184,89,80,154,150,64,49,15,76
"2011","Leicester 038E","E01032599",1103,123,24,99,226,151,87,61,174,130,46,31,15,105
"2011","Leicester 039A","E01013722",1091,33,7,26,104,105,79,70,192,262,145,109,36,101
"2011","Leicester 039B","E01013727",1045,35,6,29,100,103,64,105,203,274,96,64,32,65
"2011","Leicester 039C","E01013730",1063,27,7,20,111,92,61,87,199,257,149,96,53,80
"2011","Leicester 039D","E01013731",1149,51,13,38,168,152,69,78,206,191,119,77,42,115
"2011","Leicester 039E","E01032602",1081,29,13,16,109,94,68,95,203,238,133,86,47,112
"2011","Leicester 040A","E01013646",2560,208,19,189,224,121,77,78,166,189,189,117,72,1308
"2011","Leicester 040B","E01013647",2313,116,12,104,121,94,52,62,163,170,181,105,76,1354
"2011","Leicester 040C","E01013648",2414,51,7,44,116,76,35,53,134,154,99,73,26,1696
"2011","Leicester 040D","E01032875",1845,22,3,19,39,35,10,14,36,40,69,31,38,1580
"2011","Leicester 041A","E01032867",1688,105,14,91,164,109,56,64,100,101,94,57,37,895
"2011","Leicester 041B","E01032868",1634,79,16,63,102,41,13,26,38,22,25,19,6,1288
"2011","Leicester 041C","E01032872",1161,140,18,122,212,132,27,46,92,80,53,33,20,379
"2011","Leicester 041D","E01032873",1279,121,17,104,162,72,31,44,97,82,117,60,57,553
"2011","Nottingham 001A","E01013887",1200,95,26,69,224,206,114,120,177,146,55,33,22,63
"2011","Nottingham 001B","E01013892",1050,76,14,62,223,160,83,94,158,148,42,34,8,66
"2011","Nottingham 001C","E01013893",954,37,14,23,149,108,47,71,190,203,89,60,29,60
"2011","Nottingham 001D","E01013894",1132,79,31,48,203,175,84,98,198,166,41,19,22,88
"2011","Nottingham 002A","E01013879",882,29,6,23,88,78,48,67,198,203,123,74,49,48
"2011","Nottingham 002B","E01013880",1026,19,7,12,96,92,50,112,235,229,114,82,32,79
"2011","Nottingham 002C","E01013881",1023,13,1,12,116,108,49,82,217,246,125,77,48,67
"2011","Nottingham 002D","E01013882",991,33,12,21,99,126,67,77,190,228,102,72,30,69
"2011","Nottingham 002E","E01013885",1167,36,6,30,140,139,84,100,212,250,119,69,50,87
"2011","Nottingham 004A","E01013886",1130,45,16,29,178,158,62,106,230,210,73,46,27,68
"2011","Nottingham 004B","E01013888",1093,49,20,29,175,139,79,95,220,196,68,39,29,72
"2011","Nottingham 004C","E01013889",1227,69,18,51,222,177,80,129,216,171,82,48,34,81
"2011","Nottingham 004D","E01013890",1170,61,28,33,206,155,67,116,231,221,52,30,22,61
"2011","Nottingham 004E","E01013891",1233,43,12,31,160,130,66,111,247,253,129,78,51,94
"2011","Nottingham 005A","E01013875",1051,70,15,55,186,175,73,107,183,164,36,22,14,57
"2011","Nottingham 005B","E01013876",1291,53,13,40,155,144,64,123,228,240,182,144,38,102
"2011","Nottingham 005C","E01013877",962,14,4,10,72,83,45,60,218,226,169,112,57,75
"2011","Nottingham 005D","E01013878",883,33,11,22,96,121,44,69,175,165,123,77,46,57
"2011","Nottingham 005E","E01013883",1155,41,15,26,143,121,67,114,225,241,117,79,38,86
"2011","Nottingham 005F","E01013884",975,36,14,22,87,131,56,84,211,191,100,55,45,79
"2011","Nottingham 006A","E01013853",1061,46,11,35,136,114,55,106,234,218,80,46,34,72
"2011","Nottingham 006B","E01013854",1017,30,9,21,141,119,59,79,221,211,87,53,34,70
"2011","Nottingham 006C","E01013855",1038,23,8,15,100,101,51,84,231,223,149,94,55,76
"2011","Nottingham 006D","E01013856",1127,44,6,38,156,129,67,87,205,222,119,84,35,98
"2011","Nottingham 006F","E01033397",1268,93,15,78,205,144,61,93,219,208,115,67,48,130
"2011","Nottingham 006G","E01033398",932,89,16,73,176,106,50,61,157,138,89,51,38,66
"2011","Nottingham 007A","E01013963",1084,73,11,62,150,118,75,77,218,198,92,61,31,83
"2011","Nottingham 007B","E01013964",1210,159,33,126,255,134,83,65,156,149,105,73,32,104
"2011","Nottingham 007C","E01013965",1053,75,16,59,204,136,74,75,164,143,84,58,26,98
"2011","Nottingham 007D","E01013966",1014,76,8,68,191,134,62,65,166,137,89,61,28,94
"2011","Nottingham 007E","E01013967",1475,154,18,136,290,117,146,93,156,236,203,176,27,80
"2011","Nottingham 008A","E01013827",1037,47,10,37,162,123,58,82,187,184,110,76,34,84
"2011","Nottingham 008B","E01013828",1264,92,15,77,259,163,105,102,198,176,97,56,41,72
"2011","Nottingham 008C","E01013834",1067,26,8,18,136,125,60,73,224,223,107,73,34,93
"2011","Nottingham 008D","E01013835",1163,54,15,39,208,125,68,80,226,189,131,96,35,82
"2011","Nottingham 008E","E01013836",1363,70,26,44,243,164,91,113,256,234,102,70,32,90
"2011","Nottingham 009A","E01013829",1232,109,22,87,265,166,77,82,182,182,84,55,29,85
"2011","Nottingham 009B","E01013830",1227,82,15,67,196,172,101,102,198,191,91,64,27,94
"2011","Nottingham 009C","E01013831",1172,99,29,70,240,162,89,104,186,176,50,39,11,66
"2011","Nottingham 009D","E01013832",1394,57,10,47,189,136,123,90,201,170,126,84,42,302
"2011","Nottingham 009E","E01013833",981,31,8,23,123,89,73,85,193,193,103,69,34,91
"2011","Nottingham 010A","E01013935",1151,126,27,99,304,159,98,88,146,118,64,44,20,48
"2011","Nottingham 010B","E01013968",887,143,44,99,259,91,76,42,79,89,46,34,12,62
"2011","Nottingham 010C","E01013969",1347,161,31,130,373,169,106,84,169,116,69,54,15,100
"2011","Nottingham 010D","E01013970",1200,168,33,135,362,136,82,72,127,103,61,37,24,89
"2011","Nottingham 010E","E01013971",1231,185,30,155,352,147,84,63,144,120,73,46,27,63
"2011","Nottingham 011A","E01013817",1037,18,8,10,86,95,42,88,227,235,157,97,60,89
"2011","Nottingham 011B","E01013818",1108,11,3,8,64,83,37,64,193,264,242,172,70,150
"2011","Nottingham 011C","E01013822",1092,16,4,12,68,85,58,80,233,258,182,136,46,112
"2011","Nottingham 011D","E01013825",1258,37,8,29,147,124,84,126,242,255,135,94,41,108
"2011","Nottingham 011E","E01013826",1209,19,6,13,86,110,57,85,245,259,226,142,84,122
"2011","Nottingham 012A","E01013837",1336,193,36,157,351,183,111,64,145,113,68,51,17,108
"2011","Nottingham 012B","E01013838",1374,106,32,74,248,181,111,86,151,145,55,41,14,291
"2011","Nottingham 012C","E01013839",1320,88,20,68,216,148,84,89,220,210,172,109,63,93
"2011","Nottingham 012D","E01013840",1694,245,41,204,422,236,130,101,174,165,109,76,33,112
"2011","Nottingham 012E","E01013841",1188,73,15,58,221,134,71,74,184,183,117,85,32,131
"2011","Nottingham 013A","E01013819",1150,33,8,25,133,133,66,93,227,227,139,102,37,99
"2011","Nottingham 013B","E01013820",1182,28,8,20,106,108,51,98,246,245,179,115,64,121
"2011","Nottingham 013C","E01013821",1089,15,4,11,111,81,51,114,211,223,180,128,52,103
"2011","Nottingham 013D","E01013823",1244,35,12,23,128,124,91,112,230,233,145,101,44,146
"2011","Nottingham 013E","E01013824",1035,20,8,12,119,91,48,73,221,206,172,109,63,85
"2011","Nottingham 014A","E01013864",1083,35,7,28,130,95,59,93,234,185,167,105,62,85
"2011","Nottingham 014B","E01013865",1021,22,4,18,116,116,71,92,209,236,85,59,26,74
"2011","Nottingham 014C","E01013866",1014,22,5,17,106,102,74,94,211,232,112,86,26,61
"2011","Nottingham 014D","E01013867",1078,34,9,25,96,89,52,80,217,247,171,116,55,92
"2011","Nottingham 015A","E01013937",1293,222,36,186,356,125,111,63,107,98,94,67,27,117
"2011","Nottingham 015B","E01013938",1163,316,51,265,302,102,91,56,97,47,51,35,16,101
"2011","Nottingham 015C","E01013941",1289,245,31,214,352,149,87,39,87,87,52,32,20,191
"2011","Nottingham 015D","E01013943",1544,156,14,142,255,149,62,108,142,126,137,93,44,409
"2011","Nottingham 015E","E01013972",1172,123,21,102,326,148,88,61,126,125,93,64,29,82
"2011","Nottingham 016A","E01013936",1755,205,39,166,407,257,120,101,214,206,93,65,28,152
"2011","Nottingham 016B","E01013939",1225,97,22,75,271,168,89,102,166,171,82,54,28,79
"2011","Nottingham 016C","E01013940",1239,69,10,59,167,123,57,92,213,227,168,115,53,123
"2011","Nottingham 016D","E01013942",1507,66,10,56,170,126,123,116,257,299,202,147,55,148
"2011","Nottingham 017A","E01013843",1212,110,16,94,251,129,81,50,127,133,144,117,27,187
"2011","Nottingham 017B","E01013844",1131,77,7,70,201,95,71,75,149,149,124,96,28,190
"2011","Nottingham 017C","E01013845",1181,53,11,42,170,109,109,60,158,165,198,163,35,159
"2011","Nottingham 017D","E01013847",1078,44,8,36,146,82,90,49,120,123,187,166,21,237
"2011","Nottingham 018A","E01013810",1155,21,1,20,106,97,84,66,216,225,191,154,37,149
"2011","Nottingham 018B","E01013811",1126,34,3,31,78,62,70,74,156,147,199,146,53,306
"2011","Nottingham 018C","E01013812",1176,39,4,35,98,76,86,75,157,157,219,182,37,269
"2011","Nottingham 018D","E01013842",1235,36,10,26,163,112,94,72,183,162,146,125,21,267
"2011","Nottingham 018E","E01013846",1348,60,4,56,127,97,66,62,159,163,194,164,30,420
"2011","Nottingham 019A","E01013930",1376,75,12,63,207,147,162,84,183,179,180,145,35,159
"2011","Nottingham 019B","E01013931",1119,114,14,100,178,154,146,61,141,100,118,97,21,107
"2011","Nottingham 019C","E01013932",1216,67,19,48,174,145,126,95,187,195,116,103,13,111
"2011","Nottingham 019D","E01013933",1270,59,10,49,124,108,100,99,204,197,147,112,35,232
"2011","Nottingham 019E","E01013934",1096,71,20,51,151,130,130,84,170,161,83,66,17,116
"2011","Nottingham 020A","E01013859",1075,33,8,25,140,142,84,101,203,234,84,73,11,54
"2011","Nottingham 020B","E01013861",1025,21,5,16,107,87,58,84,195,264,142,117,25,67
"2011","Nottingham 020C","E01013868",1008,21,8,13,96,63,64,93,210,233,122,87,35,106
"2011","Nottingham 020D","E01013929",1341,97,25,72,239,171,137,113,169,182,95,76,19,138
"2011","Nottingham 021A","E01013954",973,37,10,27,109,88,53,76,164,184,147,104,43,115
"2011","Nottingham 021B","E01013959",1296,34,4,30,117,96,46,105,263,318,192,130,62,125
"2011","Nottingham 021C","E01013960",1142,26,4,22,90,72,54,97,266,241,184,126,58,112
"2011","Nottingham 021D","E01013962",1337,63,16,47,186,142,59,102,232,270,152,106,46,131
"2011","Nottingham 022A","E01013813",1995,45,10,35,109,74,49,87,165,185,147,89,58,1134
"2011","Nottingham 022B","E01013814",1903,104,17,87,159,78,55,61,114,122,223,155,68,987
"2011","Nottingham 022C","E01013815",1671,62,10,52,123,70,29,30,82,119,133,101,32,1023
"2011","Nottingham 022D","E01013816",2380,104,16,88,143,90,45,56,108,105,146,118,28,1583
"2011","Nottingham 023C","E01013958",1303,37,5,32,122,103,78,82,234,247,204,156,48,196
"2011","Nottingham 023D","E01013961",1953,46,4,42,114,81,59,67,155,167,170,137,33,1094
"2011","Nottingham 023E","E01033399",1944,52,8,44,88,50,33,41,93,101,109,81,28,1377
"2011","Nottingham 023F","E01033401",936,75,9,66,101,52,50,27,55,62,58,45,13,456
"2011","Nottingham 023G","E01033405",1248,72,1,71,111,78,24,48,79,92,86,65,21,658
"2011","Nottingham 023H","E01033409",1504,29,2,27,136,90,25,58,120,116,59,35,24,871
"2011","Nottingham 023I","E01033411",787,19,2,17,52,62,51,67,121,177,138,111,27,100
"2011","Nottingham 024A","E01013913",1295,79,21,58,230,165,143,105,198,173,89,69,20,113
"2011","Nottingham 024B","E01013914",1241,62,11,51,198,181,137,83,191,155,111,92,19,123
"2011","Nottingham 024C","E01013915",1083,54,14,40,159,153,106,99,171,178,66,48,18,97
"2011","Nottingham 024D","E01013916",1034,34,11,23,114,110,86,77,191,214,122,88,34,86
"2011","Nottingham 024E","E01013917",1330,59,15,44,201,137,107,105,234,226,148,105,43,113
"2011","Nottingham 025A","E01013858",999,28,6,22,113,106,57,80,188,226,100,62,38,101
"2011","Nottingham 025B","E01013860",1067,49,8,41,143,101,87,101,178,251,82,63,19,75
"2011","Nottingham 025C","E01013862",1040,48,11,37,134,90,54,54,195,210,141,102,39,114
"2011","Nottingham 025D","E01013863",1040,99,17,82,197,115,89,55,159,154,90,62,28,82
"2011","Nottingham 026A","E01013944",1241,61,9,52,140,115,136,98,160,189,141,122,19,201
"2011","Nottingham 026B","E01013945",1454,48,3,45,120,80,55,59,142,195,151,107,44,604
"2011","Nottingham 026D","E01013947",1555,33,3,30,110,97,58,80,172,213,183,138,45,609
"2011","Nottingham 026E","E01013948",1046,18,1,17,111,55,60,57,171,238,185,125,60,151
"2011","Nottingham 026F","E01013953",3183,62,2,60,98,58,19,31,43,49,42,31,11,2781
"2011","Nottingham 026G","E01033395",2109,50,2,48,81,38,15,24,38,73,40,32,8,1750
"2011","Nottingham 026H","E01033396",907,36,1,35,85,58,46,50,91,128,126,91,35,287
"2011","Nottingham 027A","E01013977",1331,275,48,227,329,180,127,67,105,68,68,48,20,112
"2011","Nottingham 027B","E01013978",1197,165,32,133,216,142,117,81,116,118,62,52,10,180
"2011","Nottingham 027C","E01013979",1119,251,40,211,260,139,88,52,88,62,58,44,14,121
"2011","Nottingham 027D","E01013981",1230,235,40,195,347,168,109,54,102,71,37,28,9,107
"2011","Nottingham 028E","E01032520",1880,548,68,480,406,117,91,28,63,38,41,25,16,548
"2011","Nottingham 028F","E01032522",1858,556,65,491,402,143,98,38,68,31,34,22,12,488
"2011","Nottingham 028G","E01033404",3647,130,11,119,159,84,66,84,142,163,148,95,53,2671
"2011","Nottingham 029A","E01013918",1441,85,12,73,219,167,101,87,208,223,198,153,45,153
"2011","Nottingham 029B","E01013919",1577,98,13,85,253,144,119,106,219,239,222,158,64,177
"2011","Nottingham 029C","E01013920",1777,153,26,127,278,135,107,103,253,340,270,159,111,138
"2011","Nottingham 029D","E01013921",1500,52,6,46,169,130,94,89,248,291,274,219,55,153
"2011","Nottingham 029E","E01013957",1122,44,6,38,145,90,85,86,206,226,128,96,32,112
"2011","Nottingham 030A","E01013980",1142,227,33,194,298,157,77,81,107,66,38,27,11,91
"2011","Nottingham 030B","E01013982",1105,279,71,208,306,131,115,34,76,29,22,16,6,113
"2011","Nottingham 030C","E01013983",1037,85,9,76,166,136,64,94,164,149,82,50,32,97
"2011","Nottingham 030D","E01013984",938,178,31,147,241,167,72,48,79,61,31,26,5,61
"2011","Nottingham 030E","E01013985",1251,242,31,211,258,181,88,70,150,81,62,42,20,119
"2011","Nottingham 031C","E01013924",1552,21,3,18,58,57,39,46,137,131,110,61,49,953
"2011","Nottingham 031E","E01013926",1467,108,10,98,140,73,60,53,98,97,56,38,18,782
"2011","Nottingham 031G","E01013928",1418,90,1,89,76,43,26,29,51,73,59,46,13,971
"2011","Nottingham 031H","E01033408",3122,136,9,127,162,96,74,51,126,133,119,98,21,2225
"2011","Nottingham 031I","E01033410",2478,108,9,99,141,64,51,39,69,60,57,47,10,1889
"2011","Nottingham 032A","E01013973",3700,83,4,79,74,45,27,30,71,94,61,47,14,3215
"2011","Nottingham 032B","E01013974",1721,94,5,89,143,100,66,41,124,114,90,74,16,949
"2011","Nottingham 032C","E01013975",2106,151,25,126,113,64,60,29,79,54,59,52,7,1497
"2011","Nottingham 032D","E01013976",1216,111,15,96,146,100,43,70,180,171,129,80,49,266
"2011","Nottingham 034A","E01013895",1034,91,28,63,205,194,79,99,133,132,27,25,2,74
"2011","Nottingham 034B","E01013896",900,20,5,15,108,84,70,87,177,212,79,52,27,63
"2011","Nottingham 034C","E01013901",1115,191,41,150,305,147,94,79,116,75,29,12,17,79
"2011","Nottingham 034D","E01013902",1094,142,29,113,279,158,84,92,134,116,32,21,11,57
"2011","Nottingham 035A","E01013897",990,29,8,21,99,99,64,103,177,203,88,66,22,128
"2011","Nottingham 035B","E01013898",1350,27,5,22,97,73,54,54,140,116,52,39,13,737
"2011","Nottingham 035C","E01013899",888,28,8,20,107,100,63,72,196,195,56,38,18,71
"2011","Nottingham 035D","E01013900",1072,33,5,28,149,117,72,102,240,216,78,48,30,65
"2011","Nottingham 035E","E01013903",908,60,18,42,168,119,73,91,148,113,38,28,10,98
"2011","Nottingham 035F","E01013907",962,37,10,27,105,88,50,109,220,229,64,43,21,60
"2011","Nottingham 036A","E01013905",1063,42,11,31,98,109,60,94,234,253,79,51,28,94
"2011","Nottingham 036B","E01013908",1057,30,8,22,99,141,65,87,223,250,90,59,31,72
"2011","Nottingham 036C","E01013909",1103,38,5,33,147,113,72,98,246,229,84,50,34,76
"2011","Nottingham 036D","E01013912",1175,110,36,74,207,161,103,100,213,145,51,36,15,85
"2011","Nottingham 037A","E01013904",1035,34,3,31,135,111,65,101,211,249,68,41,27,61
"2011","Nottingham 037B","E01013906",1139,47,18,29,130,126,72,117,235,248,73,41,32,91
"2011","Nottingham 037C","E01013910",993,32,7,25,110,106,64,102,198,230,65,42,23,86
"2011","Nottingham 037D","E01013911",1018,26,6,20,133,105,64,98,227,219,78,48,30,68
"2011","Nottingham 038A","E01013849",1068,19,4,15,105,127,56,94,245,259,105,60,45,58
"2011","Nottingham 038B","E01013850",1035,27,10,17,116,92,60,90,232,273,89,62,27,56
"2011","Nottingham 038C","E01013851",1132,27,5,22,110,130,41,94,232,257,145,86,59,96
"2011","Nottingham 038D","E01013852",1148,41,12,29,142,106,72,102,247,257,102,57,45,79
"2011","Nottingham 038E","E01032621",1194,41,13,28,151,156,71,123,235,252,79,50,29,86
"2011","Nottingham 039A","E01013874",1241,136,28,108,302,150,76,105,133,134,75,50,25,130
"2011","Nottingham 039B","E01033400",1038,57,9,48,134,97,52,62,111,131,118,90,28,276
"2011","Nottingham 039C","E01033402",1034,154,10,144,208,115,23,41,58,58,58,36,22,319
"2011","Nottingham 039D","E01033403",998,144,14,130,186,91,49,31,72,59,34,21,13,332
"2011","Nottingham 039E","E01033406",1031,140,10,130,143,62,35,24,43,31,35,12,23,518
"2011","Nottingham 039F","E01033407",1020,128,6,122,211,78,24,36,53,36,38,27,11,416
"2011","Nottingham 040A","E01013870",1585,224,31,193,224,163,61,113,211,227,142,101,41,220
"2011","Nottingham 040B","E01013871",1209,39,7,32,120,120,62,116,216,293,153,115,38,90
"2011","Nottingham 040C","E01013872",1365,63,7,56,183,117,89,102,231,257,170,131,39,153
"2011","Nottingham 040D","E01013873",1693,88,12,76,240,124,60,90,166,168,163,131,32,594
"2011","Rutland 001A","E01013788",1929,236,107,129,560,312,212,140,203,132,51,33,18,83
"2011","Rutland 001B","E01013789",1078,179,60,119,247,108,176,69,123,84,26,16,10,66
"2011","Rutland 001C","E01013790",1767,156,56,100,283,141,241,124,229,367,149,139,10,77
"2011","Rutland 001D","E01013796",1312,172,91,81,427,283,124,72,94,65,26,16,10,49
"2011","Rutland 002A","E01013793",973,146,56,90,269,116,121,54,116,90,23,18,5,38
"2011","Rutland 002B","E01013800",1133,84,30,54,251,137,98,121,189,165,17,9,8,71
"2011","Rutland 002C","E01013801",1170,90,17,73,226,106,112,126,212,187,57,36,21,54
"2011","Rutland 002D","E01013809",939,144,50,94,236,103,131,66,103,87,16,9,7,53
"2011","Rutland 003A","E01013798",1074,189,51,138,301,131,87,63,141,76,10,6,4,76
"2011","Rutland 003B","E01013799",1162,100,23,77,265,91,106,73,137,99,25,17,8,266
"2011","Rutland 003C","E01013802",1753,291,84,207,499,201,167,110,217,140,48,27,21,80
"2011","Rutland 003D","E01013803",1611,176,58,118,402,221,147,115,217,208,34,15,19,91
"2011","Rutland 004A","E01013791",773,111,32,79,183,73,117,45,98,74,16,11,5,56
"2011","Rutland 004B","E01013792",1160,243,76,167,319,135,149,60,95,68,19,5,14,72
"2011","Rutland 004C","E01013797",1237,196,65,131,358,160,139,82,120,86,32,19,13,64
"2011","Rutland 004D","E01013804",1147,128,32,96,304,145,157,91,138,91,18,6,12,75
"2011","Rutland 004E","E01013805",916,112,34,78,220,133,125,77,97,90,16,7,9,46
"2011","Rutland 005A","E01013787",890,170,36,134,246,69,147,35,75,59,17,10,7,72
"2011","Rutland 005B","E01013794",973,210,49,161,276,87,177,50,69,46,13,10,3,45
"2011","Rutland 005C","E01013795",832,146,37,109,210,94,125,38,87,58,28,22,6,46
"2011","Rutland 005D","E01013806",1357,95,20,75,258,67,114,68,95,75,23,14,9,562
"2011","Rutland 005E","E01013807",960,126,41,85,306,103,110,49,92,100,23,11,12,51
"2011","Rutland 005F","E01013808",906,115,31,84,216,104,102,72,123,117,26,12,14,31
"2011","Amber Valley 001A","E01019400",1189,55,19,36,135,120,80,139,250,267,80,46,34,63
"2011","Amber Valley 001B","E01019401",1209,63,23,40,173,118,75,118,249,259,97,72,25,57
"2011","Amber Valley 001C","E01019402",1199,75,28,47,186,137,74,113,231,264,52,24,28,67
"2011","Amber Valley 001D","E01019404",1235,63,19,44,188,159,109,125,227,228,81,48,33,55
"2011","Amber Valley 002A","E01019406",761,126,36,90,203,100,81,47,95,62,14,11,3,33
"2011","Amber Valley 002B","E01019423",916,158,56,102,229,97,146,53,102,79,23,17,6,29
"2011","Amber Valley 002C","E01019424",895,110,40,70,176,93,99,85,122,152,23,11,12,35
"2011","Amber Valley 002D","E01019477",1644,230,61,169,403,180,226,112,188,172,38,21,17,95
"2011","Amber Valley 003A","E01019403",1014,34,16,18,101,82,72,94,198,292,75,44,31,66
"2011","Amber Valley 003B","E01019444",961,39,11,28,115,72,55,71,164,255,146,102,44,44
"2011","Amber Valley 003C","E01019468",1141,46,19,27,176,107,102,112,197,280,63,34,29,58
"2011","Amber Valley 003D","E01019469",1154,43,10,33,145,93,81,124,212,276,123,78,45,57
"2011","Amber Valley 003E","E01019471",1003,30,9,21,118,79,93,99,202,265,64,38,26,53
"2011","Amber Valley 004A","E01019443",1131,64,26,38,223,140,105,108,208,197,38,23,15,48
"2011","Amber Valley 004B","E01019470",1266,70,18,52,198,133,97,136,219,290,46,17,29,77
"2011","Amber Valley 004C","E01019473",1041,133,40,93,267,179,86,71,113,105,16,15,1,71
"2011","Amber Valley 004D","E01019474",961,97,27,70,226,145,79,79,144,123,21,12,9,47
"2011","Amber Valley 004E","E01019475",894,89,29,60,145,112,96,86,164,136,29,19,10,37
"2011","Amber Valley 004F","E01019476",1012,92,36,56,229,131,121,109,133,130,19,10,9,48
"2011","Amber Valley 005A","E01019420",1005,58,20,38,161,88,109,121,188,176,43,29,14,61
"2011","Amber Valley 005B","E01019442",1221,92,30,62,213,148,140,122,195,206,42,27,15,63
"2011","Amber Valley 005C","E01019445",1102,71,26,45,192,127,85,115,202,219,44,17,27,47
"2011","Amber Valley 005D","E01019455",1054,64,16,48,181,125,89,99,193,205,44,24,20,54
"2011","Amber Valley 005E","E01019456",1335,83,30,53,265,147,119,115,237,241,57,37,20,71
"2011","Amber Valley 005F","E01019457",986,58,23,35,180,120,92,109,168,164,33,17,16,62
"2011","Amber Valley 006A","E01019429",1217,148,54,94,262,129,153,102,197,145,29,17,12,52
"2011","Amber Valley 006B","E01019454",1095,132,37,95,224,166,108,93,166,130,28,20,8,48
"2011","Amber Valley 006C","E01019460",1237,124,33,91,264,163,122,110,169,180,38,25,13,67
"2011","Amber Valley 006D","E01019461",1041,77,22,55,197,142,93,90,165,197,28,20,8,52
"2011","Amber Valley 006E","E01019462",948,76,22,54,196,126,91,95,150,153,21,15,6,40
"2011","Amber Valley 007A","E01019405",1083,167,60,107,272,122,235,57,89,69,12,10,2,60
"2011","Amber Valley 007B","E01019414",1205,195,61,134,305,142,129,94,127,129,25,13,12,59
"2011","Amber Valley 007C","E01019428",1108,98,30,68,220,134,114,103,157,180,37,27,10,65
"2011","Amber Valley 007D","E01019430",1449,197,53,144,349,182,135,127,201,148,28,13,15,82
"2011","Amber Valley 008A","E01019421",1497,76,22,54,195,198,125,182,312,292,47,28,19,70
"2011","Amber Valley 008B","E01019422",1173,109,34,75,204,126,135,132,190,183,47,29,18,47
"2011","Amber Valley 008C","E01019432",1464,81,20,61,241,164,154,154,267,271,50,36,14,82
"2011","Amber Valley 008D","E01019458",1207,71,22,49,201,138,98,127,214,225,64,37,27,69
"2011","Amber Valley 008E","E01019459",1007,49,16,33,155,107,68,102,176,224,59,32,27,67
"2011","Amber Valley 008F","E01019463",1057,35,8,27,110,79,65,102,230,256,111,64,47,69
"2011","Amber Valley 009A","E01019408",1114,86,14,72,250,139,101,102,186,154,25,11,14,71
"2011","Amber Valley 009B","E01019409",1287,147,37,110,282,179,74,124,236,161,16,7,9,68
"2011","Amber Valley 009C","E01019412",1174,156,35,121,340,175,93,98,128,80,17,9,8,87
"2011","Amber Valley 009D","E01019413",1039,128,39,89,246,171,79,90,125,87,21,11,10,92
"2011","Amber Valley 009E","E01019416",1066,100,21,79,260,135,94,98,167,140,21,8,13,51
"2011","Amber Valley 010A","E01019407",1566,194,48,146,361,164,161,131,227,171,84,51,33,73
"2011","Amber Valley 010B","E01019415",1308,150,40,110,324,154,136,105,181,149,43,20,23,66
"2011","Amber Valley 010C","E01019417",1380,130,40,90,299,128,98,106,236,246,64,32,32,73
"2011","Amber Valley 010D","E01019419",1490,210,57,153,415,156,148,122,199,156,25,14,11,59
"2011","Amber Valley 011A","E01019410",1115,120,31,89,290,143,100,98,147,130,15,8,7,72
"2011","Amber Valley 011B","E01019411",1117,99,31,68,226,150,80,106,175,164,35,20,15,82
"2011","Amber Valley 011C","E01019418",1287,141,36,105,304,155,118,123,179,166,38,19,19,63
"2011","Amber Valley 011D","E01019447",1086,153,39,114,286,142,114,77,142,113,17,12,5,42
"2011","Amber Valley 011E","E01019449",1358,157,38,119,337,178,144,133,143,166,31,18,13,69
"2011","Amber Valley 012A","E01019431",1114,68,20,48,152,115,87,115,263,217,45,28,17,52
"2011","Amber Valley 012B","E01019433",1344,58,24,34,188,149,106,124,291,284,64,32,32,80
"2011","Amber Valley 012C","E01019438",1253,83,24,59,199,144,88,107,234,219,86,47,39,93
"2011","Amber Valley 012D","E01019451",1483,109,37,72,279,181,163,136,246,233,67,40,27,69
"2011","Amber Valley 012E","E01019464",1455,165,49,116,356,237,138,112,200,141,18,12,6,88
"2011","Amber Valley 013A","E01019434",913,50,13,37,147,129,84,88,187,163,31,18,13,34
"2011","Amber Valley 013B","E01019435",1253,94,32,62,235,164,105,124,221,193,41,27,14,76
"2011","Amber Valley 013C","E01019436",994,69,25,44,171,109,95,95,191,167,46,25,21,51
"2011","Amber Valley 013D","E01019439",1000,87,26,61,198,118,81,102,176,148,39,25,14,51
"2011","Amber Valley 013E","E01019440",1140,93,22,71,224,165,113,111,186,164,30,13,17,54
"2011","Amber Valley 015A","E01019446",963,85,26,59,201,152,83,108,138,117,21,10,11,58
"2011","Amber Valley 015B","E01019448",1258,143,51,92,280,132,140,107,175,173,29,13,16,79
"2011","Amber Valley 015C","E01019450",1047,71,18,53,190,134,79,115,177,170,65,39,26,46
"2011","Amber Valley 015D","E01019465",831,80,15,65,170,91,90,70,134,121,38,19,19,37
"2011","Amber Valley 015E","E01019467",1109,149,40,109,255,137,148,99,115,124,24,20,4,58
"2011","Amber Valley 016A","E01019425",1070,238,67,171,306,147,85,48,85,47,18,14,4,96
"2011","Amber Valley 016B","E01019426",998,220,49,171,309,116,82,50,70,44,24,19,5,83
"2011","Amber Valley 016C","E01019427",1259,325,79,246,355,120,125,40,87,58,34,21,13,115
"2011","Amber Valley 016D","E01019472",2000,397,104,293,523,211,332,90,152,123,43,30,13,129
"2011","Amber Valley 017A","E01019437",1083,36,11,25,145,92,86,107,231,228,78,43,35,80
"2011","Amber Valley 017B","E01019441",1094,49,15,34,121,103,81,119,256,231,75,38,37,59
"2011","Amber Valley 017C","E01019452",1152,39,10,29,128,106,89,105,245,292,90,69,21,58
"2011","Amber Valley 017D","E01019453",1330,56,24,32,202,105,114,140,293,272,80,46,34,68
"2011","Amber Valley 017E","E01032613",911,88,23,65,190,116,106,72,127,125,36,24,12,51
"2011","Bolsover 001A","E01019478",1130,156,47,109,297,146,135,86,128,108,18,8,10,56
"2011","Bolsover 001B","E01019479",1247,175,57,118,296,157,141,79,141,128,40,22,18,90
"2011","Bolsover 001C","E01019491",1670,125,42,83,318,204,121,154,280,282,94,63,31,92
"2011","Bolsover 001D","E01019493",1218,92,31,61,208,211,90,118,207,174,35,22,13,83
"2011","Bolsover 001E","E01019494",1483,113,32,81,271,196,142,120,258,222,61,46,15,100
"2011","Bolsover 002A","E01019492",1251,70,12,58,189,132,91,115,233,258,86,62,24,77
"2011","Bolsover 002B","E01019495",1212,76,23,53,200,124,94,148,209,255,50,43,7,56
"2011","Bolsover 002C","E01019524",1031,99,32,67,237,129,98,84,158,136,24,19,5,66
"2011","Bolsover 002D","E01019525",1122,60,17,43,205,122,97,113,209,191,50,38,12,75
"2011","Bolsover 003A","E01019496",1022,69,24,45,205,115,66,101,167,181,75,62,13,43
"2011","Bolsover 003B","E01019497",1043,43,16,27,128,93,83,127,189,225,89,68,21,66
"2011","Bolsover 003C","E01019498",1299,53,18,35,144,104,66,129,261,303,138,88,50,101
"2011","Bolsover 003D","E01019523",801,34,18,16,123,68,65,92,151,151,84,69,15,33
"2011","Bolsover 004A","E01019483",1529,70,21,49,227,155,135,154,279,248,149,91,58,112
"2011","Bolsover 004B","E01019484",1513,91,33,58,249,166,170,147,255,263,75,48,27,97
"2011","Bolsover 004C","E01019485",844,37,8,29,148,113,79,71,147,153,51,37,14,45
"2011","Bolsover 004D","E01019488",1068,27,5,22,135,90,66,98,202,251,124,87,37,75
"2011","Bolsover 005A","E01019486",821,72,24,48,177,143,55,68,107,110,24,15,9,65
"2011","Bolsover 005B","E01019487",1075,39,13,26,147,114,67,98,239,237,57,42,15,77
"2011","Bolsover 005C","E01019489",912,65,21,44,184,133,69,98,170,139,23,15,8,31
"2011","Bolsover 005D","E01019490",862,68,20,48,203,121,65,70,147,111,28,15,13,49
"2011","Bolsover 005E","E01019502",1104,89,32,57,197,138,112,102,201,179,45,25,20,41
"2011","Bolsover 005F","E01019504",959,52,17,35,179,112,99,84,170,173,47,25,22,43
"2011","Bolsover 006A","E01019508",1408,45,18,27,145,116,85,172,298,369,103,73,30,75
"2011","Bolsover 006B","E01019509",830,18,4,14,78,61,49,75,162,243,90,60,30,54
"2011","Bolsover 006C","E01019510",881,24,7,17,66,68,53,93,180,277,72,51,21,48
"2011","Bolsover 006D","E01019512",1921,91,24,67,266,217,129,186,396,428,105,80,25,103
"2011","Bolsover 007A","E01019503",1741,97,32,65,236,217,175,173,331,351,84,53,31,77
"2011","Bolsover 007B","E01019505",1136,29,13,16,150,81,63,131,229,295,98,70,28,60
"2011","Bolsover 007C","E01019506",1024,56,12,44,143,109,108,96,191,224,58,44,14,39
"2011","Bolsover 007D","E01019507",1227,25,2,23,127,105,79,120,265,345,103,69,34,58
"2011","Bolsover 007E","E01019511",1563,44,14,30,174,115,97,149,321,429,138,97,41,96
"2011","Bolsover 008A","E01019480",1106,86,28,58,217,130,87,113,173,199,38,15,23,63
"2011","Bolsover 008B","E01019482",1127,77,28,49,203,141,106,104,193,216,33,15,18,54
"2011","Bolsover 008C","E01019520",1299,111,38,73,279,121,146,85,187,200,70,39,31,100
"2011","Bolsover 008D","E01019521",1128,94,21,73,231,137,106,103,191,171,32,15,17,63
"2011","Bolsover 008E","E01019522",1109,77,28,49,152,124,87,115,233,207,62,37,25,52
"2011","Bolsover 009A","E01019481",918,66,15,51,113,112,60,84,179,200,57,29,28,47
"2011","Bolsover 009B","E01019514",1170,83,32,51,201,115,96,112,209,240,52,31,21,62
"2011","Bolsover 009C","E01019515",1153,45,12,33,122,103,55,121,255,311,78,43,35,63
"2011","Bolsover 009D","E01019516",1103,49,20,29,143,104,85,124,205,283,61,36,25,49
"2011","Bolsover 009E","E01019519",1345,86,31,55,257,138,109,127,227,255,74,41,33,72
"2011","Bolsover 010A","E01019499",997,39,8,31,140,97,70,124,203,237,39,22,17,48
"2011","Bolsover 010B","E01019500",1067,29,5,24,108,88,106,101,201,304,73,39,34,57
"2011","Bolsover 010C","E01019501",1093,48,16,32,180,115,89,107,191,261,50,33,17,52
"2011","Bolsover 010D","E01019513",964,67,20,47,214,108,100,106,136,153,20,7,13,60
"2011","Bolsover 010E","E01019517",1192,125,51,74,272,189,106,96,149,166,37,20,17,52
"2011","Bolsover 010F","E01019518",1227,134,50,84,302,184,144,102,150,121,23,10,13,67
"2011","Chesterfield 001A","E01019526",1032,51,12,39,166,152,73,99,211,172,50,31,19,58
"2011","Chesterfield 001B","E01019528",1166,111,43,68,281,182,93,94,176,145,33,20,13,51
"2011","Chesterfield 001C","E01019572",926,22,6,16,97,106,56,82,213,221,67,43,24,62
"2011","Chesterfield 001D","E01019573",1170,86,30,56,223,145,120,94,184,163,96,66,30,59
"2011","Chesterfield 001E","E01019574",980,48,16,32,186,116,96,84,216,166,26,12,14,42
"2011","Chesterfield 002A","E01019563",1147,43,6,37,148,118,92,103,214,241,94,66,28,94
"2011","Chesterfield 002B","E01019564",1117,67,21,46,206,165,103,97,202,166,54,37,17,57
"2011","Chesterfield 002C","E01019565",1045,40,11,29,106,115,72,85,239,234,91,65,26,63
"2011","Chesterfield 002D","E01019566",1191,25,7,18,132,127,71,118,259,257,128,88,40,74
"2011","Chesterfield 002E","E01019568",1027,22,6,16,94,91,65,80,244,236,98,62,36,97
"2011","Chesterfield 003A","E01019527",1055,36,11,25,147,99,82,109,225,204,100,66,34,53
"2011","Chesterfield 003B","E01019529",1106,69,20,49,185,152,86,93,236,172,58,41,17,55
"2011","Chesterfield 003C","E01019530",1117,56,17,39,188,151,72,106,216,184,83,51,32,61
"2011","Chesterfield 003D","E01019531",1129,47,13,34,145,110,91,107,255,210,107,83,24,57
"2011","Chesterfield 003E","E01019553",1290,84,28,56,252,173,113,134,240,191,33,17,16,70
"2011","Chesterfield 004A","E01019541",1104,47,13,34,137,123,116,112,219,189,78,51,27,83
"2011","Chesterfield 004B","E01019542",1248,54,11,43,176,141,123,111,263,213,121,71,50,46
"2011","Chesterfield 004C","E01019543",1132,26,9,17,135,134,90,89,262,239,94,63,31,63
"2011","Chesterfield 004D","E01019544",1122,65,24,41,152,145,94,92,238,214,56,30,26,66
"2011","Chesterfield 004E","E01019571",1012,54,19,35,136,111,72,92,209,174,80,57,23,84
"2011","Chesterfield 005A","E01019532",934,48,17,31,135,141,56,102,199,149,40,28,12,64
"2011","Chesterfield 005B","E01019533",1095,120,34,86,271,190,103,85,151,107,15,9,6,53
"2011","Chesterfield 005C","E01019534",1019,73,25,48,198,139,77,108,180,125,63,56,7,56
"2011","Chesterfield 005D","E01019535",1071,83,28,55,240,167,79,88,182,143,29,13,16,60
"2011","Chesterfield 005E","E01019536",1214,79,25,54,235,168,84,89,229,217,53,39,14,60
"2011","Chesterfield 006A","E01019549",965,29,15,14,133,101,76,78,205,207,82,51,31,54
"2011","Chesterfield 006B","E01019550",1136,54,11,43,188,150,83,105,233,185,66,51,15,72
"2011","Chesterfield 006C","E01019551",1254,89,18,71,238,202,89,129,247,182,24,16,8,54
"2011","Chesterfield 006D","E01019552",971,50,9,41,154,131,69,93,175,150,81,67,14,68
"2011","Chesterfield 006E","E01019567",1218,64,22,42,169,120,98,118,235,249,93,62,31,72
"2011","Chesterfield 007A","E01019537",1075,122,34,88,238,161,113,67,164,92,43,31,12,75
"2011","Chesterfield 007B","E01019569",1284,87,19,68,220,152,115,132,245,207,76,43,33,50
"2011","Chesterfield 007C","E01019570",896,70,20,50,179,114,76,75,165,132,32,24,8,53
"2011","Chesterfield 007D","E01019580",1069,38,12,26,133,140,78,92,245,204,78,47,31,61
"2011","Chesterfield 007E","E01019581",1024,54,22,32,182,116,98,91,199,168,57,36,21,59
"2011","Chesterfield 008A","E01019557",1074,151,41,110,257,159,71,58,152,99,36,20,16,91
"2011","Chesterfield 008B","E01019558",1144,152,42,110,313,196,83,64,148,96,23,10,13,69
"2011","Chesterfield 008C","E01019559",906,146,37,109,256,154,70,54,105,55,12,8,4,54
"2011","Chesterfield 008D","E01019560",1010,71,14,57,156,159,84,82,191,172,37,26,11,58
"2011","Chesterfield 008E","E01019561",968,30,15,15,132,83,72,88,222,173,125,84,41,43
"2011","Chesterfield 008F","E01019562",885,46,8,38,143,109,92,70,177,147,47,37,10,54
"2011","Chesterfield 009A","E01019539",1186,129,36,93,311,185,108,82,151,109,47,25,22,64
"2011","Chesterfield 009B","E01019540",1059,118,38,80,276,173,91,71,148,91,27,20,7,64
"2011","Chesterfield 009C","E01019555",1080,83,24,59,217,149,111,86,178,156,45,30,15,55
"2011","Chesterfield 009D","E01019590",1339,149,30,119,384,210,125,88,166,115,24,15,9,78
"2011","Chesterfield 009E","E01019591",1094,146,29,117,263,182,92,58,132,113,24,12,12,84
"2011","Chesterfield 010A","E01019538",1282,131,21,110,306,151,129,82,198,153,59,38,21,73
"2011","Chesterfield 010B","E01019554",1110,64,12,52,215,158,98,94,200,156,70,39,31,55
"2011","Chesterfield 010C","E01019556",1118,71,13,58,158,119,74,104,239,192,103,69,34,58
"2011","Chesterfield 010D","E01019579",1258,85,19,66,235,126,134,79,223,200,81,52,29,95
"2011","Chesterfield 010F","E01033387",951,119,23,96,265,163,71,57,133,63,41,21,20,39
"2011","Chesterfield 010G","E01033388",1025,55,9,46,184,135,67,76,188,187,68,43,25,65
"2011","Chesterfield 011A","E01019586",1017,125,31,94,274,169,84,73,123,98,23,13,10,48
"2011","Chesterfield 011B","E01019587",1140,157,40,117,361,196,81,58,107,78,23,10,13,79
"2011","Chesterfield 011C","E01019588",1043,172,40,132,322,190,98,36,100,48,13,8,5,64
"2011","Chesterfield 011D","E01019589",1024,132,24,108,284,170,88,76,114,68,36,31,5,56
"2011","Chesterfield 011E","E01019592",1149,207,41,166,361,163,126,45,100,42,18,13,5,87
"2011","Chesterfield 011F","E01019593",778,141,29,112,238,118,80,34,82,34,12,8,4,39
"2011","Chesterfield 012A","E01019545",1034,86,20,66,231,173,88,86,178,117,25,9,16,50
"2011","Chesterfield 012B","E01019546",1106,75,23,52,230,185,97,100,182,126,37,21,16,74
"2011","Chesterfield 012C","E01019547",1024,45,12,33,159,130,79,84,201,189,79,50,29,58
"2011","Chesterfield 012D","E01019548",1676,167,51,116,386,269,144,125,250,192,52,24,28,91
"2011","Chesterfield 012E","E01019582",1080,74,20,54,218,176,84,90,187,145,44,25,19,62
"2011","Chesterfield 012F","E01019583",1067,94,26,68,265,204,96,78,159,101,20,12,8,50
"2011","Chesterfield 012G","E01019585",1749,211,37,174,392,247,144,109,260,181,67,44,23,138
"2011","Chesterfield 013A","E01019575",1187,29,9,20,102,94,74,106,279,278,142,100,42,83
"2011","Chesterfield 013B","E01019576",1180,72,19,53,186,137,96,91,236,214,90,55,35,58
"2011","Chesterfield 013C","E01019577",1190,90,27,63,194,146,116,85,224,213,65,43,22,57
"2011","Chesterfield 013D","E01019578",1135,25,12,13,101,86,58,102,245,301,159,96,63,58
"2011","Derbyshire Dales 001A","E01019602",1394,220,64,156,291,139,204,119,182,139,31,18,13,69
"2011","Derbyshire Dales 001B","E01019614",1230,333,57,276,362,104,145,56,90,60,19,13,6,61
"2011","Derbyshire Dales 001C","E01019615",1532,272,48,224,380,132,229,100,184,128,28,12,16,79
"2011","Derbyshire Dales 001D","E01019631",1337,178,33,145,280,123,192,117,205,151,30,15,15,61
"2011","Derbyshire Dales 002A","E01019600",1176,162,34,128,302,122,176,92,155,74,28,19,9,65
"2011","Derbyshire Dales 002B","E01019604",1322,258,71,187,342,137,186,55,137,86,20,13,7,101
"2011","Derbyshire Dales 002C","E01019606",1176,219,57,162,320,121,158,89,123,87,18,8,10,41
"2011","Derbyshire Dales 002D","E01019618",1215,225,44,181,339,113,215,60,84,92,18,9,9,69
"2011","Derbyshire Dales 003A","E01019599",1047,155,41,114,287,126,168,60,109,81,10,8,2,51
"2011","Derbyshire Dales 003B","E01019601",1035,95,16,79,189,112,138,87,168,148,29,17,12,69
"2011","Derbyshire Dales 003C","E01019613",1283,146,31,115,241,122,303,90,146,132,21,12,9,82
"2011","Derbyshire Dales 003D","E01019617",1171,128,28,100,276,108,239,81,152,120,30,23,7,37
"2011","Derbyshire Dales 004A","E01019608",1166,99,28,71,183,138,127,107,211,202,47,31,16,52
"2011","Derbyshire Dales 004B","E01019610",1148,142,49,93,271,174,135,82,163,112,6,5,1,63
"2011","Derbyshire Dales 004C","E01019630",1356,177,33,144,313,137,191,112,179,140,36,14,22,71
"2011","Derbyshire Dales 005A","E01019609",1592,197,54,143,413,204,165,117,210,178,39,22,17,69
"2011","Derbyshire Dales 005B","E01019621",990,134,26,108,284,146,103,59,113,71,23,16,7,57
"2011","Derbyshire Dales 005C","E01019622",1170,148,29,119,289,172,123,88,134,123,28,22,6,65
"2011","Derbyshire Dales 005D","E01019624",924,107,30,77,221,173,77,63,119,104,18,8,10,42
"2011","Derbyshire Dales 005E","E01019627",919,131,35,96,225,113,137,63,100,80,22,9,13,48
"2011","Derbyshire Dales 005F","E01019628",837,99,28,71,224,120,89,64,88,79,35,22,13,39
"2011","Derbyshire Dales 006A","E01019619",1113,133,40,93,261,107,144,88,133,158,31,18,13,58
"2011","Derbyshire Dales 006B","E01019620",1205,165,39,126,329,116,201,78,128,103,30,11,19,55
"2011","Derbyshire Dales 006C","E01019623",976,110,24,86,221,115,113,59,144,108,45,30,15,61
"2011","Derbyshire Dales 006D","E01019625",1055,30,11,19,115,83,74,101,238,258,87,58,29,69
"2011","Derbyshire Dales 006E","E01019626",1140,129,36,93,330,155,134,69,126,110,21,13,8,66
"2011","Derbyshire Dales 006F","E01019632",1279,181,47,134,322,146,196,71,140,126,29,15,14,68
"2011","Derbyshire Dales 007A","E01019633",1147,78,29,49,177,92,138,128,195,212,51,25,26,76
"2011","Derbyshire Dales 007B","E01019634",1123,138,31,107,258,107,130,107,145,154,30,14,16,54
"2011","Derbyshire Dales 007C","E01019635",918,143,38,105,244,101,109,61,100,114,9,4,5,37
"2011","Derbyshire Dales 007D","E01019636",1102,129,22,107,262,115,130,100,139,136,32,17,15,59
"2011","Derbyshire Dales 008A","E01019595",1479,222,51,171,353,148,217,97,189,135,27,11,16,91
"2011","Derbyshire Dales 008B","E01019605",1399,228,60,168,332,136,318,66,126,103,36,19,17,54
"2011","Derbyshire Dales 008C","E01019611",1317,129,33,96,277,104,336,100,139,156,24,14,10,52
"2011","Derbyshire Dales 008D","E01019616",1306,205,58,147,309,172,226,68,133,115,21,11,10,57
"2011","Derbyshire Dales 009A","E01019594",1220,66,18,48,147,119,105,124,273,275,38,22,16,73
"2011","Derbyshire Dales 009B","E01019596",1075,167,61,106,273,123,91,61,153,110,38,25,13,59
"2011","Derbyshire Dales 009C","E01019597",1092,106,32,74,199,145,116,104,185,153,16,12,4,68
"2011","Derbyshire Dales 009D","E01019598",1232,98,28,70,223,102,121,123,196,251,44,26,18,74
"2011","Derbyshire Dales 010A","E01019603",1190,225,69,156,299,151,218,43,115,63,15,7,8,61
"2011","Derbyshire Dales 010B","E01019607",1364,212,70,142,334,148,280,61,129,101,24,17,7,75
"2011","Derbyshire Dales 010C","E01019612",1993,182,50,132,389,165,311,151,245,280,144,91,53,126
"2011","Derbyshire Dales 010D","E01019629",1233,198,61,137,290,121,249,68,112,95,17,11,6,83
"2011","Erewash 001A","E01019644",1114,47,11,36,138,134,112,113,224,227,77,38,39,42
"2011","Erewash 001B","E01019646",1123,25,11,14,133,91,74,111,247,283,84,46,38,75
"2011","Erewash 001C","E01019663",997,22,8,14,83,75,49,92,222,259,140,94,46,55
"2011","Erewash 001D","E01019664",873,21,8,13,106,76,73,81,182,181,95,60,35,58
"2011","Erewash 001E","E01019665",1019,40,17,23,139,122,96,92,226,211,52,29,23,41
"2011","Erewash 003A","E01019657",1274,44,11,33,170,170,117,140,221,266,77,41,36,69
"2011","Erewash 003B","E01019660",1435,84,27,57,242,187,122,160,247,278,46,15,31,69
"2011","Erewash 003C","E01019661",1021,44,9,35,160,107,87,107,187,217,62,34,28,50
"2011","Erewash 003D","E01019662",1168,41,7,34,137,125,86,112,224,280,118,53,65,45
"2011","Erewash 003E","E01019672",1209,94,29,65,189,136,130,97,201,207,82,49,33,73
"2011","Erewash 003F","E01019690",903,57,15,42,144,108,77,86,169,163,50,21,29,49
"2011","Erewash 004A","E01019670",1323,216,63,153,353,169,149,65,152,105,29,17,12,85
"2011","Erewash 004B","E01019671",1323,212,64,148,346,185,165,61,137,101,32,25,7,84
"2011","Erewash 004C","E01019701",1552,153,51,102,315,192,186,139,227,201,58,37,21,81
"2011","Erewash 005A","E01019673",916,86,41,45,214,141,116,77,125,85,29,21,8,43
"2011","Erewash 005B","E01019702",1390,188,46,142,374,228,126,112,144,104,26,13,13,88
"2011","Erewash 005C","E01019703",1203,138,42,96,330,173,107,87,155,115,35,24,11,63
"2011","Erewash 005D","E01019704",1115,130,37,93,266,170,147,95,126,94,17,9,8,70
"2011","Erewash 006A","E01019658",1368,79,17,62,237,166,100,134,251,267,61,29,32,73
"2011","Erewash 006B","E01019659",1301,134,44,90,294,222,118,105,178,139,23,8,15,88
"2011","Erewash 006C","E01019674",900,62,18,44,151,121,83,81,159,152,27,17,10,64
"2011","Erewash 006D","E01019688",1117,35,12,23,138,105,72,115,222,268,94,62,32,68
"2011","Erewash 006E","E01019689",1130,48,19,29,162,143,89,127,194,243,62,32,30,62
"2011","Erewash 007A","E01019666",1008,21,8,13,113,108,67,127,205,233,66,38,28,68
"2011","Erewash 007B","E01019667",1139,36,11,25,113,130,78,115,260,270,76,56,20,61
"2011","Erewash 007C","E01019668",956,35,15,20,101,94,67,97,178,231,87,55,32,66
"2011","Erewash 007D","E01019669",1209,70,21,49,174,155,71,136,251,237,44,25,19,71
"2011","Erewash 008A","E01019656",843,127,34,93,216,121,116,51,85,67,16,9,7,44
"2011","Erewash 008B","E01019691",1157,118,28,90,234,182,103,102,171,133,43,27,16,71
"2011","Erewash 008C","E01019692",1054,78,29,49,148,130,78,112,155,181,89,62,27,83
"2011","Erewash 008D","E01019693",1322,136,21,115,242,169,107,117,196,196,75,38,37,84
"2011","Erewash 008E","E01019694",920,129,38,91,212,149,87,70,112,82,20,8,12,59
"2011","Erewash 008F","E01019696",997,101,26,75,196,144,97,95,154,133,18,6,12,59
"2011","Erewash 009A","E01019683",971,129,33,96,245,141,100,55,138,79,27,20,7,57
"2011","Erewash 009B","E01019684",1226,216,55,161,335,192,86,93,140,91,17,8,9,56
"2011","Erewash 009C","E01019685",1118,154,34,120,244,167,105,98,160,102,40,28,12,48
"2011","Erewash 009D","E01019686",1001,169,36,133,259,137,109,73,104,49,19,12,7,82
"2011","Erewash 009E","E01019687",1001,57,22,35,138,128,87,110,166,196,64,42,22,55
"2011","Erewash 010A","E01019648",1129,76,19,57,202,146,88,101,217,184,42,23,19,73
"2011","Erewash 010B","E01019649",1331,109,19,90,255,165,102,119,235,216,69,35,34,61
"2011","Erewash 010C","E01019650",1114,35,12,23,125,93,62,117,227,273,113,66,47,69
"2011","Erewash 010D","E01019651",1046,99,27,72,216,118,104,109,140,141,46,24,22,73
"2011","Erewash 010E","E01019695",1071,87,24,63,210,143,116,124,181,132,24,13,11,54
"2011","Erewash 011A","E01019641",1075,162,37,125,272,164,115,76,128,75,16,8,8,67
"2011","Erewash 011B","E01019652",1243,131,29,102,284,156,105,75,150,133,29,16,13,180
"2011","Erewash 011C","E01019653",1050,153,38,115,240,176,103,77,135,96,15,4,11,55
"2011","Erewash 011D","E01019707",1171,118,33,85,235,175,82,105,208,152,36,23,13,60
"2011","Erewash 011E","E01019708",1214,199,52,147,303,188,97,84,147,88,19,9,10,89
"2011","Erewash 012A","E01019647",1439,79,18,61,238,183,94,137,249,254,122,56,66,83
"2011","Erewash 012B","E01019675",1178,82,16,66,177,120,73,131,237,217,83,34,49,58
"2011","Erewash 012C","E01019679",1303,73,11,62,246,163,91,124,240,226,61,25,36,79
"2011","Erewash 012D","E01019682",1145,61,14,47,183,133,89,140,212,199,75,37,38,53
"2011","Erewash 013A","E01019642",1030,100,21,79,204,140,100,99,184,109,45,32,13,49
"2011","Erewash 013B","E01019643",1159,179,45,134,308,181,104,75,128,89,32,14,18,63
"2011","Erewash 013C","E01019654",1177,135,50,85,245,152,112,104,167,158,33,19,14,71
"2011","Erewash 013D","E01019655",1159,109,31,78,254,175,114,95,162,143,45,23,22,62
"2011","Erewash 014A","E01019676",1096,70,24,46,168,150,98,92,210,192,41,13,28,75
"2011","Erewash 014B","E01019677",1097,87,25,62,201,188,98,119,172,144,30,15,15,58
"2011","Erewash 014C","E01019678",1221,125,33,92,283,208,89,119,175,134,15,7,8,73
"2011","Erewash 014D","E01019680",1112,118,31,87,284,142,102,94,140,134,43,21,22,55
"2011","Erewash 014E","E01019681",1158,107,31,76,236,183,109,100,187,154,29,12,17,53
"2011","Erewash 014F","E01019698",1071,91,25,66,219,170,91,112,176,134,24,17,7,54
"2011","Erewash 015A","E01019697",1103,103,27,76,209,175,95,115,177,143,28,12,16,58
"2011","Erewash 015B","E01019699",1026,27,7,20,132,101,59,115,198,250,87,51,36,57
"2011","Erewash 015C","E01019700",1673,162,42,120,347,241,136,153,245,257,43,25,18,89
"2011","Erewash 015D","E01019705",1341,116,20,96,278,189,108,143,222,162,40,19,21,83
"2011","Erewash 015E","E01019706",933,75,19,56,204,149,67,110,135,117,22,9,13,54
"2011","Erewash 015F","E01019709",917,67,22,45,176,120,48,76,136,164,51,30,21,79
"2011","Erewash 016A","E01019638",1012,78,25,53,209,133,72,85,191,143,30,23,7,71
"2011","Erewash 016B","E01019639",809,60,14,46,130,105,73,71,135,130,40,18,22,65
"2011","Erewash 016C","E01019640",1124,131,35,96,286,188,86,108,143,105,17,10,7,60
"2011","Erewash 016D","E01019645",1187,59,21,38,184,147,125,152,219,196,51,21,30,54
"2011","Erewash 016E","E01032614",999,129,36,93,248,175,71,89,129,83,18,9,9,57
"2011","High Peak 001A","E01019733",1093,93,28,65,226,128,94,97,204,144,41,27,14,66
"2011","High Peak 001B","E01019752",978,100,30,70,210,138,91,79,140,98,46,21,25,76
"2011","High Peak 001C","E01019753",1148,136,28,108,289,184,115,64,164,90,39,21,18,67
"2011","High Peak 001D","E01019763",1588,152,47,105,361,222,193,105,220,175,58,33,25,102
"2011","High Peak 002A","E01019728",798,19,7,12,70,82,55,68,171,187,93,61,32,53
"2011","High Peak 002B","E01019729",924,20,8,12,82,71,69,99,211,202,106,56,50,64
"2011","High Peak 002C","E01019730",1426,84,24,60,242,188,129,124,252,202,104,68,36,101
"2011","High Peak 002D","E01019731",969,111,35,76,242,160,97,65,139,68,16,10,6,71
"2011","High Peak 002E","E01019732",1140,95,28,67,219,162,100,114,189,124,59,37,22,78
"2011","High Peak 003A","E01019738",1042,82,17,65,240,137,112,72,184,122,31,17,14,62
"2011","High Peak 003B","E01019739",1252,112,22,90,276,150,114,109,205,149,83,38,45,54
"2011","High Peak 003C","E01019740",915,109,19,90,220,116,76,62,144,89,52,34,18,47
"2011","High Peak 003D","E01019750",927,86,19,67,231,88,101,74,138,107,31,12,19,71
"2011","High Peak 003E","E01019751",1617,271,74,197,431,235,160,104,163,111,34,24,10,108
"2011","High Peak 003F","E01019768",1622,131,38,93,312,193,132,124,289,261,102,59,43,78
"2011","High Peak 004A","E01019727",1274,212,57,155,387,159,178,61,110,62,15,10,5,90
"2011","High Peak 004B","E01019749",963,177,42,135,273,155,83,52,99,35,14,4,10,75
"2011","High Peak 004C","E01019754",1364,202,50,152,386,180,235,46,122,96,33,15,18,64
"2011","High Peak 004D","E01019756",1349,242,68,174,413,205,107,77,125,56,36,20,16,88
"2011","High Peak 004E","E01019757",1027,121,30,91,256,144,104,88,153,86,16,9,7,59
"2011","High Peak 004F","E01019758",1176,172,51,121,339,177,86,71,140,99,24,12,12,68
"2011","High Peak 005A","E01019746",1246,184,33,151,345,171,126,67,147,87,28,10,18,91
"2011","High Peak 005B","E01019747",904,113,29,84,225,137,103,54,118,89,14,9,5,51
"2011","High Peak 005C","E01019748",1155,123,34,89,277,130,110,95,204,114,33,21,12,69
"2011","High Peak 005D","E01019755",1573,247,55,192,413,195,248,88,173,103,21,10,11,85
"2011","High Peak 005E","E01019766",1105,148,39,109,256,150,138,76,145,106,28,12,16,58
"2011","High Peak 006A","E01019711",1017,120,24,96,229,128,141,86,163,80,26,13,13,44
"2011","High Peak 006B","E01019734",1529,239,66,173,413,171,219,96,164,105,39,24,15,83
"2011","High Peak 006C","E01019743",971,46,12,34,143,96,93,88,214,175,55,34,21,61
"2011","High Peak 006D","E01019744",1115,86,28,58,199,109,123,116,221,136,63,48,15,62
"2011","High Peak 006E","E01019745",781,74,10,64,134,80,67,65,150,119,34,25,9,58
"2011","High Peak 008A","E01019712",1104,233,52,181,265,133,139,61,108,71,16,12,4,78
"2011","High Peak 008B","E01019713",803,128,40,88,221,93,141,43,58,52,15,8,7,52
"2011","High Peak 008C","E01019764",1135,166,45,121,281,107,142,81,145,123,25,10,15,65
"2011","High Peak 008D","E01019765",1386,189,41,148,318,187,183,88,195,103,37,18,19,86
"2011","High Peak 008E","E01019767",1189,191,48,143,303,143,118,70,140,115,28,8,20,81
"2011","High Peak 010A","E01019710",1486,96,28,68,242,152,138,142,266,234,83,54,29,133
"2011","High Peak 010B","E01019715",1168,98,15,83,228,77,126,100,180,132,60,23,37,167
"2011","High Peak 010C","E01019717",1094,63,12,51,180,75,85,69,140,122,59,32,27,301
"2011","High Peak 010D","E01019722",1386,179,48,131,330,150,152,105,167,117,49,28,21,137
"2011","High Peak 010E","E01019723",1265,192,39,153,268,145,128,115,157,108,67,57,10,85
"2011","High Peak 011A","E01019716",946,81,16,65,210,114,71,101,153,114,26,16,10,76
"2011","High Peak 011B","E01019724",870,43,16,27,124,84,75,99,178,160,42,26,16,65
"2011","High Peak 011C","E01019759",1088,25,6,19,128,86,70,134,258,248,56,35,21,83
"2011","High Peak 011D","E01019760",1073,59,17,42,155,125,75,142,216,201,26,12,14,74
"2011","High Peak 011E","E01019761",1045,21,5,16,101,75,79,106,249,225,110,66,44,79
"2011","High Peak 012A","E01019714",1833,244,68,176,439,228,237,156,227,161,32,16,16,109
"2011","High Peak 012B","E01019725",1052,78,21,57,189,149,139,127,177,129,22,14,8,42
"2011","High Peak 012C","E01019726",975,69,21,48,172,107,100,132,172,142,27,12,15,54
"2011","High Peak 012D","E01019762",1315,204,45,159,371,166,131,92,148,83,32,19,13,88
"2011","High Peak 013E","E01019718",1651,172,35,137,330,184,201,136,258,236,51,29,22,83
"2011","High Peak 013F","E01019719",1130,108,30,78,192,134,131,97,189,182,32,16,16,65
"2011","High Peak 013G","E01019720",1057,103,26,77,213,127,112,108,185,128,15,7,8,66
"2011","High Peak 013H","E01019721",854,101,25,76,175,121,87,82,121,92,23,15,8,52
"2011","High Peak 013A","E01019735",1135,216,54,162,306,123,131,93,107,79,14,9,5,66
"2011","High Peak 013B","E01019736",907,152,27,125,231,72,203,51,82,49,12,6,6,55
"2011","High Peak 013C","E01019737",800,104,23,81,183,88,128,75,93,60,25,16,9,44
"2011","High Peak 013I","E01019741",822,45,11,34,109,113,100,106,125,151,20,15,5,53
"2011","High Peak 013D","E01019742",832,58,12,46,130,71,130,100,127,143,22,10,12,51
"2011","North East Derbyshire 001A","E01019801",883,68,21,47,168,130,99,79,139,126,24,13,11,50
"2011","North East Derbyshire 001B","E01019802",1016,85,27,58,189,152,112,69,181,119,38,27,11,71
"2011","North East Derbyshire 001C","E01019803",928,38,9,29,132,96,76,90,209,181,49,30,19,57
"2011","North East Derbyshire 001D","E01019804",1077,80,17,63,221,178,87,116,181,122,15,11,4,77
"2011","North East Derbyshire 001E","E01019805",1039,86,28,58,210,174,106,103,157,119,19,10,9,65
"2011","North East Derbyshire 001F","E01019806",1196,87,30,57,231,180,115,109,228,144,28,18,10,74
"2011","North East Derbyshire 001G","E01019807",1085,38,17,21,137,111,85,91,251,210,76,47,29,86
"2011","North East Derbyshire 002A","E01019778",1209,138,41,97,315,203,128,89,183,92,14,10,4,47
"2011","North East Derbyshire 002B","E01019779",1147,143,34,109,288,177,125,67,172,110,23,18,5,42
"2011","North East Derbyshire 002C","E01019790",1560,133,32,101,372,251,144,123,245,159,46,24,22,87
"2011","North East Derbyshire 002D","E01019816",1337,134,44,90,321,161,220,87,152,153,29,16,13,80
"2011","North East Derbyshire 004A","E01019780",1002,57,18,39,206,126,97,84,189,150,51,35,16,42
"2011","North East Derbyshire 004B","E01019781",1020,118,37,81,264,138,118,80,134,82,28,15,13,58
"2011","North East Derbyshire 004C","E01019782",896,94,24,70,163,131,90,73,157,102,30,18,12,56
"2011","North East Derbyshire 004D","E01019786",1112,125,38,87,254,179,102,86,163,108,38,22,16,57
"2011","North East Derbyshire 004E","E01019827",1360,111,31,80,245,167,165,108,237,185,58,38,20,84
"2011","North East Derbyshire 005A","E01019770",1398,214,69,145,333,152,271,75,134,112,34,24,10,73
"2011","North East Derbyshire 005B","E01019787",1262,153,27,126,324,225,132,83,164,96,21,10,11,64
"2011","North East Derbyshire 005C","E01019788",1210,181,42,139,332,228,128,58,119,65,14,8,6,85
"2011","North East Derbyshire 005D","E01019794",1083,179,53,126,327,198,97,49,104,50,23,11,12,56
"2011","North East Derbyshire 006A","E01019783",956,123,24,99,230,175,109,47,133,75,9,4,5,55
"2011","North East Derbyshire 006B","E01019784",923,97,30,67,245,156,93,59,133,75,17,10,7,48
"2011","North East Derbyshire 006C","E01019785",975,123,32,91,267,195,101,44,114,58,17,9,8,56
"2011","North East Derbyshire 006D","E01019793",1103,157,37,120,300,186,106,68,141,73,12,2,10,60
"2011","North East Derbyshire 006E","E01019795",1624,175,39,136,435,252,129,116,239,122,37,21,16,119
"2011","North East Derbyshire 007A","E01019798",1081,82,31,51,227,135,135,106,170,140,36,24,12,50
"2011","North East Derbyshire 007B","E01019821",1034,65,16,49,220,142,93,93,162,154,49,42,7,56
"2011","North East Derbyshire 007C","E01019822",1207,89,21,68,221,145,147,98,197,201,35,27,8,74
"2011","North East Derbyshire 007D","E01019823",818,40,12,28,118,101,55,76,171,172,35,22,13,50
"2011","North East Derbyshire 008A","E01019771",1516,224,55,169,399,184,249,70,156,86,64,46,18,84
"2011","North East Derbyshire 008B","E01019772",1143,193,56,137,346,160,153,45,91,66,25,15,10,64
"2011","North East Derbyshire 008C","E01019828",1023,146,47,99,318,177,99,53,117,57,9,6,3,47
"2011","North East Derbyshire 008D","E01019829",1089,133,42,91,286,198,105,65,117,88,28,16,12,69
"2011","North East Derbyshire 009A","E01019796",789,18,9,9,78,65,49,79,165,198,89,63,26,48
"2011","North East Derbyshire 009B","E01019797",1028,43,14,29,142,127,79,95,201,225,68,37,31,48
"2011","North East Derbyshire 009C","E01019799",1411,80,19,61,195,137,80,110,273,301,163,117,46,72
"2011","North East Derbyshire 009D","E01019800",1308,80,18,62,181,149,113,116,264,251,70,45,25,84
"2011","North East Derbyshire 009E","E01019808",1128,42,20,22,135,113,77,113,237,259,97,68,29,55
"2011","North East Derbyshire 009F","E01019826",987,41,15,26,121,100,90,84,224,213,62,46,16,52
"2011","North East Derbyshire 010A","E01019769",1415,238,75,163,336,158,276,72,134,88,36,18,18,77
"2011","North East Derbyshire 010B","E01019774",1150,99,31,68,273,164,159,95,158,136,30,24,6,36
"2011","North East Derbyshire 010C","E01019824",916,61,20,41,187,120,67,81,158,152,41,31,10,49
"2011","North East Derbyshire 010D","E01019830",947,150,37,113,277,156,104,54,90,38,17,8,9,61
"2011","North East Derbyshire 010E","E01019831",1032,114,37,77,284,177,100,75,126,94,14,8,6,48
"2011","North East Derbyshire 011A","E01019809",867,54,17,37,145,116,75,98,153,150,37,23,14,39
"2011","North East Derbyshire 011B","E01019810",1135,69,23,46,209,134,75,109,218,207,63,34,29,51
"2011","North East Derbyshire 011C","E01019811",1202,103,26,77,286,188,104,115,178,133,26,20,6,69
"2011","North East Derbyshire 011D","E01019812",1384,111,34,77,267,205,127,159,202,219,29,11,18,65
"2011","North East Derbyshire 011E","E01019813",1218,58,14,44,187,146,123,109,229,223,80,51,29,63
"2011","North East Derbyshire 011F","E01019825",1028,106,26,80,236,147,109,75,143,109,21,8,13,82
"2011","North East Derbyshire 012A","E01019773",1770,81,27,54,264,220,143,178,333,373,97,71,26,81
"2011","North East Derbyshire 012B","E01019775",1303,53,18,35,164,143,95,117,315,248,101,58,43,67
"2011","North East Derbyshire 012C","E01019776",1050,53,20,33,149,110,94,105,204,212,69,47,22,54
"2011","North East Derbyshire 012D","E01019777",1732,75,24,51,213,165,115,149,375,409,131,93,38,100
"2011","North East Derbyshire 013A","E01019814",1270,115,48,67,269,157,157,109,198,173,30,17,13,62
"2011","North East Derbyshire 013B","E01019817",854,32,11,21,119,69,62,78,166,217,62,37,25,49
"2011","North East Derbyshire 013C","E01019818",1105,75,27,48,162,107,96,94,193,252,63,35,28,63
"2011","North East Derbyshire 013D","E01019819",1115,100,33,67,229,139,180,88,137,170,30,16,14,42
"2011","North East Derbyshire 013E","E01019820",1091,81,20,61,199,135,125,131,158,183,37,27,10,42
"2011","North East Derbyshire 014A","E01019791",1289,79,19,60,235,117,108,116,264,199,79,43,36,92
"2011","North East Derbyshire 014B","E01019792",1442,52,10,42,230,150,135,102,284,304,98,63,35,87
"2011","North East Derbyshire 014C","E01019815",2005,180,48,132,433,230,143,149,347,331,63,40,23,129
"2011","North East Derbyshire 014D","E01032586",1177,83,27,56,198,136,104,110,242,191,65,38,27,48
"2011","South Derbyshire 001A","E01019839",1376,283,79,204,390,161,172,67,112,59,33,16,17,99
"2011","South Derbyshire 001B","E01019845",986,99,28,71,233,131,103,105,141,104,14,7,7,56
"2011","South Derbyshire 001C","E01019846",895,45,14,31,144,112,83,85,201,145,33,14,19,47
"2011","South Derbyshire 001D","E01019866",1831,289,80,209,431,214,295,105,179,126,102,94,8,90
"2011","South Derbyshire 002A","E01019840",1112,157,47,110,247,153,106,87,161,103,31,12,19,67
"2011","South Derbyshire 002B","E01019841",1078,201,40,161,318,146,101,63,112,59,21,15,6,57
"2011","South Derbyshire 002C","E01019847",983,126,34,92,248,133,101,73,123,101,19,10,9,59
"2011","South Derbyshire 002D","E01019848",1557,284,76,208,462,229,96,109,137,85,30,15,15,125
"2011","South Derbyshire 002F","E01033532",1034,166,45,121,328,151,82,66,109,50,16,8,8,66
"2011","South Derbyshire 002G","E01033533",1163,229,58,171,343,160,79,86,102,60,19,9,10,85
"2011","South Derbyshire 002H","E01033534",819,126,31,95,270,137,51,57,77,54,11,5,6,36
"2011","South Derbyshire 003A","E01019873",1065,114,32,82,217,121,104,105,183,132,24,10,14,65
"2011","South Derbyshire 003B","E01019874",1123,110,26,84,208,169,96,110,207,128,34,25,9,61
"2011","South Derbyshire 003C","E01019875",1082,117,30,87,217,146,102,71,169,125,42,30,12,93
"2011","South Derbyshire 003D","E01019881",1019,131,43,88,284,170,94,92,107,72,10,7,3,59
"2011","South Derbyshire 003E","E01019882",1162,91,26,65,235,143,111,107,200,177,35,19,16,63
"2011","South Derbyshire 004A","E01019832",1324,216,56,160,369,182,151,111,137,81,27,9,18,50
"2011","South Derbyshire 004B","E01019833",1277,250,53,197,377,197,99,80,120,57,29,23,6,68
"2011","South Derbyshire 004C","E01019834",1091,179,51,128,297,137,143,66,103,77,18,11,7,71
"2011","South Derbyshire 004D","E01019835",1250,193,50,143,293,181,103,113,159,88,40,25,15,80
"2011","South Derbyshire 005A","E01019867",1122,216,78,138,313,140,149,61,89,62,25,17,8,67
"2011","South Derbyshire 005B","E01019868",1187,198,42,156,319,142,147,79,111,105,23,13,10,63
"2011","South Derbyshire 005C","E01019869",1166,180,50,130,305,113,81,56,71,40,8,7,1,312
"2011","South Derbyshire 005D","E01019880",1195,161,37,124,327,170,88,116,156,83,18,12,6,76
"2011","South Derbyshire 006A","E01019843",1118,216,60,156,288,119,167,66,101,79,19,12,7,63
"2011","South Derbyshire 006B","E01019853",1117,171,46,125,246,151,100,86,143,127,30,21,9,63
"2011","South Derbyshire 006C","E01019854",1247,190,57,133,328,134,143,94,141,131,25,14,11,61
"2011","South Derbyshire 006D","E01019855",1125,190,39,151,278,163,150,69,108,71,19,9,10,77
"2011","South Derbyshire 007A","E01019844",1092,78,21,57,170,132,73,112,213,206,55,37,18,53
"2011","South Derbyshire 007B","E01019856",1059,22,10,12,125,110,58,119,239,234,67,46,21,85
"2011","South Derbyshire 007C","E01019857",945,81,26,55,208,153,76,106,136,104,19,15,4,62
"2011","South Derbyshire 007D","E01019858",1116,43,9,34,144,146,61,114,216,259,57,35,22,76
"2011","South Derbyshire 007E","E01019859",1266,101,33,68,247,164,125,130,214,188,30,19,11,67
"2011","South Derbyshire 008A","E01019860",997,76,23,53,181,124,80,106,177,154,24,15,9,75
"2011","South Derbyshire 008B","E01019861",1329,86,31,55,198,161,107,151,306,208,40,25,15,72
"2011","South Derbyshire 008C","E01019862",1128,42,15,27,158,136,117,121,209,231,47,29,18,67
"2011","South Derbyshire 008D","E01019863",1134,40,10,30,138,128,81,100,253,236,77,37,40,81
"2011","South Derbyshire 008E","E01019864",1133,56,16,40,168,131,70,122,230,215,69,41,28,72
"2011","South Derbyshire 008F","E01019865",998,51,14,37,160,122,52,122,206,165,54,40,14,66
"2011","South Derbyshire 009A","E01019876",1404,95,31,64,238,171,82,139,279,263,48,32,16,89
"2011","South Derbyshire 009B","E01019877",1171,49,13,36,160,108,88,144,253,222,89,66,23,58
"2011","South Derbyshire 009C","E01019878",1157,58,21,37,192,125,90,142,237,232,31,22,9,50
"2011","South Derbyshire 009D","E01019879",1478,122,33,89,280,201,112,157,272,226,24,11,13,84
"2011","South Derbyshire 011A","E01019850",1194,132,42,90,277,158,143,115,146,142,22,14,8,59
"2011","South Derbyshire 011B","E01019851",1220,67,18,49,197,162,77,131,245,223,48,28,20,70
"2011","South Derbyshire 011C","E01019852",1351,110,36,74,261,154,142,127,207,214,45,24,21,91
"2011","South Derbyshire 011D","E01019870",1158,113,29,84,226,139,148,108,140,164,57,50,7,63
"2011","South Derbyshire 011E","E01019871",1288,130,34,96,252,151,155,112,218,182,28,18,10,60
"2011","South Derbyshire 011F","E01019872",1421,151,45,106,323,177,165,131,208,177,37,26,11,52
"2011","South Derbyshire 012A","E01019837",1401,93,26,67,256,175,105,146,283,224,52,37,15,67
"2011","South Derbyshire 012B","E01019838",1207,50,17,33,156,100,113,125,286,246,69,43,26,62
"2011","South Derbyshire 012C","E01033531",1204,145,49,96,342,167,99,101,154,109,25,13,12,62
"2011","South Derbyshire 012D","E01033536",1204,91,21,70,223,151,83,119,235,189,50,30,20,63
"2011","South Derbyshire 012E","E01033537",1232,83,26,57,209,164,105,133,225,199,50,35,15,64
"2011","South Derbyshire 013A","E01019842",1197,65,17,48,162,101,102,105,236,251,96,64,32,79
"2011","South Derbyshire 013B","E01019883",2057,181,45,136,398,240,172,220,349,314,79,44,35,104
"2011","South Derbyshire 013C","E01019885",1314,113,36,77,247,186,116,146,217,175,44,27,17,70
"2011","South Derbyshire 013D","E01033535",1091,101,27,74,266,164,100,94,164,118,23,14,9,61
"2011","Blaby 002A","E01025631",855,72,15,57,177,142,79,73,130,96,18,8,10,68
"2011","Blaby 002B","E01025632",1058,180,37,143,302,157,108,44,96,58,24,17,7,89
"2011","Blaby 002C","E01025633",1269,111,30,81,300,195,122,128,179,137,18,11,7,79
"2011","Blaby 002D","E01025635",888,87,30,57,185,155,97,78,110,95,26,18,8,55
"2011","Blaby 003A","E01025634",1012,147,28,119,251,176,145,64,92,61,17,13,4,59
"2011","Blaby 003B","E01025638",1005,170,40,130,255,174,148,40,89,46,20,12,8,63
"2011","Blaby 003C","E01025639",854,116,33,83,230,131,104,44,93,70,20,15,5,46
"2011","Blaby 003D","E01025640",1102,175,54,121,304,125,143,56,106,82,36,24,12,75
"2011","Blaby 003E","E01025645",873,115,28,87,234,102,130,39,93,75,21,18,3,64
"2011","Blaby 004A","E01025666",1054,61,16,45,171,155,109,87,181,177,51,27,24,62
"2011","Blaby 004B","E01025667",845,58,15,43,148,155,77,78,120,136,22,17,5,51
"2011","Blaby 004C","E01025668",1788,233,47,186,414,322,117,134,234,173,55,28,27,106
"2011","Blaby 004D","E01025669",1584,240,38,202,432,255,132,105,167,126,39,21,18,88
"2011","Blaby 005A","E01025636",907,68,16,52,157,155,73,85,144,130,27,16,11,68
"2011","Blaby 005B","E01025637",959,78,16,62,180,149,79,87,150,143,38,20,18,55
"2011","Blaby 005C","E01025652",1025,81,21,60,180,156,93,85,160,153,29,22,7,88
"2011","Blaby 005D","E01025653",1146,56,12,44,181,173,84,106,211,198,44,23,21,93
"2011","Blaby 005E","E01025654",876,69,11,58,156,132,69,80,142,128,35,23,12,65
"2011","Blaby 005F","E01025655",1144,79,18,61,199,138,95,119,210,189,50,35,15,65
"2011","Blaby 005G","E01025656",972,48,11,37,174,132,92,94,165,141,43,26,17,83
"2011","Blaby 006A","E01025625",854,48,15,33,162,128,68,76,138,140,34,15,19,60
"2011","Blaby 006B","E01025626",965,106,21,85,224,155,100,68,119,105,30,17,13,58
"2011","Blaby 006C","E01025627",1573,134,38,96,319,259,157,130,238,188,33,19,14,115
"2011","Blaby 006D","E01025651",1223,130,29,101,273,190,112,104,150,124,34,24,10,106
"2011","Blaby 006E","E01025657",1364,134,44,90,317,199,146,87,189,177,22,15,7,93
"2011","Blaby 006F","E01025660",1197,120,33,87,271,229,132,75,146,128,24,10,14,72
"2011","Blaby 007A","E01025641",1339,159,34,125,283,215,131,114,189,150,25,11,14,73
"2011","Blaby 007B","E01025642",1373,209,62,147,375,226,106,92,144,102,23,13,10,96
"2011","Blaby 007C","E01025643",1176,139,32,107,268,193,92,93,142,125,38,24,14,86
"2011","Blaby 007D","E01025649",1195,179,49,130,311,212,138,58,122,88,11,4,7,76
"2011","Blaby 007E","E01025650",1177,164,48,116,340,182,113,64,127,69,14,6,8,104
"2011","Blaby 008A","E01025610",1096,70,18,52,216,143,117,93,175,173,51,27,24,58
"2011","Blaby 008B","E01025611",1078,86,23,63,225,182,107,99,149,133,21,9,12,76
"2011","Blaby 008C","E01025612",1197,97,30,67,227,195,121,95,212,158,25,16,9,67
"2011","Blaby 008D","E01025658",1903,126,41,85,310,205,149,152,300,321,225,208,17,115
"2011","Blaby 008E","E01025659",1330,131,37,94,294,226,145,91,163,173,26,11,15,81
"2011","Blaby 009A","E01025615",1156,160,45,115,278,193,149,68,132,72,15,6,9,89
"2011","Blaby 009B","E01025646",1151,101,22,79,232,175,123,100,168,151,30,13,17,71
"2011","Blaby 009C","E01025647",1171,76,26,50,231,180,112,110,178,190,32,17,15,62
"2011","Blaby 009D","E01025648",1457,184,48,136,372,221,143,117,162,134,20,12,8,104
"2011","Blaby 010A","E01025613",1039,106,44,62,231,147,126,79,152,104,22,13,9,72
"2011","Blaby 010B","E01025614",1295,119,35,84,320,214,105,115,187,135,23,14,9,77
"2011","Blaby 010C","E01025620",768,61,14,47,158,127,71,76,100,116,14,6,8,45
"2011","Blaby 010D","E01025621",796,101,23,78,191,102,109,59,91,99,12,10,2,32
"2011","Blaby 010E","E01025644",1046,94,25,69,222,179,97,89,150,112,36,23,13,67
"2011","Blaby 011A","E01025616",1224,150,41,109,324,199,110,80,136,101,25,14,11,99
"2011","Blaby 011B","E01025617",1277,140,30,110,304,218,151,88,178,113,12,7,5,73
"2011","Blaby 011C","E01025618",1180,99,22,77,276,151,120,98,174,170,29,20,9,63
"2011","Blaby 011D","E01025619",1238,115,26,89,265,222,155,92,164,125,15,9,6,85
"2011","Blaby 012A","E01025661",1279,174,39,135,317,193,145,87,157,123,17,7,10,66
"2011","Blaby 012B","E01025662",1100,90,16,74,252,138,129,105,140,155,35,24,11,56
"2011","Blaby 012C","E01025663",1082,132,38,94,268,146,124,74,144,117,17,6,11,60
"2011","Blaby 012D","E01025664",935,137,34,103,227,106,123,79,107,106,15,7,8,35
"2011","Blaby 012E","E01025665",1119,155,41,114,301,148,110,93,131,113,15,6,9,53
"2011","Blaby 013A","E01025622",1189,134,33,101,269,204,109,79,153,130,46,27,19,65
"2011","Blaby 013B","E01025623",1110,115,28,87,265,165,153,98,126,107,21,13,8,60
"2011","Blaby 013C","E01025624",1361,213,57,156,320,242,105,80,163,90,41,29,12,107
"2011","Blaby 013D","E01025629",1064,104,26,78,187,163,111,87,159,149,37,25,12,67
"2011","Blaby 013E","E01025630",1209,157,33,124,295,217,138,74,122,88,44,35,9,74
"2011","Blaby 013F","E01032603",1056,62,17,45,176,147,135,85,176,191,25,12,13,59
"2011","Charnwood 001B","E01025692",1524,222,42,180,342,196,83,130,214,159,47,34,13,131
"2011","Charnwood 001C","E01025693",1439,180,41,139,362,218,156,101,162,144,20,13,7,96
"2011","Charnwood 001E","E01033386",1744,145,27,118,268,186,118,177,356,313,66,46,20,115
"2011","Charnwood 002A","E01025699",1093,59,12,47,124,93,56,75,179,213,168,105,63,126
"2011","Charnwood 002B","E01025700",1315,87,9,78,180,150,56,106,243,198,155,124,31,140
"2011","Charnwood 002C","E01025701",1150,103,9,94,181,99,73,100,172,190,116,86,30,116
"2011","Charnwood 002D","E01025703",1554,123,14,109,286,122,105,121,212,194,131,94,37,260
"2011","Charnwood 002E","E01025704",1174,89,11,78,195,117,63,88,162,124,54,40,14,282
"2011","Charnwood 002F","E01025705",984,86,7,79,163,92,66,79,155,152,90,68,22,101
"2011","Charnwood 002G","E01025706",1255,86,10,76,182,112,85,132,230,222,108,79,29,98
"2011","Charnwood 003A","E01025720",1864,87,11,76,180,65,39,47,84,81,46,39,7,1235
"2011","Charnwood 003B","E01025721",1458,92,11,81,147,72,36,41,94,50,30,22,8,896
"2011","Charnwood 003C","E01025722",784,74,12,62,120,88,46,69,139,110,17,7,10,121
"2011","Charnwood 003D","E01025723",1897,74,6,68,128,78,63,70,117,117,66,43,23,1184
"2011","Charnwood 003E","E01025724",1411,48,5,43,105,61,40,54,98,89,39,22,17,877
"2011","Charnwood 003F","E01025725",954,32,7,25,93,91,72,83,193,194,82,54,28,114
"2011","Charnwood 004A","E01025695",1200,208,31,177,295,156,57,85,138,94,24,15,9,143
"2011","Charnwood 004B","E01025696",1079,135,16,119,197,158,65,94,161,140,35,24,11,94
"2011","Charnwood 004C","E01025697",959,73,8,65,151,77,69,81,181,163,42,29,13,122
"2011","Charnwood 004D","E01025698",1230,129,22,107,214,172,96,111,183,150,26,12,14,149
"2011","Charnwood 005A","E01025744",1465,154,44,110,350,255,132,138,190,119,34,24,10,93
"2011","Charnwood 005B","E01025745",1096,101,23,78,196,170,77,107,194,163,28,16,12,60
"2011","Charnwood 005C","E01025746",1291,126,34,92,235,176,140,112,193,190,35,23,12,84
"2011","Charnwood 005D","E01025747",1317,87,16,71,234,144,106,146,254,240,44,29,15,62
"2011","Charnwood 006A","E01025740",1175,99,26,73,222,142,123,119,177,173,57,43,14,63
"2011","Charnwood 006B","E01025741",1198,152,30,122,277,180,101,126,147,112,21,16,5,82
"2011","Charnwood 006C","E01025742",1163,76,19,57,194,141,86,106,230,195,55,37,18,80
"2011","Charnwood 006D","E01025743",1377,142,38,104,304,217,114,124,217,168,32,14,18,59
"2011","Charnwood 007A","E01025689",2174,69,7,62,139,101,62,125,216,246,81,57,24,1135
"2011","Charnwood 007B","E01025690",3527,64,4,60,108,64,51,93,144,225,86,59,27,2692
"2011","Charnwood 007C","E01025707",1458,163,28,135,194,116,67,54,102,89,31,20,11,642
"2011","Charnwood 007D","E01025709",2037,176,17,159,198,103,61,34,65,35,13,7,6,1352
"2011","Charnwood 008A","E01025760",984,219,61,158,248,129,162,37,82,43,15,8,7,49
"2011","Charnwood 008B","E01025761",1290,278,68,210,392,129,177,55,99,74,17,10,7,69
"2011","Charnwood 008C","E01025768",1037,185,51,134,270,137,159,35,95,57,32,14,18,67
"2011","Charnwood 008D","E01025769",1118,192,54,138,295,130,156,49,90,66,23,13,10,117
"2011","Charnwood 009A","E01025702",976,82,15,67,202,124,82,89,163,136,22,15,7,76
"2011","Charnwood 009B","E01025715",1080,81,13,68,152,104,68,94,189,197,75,47,28,120
"2011","Charnwood 009C","E01025716",1095,106,15,91,176,116,77,108,170,169,49,24,25,124
"2011","Charnwood 009D","E01025717",1536,153,22,131,260,146,115,136,233,231,127,84,43,135
"2011","Charnwood 009E","E01025718",1087,87,6,81,169,79,46,58,103,113,62,47,15,370
"2011","Charnwood 009F","E01025719",1167,157,20,137,274,112,74,55,97,77,20,13,7,301
"2011","Charnwood 010A","E01025708",944,211,38,173,269,116,73,43,73,45,24,13,11,90
"2011","Charnwood 010B","E01025710",854,180,30,150,208,117,80,48,83,48,29,17,12,61
"2011","Charnwood 010C","E01025711",1054,196,40,156,301,138,96,53,85,65,29,17,12,91
"2011","Charnwood 010D","E01025712",929,130,25,105,226,147,79,61,113,84,19,15,4,70
"2011","Charnwood 010E","E01025713",1162,143,21,122,247,117,71,57,75,57,20,17,3,375
"2011","Charnwood 010F","E01025714",1564,347,48,299,461,176,135,70,127,80,22,12,10,146
"2011","Charnwood 011A","E01025674",1148,127,36,91,257,157,119,103,138,128,32,14,18,87
"2011","Charnwood 011B","E01025675",1131,155,40,115,323,127,111,82,130,85,28,14,14,90
"2011","Charnwood 011C","E01025676",1549,257,61,196,466,211,120,102,157,99,33,15,18,104
"2011","Charnwood 011D","E01025677",971,129,26,103,205,127,94,72,159,103,27,13,14,55
"2011","Charnwood 012A","E01025732",1186,224,53,171,314,148,133,65,114,90,38,26,12,60
"2011","Charnwood 012B","E01025733",1107,223,45,178,291,134,106,68,119,82,25,18,7,59
"2011","Charnwood 012C","E01025734",1087,245,59,186,320,133,103,44,78,53,28,19,9,83
"2011","Charnwood 012D","E01025735",1359,210,43,167,344,166,137,73,163,162,38,27,11,66
"2011","Charnwood 013A","E01025748",1635,162,44,118,349,225,159,154,225,185,63,41,22,113
"2011","Charnwood 013B","E01025749",1138,75,25,50,193,147,94,108,210,175,49,30,19,87
"2011","Charnwood 013C","E01025750",1083,89,31,58,208,164,92,104,203,154,16,7,9,53
"2011","Charnwood 013D","E01025751",1560,118,26,92,333,211,134,167,236,225,53,35,18,83
"2011","Charnwood 014A","E01025726",1424,202,41,161,375,219,126,108,150,117,38,20,18,89
"2011","Charnwood 014B","E01025727",1135,79,26,53,200,133,107,103,185,181,67,40,27,80
"2011","Charnwood 014C","E01025728",1327,145,33,112,290,189,116,113,207,143,35,26,9,89
"2011","Charnwood 014D","E01025729",1215,173,46,127,311,190,113,78,163,105,15,7,8,67
"2011","Charnwood 014E","E01025737",1301,203,45,158,375,195,148,83,106,90,21,9,12,80
"2011","Charnwood 014F","E01025739",1008,153,45,108,276,143,103,59,112,82,23,15,8,57
"2011","Charnwood 015A","E01025685",996,74,23,51,184,147,89,109,174,121,30,17,13,68
"2011","Charnwood 015B","E01025686",1113,92,28,64,214,178,134,104,178,119,27,13,14,67
"2011","Charnwood 015C","E01025730",1113,146,43,103,303,162,156,66,116,87,14,8,6,63
"2011","Charnwood 015D","E01025731",1104,124,37,87,241,173,166,77,130,90,26,13,13,77
"2011","Charnwood 016A","E01025687",1170,255,75,180,307,147,191,39,67,59,24,19,5,81
"2011","Charnwood 016B","E01025688",1432,210,61,149,326,117,135,63,95,76,21,16,5,389
"2011","Charnwood 016C","E01025736",1056,185,57,128,306,145,137,48,84,63,25,17,8,63
"2011","Charnwood 016D","E01025738",1061,239,83,156,317,123,162,39,53,29,10,8,2,89
"2011","Charnwood 017A","E01025756",1433,124,22,102,294,216,125,97,232,183,70,54,16,92
"2011","Charnwood 017B","E01025757",1124,111,19,92,254,191,101,74,159,109,36,23,13,89
"2011","Charnwood 017C","E01025758",1302,182,41,141,285,192,154,77,155,126,29,20,9,102
"2011","Charnwood 017D","E01025759",997,114,28,86,185,127,98,79,155,154,29,10,19,56
"2011","Charnwood 018A","E01025752",1498,128,39,89,289,227,146,115,255,186,45,30,15,107
"2011","Charnwood 018B","E01025753",1057,57,12,45,152,131,113,85,205,205,44,22,22,65
"2011","Charnwood 018C","E01025754",989,75,24,51,193,153,82,87,166,150,19,10,9,64
"2011","Charnwood 018D","E01025755",1089,77,24,53,220,167,104,104,163,131,32,23,9,91
"2011","Charnwood 019A","E01025679",1725,198,33,165,423,267,159,115,229,149,50,30,20,135
"2011","Charnwood 019B","E01025680",1179,131,32,99,253,205,110,84,161,109,33,23,10,93
"2011","Charnwood 019C","E01025681",1166,184,50,134,295,180,158,59,115,71,33,27,6,71
"2011","Charnwood 019D","E01025682",1073,87,25,62,204,192,83,94,169,135,30,17,13,79
"2011","Charnwood 020A","E01025678",1246,165,34,131,306,207,125,73,141,99,16,12,4,114
"2011","Charnwood 020B","E01025683",1207,77,25,52,232,175,103,97,186,183,47,27,20,107
"2011","Charnwood 020C","E01025684",1351,93,18,75,279,181,129,122,229,178,32,16,16,108
"2011","Charnwood 021A","E01025762",1110,52,20,32,171,156,117,103,210,184,58,35,23,59
"2011","Charnwood 021B","E01025763",1169,73,16,57,175,164,87,110,255,200,36,23,13,69
"2011","Charnwood 021C","E01025764",1043,60,10,50,159,174,86,80,191,150,47,35,12,96
"2011","Charnwood 021D","E01025765",1196,101,21,80,188,170,98,71,209,176,68,47,21,115
"2011","Charnwood 021E","E01025766",1488,68,14,54,215,179,142,135,301,285,54,22,32,109
"2011","Charnwood 021F","E01025767",1117,67,16,51,192,149,110,99,189,186,33,18,15,92
"2011","Charnwood 022A","E01025670",957,65,25,40,156,140,69,121,170,157,27,17,10,52
"2011","Charnwood 022B","E01025671",1353,123,26,97,307,216,139,106,215,144,30,17,13,73
"2011","Charnwood 022C","E01025672",1308,151,46,105,323,188,121,111,169,143,27,17,10,75
"2011","Charnwood 022D","E01025673",1158,103,27,76,235,177,123,85,182,157,33,19,14,63
"2011","Harborough 002A","E01025770",1356,233,58,175,369,163,259,57,85,71,25,15,10,94
"2011","Harborough 002B","E01025809",1613,300,92,208,455,174,281,68,140,87,24,15,9,84
"2011","Harborough 002C","E01025815",1545,275,80,195,381,192,297,70,120,95,29,19,10,86
"2011","Harborough 003A","E01025781",1134,236,58,178,297,143,166,58,76,54,30,22,8,74
"2011","Harborough 003B","E01025782",914,126,29,97,224,149,109,63,101,64,13,5,8,65
"2011","Harborough 003C","E01025783",1085,209,53,156,306,179,133,34,93,39,15,11,4,77
"2011","Harborough 003D","E01025785",1518,237,63,174,446,211,182,83,130,101,27,13,14,101
"2011","Harborough 003E","E01025786",1118,123,32,91,301,136,124,71,141,103,23,14,9,96
"2011","Harborough 003F","E01025787",1228,175,52,123,356,218,143,50,118,78,17,13,4,73
"2011","Harborough 004A","E01025772",1657,197,57,140,414,272,155,142,184,155,16,6,10,122
"2011","Harborough 004B","E01025773",1085,206,63,143,284,166,103,61,84,83,11,2,9,87
"2011","Harborough 004C","E01025774",984,148,36,112,286,168,81,49,98,64,20,10,10,70
"2011","Harborough 004D","E01025775",1298,126,33,93,268,195,142,121,176,180,30,19,11,60
"2011","Harborough 004E","E01025776",1483,191,47,144,332,232,165,99,174,163,26,12,14,101
"2011","Harborough 005A","E01025771",1873,291,73,218,499,216,343,110,154,131,40,31,9,89
"2011","Harborough 005B","E01025778",1428,148,37,111,355,183,156,103,201,144,32,19,13,106
"2011","Harborough 005C","E01025779",1194,112,27,85,292,189,165,86,144,119,17,9,8,70
"2011","Harborough 005D","E01025780",1002,96,27,69,260,166,112,68,136,90,14,6,8,60
"2011","Harborough 005E","E01025784",1028,183,56,127,250,113,171,43,85,48,63,57,6,72
"2011","Harborough 005F","E01025788",885,148,40,108,249,83,136,45,79,67,13,5,8,65
"2011","Harborough 006A","E01025777",1668,288,98,190,490,217,250,86,121,101,24,14,10,91
"2011","Harborough 006B","E01025808",1883,353,109,244,512,204,303,105,168,126,27,15,12,85
"2011","Harborough 006C","E01025810",1743,300,90,210,476,203,307,94,142,99,29,23,6,93
"2011","Harborough 006D","E01025816",1674,276,80,196,416,200,230,97,177,132,67,55,12,79
"2011","Harborough 007A","E01025789",1467,115,40,75,270,120,198,151,172,274,96,76,20,71
"2011","Harborough 007B","E01025794",1345,308,83,225,408,179,97,61,111,62,30,18,12,89
"2011","Harborough 007C","E01025797",1217,199,62,137,339,166,131,63,132,110,14,11,3,63
"2011","Harborough 007D","E01025802",947,149,37,112,244,139,128,57,104,63,20,14,6,43
"2011","Harborough 007E","E01025803",1142,211,59,152,326,168,123,59,94,61,17,6,11,83
"2011","Harborough 007F","E01025805",1135,110,23,87,254,157,102,82,204,147,24,17,7,55
"2011","Harborough 008A","E01025795",1304,119,27,92,273,162,136,95,173,144,38,22,16,164
"2011","Harborough 008B","E01025796",1412,124,34,90,263,177,119,103,238,252,53,27,26,83
"2011","Harborough 008C","E01025801",919,105,23,82,210,113,77,61,152,102,29,20,9,70
"2011","Harborough 008D","E01025806",1028,68,17,51,165,97,94,100,189,181,48,35,13,86
"2011","Harborough 009A","E01025798",1276,166,43,123,372,183,130,83,146,113,20,11,9,63
"2011","Harborough 009B","E01025799",1419,310,77,233,435,209,98,58,114,73,18,6,12,104
"2011","Harborough 009C","E01025800",877,123,28,95,237,154,84,58,113,56,10,5,5,42
"2011","Harborough 009D","E01025804",1323,120,29,91,296,207,116,110,202,179,38,23,15,55
"2011","Harborough 009E","E01025807",1042,124,29,95,282,126,87,55,146,122,41,24,17,59
"2011","Harborough 010A","E01025790",1673,269,75,194,474,253,116,109,160,173,23,15,8,96
"2011","Harborough 010B","E01025791",1551,140,41,99,317,221,137,140,230,239,43,29,14,84
"2011","Harborough 010C","E01025792",1662,175,50,125,399,214,158,124,221,253,35,18,17,83
"2011","Harborough 010D","E01025793",1864,223,66,157,395,244,135,155,261,296,37,23,14,118
"2011","Harborough 011A","E01025812",1181,171,43,128,277,203,147,66,147,84,28,14,14,58
"2011","Harborough 011B","E01025813",1129,202,56,146,298,153,144,54,88,58,28,20,8,104
"2011","Harborough 011C","E01025814",1090,200,53,147,326,163,137,30,96,47,17,13,4,74
"2011","Harborough 011D","E01032598",1514,180,41,139,335,264,172,115,167,130,31,16,15,120
"2011","Hinckley and Bosworth 001A","E01025868",1101,111,30,81,235,144,110,122,153,131,25,17,8,70
"2011","Hinckley and Bosworth 001B","E01025869",1101,126,21,105,267,174,83,92,140,142,13,10,3,64
"2011","Hinckley and Bosworth 001C","E01025870",996,131,30,101,244,159,133,67,95,73,19,7,12,75
"2011","Hinckley and Bosworth 001D","E01025871",920,74,25,49,184,134,135,71,129,123,19,13,6,51
"2011","Hinckley and Bosworth 001E","E01025878",1860,227,66,161,474,247,245,128,209,190,46,26,20,94
"2011","Hinckley and Bosworth 002A","E01025846",1491,214,41,173,388,240,155,96,154,112,29,17,12,103
"2011","Hinckley and Bosworth 002B","E01025847",1271,183,42,141,337,219,94,93,135,96,29,16,13,85
"2011","Hinckley and Bosworth 002C","E01025848",1136,134,34,100,243,164,117,80,154,162,24,12,12,58
"2011","Hinckley and Bosworth 003A","E01025845",1189,185,47,138,285,189,124,71,124,86,30,21,9,95
"2011","Hinckley and Bosworth 003B","E01025877",1196,115,24,91,272,205,142,89,170,118,24,14,10,61
"2011","Hinckley and Bosworth 003C","E01025879",887,54,20,34,147,105,87,87,163,168,26,16,10,50
"2011","Hinckley and Bosworth 003D","E01025880",1161,130,31,99,259,203,105,124,167,91,15,10,5,67
"2011","Hinckley and Bosworth 004A","E01025819",1228,130,41,89,249,164,147,100,185,158,28,17,11,67
"2011","Hinckley and Bosworth 004B","E01025820",1245,115,28,87,248,192,122,113,190,171,22,15,7,72
"2011","Hinckley and Bosworth 004C","E01025837",1503,237,65,172,438,175,222,75,146,98,26,19,7,86
"2011","Hinckley and Bosworth 004D","E01025838",1021,201,67,134,297,121,140,53,79,59,19,13,6,52
"2011","Hinckley and Bosworth 004E","E01025882",1188,170,60,110,296,151,198,82,108,97,29,18,11,57
"2011","Hinckley and Bosworth 005A","E01025872",1191,128,28,100,270,181,141,90,177,140,14,11,3,50
"2011","Hinckley and Bosworth 005B","E01025873",1203,184,57,127,303,182,197,58,120,67,17,10,7,75
"2011","Hinckley and Bosworth 005C","E01025874",1139,105,33,72,260,149,98,112,172,156,28,14,14,59
"2011","Hinckley and Bosworth 005D","E01025875",1053,70,16,54,168,121,108,88,194,191,45,25,20,68
"2011","Hinckley and Bosworth 005E","E01025876",1397,259,81,178,387,186,168,68,129,90,39,29,10,71
"2011","Hinckley and Bosworth 006A","E01025839",1240,105,29,76,254,158,95,120,177,201,41,16,25,89
"2011","Hinckley and Bosworth 006B","E01025840",1154,89,35,54,185,140,110,109,184,225,47,25,22,65
"2011","Hinckley and Bosworth 006C","E01025841",1270,102,27,75,268,204,121,124,183,182,29,14,15,57
"2011","Hinckley and Bosworth 006D","E01025842",1258,106,35,71,242,164,107,104,185,227,53,34,19,70
"2011","Hinckley and Bosworth 006E","E01025843",1195,65,17,48,212,137,96,116,217,242,60,28,32,50
"2011","Hinckley and Bosworth 006F","E01025844",1226,68,16,52,178,133,90,109,212,254,112,63,49,70
"2011","Hinckley and Bosworth 007A","E01025821",1267,114,36,78,236,185,104,121,201,199,55,29,26,52
"2011","Hinckley and Bosworth 007B","E01025822",1033,47,12,35,141,101,98,119,193,221,54,29,25,59
"2011","Hinckley and Bosworth 007C","E01025823",1140,79,28,51,195,126,112,108,205,198,57,29,28,60
"2011","Hinckley and Bosworth 007D","E01025824",1094,94,24,70,215,163,100,111,158,147,36,21,15,70
"2011","Hinckley and Bosworth 007E","E01025825",1132,76,18,58,194,140,122,117,185,198,38,26,12,62
"2011","Hinckley and Bosworth 007F","E01025826",1072,86,27,59,206,126,106,97,161,184,27,15,12,79
"2011","Hinckley and Bosworth 008A","E01025817",1485,214,63,151,371,174,215,102,160,142,26,13,13,81
"2011","Hinckley and Bosworth 008B","E01025818",1086,131,37,94,250,121,196,67,109,97,28,18,10,87
"2011","Hinckley and Bosworth 008C","E01025864",1161,119,25,94,271,163,117,100,148,150,26,13,13,67
"2011","Hinckley and Bosworth 008D","E01025881",1032,146,49,97,303,122,156,56,103,88,23,19,4,35
"2011","Hinckley and Bosworth 009A","E01025859",1054,140,41,99,283,140,99,75,126,94,23,12,11,74
"2011","Hinckley and Bosworth 009B","E01025860",1116,158,43,115,276,173,126,81,114,97,12,4,8,79
"2011","Hinckley and Bosworth 009C","E01025861",1276,143,33,110,290,216,96,109,146,173,24,14,10,79
"2011","Hinckley and Bosworth 009D","E01025862",1059,127,39,88,248,163,114,91,135,115,19,10,9,47
"2011","Hinckley and Bosworth 010A","E01025850",1031,80,18,62,222,126,101,94,146,170,37,25,12,55
"2011","Hinckley and Bosworth 010B","E01025852",1309,130,22,108,221,172,129,106,167,210,113,72,41,61
"2011","Hinckley and Bosworth 010C","E01025858",1432,115,28,87,293,190,148,118,207,236,54,32,22,71
"2011","Hinckley and Bosworth 010D","E01025863",1183,84,21,63,173,140,107,125,198,234,48,28,20,74
"2011","Hinckley and Bosworth 010E","E01025865",1305,101,30,71,241,159,120,123,194,246,51,28,23,70
"2011","Hinckley and Bosworth 011A","E01025853",2091,219,65,154,486,352,169,144,297,279,51,29,22,94
"2011","Hinckley and Bosworth 011B","E01025854",1329,118,37,81,290,214,94,126,201,186,32,14,18,68
"2011","Hinckley and Bosworth 011C","E01025855",1066,76,18,58,193,154,75,99,188,202,30,22,8,49
"2011","Hinckley and Bosworth 011D","E01025866",1194,67,20,47,196,152,75,106,180,286,79,45,34,53
"2011","Hinckley and Bosworth 011E","E01025867",1196,93,20,73,240,161,79,106,203,215,36,21,15,63
"2011","Hinckley and Bosworth 012A","E01025849",1247,112,19,93,220,155,98,92,206,234,57,32,25,73
"2011","Hinckley and Bosworth 012B","E01025851",953,67,17,50,190,171,72,86,150,138,24,13,11,55
"2011","Hinckley and Bosworth 012C","E01025856",897,59,15,44,126,105,76,80,157,197,60,36,24,37
"2011","Hinckley and Bosworth 012D","E01025857",1116,89,21,68,229,170,108,103,176,150,25,17,8,66
"2011","Hinckley and Bosworth 013A","E01025827",943,56,19,37,137,131,108,76,153,199,39,25,14,44
"2011","Hinckley and Bosworth 013B","E01025828",1051,174,53,121,269,133,103,77,98,117,18,9,9,62
"2011","Hinckley and Bosworth 013C","E01025829",1004,54,17,37,137,109,92,74,173,255,45,25,20,65
"2011","Hinckley and Bosworth 013D","E01025830",977,136,47,89,250,144,111,58,97,113,28,15,13,40
"2011","Hinckley and Bosworth 014A","E01025831",972,114,35,79,200,131,87,89,142,131,23,11,12,55
"2011","Hinckley and Bosworth 014B","E01025832",1188,209,69,140,325,177,119,70,119,75,19,14,5,75
"2011","Hinckley and Bosworth 014C","E01025833",1143,151,44,107,297,147,143,84,111,120,23,17,6,67
"2011","Hinckley and Bosworth 014D","E01025834",1117,170,38,132,314,168,133,48,116,94,20,14,6,54
"2011","Hinckley and Bosworth 014E","E01025835",1153,188,53,135,303,191,110,64,118,91,18,10,8,70
"2011","Hinckley and Bosworth 014F","E01025836",992,91,23,68,249,145,74,77,135,152,16,7,9,53
"2011","Melton 001A","E01025885",1321,231,64,167,388,166,147,71,148,73,19,12,7,78
"2011","Melton 001B","E01025886",1209,148,41,107,319,159,139,99,161,111,21,11,10,52
"2011","Melton 001C","E01025887",1366,177,50,127,352,153,245,93,138,105,30,12,18,73
"2011","Melton 001D","E01025890",913,102,17,85,200,84,148,65,132,112,21,12,9,49
"2011","Melton 001E","E01025891",936,174,43,131,261,112,121,54,94,48,15,7,8,57
"2011","Melton 001F","E01025892",1185,231,65,166,336,122,181,55,109,72,10,4,6,69
"2011","Melton 002A","E01025901",1239,101,27,74,239,202,102,131,210,160,16,7,9,78
"2011","Melton 002B","E01025902",1184,133,26,107,288,167,94,128,176,101,20,12,8,77
"2011","Melton 002C","E01025903",1355,103,31,72,266,145,105,131,264,229,32,14,18,80
"2011","Melton 002D","E01025904",1396,157,52,105,343,199,126,116,217,153,13,8,5,72
"2011","Melton 002E","E01025906",1302,161,52,109,319,191,108,110,163,134,24,13,11,92
"2011","Melton 003A","E01025883",1242,119,37,82,265,167,108,140,193,174,19,11,8,57
"2011","Melton 003B","E01025884",1207,87,33,54,196,152,125,141,209,200,38,19,19,59
"2011","Melton 003C","E01025888",1345,226,54,172,350,137,243,77,108,85,22,11,11,97
"2011","Melton 003D","E01025909",1437,207,65,142,358,155,229,84,172,126,38,21,17,68
"2011","Melton 004A","E01025896",1208,103,36,67,221,183,100,133,213,166,27,18,9,62
"2011","Melton 004B","E01025897",1486,119,34,85,255,175,92,152,344,218,43,31,12,88
"2011","Melton 004C","E01025898",972,63,18,45,162,100,69,118,186,178,26,12,14,70
"2011","Melton 004D","E01025899",876,71,24,47,180,93,47,77,175,130,48,39,9,55
"2011","Melton 004E","E01025900",1045,37,12,25,138,100,51,112,259,218,55,36,19,75
"2011","Melton 004F","E01025905",1212,63,18,45,190,126,66,111,286,234,66,36,30,70
"2011","Melton 005A","E01025893",1617,104,25,79,300,205,107,174,340,251,38,21,17,98
"2011","Melton 005B","E01025894",1081,78,18,60,183,110,91,99,231,166,65,42,23,58
"2011","Melton 005C","E01025895",1299,91,31,60,251,146,109,128,246,211,38,24,14,79
"2011","Melton 005D","E01025907",1297,64,19,45,185,125,95,110,270,256,93,68,25,99
"2011","Melton 005E","E01025908",1292,175,53,122,330,174,145,72,174,107,30,17,13,85
"2011","Melton 006A","E01025889",1305,224,83,141,321,132,239,66,126,98,25,17,8,74
"2011","Melton 006B","E01025910",1313,206,57,149,357,130,247,68,125,80,24,16,8,76
"2011","Melton 006C","E01025911",1138,203,48,155,274,106,198,66,114,95,16,13,3,66
"2011","Melton 006D","E01025912",1177,149,43,106,282,129,230,80,128,101,20,9,11,58
"2011","North West Leicestershire 001A","E01025924",781,139,38,101,172,99,125,57,67,71,15,8,7,36
"2011","North West Leicestershire 001B","E01025925",1948,261,56,205,480,248,209,148,237,226,65,36,29,74
"2011","North West Leicestershire 001C","E01025926",1183,178,45,133,272,175,107,105,145,90,33,20,13,78
"2011","North West Leicestershire 001D","E01025927",1165,94,21,73,227,159,90,106,195,207,33,20,13,54
"2011","North West Leicestershire 001E","E01025928",1149,179,32,147,302,174,92,91,142,93,24,12,12,52
"2011","North West Leicestershire 002A","E01025923",1041,177,45,132,260,119,138,51,122,97,19,13,6,58
"2011","North West Leicestershire 002B","E01025944",1132,172,43,129,316,147,125,90,108,81,17,12,5,76
"2011","North West Leicestershire 002C","E01025945",1155,125,29,96,258,157,110,104,138,85,22,9,13,156
"2011","North West Leicestershire 002D","E01025946",1274,153,26,127,215,151,110,86,152,123,46,31,15,238
"2011","North West Leicestershire 003A","E01025915",904,200,49,151,261,115,62,35,77,62,11,8,3,81
"2011","North West Leicestershire 003B","E01025916",1122,178,38,140,268,138,78,74,172,111,31,23,8,72
"2011","North West Leicestershire 003C","E01025917",1507,216,49,167,386,173,131,120,202,158,35,18,17,86
"2011","North West Leicestershire 003D","E01025918",1113,131,25,106,217,143,71,97,163,165,55,40,15,71
"2011","North West Leicestershire 004A","E01025960",1137,101,31,70,232,149,111,103,195,157,38,29,9,51
"2011","North West Leicestershire 004B","E01025961",1102,83,13,70,221,156,123,108,179,157,25,14,11,50
"2011","North West Leicestershire 004C","E01025962",1033,60,18,42,166,95,74,92,188,221,67,43,24,70
"2011","North West Leicestershire 004D","E01025965",998,89,26,63,193,109,149,72,151,140,49,30,19,46
"2011","North West Leicestershire 005A","E01025955",985,191,60,131,295,142,116,46,83,57,9,5,4,46
"2011","North West Leicestershire 005B","E01025956",832,92,37,55,168,127,73,70,119,112,38,21,17,33
"2011","North West Leicestershire 005C","E01025963",1124,165,57,108,266,119,145,88,120,133,35,23,12,53
"2011","North West Leicestershire 005D","E01025964",1238,235,77,158,317,146,180,57,117,76,26,17,9,84
"2011","North West Leicestershire 006A","E01025914",998,209,60,149,297,147,80,38,89,46,16,6,10,76
"2011","North West Leicestershire 006B","E01025919",1073,139,30,109,230,122,88,88,154,143,43,26,17,66
"2011","North West Leicestershire 006C","E01025920",1099,146,38,108,226,137,84,74,150,159,51,30,21,72
"2011","North West Leicestershire 006D","E01025921",1151,169,30,139,291,154,95,67,155,122,26,16,10,72
"2011","North West Leicestershire 007A","E01025966",1140,53,12,41,169,126,108,121,205,227,53,32,21,78
"2011","North West Leicestershire 007B","E01025967",1205,73,19,54,209,149,91,137,219,240,32,21,11,55
"2011","North West Leicestershire 007C","E01025968",1416,120,31,89,292,197,142,138,215,198,30,19,11,84
"2011","North West Leicestershire 007D","E01025969",1332,111,29,82,260,195,116,124,214,193,43,25,18,76
"2011","North West Leicestershire 008A","E01025950",1174,75,20,55,206,98,106,138,213,218,51,31,20,69
"2011","North West Leicestershire 008B","E01025951",1303,169,59,110,286,195,123,98,162,147,31,20,11,92
"2011","North West Leicestershire 008C","E01025952",1074,103,30,73,194,141,111,103,161,161,35,16,19,65
"2011","North West Leicestershire 008D","E01025953",798,65,18,47,158,83,70,78,135,139,27,20,7,43
"2011","North West Leicestershire 008E","E01025954",1094,147,37,110,253,151,119,81,126,114,42,22,20,61
"2011","North West Leicestershire 009A","E01025932",1028,25,7,18,102,60,70,90,212,276,126,75,51,67
"2011","North West Leicestershire 009B","E01025933",1045,55,13,42,174,120,60,124,175,210,59,32,27,68
"2011","North West Leicestershire 009C","E01025934",1120,60,13,47,153,121,120,81,211,193,112,67,45,69
"2011","North West Leicestershire 009D","E01025935",821,91,26,65,210,138,78,59,97,90,18,14,4,40
"2011","North West Leicestershire 009E","E01025936",873,58,13,45,164,104,77,89,139,164,32,19,13,46
"2011","North West Leicestershire 010A","E01025929",1570,117,24,93,275,206,107,158,243,289,59,26,33,116
"2011","North West Leicestershire 010B","E01025930",1208,57,22,35,184,113,87,104,260,267,82,52,30,54
"2011","North West Leicestershire 010C","E01025931",1311,53,8,45,197,125,105,143,284,273,65,44,21,66
"2011","North West Leicestershire 010D","E01025957",1328,65,18,47,194,168,94,130,270,253,69,39,30,85
"2011","North West Leicestershire 011B","E01025937",1162,121,46,75,229,155,130,79,183,160,34,23,11,71
"2011","North West Leicestershire 011C","E01025958",1203,96,28,68,245,180,92,110,182,188,32,21,11,78
"2011","North West Leicestershire 011D","E01025959",1536,110,29,81,268,212,117,156,293,248,33,20,13,99
"2011","North West Leicestershire 011E","E01033102",1192,121,31,90,260,187,76,120,177,169,31,16,15,51
"2011","North West Leicestershire 011F","E01033103",1292,155,46,109,320,189,118,108,161,130,23,15,8,88
"2011","North West Leicestershire 012A","E01025913",1665,251,85,166,416,189,243,111,161,185,30,21,9,79
"2011","North West Leicestershire 012B","E01025947",1390,120,30,90,251,179,157,133,220,221,24,10,14,85
"2011","North West Leicestershire 012C","E01025948",1229,135,42,93,262,158,137,95,165,157,43,24,19,77
"2011","North West Leicestershire 012D","E01025949",1179,56,22,34,144,109,82,113,231,299,65,35,30,80
"2011","North West Leicestershire 013A","E01025938",931,84,23,61,182,137,95,80,143,147,23,15,8,40
"2011","North West Leicestershire 013B","E01025939",1452,100,23,77,253,197,138,122,237,271,45,30,15,89
"2011","North West Leicestershire 013C","E01025940",1432,112,20,92,250,173,142,148,237,249,49,30,19,72
"2011","North West Leicestershire 013D","E01025941",1144,99,26,73,240,137,129,99,177,183,33,21,12,47
"2011","North West Leicestershire 013E","E01025942",1357,97,34,63,251,199,117,144,236,197,29,15,14,87
"2011","North West Leicestershire 013F","E01025943",1308,69,20,49,200,160,129,120,229,292,64,43,21,45
"2011","Oadby and Wigston 003A","E01025970",1019,129,24,105,238,157,87,60,132,77,28,21,7,111
"2011","Oadby and Wigston 003B","E01025971",874,110,20,90,207,130,70,56,97,63,36,21,15,105
"2011","Oadby and Wigston 003C","E01025972",865,113,21,92,209,151,84,43,92,63,31,20,11,79
"2011","Oadby and Wigston 003D","E01025976",930,73,11,62,183,105,86,56,146,141,56,38,18,84
"2011","Oadby and Wigston 003E","E01025977",926,93,17,76,227,126,93,54,134,77,47,30,17,75
"2011","Oadby and Wigston 003F","E01025978",1095,133,19,114,251,151,92,67,136,119,56,42,14,90
"2011","Oadby and Wigston 005A","E01025992",1061,61,26,35,207,140,91,92,171,185,55,35,20,59
"2011","Oadby and Wigston 005B","E01025994",1035,53,18,35,147,134,66,96,181,199,57,38,19,102
"2011","Oadby and Wigston 005C","E01025997",1025,39,9,30,133,120,58,116,198,208,40,26,14,113
"2011","Oadby and Wigston 005D","E01025999",1031,79,26,53,184,184,91,83,172,126,47,29,18,65
"2011","Oadby and Wigston 005E","E01026005",1183,85,21,64,254,196,111,97,169,137,63,48,15,71
"2011","Oadby and Wigston 006A","E01025985",956,49,17,32,149,149,83,100,179,173,29,22,7,45
"2011","Oadby and Wigston 006B","E01025986",1046,50,19,31,178,164,110,122,172,159,29,18,11,62
"2011","Oadby and Wigston 006C","E01025987",1085,58,17,41,193,153,92,98,169,178,65,25,40,79
"2011","Oadby and Wigston 006D","E01025988",1153,61,16,45,211,185,76,103,189,205,59,38,21,64
"2011","Oadby and Wigston 006E","E01025989",1227,61,14,47,219,201,95,123,192,201,54,27,27,81
"2011","Oadby and Wigston 007A","E01025990",1040,75,17,58,211,188,85,93,148,146,31,15,16,63
"2011","Oadby and Wigston 007B","E01025991",1119,110,26,84,227,200,92,89,185,126,22,17,5,68
"2011","Oadby and Wigston 007C","E01025993",1064,90,25,65,190,187,96,86,183,160,19,12,7,53
"2011","Oadby and Wigston 007D","E01025998",1393,171,37,134,362,255,139,92,161,108,21,15,6,84
"2011","Oadby and Wigston 007E","E01026000",1017,97,25,72,218,211,81,87,153,95,14,11,3,61
"2011","Oadby and Wigston 007F","E01026001",1051,110,28,82,232,179,113,81,154,91,27,16,11,64
"2011","Oadby and Wigston 008A","E01025995",1037,75,11,64,190,150,81,90,168,155,48,28,20,80
"2011","Oadby and Wigston 008B","E01026003",1153,98,32,66,252,187,99,84,181,130,30,19,11,92
"2011","Oadby and Wigston 008C","E01026004",1226,143,39,104,285,215,128,75,154,111,22,14,8,93
"2011","Oadby and Wigston 008D","E01032600",1383,111,35,76,298,203,117,105,226,175,42,23,19,106
"2011","Oadby and Wigston 008E","E01032601",1068,96,24,72,223,202,81,87,159,110,21,9,12,89
"2011","Oadby and Wigston 009A","E01025973",2323,295,61,234,237,169,188,40,84,75,78,63,15,1157
"2011","Oadby and Wigston 009B","E01025974",1884,189,32,157,233,144,124,58,108,77,48,29,19,903
"2011","Oadby and Wigston 009C","E01025975",1024,233,39,194,248,126,117,36,62,45,53,41,12,104
"2011","Oadby and Wigston 009E","E01025979",969,130,23,107,183,144,78,59,139,90,43,34,9,103
"2011","Oadby and Wigston 009D","E01025980",1011,181,40,141,190,128,100,37,108,85,50,36,14,132
"2011","Oadby and Wigston 009F","E01025981",1172,153,25,128,240,198,95,54,142,107,55,39,16,128
"2011","Oadby and Wigston 009G","E01025982",1394,338,52,286,320,198,105,43,117,60,41,27,14,172
"2011","Oadby and Wigston 009H","E01025983",907,129,24,105,222,138,82,45,105,67,27,15,12,92
"2011","Oadby and Wigston 009I","E01025984",1051,210,29,181,212,160,106,34,98,66,49,30,19,116
"2011","Boston 001A","E01026007",812,39,14,25,154,122,104,84,147,103,32,25,7,27
"2011","Boston 001B","E01026008",1200,47,17,30,187,141,157,135,185,237,65,47,18,46
"2011","Boston 001C","E01026009",948,46,17,29,130,124,125,83,179,175,36,24,12,50
"2011","Boston 001D","E01026023",1050,70,27,43,160,113,163,72,227,149,52,37,15,44
"2011","Boston 001E","E01026024",1429,82,18,64,250,170,191,119,271,206,43,29,14,97
"2011","Boston 002A","E01026010",1038,9,4,5,69,46,46,81,313,299,123,84,39,52
"2011","Boston 002B","E01026011",2142,43,12,31,206,153,107,199,597,549,150,105,45,138
"2011","Boston 002C","E01026030",1584,29,13,16,142,101,93,152,456,419,118,82,36,74
"2011","Boston 002D","E01026032",1512,24,11,13,153,101,103,142,414,390,106,68,38,79
"2011","Boston 002E","E01026037",934,18,3,15,96,65,64,83,276,205,68,44,24,59
"2011","Boston 003A","E01026006",2042,63,12,51,215,142,133,193,575,508,130,79,51,83
"2011","Boston 003B","E01026021",1277,127,22,105,265,122,104,86,263,212,41,24,17,57
"2011","Boston 003C","E01026025",1716,51,10,41,215,128,101,170,454,362,97,48,49,138
"2011","Boston 003D","E01026036",1267,50,12,38,145,108,114,116,313,293,69,39,30,59
"2011","Boston 004A","E01026012",775,19,7,12,83,73,52,68,205,186,53,36,17,36
"2011","Boston 004B","E01026015",1096,41,12,29,188,123,61,159,254,185,34,23,11,51
"2011","Boston 004C","E01026026",1328,28,9,19,113,98,100,138,375,275,113,80,33,88
"2011","Boston 004D","E01026027",1376,41,12,29,190,141,99,124,346,278,73,47,26,84
"2011","Boston 004E","E01026028",1293,35,13,22,222,136,84,124,327,248,63,36,27,54
"2011","Boston 006A","E01026016",1717,116,40,76,305,189,266,131,272,280,72,50,22,86
"2011","Boston 006B","E01026033",1466,99,29,70,289,144,258,134,246,187,52,32,20,57
"2011","Boston 006C","E01026034",1302,74,28,46,244,150,137,115,236,222,69,40,29,55
"2011","Boston 007A","E01026017",1170,47,28,19,194,115,160,111,231,191,63,36,27,58
"2011","Boston 007B","E01026018",1276,111,39,72,239,149,215,105,224,150,37,17,20,46
"2011","Boston 007C","E01026019",1906,87,24,63,295,205,161,193,409,327,102,59,43,127
"2011","Boston 007D","E01026020",1647,112,36,76,302,190,186,152,311,248,65,38,27,81
"2011","Boston 007E","E01026041",887,37,14,23,107,89,65,120,228,163,36,24,12,42
"2011","Boston 008A","E01026013",1053,83,23,60,211,147,112,81,182,151,27,18,9,59
"2011","Boston 008B","E01026014",1386,100,30,70,285,191,147,136,249,159,49,33,16,70
"2011","Boston 008C","E01026022",1488,212,33,179,297,182,160,101,235,168,51,44,7,82
"2011","Boston 008D","E01026038",958,61,15,46,182,127,70,97,192,144,25,13,12,60
"2011","Boston 008E","E01026040",917,67,24,43,162,103,107,84,182,127,46,23,23,39
"2011","Boston 009A","E01026029",1822,98,37,61,340,226,159,191,389,290,51,41,10,78
"2011","Boston 009B","E01026031",1066,26,8,18,166,124,104,129,264,190,31,27,4,32
"2011","Boston 009C","E01026035",1546,132,48,84,328,250,130,140,275,191,28,21,7,72
"2011","Boston 009D","E01026039",880,61,21,40,189,97,112,81,177,111,21,16,5,31
"2011","East Lindsey 001A","E01026045",1378,118,31,87,349,138,209,103,212,143,48,31,17,58
"2011","East Lindsey 001B","E01026061",946,74,25,49,204,137,96,95,155,106,17,8,9,62
"2011","East Lindsey 001C","E01026062",883,65,17,48,198,118,95,113,127,93,34,18,16,40
"2011","East Lindsey 001D","E01026063",938,82,27,55,226,126,93,105,141,87,20,13,7,58
"2011","East Lindsey 001E","E01026080",1477,148,46,102,380,177,203,111,194,130,39,26,13,95
"2011","East Lindsey 001F","E01026106",897,77,19,58,215,112,111,97,116,94,31,24,7,44
"2011","East Lindsey 001G","E01026107",971,71,17,54,218,101,134,89,150,90,27,16,11,91
"2011","East Lindsey 002A","E01026058",1632,125,39,86,345,240,201,136,254,196,44,23,21,91
"2011","East Lindsey 002B","E01026076",1653,117,39,78,365,196,279,121,257,187,55,34,21,76
"2011","East Lindsey 002C","E01026079",1433,76,27,49,276,158,204,125,260,197,48,34,14,89
"2011","East Lindsey 003A","E01026077",806,61,21,40,155,79,83,63,146,113,51,31,20,55
"2011","East Lindsey 003B","E01026078",810,37,12,25,124,90,65,91,169,136,45,29,16,53
"2011","East Lindsey 003C","E01026087",800,39,14,25,121,75,59,88,177,140,58,35,23,43
"2011","East Lindsey 003D","E01026088",912,75,23,52,194,133,84,78,160,98,40,30,10,50
"2011","East Lindsey 003E","E01026090",985,53,14,39,194,107,68,85,230,141,52,36,16,55
"2011","East Lindsey 003F","E01026091",816,59,20,39,194,101,83,77,136,89,17,13,4,60
"2011","East Lindsey 003G","E01026108",1712,77,21,56,222,179,128,164,385,322,135,90,45,100
"2011","East Lindsey 004A","E01026081",1761,123,29,94,327,206,163,159,336,242,107,68,39,98
"2011","East Lindsey 004C","E01026089",1458,125,50,75,403,175,170,131,226,121,40,25,15,67
"2011","East Lindsey 004D","E01032986",838,66,13,53,188,96,96,63,153,93,44,32,12,39
"2011","East Lindsey 004E","E01032987",964,67,22,45,217,122,85,76,178,121,54,35,19,44
"2011","East Lindsey 005A","E01026072",1387,41,10,31,172,127,157,133,332,257,118,83,35,50
"2011","East Lindsey 005B","E01026073",1438,31,13,18,178,97,182,149,292,287,151,123,28,71
"2011","East Lindsey 005C","E01026074",1540,43,10,33,182,115,171,180,386,299,97,74,23,67
"2011","East Lindsey 005D","E01026099",1558,88,31,57,290,167,279,111,269,207,79,54,25,68
"2011","East Lindsey 006A","E01026103",1424,50,17,33,216,164,193,138,315,201,90,74,16,57
"2011","East Lindsey 006B","E01026104",1605,75,37,38,246,193,232,153,350,242,56,44,12,58
"2011","East Lindsey 006C","E01026109",1701,63,27,36,205,139,188,190,396,363,90,48,42,67
"2011","East Lindsey 007A","E01026071",1612,181,54,127,374,187,282,124,209,139,42,24,18,74
"2011","East Lindsey 007B","E01026082",1676,127,45,82,355,186,368,124,233,159,44,33,11,80
"2011","East Lindsey 007C","E01026121",1802,132,37,95,359,214,254,164,300,219,62,48,14,98
"2011","East Lindsey 008A","E01026042",1082,40,12,28,160,98,153,94,241,157,66,41,25,73
"2011","East Lindsey 008B","E01026043",1114,31,11,20,192,133,115,109,252,157,67,48,19,58
"2011","East Lindsey 008C","E01026044",979,59,19,40,178,107,186,88,169,110,36,23,13,46
"2011","East Lindsey 008D","E01026113",1510,79,31,48,292,158,314,95,251,190,54,40,14,77
"2011","East Lindsey 008E","E01026117",1395,77,20,57,256,161,266,114,233,151,63,46,17,74
"2011","East Lindsey 009A","E01026060",1024,89,32,57,234,129,187,54,131,105,42,32,10,53
"2011","East Lindsey 009B","E01026068",1615,137,39,98,345,195,320,118,242,138,62,49,13,58
"2011","East Lindsey 009C","E01026070",1472,141,41,100,375,171,252,103,202,113,45,33,12,70
"2011","East Lindsey 009D","E01026105",1638,147,49,98,389,186,345,123,211,118,40,24,16,79
"2011","East Lindsey 010A","E01026048",1165,30,16,14,136,80,129,135,271,268,79,64,15,37
"2011","East Lindsey 010B","E01026049",1183,42,15,27,176,103,243,99,231,200,49,37,12,40
"2011","East Lindsey 010C","E01026050",1167,36,17,19,151,107,158,121,251,251,57,34,23,35
"2011","East Lindsey 010D","E01026069",1905,33,15,18,253,114,215,228,416,491,96,67,29,59
"2011","East Lindsey 011A","E01026064",1035,53,14,39,138,111,88,110,218,189,69,45,24,59
"2011","East Lindsey 011B","E01026065",1238,97,32,65,299,190,145,106,186,132,28,16,12,55
"2011","East Lindsey 011C","E01026066",1344,83,20,63,295,199,193,113,198,161,37,22,15,65
"2011","East Lindsey 011D","E01026067",1377,88,28,60,262,143,150,117,249,192,90,71,19,86
"2011","East Lindsey 012A","E01026084",1157,29,9,20,153,111,125,107,256,199,84,51,33,93
"2011","East Lindsey 012B","E01026085",1640,57,22,35,238,176,202,153,390,319,58,37,21,47
"2011","East Lindsey 012C","E01026115",1303,30,14,16,148,90,141,136,309,301,97,72,25,51
"2011","East Lindsey 012D","E01026116",1247,40,8,32,194,119,220,112,201,218,75,47,28,68
"2011","East Lindsey 013A","E01026046",838,33,9,24,164,94,148,68,133,126,35,18,17,37
"2011","East Lindsey 013B","E01026047",891,54,20,34,157,117,150,84,156,120,24,20,4,29
"2011","East Lindsey 013C","E01026055",839,56,15,41,166,110,163,69,128,86,27,19,8,34
"2011","East Lindsey 013D","E01026059",903,48,14,34,167,99,145,62,157,86,41,30,11,98
"2011","East Lindsey 013E","E01026100",1267,60,20,40,248,156,153,113,271,153,41,23,18,72
"2011","East Lindsey 013F","E01026101",844,34,9,25,130,103,70,71,190,120,83,67,16,43
"2011","East Lindsey 014A","E01026092",1073,22,9,13,126,77,102,90,276,225,89,61,28,66
"2011","East Lindsey 014B","E01026093",1341,36,8,28,153,92,162,118,299,288,145,89,56,48
"2011","East Lindsey 014C","E01026095",847,42,9,33,159,67,135,65,153,120,50,36,14,56
"2011","East Lindsey 014D","E01026114",1110,27,10,17,160,98,141,109,250,205,73,40,33,47
"2011","East Lindsey 015A","E01026083",1245,23,8,15,132,69,106,126,303,299,112,82,30,75
"2011","East Lindsey 015B","E01026094",1185,19,5,14,163,108,119,106,289,248,76,51,25,57
"2011","East Lindsey 015C","E01026096",1050,67,22,45,228,115,211,73,163,112,20,11,9,61
"2011","East Lindsey 015D","E01026097",1030,29,8,21,135,100,106,78,241,214,59,36,23,68
"2011","East Lindsey 016A","E01026051",966,46,13,33,180,134,116,103,182,132,26,15,11,47
"2011","East Lindsey 016B","E01026052",1107,59,26,33,230,145,95,121,203,164,56,25,31,34
"2011","East Lindsey 016C","E01026053",1381,149,68,81,355,196,110,117,224,125,48,26,22,57
"2011","East Lindsey 016D","E01026054",1667,123,78,45,307,338,115,210,252,196,57,35,22,69
"2011","East Lindsey 016E","E01026118",1173,131,57,74,296,190,150,80,141,107,24,16,8,54
"2011","East Lindsey 016F","E01026119",743,95,41,54,199,107,110,45,89,48,14,12,2,36
"2011","East Lindsey 016G","E01026120",946,103,42,61,201,95,130,76,136,105,33,27,6,67
"2011","East Lindsey 017A","E01026056",863,49,15,34,148,89,184,66,129,125,35,23,12,38
"2011","East Lindsey 017B","E01026110",1065,49,19,30,196,98,159,91,226,149,40,29,11,57
"2011","East Lindsey 017C","E01026111",1147,54,14,40,188,109,201,85,230,185,45,32,13,50
"2011","East Lindsey 017D","E01026112",800,25,11,14,105,49,92,65,181,149,92,67,25,42
"2011","East Lindsey 018A","E01026057",1467,115,44,71,260,167,237,120,253,188,54,27,27,73
"2011","East Lindsey 018B","E01026075",1602,122,33,89,319,204,275,138,238,180,53,35,18,73
"2011","East Lindsey 018C","E01026098",1401,138,34,104,332,163,191,118,217,142,33,16,17,67
"2011","East Lindsey 018D","E01026102",1734,86,24,62,298,217,270,149,325,234,57,36,21,98
"2011","Lincoln 001A","E01026149",1188,37,9,28,188,132,83,89,276,194,113,78,35,76
"2011","Lincoln 001B","E01026150",1038,18,3,15,104,91,75,95,249,204,139,80,59,63
"2011","Lincoln 001C","E01026166",867,33,11,22,117,98,58,78,185,150,76,54,22,72
"2011","Lincoln 001D","E01026168",988,17,5,12,92,66,61,76,295,213,103,66,37,65
"2011","Lincoln 002A","E01026153",1788,188,48,140,418,241,149,146,291,176,75,51,24,104
"2011","Lincoln 002B","E01026155",1282,101,15,86,282,213,111,118,225,123,33,18,15,76
"2011","Lincoln 002C","E01026157",924,48,13,35,142,115,59,64,171,160,117,86,31,48
"2011","Lincoln 002D","E01026165",962,35,12,23,148,105,67,89,210,171,86,55,31,51
"2011","Lincoln 003A","E01026125",1301,99,16,83,213,105,121,113,186,254,143,116,27,67
"2011","Lincoln 003B","E01026144",1268,105,18,87,216,101,67,73,141,89,67,48,19,409
"2011","Lincoln 003C","E01026147",1809,264,55,209,519,276,144,122,163,91,61,45,16,169
"2011","Lincoln 003D","E01026148",1430,129,26,103,350,152,100,86,177,140,56,33,23,240
"2011","Lincoln 003E","E01026151",1358,139,35,104,319,166,109,96,218,107,64,40,24,140
"2011","Lincoln 003F","E01026164",1054,119,24,95,252,106,65,45,114,73,29,17,12,251
"2011","Lincoln 003G","E01026167",1127,226,45,181,359,120,101,45,80,54,28,14,14,114
"2011","Lincoln 004A","E01026122",1571,170,34,136,286,113,95,110,195,150,73,49,24,379
"2011","Lincoln 004B","E01026123",1700,134,26,108,332,226,100,148,302,222,115,83,32,121
"2011","Lincoln 004C","E01026124",1217,62,8,54,167,112,65,81,271,218,73,40,33,168
"2011","Lincoln 004D","E01026126",1376,54,14,40,152,104,77,115,282,272,191,115,76,129
"2011","Lincoln 004E","E01026152",1022,20,7,13,61,76,49,85,231,251,156,113,43,93
"2011","Lincoln 004F","E01026154",1021,23,6,17,112,105,63,89,259,197,78,51,27,95
"2011","Lincoln 004G","E01026156",904,41,14,27,108,73,77,77,193,175,78,52,26,82
"2011","Lincoln 005A","E01026132",2575,130,28,102,184,136,75,95,183,123,45,29,16,1604
"2011","Lincoln 005B","E01026143",2000,163,29,134,284,125,95,55,131,86,51,32,19,1010
"2011","Lincoln 005C","E01026145",1283,134,16,118,242,112,95,61,104,97,46,28,18,392
"2011","Lincoln 005D","E01026146",1761,47,12,35,144,107,67,55,152,123,47,32,15,1019
"2011","Lincoln 006A","E01026134",1162,66,19,47,204,124,84,101,225,188,65,46,19,105
"2011","Lincoln 006B","E01026176",1426,44,11,33,143,120,62,110,265,243,134,80,54,305
"2011","Lincoln 006C","E01026177",1525,53,7,46,194,106,66,119,323,227,95,58,37,342
"2011","Lincoln 006D","E01026178",1315,59,12,47,191,122,82,112,244,208,77,36,41,220
"2011","Lincoln 007A","E01026127",989,21,2,19,112,81,82,110,248,204,81,49,32,50
"2011","Lincoln 007B","E01026128",1954,163,41,122,408,282,131,203,354,242,63,37,26,108
"2011","Lincoln 007C","E01026129",1195,20,7,13,102,96,77,90,293,240,180,127,53,97
"2011","Lincoln 007D","E01026131",1016,54,11,43,166,98,93,118,218,163,40,21,19,66
"2011","Lincoln 008A","E01026133",2967,76,19,57,300,198,124,139,368,240,79,47,32,1443
"2011","Lincoln 008B","E01026135",1222,106,27,79,244,184,132,102,209,130,35,24,11,80
"2011","Lincoln 008C","E01026136",1031,77,21,56,226,151,99,86,198,104,27,13,14,63
"2011","Lincoln 008D","E01026174",1052,84,22,62,198,139,72,94,190,144,63,37,26,68
"2011","Lincoln 009A","E01026130",1014,100,31,69,230,160,98,74,166,99,35,30,5,52
"2011","Lincoln 009B","E01026158",1042,104,34,70,215,164,103,93,185,107,19,12,7,52
"2011","Lincoln 009C","E01026159",1099,83,21,62,227,176,72,104,212,126,35,22,13,64
"2011","Lincoln 009D","E01026160",1015,87,19,68,244,173,77,101,169,101,19,8,11,44
"2011","Lincoln 009E","E01026162",1056,83,22,61,197,169,86,90,198,134,35,24,11,64
"2011","Lincoln 009F","E01026163",1090,105,24,81,260,196,73,96,159,124,19,13,6,58
"2011","Lincoln 010A","E01026161",997,27,6,21,110,100,75,94,237,218,78,50,28,58
"2011","Lincoln 010B","E01026170",1038,49,15,34,134,119,83,102,201,170,91,64,27,89
"2011","Lincoln 010C","E01026172",995,23,6,17,128,105,66,95,236,187,82,60,22,73
"2011","Lincoln 010D","E01026173",1054,23,7,16,77,69,63,80,255,257,163,105,58,67
"2011","Lincoln 010E","E01026175",1420,43,10,33,219,150,101,133,318,241,137,86,51,78
"2011","Lincoln 011A","E01026137",920,59,15,44,182,116,91,91,176,116,25,20,5,64
"2011","Lincoln 011B","E01026138",1115,57,11,46,208,167,92,129,216,152,29,18,11,65
"2011","Lincoln 011C","E01026139",869,68,22,46,203,138,84,72,143,86,15,11,4,60
"2011","Lincoln 011D","E01026140",948,47,10,37,165,127,68,94,200,153,53,30,23,41
"2011","Lincoln 011E","E01026141",1022,102,30,72,266,139,101,75,161,78,26,17,9,74
"2011","Lincoln 011F","E01026142",952,45,19,26,145,120,66,116,197,138,54,36,18,71
"2011","Lincoln 011G","E01026169",1177,64,14,50,222,141,109,93,245,162,64,45,19,77
"2011","Lincoln 011H","E01026171",1086,78,24,54,261,182,95,78,208,116,19,11,8,49
"2011","North Kesteven 001A","E01026186",1170,115,49,66,292,177,96,117,161,112,27,21,6,73
"2011","North Kesteven 001B","E01026187",1420,180,76,104,425,221,99,107,174,100,25,9,16,89
"2011","North Kesteven 001C","E01026189",1296,139,35,104,354,231,132,117,163,100,16,9,7,44
"2011","North Kesteven 001D","E01026203",1305,155,49,106,353,201,152,100,144,104,27,16,11,69
"2011","North Kesteven 001E","E01026204",1246,118,36,82,317,245,96,97,183,112,13,4,9,65
"2011","North Kesteven 001F","E01026206",1381,161,57,104,347,226,131,100,191,110,25,15,10,90
"2011","North Kesteven 003B","E01026182",1046,170,61,109,270,134,111,72,134,86,15,11,4,54
"2011","North Kesteven 003C","E01026193",1070,162,53,109,266,140,158,71,111,81,17,10,7,64
"2011","North Kesteven 003D","E01026199",1714,182,56,126,416,192,292,135,226,141,49,32,17,81
"2011","North Kesteven 003E","E01026225",1185,108,39,69,266,188,178,91,147,126,21,15,6,60
"2011","North Kesteven 003F","E01026226",1364,118,36,82,281,235,156,110,231,137,31,24,7,65
"2011","North Kesteven 003G","E01032990",1712,215,84,131,537,263,139,125,192,119,21,12,9,101
"2011","North Kesteven 003H","E01032994",983,104,35,69,229,142,130,74,139,88,23,13,10,54
"2011","North Kesteven 004A","E01026184",1358,188,126,62,416,316,48,139,106,65,27,12,15,53
"2011","North Kesteven 004B","E01026185",1238,101,43,58,290,185,156,89,176,136,33,22,11,72
"2011","North Kesteven 004C","E01026188",1515,112,42,70,363,271,127,140,208,170,45,31,14,79
"2011","North Kesteven 004D","E01026190",1045,95,33,62,216,152,90,95,192,114,46,34,12,45
"2011","North Kesteven 004E","E01026237",843,56,14,42,190,121,71,84,157,105,19,8,11,40
"2011","North Kesteven 004F","E01026238",988,85,22,63,234,152,70,98,135,109,37,28,9,68
"2011","North Kesteven 005A","E01026191",1223,145,49,96,313,175,131,90,159,110,28,16,12,72
"2011","North Kesteven 005B","E01026205",1014,70,21,49,227,155,123,75,166,126,26,17,9,46
"2011","North Kesteven 005C","E01026211",1454,179,69,110,400,203,162,101,175,141,23,11,12,70
"2011","North Kesteven 005D","E01026212",1131,92,33,59,271,182,102,110,164,106,45,32,13,59
"2011","North Kesteven 005E","E01026213",1189,81,24,57,198,160,112,126,216,186,46,35,11,64
"2011","North Kesteven 006A","E01026192",904,130,40,90,247,97,128,54,113,66,15,9,6,54
"2011","North Kesteven 006B","E01026194",1307,153,61,92,330,184,138,114,191,105,28,19,9,64
"2011","North Kesteven 006C","E01026195",1402,246,100,146,378,198,191,80,144,85,16,10,6,64
"2011","North Kesteven 006D","E01026196",1097,156,57,99,271,136,173,77,122,88,20,15,5,54
"2011","North Kesteven 007A","E01026180",1069,110,38,72,237,117,151,92,162,123,39,24,15,38
"2011","North Kesteven 007B","E01026183",1830,106,41,65,328,192,241,183,339,239,95,74,21,107
"2011","North Kesteven 007C","E01026210",1697,127,46,81,349,207,280,123,276,194,52,31,21,89
"2011","North Kesteven 007D","E01026224",1210,59,26,33,204,152,119,100,243,199,65,40,25,69
"2011","North Kesteven 008A","E01026179",973,104,51,53,324,182,60,51,95,54,64,60,4,39
"2011","North Kesteven 008B","E01026197",1037,102,36,66,249,145,80,116,171,106,21,12,9,47
"2011","North Kesteven 008C","E01026198",1044,269,230,39,297,156,39,68,95,70,15,6,9,35
"2011","North Kesteven 008D","E01026223",1532,139,54,85,357,209,148,142,245,173,37,22,15,82
"2011","North Kesteven 009A","E01026209",1519,161,46,115,382,204,164,115,232,150,36,22,14,75
"2011","North Kesteven 009B","E01026221",1727,225,76,149,426,205,271,95,224,146,41,22,19,94
"2011","North Kesteven 009C","E01026222",1325,114,49,65,307,207,151,102,230,116,37,27,10,61
"2011","North Kesteven 010A","E01026227",1047,45,11,34,187,110,96,110,240,163,49,29,20,47
"2011","North Kesteven 010B","E01026230",862,26,11,15,127,84,71,84,179,191,52,33,19,48
"2011","North Kesteven 010C","E01026231",1983,177,54,123,438,269,164,207,337,203,49,22,27,139
"2011","North Kesteven 010D","E01026232",1581,97,31,66,310,179,124,132,350,226,75,44,31,88
"2011","North Kesteven 010E","E01026235",1126,40,10,30,176,127,98,104,226,194,92,56,36,69
"2011","North Kesteven 011A","E01026228",1119,76,28,48,242,153,109,105,192,142,32,13,19,68
"2011","North Kesteven 011B","E01026229",1133,108,41,67,264,157,79,111,182,109,41,15,26,82
"2011","North Kesteven 011C","E01026233",1238,123,47,76,357,181,116,77,164,114,30,17,13,76
"2011","North Kesteven 011D","E01026234",2015,269,111,158,561,319,134,130,261,150,42,22,20,149
"2011","North Kesteven 011E","E01026236",836,47,12,35,168,100,82,75,173,128,23,18,5,40
"2011","North Kesteven 012A","E01026200",1185,133,50,83,269,181,145,74,163,122,35,23,12,63
"2011","North Kesteven 012B","E01026201",1443,111,42,69,295,191,238,94,215,161,59,27,32,79
"2011","North Kesteven 012C","E01026202",1231,121,43,78,287,182,145,72,189,151,29,22,7,55
"2011","North Kesteven 012D","E01026207",936,49,19,30,177,126,132,75,163,114,44,33,11,56
"2011","North Kesteven 012E","E01026208",1197,147,53,94,295,176,132,79,166,104,32,23,9,66
"2011","North Kesteven 013A","E01026220",1623,98,25,73,298,282,144,160,308,196,48,34,14,89
"2011","North Kesteven 013B","E01032988",1009,62,16,46,227,133,86,95,175,122,44,35,9,65
"2011","North Kesteven 013C","E01032989",1018,110,35,75,295,163,64,82,112,89,37,21,16,66
"2011","North Kesteven 013D","E01032993",1062,109,34,75,243,149,82,95,192,95,18,11,7,79
"2011","North Kesteven 014A","E01026214",834,64,21,43,168,128,68,88,152,105,19,10,9,42
"2011","North Kesteven 014B","E01026215",753,58,20,38,196,130,66,67,102,64,18,13,5,52
"2011","North Kesteven 014C","E01026218",852,54,16,38,157,131,96,92,148,111,21,17,4,42
"2011","North Kesteven 014D","E01026219",905,54,13,41,187,137,88,88,159,120,18,12,6,54
"2011","North Kesteven 014E","E01032991",1067,87,33,54,238,185,106,92,179,104,17,7,10,59
"2011","North Kesteven 014F","E01032992",998,75,18,57,210,155,89,84,183,93,44,36,8,65
"2011","South Holland 001A","E01026242",1096,61,29,32,209,124,143,96,200,177,30,11,19,56
"2011","South Holland 001B","E01026243",964,43,15,28,156,95,107,91,189,193,42,19,23,48
"2011","South Holland 001C","E01026244",975,69,22,47,181,117,147,103,165,119,28,15,13,46
"2011","South Holland 001D","E01026247",1356,87,25,62,263,151,212,113,235,186,55,37,18,54
"2011","South Holland 001E","E01026276",1777,122,53,69,321,203,303,152,295,254,62,34,28,65
"2011","South Holland 002A","E01026246",1756,110,36,74,305,178,260,148,342,254,72,34,38,87
"2011","South Holland 002B","E01026248",1703,104,35,69,265,153,211,164,384,255,58,28,30,109
"2011","South Holland 002C","E01026257",1315,74,27,47,236,186,156,140,252,185,40,26,14,46
"2011","South Holland 003A","E01026250",1289,57,28,29,181,109,133,136,291,246,74,36,38,62
"2011","South Holland 003B","E01026251",1236,78,22,56,200,164,126,132,244,193,44,26,18,55
"2011","South Holland 003C","E01026252",1185,71,24,47,218,151,108,102,257,183,31,18,13,64
"2011","South Holland 003D","E01026253",1233,54,11,43,188,127,122,129,277,221,53,29,24,62
"2011","South Holland 004A","E01026281",992,101,40,61,203,112,118,90,166,109,33,20,13,60
"2011","South Holland 004B","E01026282",1217,80,26,54,230,139,159,117,215,177,44,26,18,56
"2011","South Holland 004C","E01026283",1244,111,37,74,237,151,182,115,199,156,38,16,22,55
"2011","South Holland 004D","E01026285",1059,68,16,52,190,117,159,98,182,162,35,17,18,48
"2011","South Holland 004E","E01026286",927,67,22,45,159,91,138,78,173,131,36,19,17,54
"2011","South Holland 005A","E01026241",1480,121,40,81,288,165,180,142,245,236,40,21,19,63
"2011","South Holland 005B","E01026258",1302,121,35,86,242,178,181,132,185,167,41,19,22,55
"2011","South Holland 005C","E01026259",1309,79,19,60,223,145,209,114,222,206,41,19,22,70
"2011","South Holland 005D","E01026260",1369,87,24,63,207,131,163,138,279,243,57,38,19,64
"2011","South Holland 006B","E01026266",1529,92,26,66,217,148,103,146,335,362,57,27,30,69
"2011","South Holland 006C","E01026273",1216,96,27,69,279,179,107,98,210,153,38,22,16,56
"2011","South Holland 006D","E01026274",1355,106,39,67,276,198,92,120,246,199,42,22,20,76
"2011","South Holland 006E","E01026275",1433,81,33,48,219,152,120,142,287,329,59,33,26,44
"2011","South Holland 006F","E01032995",1009,58,20,38,140,93,84,86,233,226,50,31,19,39
"2011","South Holland 006G","E01032996",980,97,37,60,230,125,68,95,156,129,33,19,14,47
"2011","South Holland 007A","E01026268",1405,59,18,41,203,105,126,121,314,338,73,53,20,66
"2011","South Holland 007B","E01026269",1565,118,38,80,283,209,157,115,304,265,40,27,13,74
"2011","South Holland 007C","E01026270",1356,59,24,35,164,96,118,128,278,356,89,58,31,68
"2011","South Holland 007D","E01026271",1280,45,20,25,137,94,84,134,274,370,71,40,31,71
"2011","South Holland 007E","E01026272",924,97,29,68,188,81,100,82,153,154,31,19,12,38
"2011","South Holland 008A","E01026254",1293,82,31,51,203,157,203,123,238,193,52,30,22,42
"2011","South Holland 008B","E01026255",1398,78,29,49,215,162,159,128,321,218,59,36,23,58
"2011","South Holland 008C","E01026256",1202,64,27,37,169,134,159,102,270,207,44,28,16,53
"2011","South Holland 008D","E01026277",1136,41,14,27,136,78,98,110,307,221,76,40,36,69
"2011","South Holland 008E","E01026278",1041,54,14,40,170,116,123,121,217,179,32,16,16,29
"2011","South Holland 008F","E01026279",926,45,17,28,135,137,81,101,205,135,34,21,13,53
"2011","South Holland 009A","E01026262",1184,68,22,46,215,164,142,108,225,169,32,21,11,61
"2011","South Holland 009B","E01026263",1383,126,37,89,297,181,107,142,232,203,37,24,13,58
"2011","South Holland 009C","E01026264",1127,49,19,30,157,118,84,135,241,244,57,34,23,42
"2011","South Holland 009D","E01026265",942,61,12,49,170,114,93,90,173,149,39,23,16,53
"2011","South Holland 009E","E01026267",2104,130,46,84,335,239,169,208,441,418,68,32,36,96
"2011","South Holland 010A","E01026245",1555,92,28,64,289,189,229,142,264,204,81,61,20,65
"2011","South Holland 010B","E01026249",1416,100,30,70,259,182,242,110,254,162,49,31,18,58
"2011","South Holland 010C","E01026280",1897,149,43,106,327,226,313,145,318,257,71,45,26,91
"2011","South Holland 011A","E01026239",1278,124,48,76,284,172,200,84,171,147,38,19,19,58
"2011","South Holland 011B","E01026240",1738,164,54,110,357,270,183,142,257,210,57,31,26,98
"2011","South Holland 011C","E01026284",1464,153,42,111,321,195,163,121,199,170,45,19,26,97
"2011","South Kesteven 001A","E01026313",1125,147,54,93,293,166,166,75,122,75,22,12,10,59
"2011","South Kesteven 001B","E01026314",896,89,24,65,201,135,100,92,108,93,25,14,11,53
"2011","South Kesteven 001C","E01026329",1354,214,79,135,355,147,177,84,149,116,30,17,13,82
"2011","South Kesteven 001D","E01026333",1847,282,89,193,515,190,282,95,176,159,47,22,25,101
"2011","South Kesteven 002A","E01026291",1426,166,54,112,329,212,153,109,202,135,45,32,13,75
"2011","South Kesteven 002B","E01026340",1531,134,49,85,342,210,180,119,230,172,57,45,12,87
"2011","South Kesteven 002C","E01026355",1685,264,65,199,445,226,235,84,183,121,34,28,6,93
"2011","South Kesteven 002D","E01026365",1701,261,79,182,437,221,230,88,197,148,24,15,9,95
"2011","South Kesteven 003A","E01026325",998,32,10,22,124,121,69,99,235,192,58,39,19,68
"2011","South Kesteven 003B","E01026326",1070,81,27,54,216,138,109,101,193,121,43,27,16,68
"2011","South Kesteven 003C","E01026327",950,35,9,26,170,113,79,86,200,174,32,25,7,61
"2011","South Kesteven 003D","E01026328",995,28,13,15,92,79,67,94,229,231,92,65,27,83
"2011","South Kesteven 003E","E01026352",939,143,39,104,226,145,73,67,147,70,20,13,7,48
"2011","South Kesteven 003F","E01026353",1133,103,25,78,220,115,99,105,219,143,74,46,28,55
"2011","South Kesteven 003G","E01026354",925,118,47,71,214,159,81,75,135,68,19,12,7,56
"2011","South Kesteven 004A","E01026320",1250,167,51,116,299,207,93,103,170,95,17,10,7,99
"2011","South Kesteven 004B","E01026321",942,96,24,72,225,168,88,79,142,64,12,8,4,68
"2011","South Kesteven 004C","E01026322",856,74,24,50,191,143,53,70,156,108,13,5,8,48
"2011","South Kesteven 004D","E01026323",1377,139,40,99,267,159,113,106,249,191,76,40,36,77
"2011","South Kesteven 004E","E01026324",1661,136,34,102,372,260,139,163,280,178,25,16,9,108
"2011","South Kesteven 005A","E01026308",1023,21,5,16,84,64,60,112,264,247,112,67,45,59
"2011","South Kesteven 005B","E01026309",1188,47,16,31,160,159,87,133,276,208,44,25,19,74
"2011","South Kesteven 005C","E01026310",861,38,12,26,110,58,77,86,199,187,55,37,18,51
"2011","South Kesteven 005D","E01026311",1176,37,18,19,136,122,76,138,294,229,68,41,27,76
"2011","South Kesteven 005E","E01026312",881,17,6,11,76,52,55,70,214,220,88,57,31,89
"2011","South Kesteven 006A","E01026317",1619,88,19,69,250,163,112,164,369,296,84,44,40,93
"2011","South Kesteven 006B","E01026318",1404,59,19,40,195,171,75,128,313,288,78,46,32,97
"2011","South Kesteven 006C","E01026319",1592,119,46,73,351,206,167,164,279,213,30,20,10,63
"2011","South Kesteven 006D","E01026343",1368,92,29,63,241,143,107,132,256,245,79,53,26,73
"2011","South Kesteven 006E","E01026344",1163,78,26,52,247,146,105,100,218,148,47,20,27,74
"2011","South Kesteven 006F","E01026345",1043,71,17,54,185,111,90,75,213,157,41,26,15,100
"2011","South Kesteven 007A","E01026292",1089,56,19,37,195,150,103,134,231,141,26,15,11,53
"2011","South Kesteven 007B","E01026293",1510,170,63,107,352,233,158,133,220,138,30,18,12,76
"2011","South Kesteven 007C","E01026294",1227,126,45,81,320,203,89,105,177,126,12,4,8,69
"2011","South Kesteven 007D","E01026316",1773,253,89,164,403,249,251,110,246,136,43,28,15,82
"2011","South Kesteven 007E","E01026332",1624,235,73,162,370,193,279,75,207,127,52,28,24,86
"2011","South Kesteven 008A","E01026290",1621,186,63,123,402,174,218,133,224,147,38,25,13,99
"2011","South Kesteven 008B","E01026341",1076,105,38,67,249,142,126,89,166,105,30,16,14,64
"2011","South Kesteven 008C","E01026342",1080,116,36,80,273,136,132,80,146,107,23,13,10,67
"2011","South Kesteven 008D","E01026361",1926,187,59,128,424,242,253,142,290,206,67,45,22,115
"2011","South Kesteven 009A","E01026315",1528,166,53,113,349,190,238,119,209,148,27,16,11,82
"2011","South Kesteven 009B","E01026331",1770,176,60,116,428,191,239,129,250,205,51,24,27,101
"2011","South Kesteven 009C","E01026338",907,130,36,94,212,100,161,71,100,74,22,9,13,37
"2011","South Kesteven 009D","E01026339",923,67,22,45,201,101,93,101,167,136,26,15,11,31
"2011","South Kesteven 010A","E01026299",1164,97,29,68,237,138,92,105,199,170,47,24,23,79
"2011","South Kesteven 010B","E01026300",1100,117,41,76,266,187,116,88,145,91,31,25,6,59
"2011","South Kesteven 010C","E01026301",1156,104,34,70,248,163,106,111,188,143,32,24,8,61
"2011","South Kesteven 010D","E01026302",891,103,29,74,174,153,66,89,136,98,13,6,7,59
"2011","South Kesteven 011B","E01026296",1125,130,47,83,254,162,160,83,148,102,28,19,9,58
"2011","South Kesteven 011C","E01026297",976,56,18,38,194,105,96,82,175,176,30,19,11,62
"2011","South Kesteven 011D","E01026298",1237,63,22,41,227,137,100,113,274,195,64,40,24,64
"2011","South Kesteven 011E","E01032997",874,90,26,64,233,118,77,66,108,92,30,13,17,60
"2011","South Kesteven 011F","E01032998",919,139,40,99,237,124,68,64,128,66,18,9,9,75
"2011","South Kesteven 011G","E01032999",814,89,26,63,165,103,73,75,131,100,24,14,10,54
"2011","South Kesteven 012A","E01026330",1630,264,87,177,449,190,272,73,158,105,38,23,15,81
"2011","South Kesteven 012B","E01026360",1602,226,63,163,447,237,176,113,184,109,30,16,14,80
"2011","South Kesteven 012C","E01026362",1285,193,62,131,329,204,138,78,144,108,20,10,10,71
"2011","South Kesteven 012D","E01026363",916,194,60,134,278,102,121,42,92,35,13,7,6,39
"2011","South Kesteven 012E","E01026364",1222,176,47,129,345,209,125,73,130,80,27,14,13,57
"2011","South Kesteven 013A","E01026334",1181,186,61,125,314,180,114,64,120,79,34,16,18,90
"2011","South Kesteven 013B","E01026335",1151,154,45,109,297,182,108,75,152,94,41,25,16,48
"2011","South Kesteven 013C","E01026336",1176,109,41,68,217,168,97,106,215,138,62,33,29,64
"2011","South Kesteven 013D","E01026337",1134,106,30,76,264,166,103,97,194,116,34,18,16,54
"2011","South Kesteven 014A","E01026303",1052,113,26,87,265,186,85,91,143,91,11,3,8,67
"2011","South Kesteven 014B","E01026304",1134,163,49,114,286,187,131,70,134,92,22,12,10,49
"2011","South Kesteven 014C","E01026305",1074,124,31,93,264,220,69,87,157,80,28,21,7,45
"2011","South Kesteven 014D","E01026306",1101,73,15,58,226,176,85,99,193,139,47,25,22,63
"2011","South Kesteven 014E","E01026307",997,119,32,87,285,148,108,76,124,63,25,14,11,49
"2011","South Kesteven 015A","E01026287",1107,60,15,45,205,140,85,107,235,165,42,28,14,68
"2011","South Kesteven 015B","E01026288",1137,69,19,50,189,97,99,110,231,234,55,25,30,53
"2011","South Kesteven 015C","E01026289",1517,183,48,135,372,166,111,141,245,180,43,27,16,76
"2011","South Kesteven 015D","E01026346",892,68,18,50,216,101,84,82,151,121,26,14,12,43
"2011","South Kesteven 015E","E01026347",1116,146,40,106,355,131,108,63,147,100,20,13,7,46
"2011","South Kesteven 015F","E01026348",815,48,13,35,127,76,64,87,162,153,33,18,15,65
"2011","South Kesteven 016A","E01026349",1098,131,43,88,259,130,101,85,164,150,38,18,20,40
"2011","South Kesteven 016B","E01026350",1160,209,58,151,324,139,114,66,124,69,41,19,22,74
"2011","South Kesteven 016C","E01026351",1124,190,58,132,326,107,135,63,114,82,39,17,22,68
"2011","South Kesteven 016D","E01026356",1105,150,50,100,317,155,85,98,128,96,16,9,7,60
"2011","South Kesteven 016E","E01026357",1102,88,23,65,236,168,87,107,203,144,19,15,4,50
"2011","South Kesteven 016F","E01026358",1077,148,38,110,309,121,86,86,148,113,15,11,4,51
"2011","South Kesteven 016G","E01026359",1125,187,50,137,323,158,110,74,133,79,8,4,4,53
"2011","West Lindsey 001A","E01026367",1172,122,29,93,265,102,156,107,176,132,51,35,16,61
"2011","West Lindsey 001B","E01026368",1186,115,37,78,249,138,108,115,190,179,27,15,12,65
"2011","West Lindsey 001C","E01026387",2044,257,71,186,505,244,298,159,194,209,64,46,18,114
"2011","West Lindsey 001D","E01026416",953,90,25,65,233,111,115,78,153,81,37,25,12,55
"2011","West Lindsey 001G","E01032683",1682,140,46,94,402,243,174,187,237,185,32,21,11,82
"2011","West Lindsey 002A","E01026380",1340,104,26,78,235,176,87,157,262,184,61,38,23,74
"2011","West Lindsey 002B","E01026401",1167,117,38,79,321,168,133,87,139,117,29,24,5,56
"2011","West Lindsey 002C","E01026402",1349,147,38,109,376,201,135,113,142,128,33,12,21,74
"2011","West Lindsey 002D","E01026403",1004,115,37,78,269,114,145,66,115,94,27,17,10,59
"2011","West Lindsey 002E","E01026407",1012,75,27,48,223,126,130,106,143,104,63,47,16,42
"2011","West Lindsey 002F","E01026408",984,82,31,51,167,159,100,102,171,120,42,28,14,41
"2011","West Lindsey 003A","E01026389",1201,82,22,60,195,155,118,106,230,165,85,55,30,65
"2011","West Lindsey 003B","E01026390",1297,79,28,51,219,115,153,113,249,211,66,47,19,92
"2011","West Lindsey 003C","E01026391",1405,150,41,109,339,166,246,84,183,99,40,22,18,98
"2011","West Lindsey 003D","E01026392",2208,213,62,151,576,251,318,145,295,219,80,64,16,111
"2011","West Lindsey 003E","E01026415",796,51,14,37,154,81,85,69,145,127,42,27,15,42
"2011","West Lindsey 004A","E01026378",1233,30,10,20,175,102,84,117,303,245,110,73,37,67
"2011","West Lindsey 004B","E01026379",1203,70,24,46,178,172,100,134,232,181,69,46,23,67
"2011","West Lindsey 004C","E01026381",1241,51,9,42,182,155,95,138,255,213,79,45,34,73
"2011","West Lindsey 004D","E01026382",1194,53,18,35,223,127,80,130,244,194,82,51,31,61
"2011","West Lindsey 004E","E01026383",925,27,4,23,99,75,62,99,202,186,135,80,55,40
"2011","West Lindsey 004F","E01026384",1293,59,11,48,190,124,123,122,272,233,101,58,43,69
"2011","West Lindsey 005A","E01026385",856,83,26,57,175,101,152,66,116,84,35,25,10,44
"2011","West Lindsey 005B","E01026386",1054,63,20,43,203,98,120,89,180,166,67,51,16,68
"2011","West Lindsey 005C","E01026399",1129,134,41,93,303,133,135,73,142,96,43,33,10,70
"2011","West Lindsey 005D","E01026411",1884,223,69,154,443,212,307,129,250,184,57,33,24,79
"2011","West Lindsey 006A","E01026374",1011,22,4,18,83,69,34,87,272,215,160,102,58,69
"2011","West Lindsey 006B","E01026375",1113,35,13,22,139,111,73,104,248,211,116,66,50,76
"2011","West Lindsey 006C","E01026376",1227,46,19,27,145,136,86,115,297,240,100,70,30,62
"2011","West Lindsey 006D","E01026377",1556,75,25,50,248,179,83,169,327,267,118,82,36,90
"2011","West Lindsey 007A","E01026388",1580,153,49,104,346,208,245,134,224,146,37,17,20,87
"2011","West Lindsey 007B","E01026404",1694,182,56,126,430,220,223,132,223,140,52,33,19,92
"2011","West Lindsey 007C","E01026409",925,113,43,70,233,120,146,60,109,81,20,13,7,43
"2011","West Lindsey 007D","E01026410",1199,80,44,36,264,162,147,108,181,143,62,52,10,52
"2011","West Lindsey 008A","E01026372",1807,182,44,138,441,265,194,126,259,169,37,24,13,134
"2011","West Lindsey 008B","E01026412",1186,125,33,92,280,190,75,98,178,109,51,42,9,80
"2011","West Lindsey 008C","E01026413",1572,229,77,152,438,249,114,109,181,107,20,10,10,125
"2011","West Lindsey 008D","E01026414",1284,151,38,113,328,181,172,78,160,109,25,13,12,80
"2011","West Lindsey 009A","E01026396",920,105,28,77,216,159,85,66,141,81,13,8,5,54
"2011","West Lindsey 009B","E01026397",1766,283,93,190,500,255,202,112,176,91,56,36,20,91
"2011","West Lindsey 009C","E01026398",1085,98,30,68,209,157,134,89,186,122,36,18,18,54
"2011","West Lindsey 009D","E01026400",1225,129,41,88,338,193,106,84,152,94,26,16,10,103
"2011","West Lindsey 010A","E01026393",987,127,35,92,308,146,95,83,97,57,15,11,4,59
"2011","West Lindsey 010B","E01026394",1411,129,35,94,321,172,154,90,185,133,31,16,15,196
"2011","West Lindsey 010C","E01026395",1017,149,32,117,296,170,99,66,100,49,14,9,5,74
"2011","West Lindsey 010D","E01026405",975,166,40,126,313,131,103,41,83,42,16,11,5,80
"2011","West Lindsey 010E","E01026406",940,146,36,110,292,152,79,50,90,43,20,15,5,68
"2011","West Lindsey 011A","E01026366",1517,108,30,78,308,178,191,141,292,188,53,38,15,58
"2011","West Lindsey 011B","E01026369",778,69,20,49,168,107,80,69,125,91,30,17,13,39
"2011","West Lindsey 011C","E01026370",1485,143,44,99,386,233,152,105,233,132,39,27,12,62
"2011","West Lindsey 011D","E01026371",907,106,29,77,234,141,103,58,122,80,11,7,4,52
"2011","West Lindsey 011E","E01026373",1552,127,35,92,324,217,209,111,253,185,55,34,21,71
"2011","Corby 001A","E01026971",1245,77,21,56,178,150,62,145,268,250,36,20,16,79
"2011","Corby 001B","E01026979",1029,106,29,77,251,146,132,66,115,121,32,26,6,60
"2011","Corby 001C","E01026980",1186,150,46,104,306,157,169,92,109,126,7,3,4,70
"2011","Corby 001D","E01026982",1416,68,20,48,156,146,76,140,332,337,72,40,32,89
"2011","Corby 002A","E01026969",1182,45,23,22,134,132,58,129,266,298,55,28,27,65
"2011","Corby 002B","E01026970",1257,54,14,40,159,136,71,127,272,314,40,21,19,84
"2011","Corby 002C","E01026972",1308,48,19,29,165,128,69,151,289,319,49,33,16,90
"2011","Corby 002D","E01026976",990,27,11,16,116,102,46,100,235,266,42,21,21,56
"2011","Corby 002E","E01026981",877,45,18,27,138,112,49,120,185,167,25,12,13,36
"2011","Corby 002F","E01026983",868,24,12,12,83,86,32,110,213,245,31,15,16,44
"2011","Corby 003A","E01026957",1159,45,23,22,131,95,66,125,256,328,59,44,15,54
"2011","Corby 003B","E01026958",1340,54,23,31,142,115,80,147,282,389,78,45,33,53
"2011","Corby 003C","E01026977",1419,167,56,111,335,196,163,113,179,174,26,10,16,66
"2011","Corby 003D","E01026978",1059,107,31,76,223,120,113,94,142,181,18,9,9,61
"2011","Corby 004A","E01026962",1050,29,14,15,125,121,53,119,234,263,40,28,12,66
"2011","Corby 004B","E01026973",1011,34,12,22,158,96,51,111,218,258,28,17,11,57
"2011","Corby 004C","E01026974",851,40,14,26,139,132,61,92,158,164,25,19,6,40
"2011","Corby 004D","E01026975",965,23,8,15,92,107,41,104,198,279,62,25,37,59
"2011","Corby 004E","E01026984",1272,41,13,28,161,140,74,130,256,368,46,33,13,56
"2011","Corby 004F","E01026985",1133,69,23,46,184,152,65,121,206,248,24,17,7,64
"2011","Corby 005A","E01026949",982,43,16,27,144,100,53,106,204,228,51,29,22,53
"2011","Corby 005B","E01026950",1086,15,8,7,81,68,50,110,269,345,72,48,24,76
"2011","Corby 005C","E01026951",921,22,5,17,77,79,45,93,207,262,66,45,21,70
"2011","Corby 005D","E01026952",901,55,13,42,137,106,57,97,156,207,30,27,3,56
"2011","Corby 006A","E01026959",1063,47,14,33,123,106,46,134,232,279,47,22,25,49
"2011","Corby 006B","E01026960",1072,21,5,16,85,66,45,83,288,323,96,57,39,65
"2011","Corby 006C","E01026961",921,23,8,15,83,81,44,95,197,261,66,44,22,71
"2011","Corby 006D","E01026965",772,13,5,8,73,52,40,79,186,219,57,36,21,53
"2011","Corby 006E","E01026966",1031,62,24,38,173,90,70,74,189,220,66,46,20,87
"2011","Corby 006F","E01026967",1216,44,19,25,119,102,61,133,267,335,87,54,33,68
"2011","Corby 006G","E01026968",987,23,8,15,82,76,34,101,229,290,98,51,47,54
"2011","Corby 008A","E01026953",1057,66,20,46,196,160,72,114,174,188,29,18,11,58
"2011","Corby 008B","E01026954",1037,38,13,25,119,115,65,105,210,262,44,27,17,79
"2011","Corby 008C","E01026955",1136,156,50,106,294,159,108,96,124,94,15,10,5,90
"2011","Corby 008D","E01026956",1489,87,30,57,279,199,85,157,264,268,58,35,23,92
"2011","Corby 009A","E01026963",973,47,14,33,155,101,57,98,182,229,47,29,18,57
"2011","Corby 009B","E01032963",1208,115,41,74,255,169,69,90,191,205,30,21,9,84
"2011","Corby 009C","E01032964",1195,107,36,71,223,160,80,114,190,205,29,15,14,87
"2011","Corby 009D","E01032965",997,95,20,75,247,124,55,77,146,173,25,13,12,55
"2011","Corby 009E","E01032966",1241,113,34,79,264,146,78,113,198,226,26,11,15,77
"2011","Corby 009F","E01032967",1147,101,31,70,265,127,73,81,173,196,41,28,13,90
"2011","Daventry 001A","E01027005",1538,262,69,193,439,168,262,58,129,104,22,13,9,94
"2011","Daventry 001B","E01027026",1413,242,72,170,377,177,239,56,120,86,32,20,12,84
"2011","Daventry 001C","E01027030",1351,203,59,144,324,168,207,73,138,108,23,17,6,107
"2011","Daventry 002A","E01027000",1035,100,15,85,261,134,112,78,123,146,21,11,10,60
"2011","Daventry 002B","E01027001",1117,185,54,131,318,170,88,62,97,61,21,10,11,115
"2011","Daventry 002C","E01027002",1208,209,56,153,329,166,172,71,101,65,15,7,8,80
"2011","Daventry 002D","E01027003",1071,138,36,102,262,178,116,67,123,96,19,11,8,72
"2011","Daventry 002E","E01027022",1357,217,44,173,349,172,191,83,134,122,23,15,8,66
"2011","Daventry 003A","E01026994",744,122,45,77,207,87,99,45,69,67,15,8,7,33
"2011","Daventry 003D","E01026999",1313,208,46,162,319,169,148,96,160,121,29,13,16,63
"2011","Daventry 003E","E01027006",1358,224,61,163,387,171,159,71,125,107,33,19,14,81
"2011","Daventry 003F","E01032968",2686,258,63,195,508,261,307,176,299,452,285,266,19,140
"2011","Daventry 004A","E01026998",1380,255,77,178,366,205,227,65,95,68,26,14,12,73
"2011","Daventry 004B","E01027015",917,144,35,109,248,128,95,47,97,85,13,8,5,60
"2011","Daventry 004C","E01027016",1135,204,57,147,335,141,125,56,106,81,20,7,13,67
"2011","Daventry 004D","E01027021",1378,254,63,191,418,172,206,63,108,73,20,14,6,64
"2011","Daventry 004E","E01027027",1690,292,87,205,442,219,217,94,139,119,33,12,21,135
"2011","Daventry 005A","E01026997",1243,216,65,151,363,159,163,64,92,72,24,20,4,90
"2011","Daventry 005B","E01027018",1093,173,45,128,281,166,164,60,109,58,15,6,9,67
"2011","Daventry 005C","E01027019",1151,138,36,102,264,172,95,56,128,107,31,16,15,160
"2011","Daventry 005D","E01027020",840,79,16,63,207,135,103,53,95,90,15,12,3,63
"2011","Daventry 005E","E01027023",1499,251,68,183,414,194,209,61,124,126,37,18,19,83
"2011","Daventry 006A","E01026987",933,78,27,51,182,146,71,88,146,159,15,11,4,48
"2011","Daventry 006B","E01026989",1052,96,22,74,244,157,83,72,150,144,45,21,24,61
"2011","Daventry 006C","E01026990",1987,234,61,173,463,301,148,161,276,271,34,21,13,99
"2011","Daventry 006D","E01027012",1302,74,29,45,231,165,104,138,221,277,34,21,13,58
"2011","Daventry 006E","E01027014",1548,201,56,145,424,234,117,118,184,126,35,18,17,109
"2011","Daventry 007A","E01026986",2070,197,50,147,370,275,144,193,335,347,78,43,35,131
"2011","Daventry 007B","E01026988",1078,36,7,29,147,140,71,92,220,244,48,32,16,80
"2011","Daventry 007C","E01026991",1188,108,29,79,236,176,87,113,202,210,24,15,9,32
"2011","Daventry 007D","E01026992",1310,76,21,55,212,171,104,141,246,239,62,27,35,59
"2011","Daventry 007E","E01027010",907,77,16,61,190,145,91,78,128,130,14,4,10,54
"2011","Daventry 008A","E01027007",1024,57,20,37,153,137,82,96,185,197,49,34,15,68
"2011","Daventry 008B","E01027008",1546,129,35,94,284,222,122,153,249,272,47,16,31,68
"2011","Daventry 008C","E01027009",1064,37,7,30,131,114,69,111,235,230,70,35,35,67
"2011","Daventry 008D","E01027013",1267,21,5,16,131,141,73,138,238,311,102,57,45,112
"2011","Daventry 009A","E01027011",1416,212,59,153,371,183,205,80,135,131,33,16,17,66
"2011","Daventry 009B","E01027017",1047,104,24,80,200,138,115,93,161,153,29,19,10,54
"2011","Daventry 009C","E01027024",1304,211,58,153,377,175,183,64,109,107,20,7,13,58
"2011","Daventry 009D","E01027025",1223,119,31,88,283,176,115,105,153,179,34,18,16,59
"2011","Daventry 010A","E01026993",1488,242,67,175,423,187,221,90,128,83,31,22,9,83
"2011","Daventry 010B","E01027004",1375,234,50,184,349,144,200,90,133,123,38,26,12,64
"2011","Daventry 010C","E01027028",1606,189,59,130,403,195,209,120,194,171,41,30,11,84
"2011","Daventry 010D","E01027029",1127,87,18,69,218,147,125,118,161,188,24,15,9,59
"2011","East Northamptonshire 001A","E01027033",1350,192,52,140,344,165,183,76,129,146,35,17,18,80
"2011","East Northamptonshire 001B","E01027043",1421,206,61,145,379,151,193,85,140,149,33,19,14,85
"2011","East Northamptonshire 001C","E01027050",1391,239,66,173,391,161,196,72,121,110,29,19,10,72
"2011","East Northamptonshire 002A","E01027031",1535,245,76,169,423,164,297,67,135,92,24,9,15,88
"2011","East Northamptonshire 002B","E01027044",1531,277,73,204,452,180,208,70,153,88,22,12,10,81
"2011","East Northamptonshire 002C","E01027046",947,155,51,104,278,138,85,53,78,73,12,5,7,75
"2011","East Northamptonshire 002D","E01027047",945,105,27,78,242,96,85,63,122,158,25,14,11,49
"2011","East Northamptonshire 002E","E01027048",1382,155,52,103,335,96,91,48,84,69,18,9,9,486
"2011","East Northamptonshire 002F","E01027049",688,107,33,74,228,74,73,43,58,51,9,4,5,45
"2011","East Northamptonshire 003A","E01027032",1359,210,52,158,332,148,214,84,133,144,24,14,10,70
"2011","East Northamptonshire 003B","E01027045",1411,183,61,122,348,174,197,88,150,174,25,14,11,72
"2011","East Northamptonshire 003C","E01027075",1518,157,37,120,371,238,126,113,204,195,31,21,10,83
"2011","East Northamptonshire 003D","E01027076",1543,153,42,111,341,194,154,121,214,259,44,26,18,63
"2011","East Northamptonshire 003E","E01027077",1448,209,63,146,393,220,149,85,119,148,20,10,10,105
"2011","East Northamptonshire 004A","E01027057",1308,155,52,103,316,145,182,81,169,157,43,31,12,60
"2011","East Northamptonshire 004B","E01027074",1638,216,67,149,415,197,221,96,190,174,28,19,9,101
"2011","East Northamptonshire 004C","E01027078",1562,222,68,154,361,189,204,106,157,202,38,18,20,83
"2011","East Northamptonshire 005A","E01027051",1282,79,20,59,251,171,152,113,217,176,41,21,20,82
"2011","East Northamptonshire 005B","E01027052",1065,113,33,80,257,132,93,88,150,135,23,14,9,74
"2011","East Northamptonshire 005C","E01027053",1158,122,34,88,294,184,137,82,136,108,23,15,8,72
"2011","East Northamptonshire 005D","E01027054",950,61,21,40,167,146,105,92,155,152,25,13,12,47
"2011","East Northamptonshire 005E","E01027055",840,45,12,33,142,116,83,91,166,140,12,6,6,45
"2011","East Northamptonshire 005F","E01027056",1091,51,14,37,143,122,99,118,213,231,56,39,17,58
"2011","East Northamptonshire 006A","E01027038",1189,66,17,49,189,130,126,90,213,242,49,31,18,84
"2011","East Northamptonshire 006B","E01027039",1259,103,33,70,261,175,115,107,182,209,51,36,15,56
"2011","East Northamptonshire 006C","E01027040",1224,101,30,71,262,202,88,122,179,184,26,12,14,60
"2011","East Northamptonshire 006D","E01027041",1136,52,17,35,145,123,102,114,194,266,68,41,27,72
"2011","East Northamptonshire 006E","E01027042",1423,155,40,115,341,219,117,99,221,175,30,20,10,66
"2011","East Northamptonshire 007A","E01027034",1169,96,25,71,250,149,109,94,189,188,29,15,14,65
"2011","East Northamptonshire 007B","E01027035",1025,87,28,59,186,111,112,77,138,187,67,41,26,60
"2011","East Northamptonshire 007D","E01027037",1560,205,46,159,436,223,144,107,189,149,29,14,15,78
"2011","East Northamptonshire 007E","E01033244",1756,230,69,161,454,285,155,133,201,193,22,10,12,83
"2011","East Northamptonshire 007F","E01033245",747,74,19,55,180,98,65,64,100,105,13,5,8,48
"2011","East Northamptonshire 008A","E01027061",1269,80,23,57,215,167,92,112,220,254,63,28,35,66
"2011","East Northamptonshire 008B","E01027062",1595,129,25,104,325,206,144,137,266,229,68,41,27,91
"2011","East Northamptonshire 008C","E01027063",1379,181,51,130,324,201,135,92,193,139,56,44,12,58
"2011","East Northamptonshire 008D","E01027064",1181,103,31,72,261,191,107,104,164,167,39,26,13,45
"2011","East Northamptonshire 008E","E01027072",1097,43,12,31,112,120,82,103,234,261,64,34,30,78
"2011","East Northamptonshire 008F","E01027073",1461,107,23,84,263,203,168,129,250,211,57,34,23,73
"2011","East Northamptonshire 009A","E01027058",1017,45,13,32,133,121,90,95,179,230,64,38,26,60
"2011","East Northamptonshire 009B","E01027059",1236,86,18,68,206,151,104,126,229,217,34,14,20,83
"2011","East Northamptonshire 009C","E01027060",1260,71,12,59,202,161,110,110,215,252,76,46,30,63
"2011","East Northamptonshire 009D","E01027065",1292,63,18,45,221,163,108,111,237,255,70,40,30,64
"2011","East Northamptonshire 009E","E01027069",1177,79,18,61,230,156,104,88,198,203,56,29,27,63
"2011","East Northamptonshire 010A","E01027066",1552,188,42,146,408,239,205,90,185,128,27,17,10,82
"2011","East Northamptonshire 010B","E01027067",1150,105,27,78,225,181,133,97,186,133,39,32,7,51
"2011","East Northamptonshire 010C","E01027068",2155,262,67,195,561,351,204,147,268,189,42,25,17,131
"2011","East Northamptonshire 010D","E01027070",1209,90,23,67,211,200,108,125,204,178,36,16,20,57
"2011","East Northamptonshire 010E","E01027071",1125,67,13,54,225,177,83,118,189,168,27,16,11,71
"2011","Kettering 001A","E01027090",1102,160,50,110,269,124,195,66,103,96,19,14,5,70
"2011","Kettering 001B","E01027103",1200,164,54,110,319,167,147,71,134,123,19,8,11,56
"2011","Kettering 001C","E01027129",1646,290,79,211,465,190,263,71,154,111,34,19,15,68
"2011","Kettering 002B","E01027094",1088,102,29,73,258,163,115,83,141,139,29,17,12,58
"2011","Kettering 002C","E01027095",1050,74,23,51,219,128,94,92,168,164,45,21,24,66
"2011","Kettering 002D","E01027107",960,64,19,45,193,157,78,85,156,164,27,12,15,36
"2011","Kettering 002E","E01027108",981,102,40,62,243,158,125,57,117,105,14,9,5,60
"2011","Kettering 002F","E01027109",958,73,33,40,189,139,96,86,138,145,37,23,14,55
"2011","Kettering 002G","E01032969",911,123,28,95,243,126,81,56,105,111,16,11,5,50
"2011","Kettering 002H","E01032970",1032,106,26,80,229,152,91,81,137,142,38,25,13,56
"2011","Kettering 002I","E01032971",772,76,20,56,155,91,60,69,119,152,23,13,10,27
"2011","Kettering 003A","E01027123",1116,98,29,69,239,145,121,73,150,197,32,23,9,61
"2011","Kettering 003B","E01027124",1627,115,34,81,291,192,185,122,265,278,81,36,45,98
"2011","Kettering 003C","E01027125",1366,157,54,103,337,205,123,102,177,155,31,15,16,79
"2011","Kettering 003D","E01027126",1530,127,38,89,322,188,142,119,265,258,50,24,26,59
"2011","Kettering 004A","E01027079",1310,110,20,90,288,177,104,105,195,187,44,24,20,100
"2011","Kettering 004B","E01027080",1412,130,40,90,322,244,186,79,193,157,31,18,13,70
"2011","Kettering 004C","E01027087",890,67,24,43,188,135,76,90,123,131,29,12,17,51
"2011","Kettering 004D","E01027088",927,124,24,100,212,134,80,68,121,95,21,10,11,72
"2011","Kettering 004E","E01027089",1455,163,48,115,336,223,129,124,206,174,41,27,14,59
"2011","Kettering 005A","E01027081",997,42,12,30,137,105,87,97,210,217,49,27,22,53
"2011","Kettering 005B","E01027082",1187,39,11,28,188,123,97,83,263,248,75,41,34,71
"2011","Kettering 005C","E01027083",999,40,18,22,105,93,59,84,202,269,105,61,44,42
"2011","Kettering 005D","E01027127",1301,37,9,28,121,121,85,120,279,310,119,80,39,109
"2011","Kettering 005E","E01027128",1193,52,17,35,164,108,81,86,264,280,80,53,27,78
"2011","Kettering 006A","E01027105",1601,76,19,57,276,196,98,158,289,302,112,85,27,94
"2011","Kettering 006B","E01027106",1455,57,16,41,213,157,105,104,311,313,105,58,47,90
"2011","Kettering 006C","E01027111",1587,98,27,71,307,196,121,123,260,265,119,86,33,98
"2011","Kettering 006D","E01027112",1581,72,25,47,263,182,126,149,315,320,83,38,45,71
"2011","Kettering 007A","E01027104",1715,114,21,93,336,190,123,147,310,285,121,68,53,89
"2011","Kettering 007B","E01027110",1257,88,16,72,192,130,94,118,209,279,100,58,42,47
"2011","Kettering 007C","E01027113",1475,153,30,123,362,179,119,106,218,179,68,47,21,91
"2011","Kettering 007D","E01027115",791,123,26,97,221,128,71,43,91,56,12,8,4,46
"2011","Kettering 007E","E01027116",1570,261,58,203,413,239,121,102,161,128,47,25,22,98
"2011","Kettering 007F","E01027117",1042,149,26,123,229,147,90,53,162,124,32,21,11,56
"2011","Kettering 008A","E01027096",841,56,18,38,192,126,86,67,146,104,21,13,8,43
"2011","Kettering 008B","E01027097",1045,88,15,73,243,165,94,95,160,127,20,11,9,53
"2011","Kettering 008C","E01027098",894,73,15,58,196,141,53,91,157,116,21,12,9,46
"2011","Kettering 008D","E01027099",1023,87,31,56,233,154,95,84,166,138,14,8,6,52
"2011","Kettering 008E","E01027122",880,63,25,38,184,132,93,86,156,106,21,15,6,39
"2011","Kettering 009A","E01027100",1118,109,31,78,240,153,119,89,150,148,42,23,19,68
"2011","Kettering 009B","E01027114",1170,89,24,65,233,149,97,118,184,187,38,18,20,75
"2011","Kettering 009C","E01027130",1313,102,25,77,253,200,113,97,225,190,67,41,26,66
"2011","Kettering 009D","E01027131",1483,82,19,63,239,160,90,144,284,302,114,61,53,68
"2011","Kettering 010A","E01027084",1035,87,29,58,236,171,96,85,143,141,23,19,4,53
"2011","Kettering 010B","E01027085",904,78,24,54,183,138,92,66,149,116,37,24,13,45
"2011","Kettering 010C","E01027086",1224,160,51,109,324,192,109,83,137,110,16,12,4,93
"2011","Kettering 010D","E01027120",1007,128,38,90,267,156,82,72,130,76,21,13,8,75
"2011","Kettering 010E","E01027121",1086,197,54,143,288,168,104,57,108,84,9,8,1,71
"2011","Kettering 011A","E01027091",1347,97,30,67,266,150,118,102,222,248,51,34,17,93
"2011","Kettering 011B","E01027092",1112,81,25,56,195,158,123,103,204,158,24,12,12,66
"2011","Kettering 011C","E01027101",1742,179,52,127,397,258,183,130,215,225,57,41,16,98
"2011","Kettering 011D","E01027102",1211,80,20,60,216,171,127,119,224,185,27,16,11,62
"2011","Kettering 011F","E01027119",1230,138,22,116,284,154,147,101,160,154,36,20,16,56
"2011","Kettering 011G","E01032972",1067,136,42,94,272,154,138,59,132,97,18,10,8,61
"2011","Kettering 011H","E01032973",1153,212,56,156,377,158,104,61,95,73,18,8,10,55
"2011","Kettering 011I","E01032974",951,181,54,127,282,134,122,41,70,55,12,9,3,54
"2011","Northampton 001A","E01027145",1063,74,18,56,174,192,88,70,158,130,38,21,17,139
"2011","Northampton 001B","E01027148",1119,82,19,63,240,247,85,82,131,127,23,14,9,102
"2011","Northampton 001C","E01027149",1124,76,20,56,222,216,99,100,151,141,36,12,24,83
"2011","Northampton 001D","E01027232",2193,61,14,47,167,134,74,86,190,180,52,34,18,1249
"2011","Northampton 002A","E01027218",1192,91,21,70,246,229,98,106,188,144,37,25,12,53
"2011","Northampton 002B","E01027219",1192,79,12,67,230,201,119,100,190,179,31,17,14,63
"2011","Northampton 002C","E01027221",1294,119,30,89,282,243,112,91,172,171,18,11,7,86
"2011","Northampton 002D","E01027222",1010,97,21,76,209,224,82,87,125,100,17,11,6,69
"2011","Northampton 003A","E01027143",944,67,17,50,177,174,100,77,141,118,39,30,9,51
"2011","Northampton 003B","E01027144",1173,105,24,81,231,228,120,103,166,128,24,9,15,68
"2011","Northampton 003C","E01027146",1103,70,20,50,217,199,114,87,186,125,26,17,9,79
"2011","Northampton 003D","E01027147",1162,70,18,52,173,155,98,89,205,184,65,41,24,123
"2011","Northampton 004A","E01027195",1132,43,11,32,141,110,77,80,226,238,115,82,33,102
"2011","Northampton 004B","E01027245",1148,78,20,58,209,162,90,88,178,190,70,34,36,83
"2011","Northampton 004C","E01027247",1162,76,21,55,226,201,73,88,165,169,67,32,35,97
"2011","Northampton 004D","E01027248",1066,33,10,23,143,137,73,91,203,208,97,58,39,81
"2011","Northampton 004E","E01027249",1262,44,13,31,161,156,54,89,245,254,141,84,57,118
"2011","Northampton 005A","E01027174",1017,114,26,88,263,168,103,69,115,92,17,9,8,76
"2011","Northampton 005B","E01027175",1111,57,16,41,213,167,75,97,194,159,61,37,24,88
"2011","Northampton 005C","E01027178",1379,74,14,60,221,231,83,106,243,197,101,62,39,123
"2011","Northampton 005D","E01027200",988,46,14,32,128,138,70,86,174,171,83,57,26,92
"2011","Northampton 005E","E01027246",1272,59,15,44,191,181,82,77,249,211,114,69,45,108
"2011","Northampton 006A","E01027171",1055,105,21,84,229,143,73,77,164,156,46,27,19,62
"2011","Northampton 006B","E01027172",1082,108,29,79,242,171,115,67,127,120,47,31,16,85
"2011","Northampton 006C","E01027182",1039,89,16,73,221,173,92,88,158,121,30,22,8,67
"2011","Northampton 006D","E01027183",1010,112,27,85,223,172,112,63,127,106,25,22,3,70
"2011","Northampton 007A","E01027196",1097,52,9,43,144,149,72,89,223,180,90,72,18,98
"2011","Northampton 007B","E01027197",1018,51,8,43,168,144,77,75,189,190,63,28,35,61
"2011","Northampton 007C","E01027198",1133,31,9,22,113,145,55,96,259,235,109,71,38,90
"2011","Northampton 007D","E01027199",892,15,2,13,108,84,46,77,200,184,98,69,29,80
"2011","Northampton 008A","E01027190",1131,137,33,104,261,169,113,71,163,116,25,12,13,76
"2011","Northampton 008B","E01027191",1339,100,20,80,277,158,98,97,217,174,60,39,21,158
"2011","Northampton 008C","E01027193",1119,111,26,85,255,206,108,75,161,113,26,15,11,64
"2011","Northampton 008D","E01027194",966,79,15,64,186,177,102,72,151,116,24,13,11,59
"2011","Northampton 009A","E01027192",1068,81,21,60,199,125,70,66,122,139,46,25,21,220
"2011","Northampton 009B","E01027229",1117,36,13,23,128,104,78,91,206,225,77,50,27,172
"2011","Northampton 009C","E01027230",1067,32,10,22,117,117,64,87,178,208,88,52,36,176
"2011","Northampton 009D","E01027231",1309,38,10,28,151,141,83,94,222,282,124,70,54,174
"2011","Northampton 010A","E01027179",1296,70,11,59,262,212,112,95,219,182,61,47,14,83
"2011","Northampton 010B","E01027180",1080,82,21,61,207,181,93,71,176,151,52,31,21,67
"2011","Northampton 010C","E01027181",1082,114,25,89,262,188,115,70,133,114,27,19,8,59
"2011","Northampton 011A","E01027140",833,26,5,21,101,85,61,67,166,154,102,70,32,71
"2011","Northampton 011B","E01027142",990,112,35,77,193,152,91,59,122,134,52,33,19,75
"2011","Northampton 011C","E01027176",1142,91,21,70,233,191,82,87,177,144,59,31,28,78
"2011","Northampton 011D","E01027177",1041,44,8,36,135,141,52,82,199,208,89,58,31,91
"2011","Northampton 012A","E01027168",1121,29,6,23,134,103,64,99,215,242,126,76,50,109
"2011","Northampton 012B","E01027169",1137,141,35,106,254,169,128,53,138,120,43,24,19,91
"2011","Northampton 012C","E01027170",1035,38,7,31,148,132,69,83,167,194,90,57,33,114
"2011","Northampton 012D","E01027173",1125,58,8,50,201,136,111,72,165,182,111,74,37,89
"2011","Northampton 013A","E01027136",1325,150,19,131,355,170,132,60,162,132,39,21,18,125
"2011","Northampton 013B","E01027186",1303,148,33,115,313,157,156,76,143,156,41,26,15,113
"2011","Northampton 013C","E01027188",1314,52,15,37,191,207,101,102,228,213,78,54,24,142
"2011","Northampton 013D","E01027220",976,68,19,49,167,145,92,89,169,167,28,23,5,51
"2011","Northampton 014A","E01027208",1087,133,38,95,296,202,110,58,124,78,24,15,9,62
"2011","Northampton 014B","E01027209",926,97,22,75,249,191,63,64,113,106,10,5,5,33
"2011","Northampton 014C","E01027211",1044,65,16,49,198,209,89,93,189,143,12,5,7,46
"2011","Northampton 014D","E01027212",1102,139,32,107,283,196,98,61,131,97,21,10,11,76
"2011","Northampton 015A","E01027184",1131,102,18,84,273,128,99,63,138,120,102,89,13,106
"2011","Northampton 015B","E01027185",1122,91,24,67,209,102,65,61,132,134,65,55,10,263
"2011","Northampton 015C","E01027187",1057,115,25,90,259,132,78,46,99,99,63,40,23,166
"2011","Northampton 015D","E01027189",1212,96,24,72,221,166,80,78,213,211,52,29,23,95
"2011","Northampton 016A","E01027137",1006,48,9,39,157,150,71,71,209,182,58,34,24,60
"2011","Northampton 016B","E01027138",1117,101,30,71,267,197,107,73,167,112,31,22,9,62
"2011","Northampton 016C","E01027139",1128,91,26,65,231,204,95,90,148,136,53,30,23,80
"2011","Northampton 016D","E01027141",1115,172,54,118,266,191,122,50,118,80,21,11,10,95
"2011","Northampton 016E","E01027259",1196,134,29,105,246,177,117,77,173,141,51,30,21,80
"2011","Northampton 017A","E01027239",1108,28,7,21,117,95,91,90,195,241,156,111,45,95
"2011","Northampton 017B","E01027241",1254,40,9,31,162,163,90,102,207,290,98,61,37,102
"2011","Northampton 017C","E01027242",1072,24,2,22,117,108,63,71,205,265,128,89,39,91
"2011","Northampton 017D","E01027243",1040,37,8,29,119,104,77,101,203,233,97,69,28,69
"2011","Northampton 017E","E01027244",1036,24,4,20,76,109,49,83,217,256,154,98,56,68
"2011","Northampton 018A","E01027213",1127,61,14,47,217,190,121,86,170,171,38,27,11,73
"2011","Northampton 018B","E01027214",1117,41,13,28,159,164,91,104,237,187,73,51,22,61
"2011","Northampton 018C","E01027216",1235,113,31,82,224,222,123,105,183,175,30,17,13,60
"2011","Northampton 018D","E01027240",884,64,20,44,161,105,79,48,153,157,53,37,16,64
"2011","Northampton 019A","E01027207",985,61,12,49,191,168,103,99,155,153,21,11,10,34
"2011","Northampton 019B","E01027210",842,51,16,35,168,151,90,67,127,120,23,14,9,45
"2011","Northampton 019C","E01027215",1063,63,17,46,208,180,110,99,160,151,36,23,13,56
"2011","Northampton 019D","E01027217",1447,162,46,116,351,269,145,102,182,124,38,19,19,74
"2011","Northampton 020A","E01027255",998,134,31,103,246,195,99,46,114,77,20,9,11,67
"2011","Northampton 020B","E01027256",1004,160,39,121,310,153,125,47,82,46,18,12,6,63
"2011","Northampton 020C","E01027258",1046,159,37,122,296,182,101,64,78,52,21,16,5,93
"2011","Northampton 020D","E01027260",1063,187,47,140,302,175,129,43,70,62,26,14,12,69
"2011","Northampton 021B","E01027152",1363,75,13,62,196,146,74,84,206,283,95,54,41,204
"2011","Northampton 021C","E01027153",1682,91,13,78,239,135,86,103,195,305,137,82,55,391
"2011","Northampton 021D","E01027154",1326,60,15,45,180,154,84,117,230,257,78,40,38,166
"2011","Northampton 021E","E01032978",1115,69,8,61,122,117,40,80,175,247,132,80,52,133
"2011","Northampton 021F","E01032979",1017,50,7,43,106,94,44,91,171,236,154,89,65,71
"2011","Northampton 022A","E01027132",1644,120,22,98,343,243,121,103,233,232,51,31,20,198
"2011","Northampton 022B","E01027133",1321,144,23,121,333,163,95,96,156,184,45,26,19,105
"2011","Northampton 022C","E01027134",1374,99,11,88,275,153,113,100,180,198,56,41,15,200
"2011","Northampton 022D","E01027135",1316,165,45,120,359,172,123,91,142,95,62,38,24,107
"2011","Northampton 023A","E01027155",1744,124,19,105,271,166,113,121,191,350,131,97,34,277
"2011","Northampton 023B","E01027225",1360,117,24,93,247,142,96,92,138,216,81,56,25,231
"2011","Northampton 023C","E01027227",1229,73,13,60,219,140,61,91,183,183,91,65,26,188
"2011","Northampton 023D","E01027228",1598,146,22,124,325,192,90,111,183,271,86,56,30,194
"2011","Northampton 024A","E01027151",1272,60,17,43,222,140,90,88,221,237,111,74,37,103
"2011","Northampton 024B","E01027236",1062,99,26,73,198,164,89,74,172,177,39,24,15,50
"2011","Northampton 024C","E01027237",1503,130,25,105,347,198,123,144,206,196,80,51,29,79
"2011","Northampton 024D","E01027238",1484,102,19,83,274,184,109,119,214,313,90,55,35,79
"2011","Northampton 025A","E01027223",1696,225,25,200,396,215,102,105,176,228,100,55,45,149
"2011","Northampton 025B","E01027224",1380,136,26,110,305,162,105,93,179,219,90,62,28,91
"2011","Northampton 025C","E01027226",1430,119,18,101,265,171,81,93,208,243,103,78,25,147
"2011","Northampton 025D","E01027257",1168,138,29,109,234,141,91,43,116,117,215,203,12,73
"2011","Northampton 026A","E01027233",897,49,8,41,130,104,69,78,148,168,77,47,30,74
"2011","Northampton 026B","E01027234",1002,106,29,77,213,159,84,79,141,138,34,21,13,48
"2011","Northampton 026C","E01027235",983,27,6,21,128,129,77,66,180,209,93,57,36,74
"2011","Northampton 026D","E01027252",1065,75,15,60,213,155,79,86,170,171,53,23,30,63
"2011","Northampton 027A","E01027156",880,32,10,22,117,96,82,98,158,170,58,36,22,69
"2011","Northampton 027B","E01027159",929,68,19,49,200,147,96,73,137,113,34,13,21,61
"2011","Northampton 027C","E01027160",1360,154,31,123,312,225,107,104,168,164,49,30,19,77
"2011","Northampton 027D","E01027161",1084,41,12,29,153,144,80,79,196,206,107,79,28,78
"2011","Northampton 028B","E01027158",1097,69,14,55,204,152,90,79,199,219,44,28,16,41
"2011","Northampton 028C","E01027201",1461,234,62,172,392,249,121,68,167,118,37,24,13,75
"2011","Northampton 028D","E01027202",1129,182,42,140,293,159,120,57,127,111,28,13,15,52
"2011","Northampton 028E","E01032980",1183,143,21,122,235,163,73,94,158,175,49,34,15,93
"2011","Northampton 028F","E01032981",1208,105,26,79,241,164,85,83,190,220,41,19,22,79
"2011","Northampton 029A","E01027250",1047,181,47,134,279,173,88,60,123,71,24,13,11,48
"2011","Northampton 029C","E01027253",1385,208,59,149,381,225,154,81,136,95,22,13,9,83
"2011","Northampton 029D","E01027254",1309,207,50,157,364,233,145,68,125,85,18,12,6,64
"2011","Northampton 029E","E01032975",1260,213,49,164,389,181,103,72,118,67,39,26,13,78
"2011","Northampton 029F","E01032976",792,146,39,107,244,127,54,42,63,50,33,26,7,33
"2011","Northampton 029G","E01032977",1220,222,40,182,383,141,83,79,108,87,45,19,26,72
"2011","Northampton 030A","E01027162",1195,121,24,97,285,201,83,86,173,156,28,9,19,62
"2011","Northampton 030B","E01027163",1029,127,36,91,281,181,97,66,120,70,17,9,8,70
"2011","Northampton 030C","E01027164",1159,116,23,93,318,192,85,80,154,114,18,7,11,82
"2011","Northampton 030D","E01027165",993,157,42,115,273,193,75,63,92,67,12,7,5,61
"2011","Northampton 030E","E01027166",1203,154,38,116,306,199,127,93,138,91,16,11,5,79
"2011","Northampton 030F","E01027167",1030,156,46,110,291,171,83,59,120,63,17,9,8,70
"2011","Northampton 031A","E01027203",1127,169,38,131,296,219,103,65,90,63,16,10,6,106
"2011","Northampton 031B","E01027204",1198,158,45,113,281,156,122,67,163,105,35,24,11,111
"2011","Northampton 031C","E01027205",1466,311,60,251,475,216,109,56,105,62,25,16,9,107
"2011","Northampton 031D","E01027206",1995,386,100,286,590,301,198,91,149,102,44,27,17,134
"2011","South Northamptonshire 001A","E01027282",1203,100,32,68,231,187,132,110,173,163,29,16,13,78
"2011","South Northamptonshire 001B","E01027283",1169,183,54,129,300,160,152,62,102,87,32,20,12,91
"2011","South Northamptonshire 001C","E01027285",1250,153,45,108,301,182,150,85,134,141,25,18,7,79
"2011","South Northamptonshire 001D","E01027286",1129,125,35,90,263,189,151,76,133,108,19,11,8,65
"2011","South Northamptonshire 001E","E01027287",1184,159,44,115,261,199,160,72,141,101,19,7,12,72
"2011","South Northamptonshire 002A","E01027273",1273,172,38,134,333,191,147,83,143,126,21,9,12,57
"2011","South Northamptonshire 002B","E01027274",1156,202,52,150,349,161,171,37,89,58,17,8,9,72
"2011","South Northamptonshire 002C","E01027275",1045,127,36,91,280,161,114,65,120,95,25,16,9,58
"2011","South Northamptonshire 002D","E01027308",1174,184,59,125,311,172,154,68,118,81,25,15,10,61
"2011","South Northamptonshire 003A","E01027263",1363,157,49,108,312,200,163,103,180,158,30,19,11,60
"2011","South Northamptonshire 003C","E01027279",1227,90,25,65,234,180,124,117,202,182,30,15,15,68
"2011","South Northamptonshire 003D","E01027284",1505,237,52,185,397,209,197,86,147,115,26,18,8,91
"2011","South Northamptonshire 003E","E01027294",1393,155,33,122,339,232,163,109,159,128,34,20,14,74
"2011","South Northamptonshire 003F","E01032982",861,142,25,117,278,139,52,56,75,45,21,9,12,53
"2011","South Northamptonshire 003G","E01032983",1019,205,47,158,303,161,100,34,73,62,15,4,11,66
"2011","South Northamptonshire 003H","E01032984",1076,224,64,160,340,167,94,53,82,45,14,10,4,57
"2011","South Northamptonshire 003I","E01032985",1097,181,49,132,285,160,132,61,121,85,16,9,7,56
"2011","South Northamptonshire 004A","E01027262",1215,243,61,182,334,137,223,50,98,54,22,9,13,54
"2011","South Northamptonshire 004B","E01027277",1353,254,74,180,348,184,200,74,110,101,16,5,11,66
"2011","South Northamptonshire 004C","E01027289",1218,191,50,141,358,148,142,74,127,88,24,19,5,66
"2011","South Northamptonshire 004D","E01027300",1066,163,35,128,291,180,103,68,127,43,11,6,5,80
"2011","South Northamptonshire 004E","E01027303",1111,197,56,141,343,151,127,62,102,62,10,5,5,57
"2011","South Northamptonshire 005A","E01027297",1237,216,51,165,341,147,173,66,118,105,18,9,9,53
"2011","South Northamptonshire 005B","E01027298",992,144,38,106,246,148,123,71,120,84,12,5,7,44
"2011","South Northamptonshire 005C","E01027299",1105,103,25,78,213,151,90,105,193,152,41,23,18,57
"2011","South Northamptonshire 005D","E01027301",1539,243,55,188,432,230,114,70,184,134,33,17,16,99
"2011","South Northamptonshire 005E","E01027302",1005,92,23,69,184,116,73,99,167,176,42,23,19,56
"2011","South Northamptonshire 006A","E01027291",1032,146,44,102,238,145,163,75,120,82,5,3,2,58
"2011","South Northamptonshire 006B","E01027292",825,56,17,39,120,121,79,74,148,160,18,12,6,49
"2011","South Northamptonshire 006C","E01027293",903,98,18,80,230,157,99,68,122,64,4,1,3,61
"2011","South Northamptonshire 006D","E01027304",1302,260,66,194,341,165,244,54,86,74,21,8,13,57
"2011","South Northamptonshire 006E","E01027305",1363,182,52,130,346,164,197,93,152,127,31,22,9,71
"2011","South Northamptonshire 007A","E01027261",1487,248,66,182,408,182,250,57,137,89,23,12,11,93
"2011","South Northamptonshire 007B","E01027295",1630,270,68,202,417,215,221,99,169,143,18,9,9,78
"2011","South Northamptonshire 007C","E01027306",1303,224,58,166,351,148,242,57,108,69,41,30,11,63
"2011","South Northamptonshire 008A","E01027276",1846,289,85,204,503,262,231,116,203,114,45,27,18,83
"2011","South Northamptonshire 008B","E01027280",1795,248,60,188,508,267,213,114,186,125,24,11,13,110
"2011","South Northamptonshire 008C","E01027281",1228,112,35,77,245,195,125,115,198,162,29,20,9,47
"2011","South Northamptonshire 008D","E01027307",1546,222,60,162,385,229,208,113,150,137,30,22,8,72
"2011","South Northamptonshire 009A","E01027265",1079,95,27,68,255,166,111,93,159,127,22,12,10,51
"2011","South Northamptonshire 009B","E01027266",969,144,49,95,251,158,100,57,87,67,21,14,7,84
"2011","South Northamptonshire 009C","E01027270",1164,208,50,158,345,160,101,69,116,67,15,5,10,83
"2011","South Northamptonshire 009D","E01027271",1097,167,36,131,290,194,79,87,126,76,17,7,10,61
"2011","South Northamptonshire 009E","E01027272",1160,119,35,84,258,217,109,93,145,136,16,8,8,67
"2011","South Northamptonshire 010A","E01027264",1085,118,23,95,245,141,115,102,142,142,30,22,8,50
"2011","South Northamptonshire 010B","E01027267",832,83,26,57,198,119,91,69,121,88,27,20,7,36
"2011","South Northamptonshire 010C","E01027268",971,121,29,92,244,134,107,66,131,87,16,11,5,65
"2011","South Northamptonshire 010D","E01027269",1065,89,32,57,219,118,97,78,182,188,31,20,11,63
"2011","South Northamptonshire 011A","E01027288",1528,160,45,115,339,221,185,93,206,209,31,17,14,84
"2011","South Northamptonshire 011B","E01027290",1652,249,77,172,506,267,218,84,150,84,25,13,12,69
"2011","South Northamptonshire 011C","E01027296",1494,197,57,140,387,214,231,98,145,109,24,13,11,89
"2011","Wellingborough 001A","E01027326",1116,124,41,83,275,150,141,78,132,149,26,15,11,41
"2011","Wellingborough 001B","E01027327",1144,75,24,51,203,146,94,94,175,230,57,26,31,70
"2011","Wellingborough 001C","E01027328",959,53,17,36,144,135,88,81,155,217,33,21,12,53
"2011","Wellingborough 001D","E01027338",1688,238,73,165,435,247,191,89,188,172,37,18,19,91
"2011","Wellingborough 002A","E01027330",1176,61,8,53,193,146,80,93,194,217,99,62,37,93
"2011","Wellingborough 002B","E01027331",952,43,10,33,121,108,53,64,175,241,101,55,46,46
"2011","Wellingborough 002C","E01027332",1056,86,22,64,201,170,106,86,170,144,35,25,10,58
"2011","Wellingborough 002D","E01027333",1731,239,66,173,422,251,129,118,204,191,45,21,24,132
"2011","Wellingborough 002E","E01027334",886,17,4,13,92,73,38,83,162,232,121,72,49,68
"2011","Wellingborough 003A","E01027343",1116,95,23,72,215,190,84,86,170,176,30,20,10,70
"2011","Wellingborough 003B","E01027344",1047,124,33,91,256,149,116,55,134,113,37,20,17,63
"2011","Wellingborough 003C","E01027345",1031,124,35,89,248,180,80,59,131,102,23,17,6,84
"2011","Wellingborough 003D","E01027346",1115,134,31,103,262,188,91,82,146,111,25,15,10,76
"2011","Wellingborough 003E","E01027347",1492,177,55,122,361,244,131,96,192,139,43,24,19,109
"2011","Wellingborough 004A","E01027313",1225,52,13,39,142,105,69,97,256,308,115,92,23,81
"2011","Wellingborough 004B","E01027314",1500,87,17,70,223,149,91,113,279,350,123,90,33,85
"2011","Wellingborough 004C","E01027315",1714,97,29,68,316,214,98,144,298,362,90,46,44,95
"2011","Wellingborough 004D","E01027316",1093,53,15,38,126,130,90,107,195,262,66,45,21,64
"2011","Wellingborough 005A","E01027339",949,12,4,8,102,108,57,96,197,226,74,46,28,77
"2011","Wellingborough 005B","E01027340",1031,34,12,22,109,133,67,110,211,253,61,39,22,53
"2011","Wellingborough 005C","E01027341",1058,29,7,22,127,121,51,83,216,262,87,50,37,82
"2011","Wellingborough 005D","E01027342",985,40,12,28,172,132,59,95,184,179,63,40,23,61
"2011","Wellingborough 006A","E01027349",1259,62,19,43,198,138,83,122,216,280,104,71,33,56
"2011","Wellingborough 006B","E01027350",1068,94,17,77,212,151,63,85,151,192,56,43,13,64
"2011","Wellingborough 006C","E01027351",1084,50,14,36,185,119,66,98,199,225,94,59,35,48
"2011","Wellingborough 006D","E01027352",1011,57,16,41,149,134,68,90,193,205,68,45,23,47
"2011","Wellingborough 007A","E01027309",1111,79,20,59,227,177,117,91,175,161,32,19,13,52
"2011","Wellingborough 007B","E01027310",1022,15,3,12,118,86,47,99,201,288,102,53,49,66
"2011","Wellingborough 007C","E01027311",938,92,18,74,189,153,84,55,135,131,32,21,11,67
"2011","Wellingborough 007D","E01027312",1012,56,15,41,151,131,75,89,196,209,60,34,26,45
"2011","Wellingborough 008A","E01027317",1058,53,11,42,169,125,66,86,199,206,74,43,31,80
"2011","Wellingborough 008B","E01027318",940,23,6,17,102,97,55,80,192,237,99,65,34,55
"2011","Wellingborough 008C","E01027319",1066,46,12,34,179,128,58,107,196,216,66,46,20,70
"2011","Wellingborough 008D","E01027320",1560,119,28,91,231,203,124,130,233,307,141,109,32,72
"2011","Wellingborough 008E","E01027321",1138,154,41,113,265,163,84,78,147,134,35,22,13,78
"2011","Wellingborough 009A","E01027322",885,110,33,77,240,136,94,46,89,91,12,4,8,67
"2011","Wellingborough 009B","E01027323",1013,104,26,78,201,159,105,70,124,150,30,14,16,70
"2011","Wellingborough 009C","E01027324",886,94,26,68,222,161,101,62,106,90,8,4,4,42
"2011","Wellingborough 009D","E01027325",1138,113,29,84,284,167,128,74,130,154,21,12,9,67
"2011","Wellingborough 009E","E01027329",1292,138,50,88,342,188,157,92,137,159,21,9,12,58
"2011","Wellingborough 009F","E01027353",1281,196,51,145,318,176,191,58,129,124,19,7,12,70
"2011","Wellingborough 010A","E01027335",1122,80,30,50,218,191,105,92,161,183,33,23,10,59
"2011","Wellingborough 010B","E01027336",1031,83,24,59,191,164,106,69,149,165,63,48,15,41
"2011","Wellingborough 010C","E01027337",1339,88,24,64,254,210,121,143,209,221,41,29,12,52
"2011","Wellingborough 010D","E01027348",1531,187,32,155,382,200,194,109,190,169,39,23,16,61
"2011","Wellingborough 010E","E01027354",1745,219,65,154,452,218,192,122,226,180,42,22,20,94
"2011","Wellingborough 010F","E01027355",1223,158,48,110,311,216,119,113,117,110,16,9,7,63
"2011","Ashfield 001A","E01027979",1170,76,34,42,217,160,133,107,191,196,43,23,20,47
"2011","Ashfield 001B","E01027980",1087,33,9,24,133,105,88,102,222,225,105,77,28,74
"2011","Ashfield 001C","E01027981",1190,86,29,57,216,144,166,114,187,176,41,33,8,60
"2011","Ashfield 001D","E01027983",1123,38,12,26,129,89,87,105,222,276,99,62,37,78
"2011","Ashfield 002A","E01027970",1079,62,21,41,166,144,102,101,182,231,27,16,11,64
"2011","Ashfield 002B","E01027971",1105,67,17,50,188,150,87,119,197,216,23,17,6,58
"2011","Ashfield 002C","E01027982",1052,56,20,36,166,135,98,115,207,195,42,25,17,38
"2011","Ashfield 002D","E01027984",1134,79,32,47,217,154,77,117,205,191,29,18,11,65
"2011","Ashfield 003A","E01027966",998,21,10,11,83,81,57,93,214,291,105,82,23,53
"2011","Ashfield 003B","E01027986",1013,42,12,30,128,88,73,118,209,242,64,38,26,49
"2011","Ashfield 003C","E01027987",1263,53,13,40,173,133,70,117,242,287,127,83,44,61
"2011","Ashfield 003D","E01027990",1411,109,43,66,252,188,110,150,229,254,51,30,21,68
"2011","Ashfield 004A","E01027967",1241,43,17,26,135,127,87,109,295,293,100,58,42,52
"2011","Ashfield 004B","E01027972",1609,111,25,86,304,208,134,146,294,251,62,42,20,99
"2011","Ashfield 004C","E01027977",1417,55,18,37,184,136,106,142,299,324,93,71,22,78
"2011","Ashfield 004D","E01027978",1357,40,14,26,130,112,97,117,327,326,138,95,43,70
"2011","Ashfield 004E","E01027985",1348,70,24,46,243,160,108,126,234,278,72,49,23,57
"2011","Ashfield 005A","E01027964",1091,34,8,26,112,116,76,102,268,246,86,67,19,51
"2011","Ashfield 005B","E01027965",918,14,7,7,72,74,63,96,204,226,118,79,39,51
"2011","Ashfield 005C","E01027968",853,23,11,12,107,69,63,60,160,217,108,78,30,46
"2011","Ashfield 005D","E01027974",1145,25,4,21,85,73,73,106,271,306,116,82,34,90
"2011","Ashfield 005E","E01027976",1113,29,7,22,116,108,93,101,239,291,83,48,35,53
"2011","Ashfield 006A","E01027969",1038,51,13,38,144,125,84,101,197,225,65,46,19,46
"2011","Ashfield 006B","E01027975",1239,71,29,42,201,144,83,123,238,246,54,34,20,79
"2011","Ashfield 006C","E01027988",1192,66,23,43,214,167,82,123,207,237,39,22,17,57
"2011","Ashfield 006D","E01027989",1222,78,25,53,231,149,107,120,215,252,33,24,9,37
"2011","Ashfield 006E","E01027991",943,57,14,43,148,94,64,91,181,215,50,29,21,43
"2011","Ashfield 006F","E01027992",1665,198,57,141,438,260,143,137,197,174,31,14,17,87
"2011","Ashfield 007A","E01027949",1155,55,19,36,194,141,95,108,237,226,39,18,21,60
"2011","Ashfield 007B","E01027951",1098,22,5,17,93,73,61,113,250,278,133,83,50,75
"2011","Ashfield 007C","E01027953",1144,100,29,71,205,140,100,120,182,188,53,35,18,56
"2011","Ashfield 007D","E01027954",1202,56,14,42,159,138,72,142,227,287,65,31,34,56
"2011","Ashfield 007E","E01027973",1269,146,45,101,268,155,121,116,122,157,28,15,13,156
"2011","Ashfield 008A","E01027952",1318,61,17,44,146,116,80,121,277,334,108,83,25,75
"2011","Ashfield 008B","E01027955",948,30,9,21,137,94,62,93,177,228,86,60,26,41
"2011","Ashfield 008C","E01027956",1034,34,10,24,137,98,52,82,208,284,87,58,29,52
"2011","Ashfield 008D","E01027958",1010,36,9,27,113,102,61,98,201,267,72,49,23,60
"2011","Ashfield 009A","E01027947",1223,118,40,78,256,150,126,108,160,182,56,37,19,67
"2011","Ashfield 009B","E01027948",1391,106,34,72,269,188,111,149,214,228,47,24,23,79
"2011","Ashfield 009C","E01027950",1476,107,29,78,271,168,131,132,261,269,73,47,26,64
"2011","Ashfield 009D","E01027957",922,48,19,29,147,113,60,112,136,200,47,34,13,59
"2011","Ashfield 009E","E01027959",1119,117,42,75,245,163,88,108,164,111,25,19,6,98
"2011","Ashfield 010A","E01027995",1230,84,28,56,241,168,101,136,184,220,45,35,10,51
"2011","Ashfield 010B","E01027996",1535,92,34,58,232,173,137,140,241,335,95,65,30,90
"2011","Ashfield 010C","E01027997",1287,66,19,47,242,170,110,143,214,235,34,27,7,73
"2011","Ashfield 010D","E01027998",1384,76,32,44,228,180,131,158,255,277,27,13,14,52
"2011","Ashfield 011A","E01027960",1236,78,29,49,176,152,112,142,198,263,62,41,21,53
"2011","Ashfield 011B","E01027961",1413,105,38,67,264,188,161,120,228,250,34,18,16,63
"2011","Ashfield 011C","E01027962",1124,73,28,45,199,158,104,121,181,199,22,17,5,67
"2011","Ashfield 011D","E01027963",1196,65,18,47,200,128,131,120,188,231,58,31,27,75
"2011","Ashfield 012A","E01027945",1265,73,24,49,170,151,147,142,212,262,48,35,13,60
"2011","Ashfield 012B","E01027946",1144,51,18,33,163,121,117,109,228,244,46,28,18,65
"2011","Ashfield 012C","E01027993",1158,94,30,64,255,163,149,78,147,174,39,22,17,59
"2011","Ashfield 012D","E01027994",1054,87,31,56,206,135,125,80,167,172,30,16,14,52
"2011","Ashfield 013A","E01027929",1793,173,51,122,401,264,144,160,262,230,71,43,28,88
"2011","Ashfield 013B","E01027931",1500,105,28,77,262,208,111,114,234,237,153,102,51,76
"2011","Ashfield 013C","E01027934",1034,102,27,75,239,177,92,100,146,96,20,10,10,62
"2011","Ashfield 013D","E01027935",944,60,16,44,137,124,76,99,174,166,34,19,15,74
"2011","Ashfield 013E","E01027936",1113,105,27,78,268,187,93,89,169,132,21,11,10,49
"2011","Ashfield 014A","E01027927",1462,90,17,73,239,223,103,123,249,269,96,44,52,70
"2011","Ashfield 014B","E01027928",1417,98,15,83,253,223,110,117,233,223,90,49,41,70
"2011","Ashfield 014C","E01027932",1557,119,25,94,305,218,105,143,260,232,86,53,33,89
"2011","Ashfield 014D","E01027933",1114,66,17,49,205,157,85,106,215,182,47,23,24,51
"2011","Ashfield 014E","E01027937",986,44,18,26,135,126,62,99,197,214,69,42,27,40
"2011","Ashfield 015A","E01027925",1344,92,22,70,233,215,145,126,207,196,47,35,12,83
"2011","Ashfield 015B","E01027938",1000,86,23,63,219,181,82,92,151,99,18,12,6,72
"2011","Ashfield 015C","E01027940",1052,86,30,56,192,173,81,107,187,153,26,16,10,47
"2011","Ashfield 015D","E01027943",1031,51,16,35,188,169,99,90,201,147,43,27,16,43
"2011","Ashfield 015E","E01027944",1153,75,26,49,219,191,100,133,195,166,24,15,9,50
"2011","Ashfield 016A","E01027926",1115,53,9,44,180,173,75,127,205,209,34,14,20,59
"2011","Ashfield 016B","E01027930",1119,52,17,35,128,117,97,85,234,254,93,52,41,59
"2011","Ashfield 016C","E01027939",1007,27,8,19,117,72,55,109,223,267,79,44,35,58
"2011","Ashfield 016D","E01027941",1002,56,16,40,157,124,88,114,175,176,45,30,15,67
"2011","Ashfield 016E","E01027942",943,40,12,28,123,111,84,83,202,186,69,42,27,45
"2011","Bassetlaw 001A","E01028000",1646,190,61,129,386,209,204,144,233,150,53,33,20,77
"2011","Bassetlaw 001B","E01028024",1358,85,19,66,227,144,108,151,280,221,60,44,16,82
"2011","Bassetlaw 001C","E01028025",1103,26,8,18,123,91,70,146,279,239,51,35,16,78
"2011","Bassetlaw 001D","E01028026",1083,29,15,14,122,98,70,151,223,236,94,65,29,60
"2011","Bassetlaw 001E","E01028027",1075,34,15,19,127,90,79,155,236,224,74,51,23,56
"2011","Bassetlaw 001F","E01028028",1114,41,8,33,142,117,81,136,219,235,81,57,24,62
"2011","Bassetlaw 002A","E01027999",1652,173,53,120,398,224,239,127,224,148,46,20,26,73
"2011","Bassetlaw 002B","E01028005",1470,180,69,111,411,201,173,110,171,110,44,33,11,70
"2011","Bassetlaw 002C","E01028031",804,60,18,42,135,86,100,89,144,116,43,28,15,31
"2011","Bassetlaw 002D","E01028032",986,123,40,83,237,130,122,85,109,112,28,20,8,40
"2011","Bassetlaw 002E","E01028035",1725,177,47,130,446,215,245,153,211,151,46,33,13,81
"2011","Bassetlaw 003A","E01028023",1710,279,104,175,470,189,254,93,162,125,48,34,14,90
"2011","Bassetlaw 003B","E01028034",1843,219,78,141,440,206,205,142,202,198,63,42,21,168
"2011","Bassetlaw 003C","E01028036",2580,210,76,134,461,234,326,206,299,445,291,252,39,108
"2011","Bassetlaw 004A","E01028001",871,23,10,13,89,53,57,76,220,228,84,60,24,41
"2011","Bassetlaw 004B","E01028002",1042,87,35,52,224,130,80,91,175,163,35,25,10,57
"2011","Bassetlaw 004C","E01028003",1059,74,32,42,236,123,97,92,172,184,26,15,11,55
"2011","Bassetlaw 004D","E01028004",1162,126,39,87,280,171,139,87,133,126,45,31,14,55
"2011","Bassetlaw 004E","E01028029",900,35,15,20,134,68,79,76,177,213,73,48,25,45
"2011","Bassetlaw 004F","E01028030",969,23,3,20,109,91,80,97,212,260,44,28,16,53
"2011","Bassetlaw 005A","E01028013",1202,101,36,65,272,146,85,114,217,139,49,34,15,79
"2011","Bassetlaw 005B","E01028014",1049,27,10,17,124,116,55,135,261,203,70,42,28,58
"2011","Bassetlaw 005C","E01028015",1170,82,21,61,202,158,96,131,232,169,36,23,13,64
"2011","Bassetlaw 005D","E01028016",959,43,12,31,175,118,63,110,207,152,42,27,15,49
"2011","Bassetlaw 006A","E01028046",1215,65,26,39,204,146,99,127,256,192,57,35,22,69
"2011","Bassetlaw 006B","E01028047",1549,213,52,161,399,224,124,112,197,118,39,28,11,123
"2011","Bassetlaw 006C","E01028048",1236,110,30,80,259,180,75,118,212,164,48,34,14,70
"2011","Bassetlaw 006D","E01028049",1222,74,23,51,184,173,100,120,244,212,44,24,20,71
"2011","Bassetlaw 006E","E01028050",1427,87,31,56,249,166,128,124,269,243,46,28,18,115
"2011","Bassetlaw 008A","E01028008",906,48,19,29,132,79,57,71,183,180,105,69,36,51
"2011","Bassetlaw 008B","E01028009",1029,108,36,72,239,160,107,102,171,87,18,12,6,37
"2011","Bassetlaw 008C","E01028010",1014,117,33,84,281,151,103,71,102,81,27,22,5,81
"2011","Bassetlaw 008D","E01028011",1175,71,20,51,185,115,68,131,235,219,89,49,40,62
"2011","Bassetlaw 008E","E01028012",1013,53,14,39,213,128,65,94,212,141,46,28,18,61
"2011","Bassetlaw 008F","E01028022",1139,63,14,49,230,150,86,100,238,152,52,35,17,68
"2011","Bassetlaw 009A","E01028055",1139,50,19,31,139,101,64,109,280,235,106,76,30,55
"2011","Bassetlaw 009B","E01028056",918,53,19,34,144,84,64,91,198,177,48,34,14,59
"2011","Bassetlaw 009C","E01028058",1354,153,46,107,336,182,106,107,202,165,31,20,11,72
"2011","Bassetlaw 009D","E01028059",1334,185,65,120,356,183,109,99,168,112,23,15,8,99
"2011","Bassetlaw 010A","E01028017",917,39,14,25,139,81,57,108,212,192,44,27,17,45
"2011","Bassetlaw 010B","E01028018",1136,93,26,67,241,154,61,131,198,145,43,25,18,70
"2011","Bassetlaw 010C","E01028019",1009,34,9,25,135,110,61,98,252,190,69,33,36,60
"2011","Bassetlaw 010D","E01028020",1367,96,23,73,275,134,115,140,248,200,82,50,32,77
"2011","Bassetlaw 010E","E01028021",1084,84,25,59,257,158,116,86,178,116,36,19,17,53
"2011","Bassetlaw 012A","E01028057",985,40,12,28,149,95,83,80,209,210,72,47,25,47
"2011","Bassetlaw 012B","E01028065",1169,13,5,8,89,71,48,96,265,345,176,131,45,66
"2011","Bassetlaw 012C","E01028066",1164,15,5,10,84,64,62,99,274,345,151,111,40,70
"2011","Bassetlaw 012D","E01028068",1317,60,15,45,148,95,84,126,310,289,156,127,29,49
"2011","Bassetlaw 013A","E01028060",1240,174,44,130,328,161,140,59,159,105,49,40,9,65
"2011","Bassetlaw 013B","E01028061",1111,85,21,64,267,179,91,94,183,132,13,12,1,67
"2011","Bassetlaw 013C","E01028062",1474,83,28,55,213,152,142,116,330,261,119,96,23,58
"2011","Bassetlaw 013D","E01028067",1112,26,6,20,97,87,69,111,271,318,66,44,22,67
"2011","Bassetlaw 014A","E01028040",745,62,16,46,161,72,91,57,137,109,25,14,11,31
"2011","Bassetlaw 014B","E01028041",778,50,17,33,152,80,77,93,132,103,32,23,9,59
"2011","Bassetlaw 014C","E01028043",1092,57,15,42,172,121,85,124,227,208,30,17,13,68
"2011","Bassetlaw 014D","E01028063",1372,156,58,98,352,176,142,112,197,131,30,21,9,76
"2011","Bassetlaw 014E","E01028064",1051,23,8,15,115,61,62,100,217,257,55,39,16,161
"2011","Bassetlaw 015A","E01028006",969,115,38,77,232,107,152,59,122,76,36,17,19,70
"2011","Bassetlaw 015B","E01028007",825,127,43,84,215,99,130,43,75,53,23,13,10,60
"2011","Bassetlaw 015C","E01028033",1823,169,50,119,418,172,229,121,247,221,165,156,9,81
"2011","Bassetlaw 015D","E01028037",1245,97,29,68,257,125,195,129,162,171,39,27,12,70
"2011","Bassetlaw 015E","E01028038",1094,61,27,34,174,109,96,115,210,205,58,32,26,66
"2011","Bassetlaw 015F","E01028039",882,81,19,62,220,92,164,61,131,83,16,13,3,34
"2011","Bassetlaw 016E","E01028042",1048,65,17,48,185,143,82,93,189,184,33,24,9,74
"2011","Bassetlaw 016F","E01028044",1069,35,15,20,140,95,66,111,238,260,71,44,27,53
"2011","Bassetlaw 016G","E01028045",1386,64,17,47,165,149,97,130,334,310,57,47,10,80
"2011","Bassetlaw 016A","E01028051",1124,65,22,43,212,150,77,114,223,175,39,26,13,69
"2011","Bassetlaw 016B","E01028052",1235,101,32,69,257,150,114,106,206,179,27,14,13,95
"2011","Bassetlaw 016C","E01028053",1177,45,15,30,125,126,60,110,307,260,82,54,28,62
"2011","Bassetlaw 016D","E01028054",1103,109,29,80,273,164,98,95,141,114,35,26,9,74
"2011","Broxtowe 001A","E01028092",951,84,25,59,167,118,89,77,152,161,41,28,13,62
"2011","Broxtowe 001B","E01028093",807,66,21,45,165,148,88,72,110,109,16,10,6,33
"2011","Broxtowe 001C","E01028107",1218,96,32,64,229,199,117,118,200,166,37,24,13,56
"2011","Broxtowe 001D","E01028108",1148,65,15,50,171,145,83,142,224,209,45,22,23,64
"2011","Broxtowe 001E","E01028114",1099,67,17,50,176,143,103,101,211,205,39,21,18,54
"2011","Broxtowe 002A","E01028110",1076,40,10,30,132,84,104,105,219,212,121,83,38,59
"2011","Broxtowe 002B","E01028111",1082,86,22,64,123,147,84,107,211,197,85,53,32,42
"2011","Broxtowe 002C","E01028112",1170,60,14,46,172,107,109,77,248,227,101,57,44,69
"2011","Broxtowe 002D","E01028113",1060,40,13,27,115,100,76,91,240,249,85,54,31,64
"2011","Broxtowe 003A","E01028109",1290,95,26,69,229,174,136,133,240,181,46,30,16,56
"2011","Broxtowe 003B","E01028115",1151,89,39,50,214,184,100,117,207,167,19,6,13,54
"2011","Broxtowe 003C","E01028116",1169,79,19,60,219,168,125,120,208,157,36,21,15,57
"2011","Broxtowe 003D","E01028117",1179,141,39,102,272,197,98,99,170,93,30,19,11,79
"2011","Broxtowe 003E","E01028118",1226,119,39,80,254,199,137,113,198,142,20,13,7,44
"2011","Broxtowe 004A","E01028102",1051,82,18,64,225,156,90,88,139,146,45,24,21,80
"2011","Broxtowe 004B","E01028103",863,67,20,47,164,122,78,73,142,130,42,24,18,45
"2011","Broxtowe 004C","E01028104",1127,133,32,101,253,188,105,90,152,106,22,12,10,78
"2011","Broxtowe 004D","E01028122",1146,106,23,83,214,142,97,95,189,186,48,32,16,69
"2011","Broxtowe 004E","E01028123",1457,229,54,175,406,201,133,94,154,108,27,16,11,105
"2011","Broxtowe 004F","E01028124",1111,118,27,91,262,162,111,75,159,105,43,28,15,76
"2011","Broxtowe 007A","E01028087",1165,251,58,193,311,159,145,54,81,48,23,10,13,93
"2011","Broxtowe 007B","E01028088",1072,240,34,206,292,151,68,40,103,69,23,17,6,86
"2011","Broxtowe 007C","E01028089",950,226,40,186,276,151,72,23,61,47,25,17,8,69
"2011","Broxtowe 007D","E01028090",1000,155,24,131,265,143,86,62,124,77,23,18,5,65
"2011","Broxtowe 007E","E01028091",1056,255,57,198,323,125,87,31,81,56,24,15,9,74
"2011","Broxtowe 008A","E01028125",1231,105,31,74,226,198,110,124,200,157,44,22,22,67
"2011","Broxtowe 008B","E01028126",1018,68,19,49,185,127,57,96,193,176,38,27,11,78
"2011","Broxtowe 008C","E01028127",1203,59,13,46,179,143,72,127,234,227,93,52,41,69
"2011","Broxtowe 008D","E01028134",1122,81,14,67,209,157,63,110,216,183,34,15,19,69
"2011","Broxtowe 009A","E01028076",966,166,28,138,216,125,53,60,112,99,52,23,29,83
"2011","Broxtowe 009B","E01028077",1067,126,21,105,165,97,52,66,131,156,89,61,28,185
"2011","Broxtowe 009C","E01028078",1213,177,21,156,185,122,80,81,164,145,60,39,21,199
"2011","Broxtowe 009D","E01028079",1065,171,27,144,196,85,44,42,83,71,45,29,16,328
"2011","Broxtowe 009E","E01028084",1303,308,44,264,385,146,83,55,106,65,44,24,20,111
"2011","Broxtowe 010A","E01028128",1334,194,51,143,322,220,104,95,161,123,32,15,17,83
"2011","Broxtowe 010B","E01028129",1067,98,22,76,201,155,83,110,161,147,44,28,16,68
"2011","Broxtowe 010C","E01028130",1242,88,28,60,219,171,82,136,180,231,66,33,33,69
"2011","Broxtowe 010D","E01028131",1104,95,20,75,213,154,90,115,198,134,53,32,21,52
"2011","Broxtowe 010E","E01028132",734,48,10,38,101,107,61,68,154,116,32,15,17,47
"2011","Broxtowe 010F","E01028133",1118,70,20,50,214,150,96,94,199,178,38,22,16,79
"2011","Broxtowe 011A","E01028073",1128,155,17,138,200,112,49,55,145,140,47,35,12,225
"2011","Broxtowe 011B","E01028074",1296,184,11,173,161,93,46,67,115,132,61,43,18,437
"2011","Broxtowe 011C","E01028075",1332,186,18,168,231,124,58,63,152,140,48,22,26,330
"2011","Broxtowe 011D","E01028085",1542,330,36,294,326,126,108,45,120,90,83,54,29,314
"2011","Broxtowe 011E","E01028086",1173,213,21,192,281,141,75,70,133,98,37,25,12,125
"2011","Broxtowe 012A","E01028080",1383,224,38,186,353,164,90,100,165,116,47,29,18,124
"2011","Broxtowe 012B","E01028081",896,82,14,68,140,127,62,81,159,140,45,24,21,60
"2011","Broxtowe 012C","E01028082",985,120,16,104,198,149,55,87,173,128,13,7,6,62
"2011","Broxtowe 012D","E01028083",1044,125,12,113,156,108,50,63,164,165,70,42,28,143
"2011","Broxtowe 013A","E01028097",1139,173,30,143,271,202,70,76,150,104,23,14,9,70
"2011","Broxtowe 013B","E01028098",1256,113,51,62,233,174,58,93,230,198,78,41,37,79
"2011","Broxtowe 013C","E01028099",1173,142,45,97,323,186,79,95,153,111,25,15,10,59
"2011","Broxtowe 013D","E01028100",1165,138,15,123,246,161,73,110,172,138,37,23,14,90
"2011","Broxtowe 013E","E01028101",1009,65,18,47,151,106,54,73,198,199,81,51,30,82
"2011","Broxtowe 014A","E01028069",879,136,31,105,215,103,71,61,124,84,24,10,14,61
"2011","Broxtowe 014B","E01028070",794,156,39,117,197,115,85,42,78,49,19,13,6,53
"2011","Broxtowe 014C","E01028094",1228,206,32,174,314,171,125,70,130,83,35,24,11,94
"2011","Broxtowe 014D","E01028095",1032,182,38,144,276,145,77,61,122,77,24,16,8,68
"2011","Broxtowe 014E","E01028096",1287,176,34,142,321,186,109,82,155,114,53,44,9,91
"2011","Broxtowe 015A","E01028135",1010,175,38,137,261,185,76,57,107,63,12,4,8,74
"2011","Broxtowe 015B","E01028136",1220,156,44,112,314,203,84,103,150,110,17,8,9,83
"2011","Broxtowe 015C","E01028137",1840,409,82,327,574,238,94,99,178,88,31,20,11,129
"2011","Broxtowe 015D","E01028138",852,107,23,84,206,145,65,76,113,77,19,14,5,44
"2011","Broxtowe 015E","E01028139",1054,158,39,119,275,191,90,71,118,67,23,10,13,61
"2011","Broxtowe 016A","E01028105",906,74,19,55,188,116,73,83,143,138,30,15,15,61
"2011","Broxtowe 016B","E01028106",1141,98,24,74,237,151,173,94,170,138,32,20,12,48
"2011","Broxtowe 016C","E01028119",1637,274,50,224,386,224,180,111,168,101,53,31,22,140
"2011","Broxtowe 016D","E01028120",1174,137,35,102,297,211,122,88,131,86,27,15,12,75
"2011","Broxtowe 016E","E01028121",1078,174,43,131,251,155,114,76,107,84,40,30,10,77
"2011","Broxtowe 016F","E01033412",1789,197,51,146,391,259,200,176,238,174,41,25,16,113
"2011","Broxtowe 016G","E01033413",1720,126,37,89,293,227,160,185,296,264,73,39,34,96
"2011","Gedling 001A","E01028189",1744,209,70,139,367,199,220,110,218,230,83,59,24,108
"2011","Gedling 001B","E01028198",1020,163,42,121,329,153,115,52,91,39,15,7,8,63
"2011","Gedling 001C","E01028199",1063,165,43,122,366,161,115,56,84,56,12,8,4,48
"2011","Gedling 001D","E01028200",1191,197,60,137,341,155,173,54,93,68,39,27,12,71
"2011","Gedling 001E","E01028201",865,150,43,107,278,133,86,44,77,40,7,3,4,50
"2011","Gedling 002A","E01028150",1034,76,20,56,249,154,110,96,174,112,18,8,10,45
"2011","Gedling 002B","E01028151",873,110,37,73,215,164,89,44,107,59,28,20,8,57
"2011","Gedling 002C","E01028152",1140,101,29,72,256,154,143,84,167,123,42,30,12,70
"2011","Gedling 002D","E01028153",906,32,14,18,152,114,69,110,179,154,51,35,16,45
"2011","Gedling 002E","E01028154",1274,76,22,54,240,192,103,123,236,184,47,31,16,73
"2011","Gedling 002F","E01028213",1422,248,64,184,376,178,178,91,132,118,37,23,14,64
"2011","Gedling 004A","E01028143",910,58,11,47,200,156,84,76,150,99,43,23,20,44
"2011","Gedling 004B","E01028205",956,88,18,70,215,156,87,67,129,108,31,15,16,75
"2011","Gedling 004C","E01028206",1104,93,16,77,213,197,106,82,172,135,27,14,13,79
"2011","Gedling 004D","E01028207",964,75,25,50,177,166,93,75,146,138,29,20,9,65
"2011","Gedling 004E","E01028208",767,50,6,44,147,120,66,72,148,100,30,15,15,34
"2011","Gedling 005A","E01028173",662,13,3,10,81,60,49,66,152,111,71,55,16,59
"2011","Gedling 005B","E01028174",1047,40,14,26,176,118,70,89,220,181,78,45,33,75
"2011","Gedling 005C","E01028175",1282,96,29,67,292,195,110,104,215,152,49,24,25,69
"2011","Gedling 005D","E01028209",1034,38,6,32,153,132,88,90,205,170,85,38,47,73
"2011","Gedling 006A","E01028144",1076,73,20,53,224,162,76,89,185,160,45,21,24,62
"2011","Gedling 006B","E01028165",1041,74,20,54,219,173,80,69,192,144,47,28,19,43
"2011","Gedling 006C","E01028166",1238,61,21,40,165,166,79,112,250,231,86,50,36,88
"2011","Gedling 006D","E01028167",1384,77,15,62,271,181,86,101,237,221,117,80,37,93
"2011","Gedling 007A","E01028179",1104,101,22,79,241,181,92,93,164,120,39,33,6,73
"2011","Gedling 007B","E01028180",1092,119,34,85,275,166,101,75,154,99,38,28,10,65
"2011","Gedling 007C","E01028181",1112,112,25,87,316,211,81,79,144,89,24,12,12,56
"2011","Gedling 007D","E01028182",1192,124,28,96,271,207,119,96,141,111,33,20,13,90
"2011","Gedling 007E","E01028183",895,60,22,38,170,172,75,93,129,130,28,18,10,38
"2011","Gedling 008A","E01028148",1376,264,71,193,393,203,167,75,113,69,25,14,11,67
"2011","Gedling 008B","E01028149",1139,172,36,136,326,160,159,69,104,63,25,12,13,61
"2011","Gedling 008C","E01028178",1547,219,55,164,368,224,232,95,154,136,44,30,14,75
"2011","Gedling 009A","E01028176",1108,142,32,110,288,172,109,69,131,67,38,23,15,92
"2011","Gedling 009B","E01028177",1194,141,33,108,283,250,115,77,145,98,27,14,13,58
"2011","Gedling 009C","E01028214",1036,148,41,107,316,153,100,71,106,53,24,17,7,65
"2011","Gedling 009D","E01028215",973,161,39,122,302,126,97,43,102,48,27,19,8,67
"2011","Gedling 009E","E01028216",933,154,29,125,288,153,87,42,72,45,14,5,9,78
"2011","Gedling 009F","E01028217",951,197,36,161,318,112,94,38,56,30,25,21,4,81
"2011","Gedling 009G","E01028218",1076,157,46,111,324,188,110,58,94,61,26,17,9,58
"2011","Gedling 010A","E01028193",973,124,24,100,272,127,110,52,97,83,46,28,18,62
"2011","Gedling 010B","E01028194",1093,145,26,119,323,150,114,54,125,72,31,16,15,79
"2011","Gedling 010C","E01028195",1085,148,31,117,329,154,112,70,102,83,32,18,14,55
"2011","Gedling 010D","E01028196",1069,150,39,111,301,170,111,64,115,57,27,12,15,74
"2011","Gedling 010E","E01028197",970,99,20,79,264,167,113,73,103,70,35,22,13,46
"2011","Gedling 010F","E01028204",1035,101,30,71,238,165,98,83,160,114,25,14,11,51
"2011","Gedling 011A","E01028172",844,82,21,61,179,132,105,62,109,98,23,18,5,54
"2011","Gedling 011B","E01028190",1191,99,32,67,224,195,127,118,182,135,39,21,18,72
"2011","Gedling 011C","E01028202",1097,86,32,54,216,170,113,100,172,140,33,18,15,67
"2011","Gedling 011D","E01028203",1072,69,22,47,204,151,96,113,172,155,47,31,16,65
"2011","Gedling 011E","E01028212",1094,48,15,33,183,131,83,105,192,203,67,46,21,82
"2011","Gedling 012A","E01028168",917,99,27,72,206,127,114,73,127,87,33,21,12,51
"2011","Gedling 012B","E01028169",1087,165,54,111,242,162,119,74,133,93,28,19,9,71
"2011","Gedling 012C","E01028170",1030,126,33,93,248,154,117,66,133,78,32,19,13,76
"2011","Gedling 012D","E01028171",1010,81,29,52,203,141,99,85,161,119,54,39,15,67
"2011","Gedling 012E","E01028191",1329,90,19,71,255,214,106,138,206,186,41,22,19,93
"2011","Gedling 012F","E01028192",1120,59,17,42,159,150,85,143,204,180,85,54,31,55
"2011","Gedling 013A","E01028160",1134,85,27,58,215,184,109,89,201,132,42,25,17,77
"2011","Gedling 013B","E01028161",1103,48,12,36,192,170,75,103,226,175,40,20,20,74
"2011","Gedling 013C","E01028162",1052,78,19,59,215,158,94,97,167,135,36,18,18,72
"2011","Gedling 013D","E01028163",1109,120,32,88,259,167,127,85,162,97,41,24,17,51
"2011","Gedling 013E","E01028211",1011,79,19,60,214,181,90,67,149,122,54,39,15,55
"2011","Gedling 014A","E01028155",1054,80,27,53,208,162,98,102,163,130,40,24,16,71
"2011","Gedling 014B","E01028156",952,85,19,66,188,137,113,86,131,121,41,24,17,50
"2011","Gedling 014C","E01028157",981,88,16,72,210,136,100,86,140,103,38,31,7,80
"2011","Gedling 014D","E01028158",1165,87,21,66,215,166,106,86,205,151,71,51,20,78
"2011","Gedling 014E","E01028159",968,48,16,32,192,142,98,76,155,127,47,33,14,83
"2011","Gedling 014F","E01028164",940,49,14,35,147,127,78,76,178,155,58,30,28,72
"2011","Gedling 014G","E01028210",1020,69,23,46,194,145,74,95,180,147,58,36,22,58
"2011","Gedling 015A","E01028184",900,125,31,94,222,132,99,54,89,87,33,22,11,59
"2011","Gedling 015B","E01028185",1351,83,11,72,264,202,120,116,230,191,64,40,24,81
"2011","Gedling 015C","E01028186",1165,70,15,55,205,167,80,104,228,182,66,34,32,63
"2011","Gedling 015D","E01028187",1063,64,19,45,179,141,64,84,201,183,78,44,34,69
"2011","Gedling 015E","E01028188",1147,109,21,88,256,180,70,118,180,142,35,14,21,57
"2011","Gedling 016A","E01028142",1422,139,39,100,300,198,134,119,230,180,55,33,22,67
"2011","Gedling 016B","E01028146",1202,98,23,75,262,207,98,98,173,131,57,34,23,78
"2011","Gedling 016C","E01028147",773,38,12,26,105,102,38,58,170,130,75,43,32,57
"2011","Gedling 016D","E01032622",1031,137,31,106,258,158,105,68,110,103,26,16,10,66
"2011","Mansfield 001A","E01028224",1075,51,20,31,159,115,87,114,221,210,57,38,19,61
"2011","Mansfield 001B","E01028257",1155,27,10,17,135,111,84,152,260,247,78,57,21,61
"2011","Mansfield 001C","E01028258",1217,65,31,34,181,132,102,145,232,228,59,44,15,73
"2011","Mansfield 001D","E01028259",1098,36,9,27,125,95,88,106,243,267,66,42,24,72
"2011","Mansfield 002A","E01028223",703,29,9,20,98,86,61,71,135,144,43,35,8,36
"2011","Mansfield 002B","E01028225",1125,45,15,30,153,102,87,129,216,250,79,61,18,64
"2011","Mansfield 002C","E01028226",1073,35,11,24,128,86,73,118,222,264,81,53,28,66
"2011","Mansfield 002D","E01028260",1255,63,19,44,191,140,122,151,231,258,40,21,19,59
"2011","Mansfield 003A","E01028251",1242,108,43,65,287,172,126,109,176,159,31,17,14,74
"2011","Mansfield 003B","E01028252",1430,106,38,68,285,189,108,122,250,219,66,45,21,85
"2011","Mansfield 003C","E01028253",1307,84,23,61,270,211,136,143,212,169,26,13,13,56
"2011","Mansfield 003D","E01028277",969,57,16,41,186,147,62,109,168,154,41,32,9,45
"2011","Mansfield 003E","E01028278",1050,46,13,33,142,121,115,103,199,227,48,37,11,49
"2011","Mansfield 004A","E01028271",1248,55,21,34,187,116,82,129,232,261,110,75,35,76
"2011","Mansfield 004B","E01028279",1038,30,9,21,134,101,78,106,222,254,59,48,11,54
"2011","Mansfield 004C","E01028280",972,36,18,18,114,69,74,87,193,264,67,46,21,68
"2011","Mansfield 004D","E01028281",1017,32,9,23,108,98,69,69,224,226,115,82,33,76
"2011","Mansfield 004E","E01028283",1347,111,31,80,316,184,99,121,198,199,49,36,13,70
"2011","Mansfield 005A","E01028242",1202,85,28,57,242,161,89,117,225,203,25,12,13,55
"2011","Mansfield 005B","E01028250",1124,64,21,43,224,150,94,100,202,190,36,15,21,64
"2011","Mansfield 005C","E01028272",1193,64,20,44,214,131,113,110,207,193,71,44,27,90
"2011","Mansfield 005D","E01028273",1178,97,34,63,227,181,93,114,177,175,41,28,13,73
"2011","Mansfield 006A","E01028229",1124,44,21,23,155,143,85,136,211,253,55,37,18,42
"2011","Mansfield 006B","E01028232",1094,42,14,28,177,133,106,93,205,230,46,30,16,62
"2011","Mansfield 006E","E01028267",1404,44,18,26,190,130,94,139,279,310,129,88,41,89
"2011","Mansfield 006F","E01028282",805,36,14,22,140,80,57,83,150,170,45,30,15,44
"2011","Mansfield 006G","E01033392",1632,68,23,45,255,186,160,147,284,317,132,97,35,83
"2011","Mansfield 007A","E01028237",1181,76,24,52,208,136,119,136,228,182,26,16,10,70
"2011","Mansfield 007B","E01028238",1113,21,8,13,134,93,101,120,234,254,67,50,17,89
"2011","Mansfield 007C","E01028239",1198,60,12,48,200,164,84,111,233,202,62,48,14,82
"2011","Mansfield 007D","E01028240",1130,80,26,54,261,172,73,122,184,162,17,8,9,59
"2011","Mansfield 007E","E01028241",1714,144,51,93,433,283,145,156,232,158,33,22,11,130
"2011","Mansfield 007F","E01028243",1282,58,23,35,226,161,112,126,251,211,64,41,23,73
"2011","Mansfield 008A","E01028227",975,32,10,22,130,93,53,103,207,241,59,39,20,57
"2011","Mansfield 008B","E01028228",857,29,10,19,114,94,65,71,181,229,39,30,9,35
"2011","Mansfield 008C","E01028247",1275,44,9,35,147,97,83,110,252,348,129,83,46,65
"2011","Mansfield 008D","E01028268",1323,33,6,27,159,109,74,107,264,378,133,80,53,66
"2011","Mansfield 008E","E01028269",1129,40,9,31,153,121,90,80,194,286,112,81,31,53
"2011","Mansfield 008F","E01028284",1126,65,17,48,172,110,86,84,202,249,95,62,33,63
"2011","Mansfield 009A","E01028233",1408,55,14,41,188,137,84,130,296,357,94,60,34,67
"2011","Mansfield 009B","E01028234",1189,35,7,28,147,108,73,117,256,286,84,59,25,83
"2011","Mansfield 009C","E01028274",1111,63,17,46,191,113,97,99,189,191,112,81,31,56
"2011","Mansfield 009D","E01028275",1104,43,11,32,127,86,78,80,241,261,121,84,37,67
"2011","Mansfield 009E","E01028276",1135,14,5,9,83,69,60,101,220,357,173,124,49,58
"2011","Mansfield 010A","E01028230",997,20,5,15,85,92,64,104,245,257,71,48,23,59
"2011","Mansfield 010B","E01028231",1010,29,13,16,113,114,78,97,203,254,64,45,19,58
"2011","Mansfield 010C","E01028244",1139,58,18,40,237,143,98,117,193,192,38,27,11,63
"2011","Mansfield 010D","E01028245",932,37,17,20,119,87,51,111,201,214,61,41,20,51
"2011","Mansfield 010E","E01028246",1325,111,27,84,282,202,122,130,183,202,25,18,7,68
"2011","Mansfield 010F","E01028248",1065,33,12,21,140,119,60,107,219,257,65,46,19,65
"2011","Mansfield 010G","E01028249",974,50,9,41,165,125,95,76,173,168,43,30,13,79
"2011","Mansfield 011A","E01028235",1202,85,23,62,250,185,128,112,186,160,33,25,8,63
"2011","Mansfield 011B","E01028236",1289,89,28,61,263,186,104,119,212,202,43,28,15,71
"2011","Mansfield 011C","E01028262",1137,65,28,37,216,160,87,120,212,181,31,20,11,65
"2011","Mansfield 011D","E01028264",1476,121,41,80,319,219,111,159,240,180,36,20,16,91
"2011","Mansfield 012A","E01028254",982,46,18,28,155,131,120,108,158,145,58,40,18,61
"2011","Mansfield 012B","E01028256",1230,34,11,23,153,108,72,127,265,261,129,77,52,81
"2011","Mansfield 012C","E01028261",1243,81,31,50,185,118,104,81,217,196,156,115,41,105
"2011","Mansfield 012D","E01028263",1132,25,6,19,99,77,76,88,253,262,183,133,50,69
"2011","Mansfield 013A","E01028219",1034,121,45,76,272,167,130,64,123,95,22,8,14,40
"2011","Mansfield 013B","E01028220",1416,150,42,108,335,243,97,105,171,186,52,39,13,77
"2011","Mansfield 013D","E01028222",1132,188,70,118,357,167,96,62,110,55,18,13,5,79
"2011","Mansfield 013E","E01028255",1002,163,52,111,267,147,123,63,102,84,17,9,8,36
"2011","Mansfield 013F","E01028270",1114,141,38,103,296,174,109,70,129,101,25,16,9,69
"2011","Mansfield 013G","E01033389",1011,118,35,83,326,158,91,71,106,72,22,14,8,47
"2011","Mansfield 013H","E01033390",1116,172,47,125,360,181,80,71,94,63,20,10,10,75
"2011","Mansfield 013I","E01033391",870,123,31,92,233,148,67,68,102,68,18,11,7,43
"2011","Newark and Sherwood 001A","E01028301",1350,32,11,21,118,90,63,125,307,354,157,102,55,104
"2011","Newark and Sherwood 001B","E01028302",1171,53,19,34,158,122,89,144,217,258,59,48,11,71
"2011","Newark and Sherwood 001C","E01028338",1180,27,11,16,126,103,59,134,262,342,53,31,22,74
"2011","Newark and Sherwood 001D","E01028339",1323,40,20,20,183,135,72,145,298,289,72,53,19,89
"2011","Newark and Sherwood 001E","E01028340",1076,40,16,24,138,95,70,117,238,252,59,35,24,67
"2011","Newark and Sherwood 001F","E01028341",1263,83,19,64,258,163,122,124,215,172,73,60,13,53
"2011","Newark and Sherwood 002A","E01028313",1345,71,17,54,228,136,115,135,235,274,88,66,22,63
"2011","Newark and Sherwood 002B","E01028314",1904,137,40,97,363,224,167,170,340,313,65,45,20,125
"2011","Newark and Sherwood 002C","E01028321",1185,127,29,98,312,194,93,103,130,137,22,15,7,67
"2011","Newark and Sherwood 002D","E01028322",1438,105,42,63,295,187,124,142,210,258,32,22,10,85
"2011","Newark and Sherwood 002E","E01028323",1176,48,10,38,232,156,85,136,199,225,34,23,11,61
"2011","Newark and Sherwood 003A","E01028303",1161,110,39,71,242,122,139,108,172,169,39,28,11,60
"2011","Newark and Sherwood 003B","E01028312",1710,248,70,178,461,201,274,118,153,137,27,17,10,91
"2011","Newark and Sherwood 003C","E01028337",1139,150,44,106,324,152,174,70,106,77,18,9,9,68
"2011","Newark and Sherwood 003D","E01028349",1155,170,49,121,303,130,185,65,119,102,23,19,4,58
"2011","Newark and Sherwood 003E","E01028350",854,118,35,83,190,99,128,54,100,93,23,15,8,49
"2011","Newark and Sherwood 004A","E01028315",1044,168,55,113,279,148,161,59,96,70,17,8,9,46
"2011","Newark and Sherwood 004B","E01028316",1062,125,33,92,214,130,142,79,171,129,32,19,13,40
"2011","Newark and Sherwood 004C","E01028317",1204,146,45,101,301,142,228,69,129,96,24,18,6,69
"2011","Newark and Sherwood 004D","E01028353",1998,308,94,214,538,242,251,121,240,154,61,48,13,83
"2011","Newark and Sherwood 005A","E01028295",1523,149,53,96,358,206,168,123,175,203,59,43,16,82
"2011","Newark and Sherwood 005B","E01028297",1350,37,18,19,156,130,84,144,284,361,70,44,26,84
"2011","Newark and Sherwood 005C","E01028327",1150,165,43,122,332,135,157,43,132,98,26,20,6,62
"2011","Newark and Sherwood 005D","E01028328",1247,208,57,151,398,167,126,65,119,74,22,18,4,68
"2011","Newark and Sherwood 005E","E01028329",1197,212,63,149,308,157,176,65,94,69,30,18,12,86
"2011","Newark and Sherwood 006A","E01028296",984,35,11,24,134,128,64,120,197,194,58,45,13,54
"2011","Newark and Sherwood 006B","E01028298",1190,102,30,72,238,168,130,107,169,155,38,27,11,83
"2011","Newark and Sherwood 006C","E01028299",953,36,12,24,140,102,80,101,176,193,68,42,26,57
"2011","Newark and Sherwood 006D","E01028300",1112,34,13,21,167,120,87,109,226,229,79,56,23,61
"2011","Newark and Sherwood 006E","E01028342",1138,59,20,39,172,156,78,111,230,196,58,43,15,78
"2011","Newark and Sherwood 006F","E01028343",1497,71,25,46,226,164,126,147,298,305,65,39,26,95
"2011","Newark and Sherwood 006G","E01028344",1103,86,29,57,250,175,73,120,171,123,24,17,7,81
"2011","Newark and Sherwood 007A","E01028294",1284,88,24,64,261,131,95,131,283,195,46,36,10,54
"2011","Newark and Sherwood 007B","E01028304",1043,34,7,27,113,86,56,111,221,276,96,70,26,50
"2011","Newark and Sherwood 007C","E01028305",1064,69,15,54,145,105,93,88,249,190,64,46,18,61
"2011","Newark and Sherwood 007D","E01028306",1184,67,15,52,164,138,92,119,249,226,70,46,24,59
"2011","Newark and Sherwood 007E","E01028307",994,67,14,53,167,120,75,100,197,172,37,26,11,59
"2011","Newark and Sherwood 007F","E01028310",1329,85,20,65,218,127,106,131,265,205,103,61,42,89
"2011","Newark and Sherwood 007G","E01028311",1191,102,25,77,210,109,98,107,215,178,85,59,26,87
"2011","Newark and Sherwood 008A","E01028345",1471,273,53,220,448,175,178,60,117,79,24,10,14,117
"2011","Newark and Sherwood 008B","E01028346",1552,203,52,151,424,183,159,98,188,135,34,22,12,128
"2011","Newark and Sherwood 008C","E01028347",1083,207,47,160,334,134,90,44,89,57,16,8,8,112
"2011","Newark and Sherwood 008D","E01028348",1070,142,34,108,195,79,102,41,82,56,20,10,10,353
"2011","Newark and Sherwood 009A","E01028292",1666,225,81,144,467,254,163,125,218,123,28,13,15,63
"2011","Newark and Sherwood 009B","E01028293",1402,127,25,102,320,194,119,104,263,169,43,33,10,63
"2011","Newark and Sherwood 009C","E01028333",992,98,19,79,213,125,78,86,196,128,32,21,11,36
"2011","Newark and Sherwood 009D","E01028334",1077,45,11,34,91,91,71,85,255,232,114,80,34,93
"2011","Newark and Sherwood 009E","E01028335",1308,98,25,73,251,137,111,116,257,175,82,42,40,81
"2011","Newark and Sherwood 010A","E01028308",1169,115,21,94,250,164,107,91,197,139,49,41,8,57
"2011","Newark and Sherwood 010B","E01028309",1085,129,41,88,251,162,112,85,173,99,21,15,6,53
"2011","Newark and Sherwood 010C","E01028318",1106,33,7,26,126,82,67,69,260,282,115,98,17,72
"2011","Newark and Sherwood 010D","E01028319",1296,40,7,33,167,122,82,125,309,276,111,78,33,64
"2011","Newark and Sherwood 010E","E01028320",1134,24,9,15,99,79,100,99,268,284,126,82,44,55
"2011","Newark and Sherwood 011A","E01028285",936,72,23,49,172,128,107,96,151,129,23,16,7,58
"2011","Newark and Sherwood 011B","E01028286",860,52,16,36,136,109,70,100,178,126,43,25,18,46
"2011","Newark and Sherwood 011C","E01028287",1031,76,31,45,182,142,124,99,183,127,39,24,15,59
"2011","Newark and Sherwood 011D","E01028288",1122,94,30,64,223,166,114,94,197,143,23,11,12,68
"2011","Newark and Sherwood 011E","E01028289",1030,75,22,53,193,143,101,102,202,138,31,17,14,45
"2011","Newark and Sherwood 011F","E01028290",1046,74,18,56,191,139,93,98,206,134,40,24,16,71
"2011","Newark and Sherwood 011G","E01028291",1155,66,15,51,176,111,95,119,264,203,44,30,14,77
"2011","Newark and Sherwood 012B","E01028325",885,158,60,98,246,99,146,55,73,55,25,19,6,28
"2011","Newark and Sherwood 012C","E01028326",944,98,23,75,201,106,104,74,158,126,42,25,17,35
"2011","Newark and Sherwood 012D","E01028336",840,130,38,92,234,94,113,40,93,49,24,13,11,63
"2011","Newark and Sherwood 012E","E01028352",878,179,52,127,292,101,100,35,59,43,10,6,4,59
"2011","Newark and Sherwood 012F","E01033393",1584,249,65,184,473,221,148,112,173,105,34,23,11,69
"2011","Newark and Sherwood 012G","E01033394",923,98,26,72,207,133,130,78,126,84,25,15,10,42
"2011","Newark and Sherwood 013A","E01028330",1187,203,59,144,344,153,165,58,108,58,18,12,6,80
"2011","Newark and Sherwood 013B","E01028331",1877,169,52,117,332,198,216,102,225,430,132,112,20,73
"2011","Newark and Sherwood 013C","E01028332",1262,246,65,181,365,158,184,45,99,68,18,12,6,79
"2011","Newark and Sherwood 013D","E01028351",903,191,51,140,260,113,148,33,50,33,13,11,2,62
"2011","Rushcliffe 001A","E01028371",2163,255,75,180,419,209,250,182,298,376,87,59,28,87
"2011","Rushcliffe 001B","E01028403",1556,293,69,224,459,189,204,63,133,77,38,30,8,100
"2011","Rushcliffe 001C","E01028411",1578,272,66,206,488,195,245,71,117,82,14,10,4,94
"2011","Rushcliffe 002A","E01028357",1071,165,47,118,285,171,92,74,124,79,17,6,11,64
"2011","Rushcliffe 002B","E01028358",931,130,26,104,223,155,80,74,121,82,26,15,11,40
"2011","Rushcliffe 002C","E01028359",1227,246,61,185,369,209,105,56,97,62,17,11,6,66
"2011","Rushcliffe 002D","E01028360",1361,183,52,131,371,245,100,102,157,99,39,22,17,65
"2011","Rushcliffe 002E","E01028361",1014,176,38,138,299,172,86,55,106,42,9,4,5,69
"2011","Rushcliffe 002F","E01028362",1004,68,16,52,183,111,73,79,205,146,54,25,29,85
"2011","Rushcliffe 003A","E01028393",847,146,30,116,249,152,77,41,89,39,16,9,7,38
"2011","Rushcliffe 003B","E01028394",1014,143,37,106,280,169,103,57,125,72,21,15,6,44
"2011","Rushcliffe 003C","E01028395",1033,235,48,187,333,130,104,44,89,34,21,7,14,43
"2011","Rushcliffe 003D","E01028413",1103,148,37,111,272,153,111,54,151,106,54,32,22,54
"2011","Rushcliffe 003E","E01028414",1093,217,56,161,339,122,114,40,124,66,21,10,11,50
"2011","Rushcliffe 003F","E01028415",1119,189,47,142,342,119,140,65,114,70,15,8,7,65
"2011","Rushcliffe 004A","E01028354",1079,291,52,239,345,114,76,34,83,28,12,7,5,96
"2011","Rushcliffe 004B","E01028355",1091,233,39,194,327,138,79,55,85,69,28,18,10,77
"2011","Rushcliffe 004C","E01028384",1308,306,53,253,429,121,88,40,61,39,30,19,11,194
"2011","Rushcliffe 004D","E01028385",1227,266,51,215,395,128,89,56,102,79,26,16,10,86
"2011","Rushcliffe 004E","E01028386",1246,295,56,239,375,122,85,39,89,54,35,25,10,152
"2011","Rushcliffe 005A","E01028396",1135,306,46,260,371,137,70,32,56,29,16,6,10,118
"2011","Rushcliffe 005B","E01028398",1044,219,40,179,312,127,61,48,83,40,33,21,12,121
"2011","Rushcliffe 005C","E01028399",990,253,39,214,260,73,72,24,50,39,29,15,14,190
"2011","Rushcliffe 005D","E01028416",1281,216,31,185,293,80,58,42,70,73,37,23,14,412
"2011","Rushcliffe 005E","E01028417",1307,227,37,190,320,117,67,46,77,49,63,39,24,341
"2011","Rushcliffe 005F","E01028418",1155,204,35,169,259,122,68,49,89,62,40,27,13,262
"2011","Rushcliffe 006A","E01028356",1104,214,40,174,326,146,78,43,106,61,37,17,20,93
"2011","Rushcliffe 006B","E01028375",1319,293,53,240,394,180,93,61,126,64,33,16,17,75
"2011","Rushcliffe 006C","E01028376",1167,240,42,198,324,160,113,52,111,65,32,17,15,70
"2011","Rushcliffe 006D","E01028377",1386,383,83,300,407,181,83,56,95,55,29,15,14,97
"2011","Rushcliffe 006E","E01028397",1255,370,62,308,366,145,89,34,84,44,22,16,6,101
"2011","Rushcliffe 007A","E01028363",1103,248,43,205,305,147,79,49,91,38,32,15,17,114
"2011","Rushcliffe 007B","E01028364",1275,280,60,220,343,192,116,54,99,44,48,42,6,99
"2011","Rushcliffe 007C","E01028365",1251,273,40,233,350,140,84,59,80,60,31,26,5,174
"2011","Rushcliffe 007D","E01028391",1394,254,54,200,405,224,122,63,127,60,39,27,12,100
"2011","Rushcliffe 007E","E01028392",1318,205,25,180,323,196,101,65,156,118,47,31,16,107
"2011","Rushcliffe 008A","E01028372",812,137,21,116,188,107,86,50,101,66,33,18,15,44
"2011","Rushcliffe 008B","E01028373",963,253,71,182,288,118,110,26,52,28,23,20,3,65
"2011","Rushcliffe 008C","E01028374",813,137,32,105,189,105,65,49,103,53,37,29,8,75
"2011","Rushcliffe 008D","E01028400",1143,314,58,256,367,124,87,28,59,31,28,23,5,105
"2011","Rushcliffe 008E","E01028401",923,214,45,169,251,107,84,36,72,46,29,20,9,84
"2011","Rushcliffe 009A","E01028366",956,45,12,33,137,95,52,113,218,185,46,28,18,65
"2011","Rushcliffe 009B","E01028367",1044,101,25,76,217,138,117,90,132,136,56,42,14,57
"2011","Rushcliffe 009C","E01028368",1148,113,27,86,318,181,99,108,152,93,23,10,13,61
"2011","Rushcliffe 009D","E01028369",1078,69,17,52,201,134,66,116,204,157,62,38,24,69
"2011","Rushcliffe 009E","E01028370",1070,94,22,72,199,128,98,109,180,161,32,14,18,69
"2011","Rushcliffe 010A","E01028402",1397,294,87,207,392,168,223,60,110,62,25,14,11,63
"2011","Rushcliffe 010B","E01028419",1825,285,62,223,470,233,237,125,194,152,41,19,22,88
"2011","Rushcliffe 010C","E01028420",1036,156,50,106,277,119,158,58,110,87,10,6,4,61
"2011","Rushcliffe 011A","E01028404",1131,211,46,165,308,146,130,70,97,59,23,9,14,87
"2011","Rushcliffe 011B","E01028405",1386,170,36,134,333,193,119,120,196,153,38,22,16,64
"2011","Rushcliffe 011C","E01028406",1194,182,45,137,259,164,135,92,136,111,54,38,16,61
"2011","Rushcliffe 011D","E01028407",1483,283,64,219,377,199,146,107,143,111,41,28,13,76
"2011","Rushcliffe 012A","E01028379",1157,252,43,209,329,167,129,43,91,58,15,7,8,73
"2011","Rushcliffe 012B","E01028412",1320,246,47,199,391,218,144,55,122,55,13,6,7,76
"2011","Rushcliffe 012C","E01028421",1558,353,89,264,448,182,257,50,83,69,21,13,8,95
"2011","Rushcliffe 013A","E01028380",861,61,13,48,136,77,87,78,172,137,58,30,28,55
"2011","Rushcliffe 013B","E01028381",971,137,27,110,261,164,85,46,113,84,23,13,10,58
"2011","Rushcliffe 013C","E01028382",1015,156,31,125,262,163,97,71,109,69,16,8,8,72
"2011","Rushcliffe 013D","E01028383",793,151,32,119,228,97,87,40,83,42,12,8,4,53
"2011","Rushcliffe 014A","E01028378",1510,209,52,157,391,181,190,100,188,133,27,20,7,91
"2011","Rushcliffe 014B","E01028387",1184,120,32,88,241,154,97,77,181,156,46,33,13,112
"2011","Rushcliffe 014C","E01028408",2106,301,66,235,355,189,193,80,144,96,20,12,8,728
"2011","Rushcliffe 015A","E01028388",1194,271,63,208,358,157,90,62,86,49,18,8,10,103
"2011","Rushcliffe 015B","E01028389",1025,154,24,130,252,140,104,79,129,81,27,15,12,59
"2011","Rushcliffe 015C","E01028390",1189,204,51,153,282,189,92,76,168,89,11,8,3,78
"2011","Rushcliffe 015D","E01028409",975,204,40,164,276,118,145,41,61,38,27,25,2,65
"2011","Rushcliffe 015E","E01028410",946,194,46,148,264,110,147,43,69,46,16,12,4,57
"2011","Herefordshire 001A","E01013998",967,123,26,97,241,125,197,57,105,71,13,8,5,35
"2011","Herefordshire 001B","E01014051",1212,115,30,85,254,157,223,75,194,109,32,20,12,53
"2011","Herefordshire 001C","E01014052",1153,126,26,100,247,121,333,50,125,71,24,16,8,56
"2011","Herefordshire 001D","E01014096",1129,124,32,92,272,150,230,54,149,64,38,22,16,48
"2011","Herefordshire 002A","E01014041",1036,61,19,42,137,129,118,98,253,147,48,30,18,45
"2011","Herefordshire 002B","E01014042",1129,48,10,38,106,84,118,95,263,247,91,57,34,77
"2011","Herefordshire 002C","E01014043",738,50,21,29,163,102,83,56,141,94,19,15,4,30
"2011","Herefordshire 002D","E01014044",1082,67,22,45,171,132,113,107,219,149,54,36,18,70
"2011","Herefordshire 003A","E01014045",1174,74,22,52,202,144,170,93,221,166,37,26,11,67
"2011","Herefordshire 003B","E01014046",1065,84,24,60,205,137,155,90,169,133,29,20,9,63
"2011","Herefordshire 003C","E01014047",1029,51,13,38,164,79,102,78,232,197,63,44,19,63
"2011","Herefordshire 003D","E01014048",1064,54,15,39,159,92,147,88,240,170,69,45,24,45
"2011","Herefordshire 004A","E01013999",1053,144,26,118,243,100,202,73,109,70,26,17,9,86
"2011","Herefordshire 004B","E01014017",1055,129,43,86,243,109,244,49,127,70,26,14,12,58
"2011","Herefordshire 004C","E01014024",978,109,30,79,234,82,255,57,110,64,22,14,8,45
"2011","Herefordshire 004D","E01014025",1040,109,24,85,246,117,192,76,124,108,32,22,10,36
"2011","Herefordshire 004E","E01014055",1187,106,33,73,262,109,265,70,154,117,37,22,15,67
"2011","Herefordshire 004F","E01014097",972,102,22,80,252,95,231,42,114,68,16,11,5,52
"2011","Herefordshire 005A","E01014000",1043,122,41,81,257,112,260,54,118,58,16,13,3,46
"2011","Herefordshire 005B","E01014001",1112,145,48,97,250,137,230,59,123,56,38,23,15,74
"2011","Herefordshire 005C","E01014002",933,94,25,69,199,122,153,70,145,87,21,15,6,42
"2011","Herefordshire 005D","E01014003",1110,85,29,56,168,126,148,92,204,134,65,52,13,88
"2011","Herefordshire 005E","E01014004",1043,112,29,83,214,123,250,62,118,87,16,9,7,61
"2011","Herefordshire 005F","E01014005",1139,56,12,44,168,98,143,100,264,192,69,44,25,49
"2011","Herefordshire 005G","E01014015",1225,175,39,136,258,141,257,52,153,90,30,20,10,69
"2011","Herefordshire 006A","E01014008",1177,115,35,80,291,127,254,71,145,88,32,26,6,54
"2011","Herefordshire 006B","E01014009",1102,125,30,95,253,112,290,70,110,66,30,24,6,46
"2011","Herefordshire 006C","E01014033",1199,88,24,64,228,121,287,78,181,111,55,42,13,50
"2011","Herefordshire 006D","E01014034",1034,65,18,47,142,85,179,90,207,165,58,32,26,43
"2011","Herefordshire 006E","E01014056",1119,116,28,88,276,111,276,57,119,83,28,19,9,53
"2011","Herefordshire 007A","E01014006",1175,143,46,97,301,143,201,78,141,69,32,17,15,67
"2011","Herefordshire 007B","E01014012",1223,136,38,98,299,147,165,86,177,108,28,21,7,77
"2011","Herefordshire 007C","E01014013",1294,113,54,59,304,186,116,103,215,124,54,31,23,79
"2011","Herefordshire 007D","E01014016",1008,95,32,63,203,92,178,63,160,115,33,27,6,69
"2011","Herefordshire 007E","E01014100",1140,148,35,113,296,148,167,58,137,71,38,20,18,77
"2011","Herefordshire 007F","E01014101",823,95,24,71,212,81,163,42,116,54,16,9,7,44
"2011","Herefordshire 008A","E01014022",1524,216,69,147,411,214,183,76,184,101,42,36,6,97
"2011","Herefordshire 008B","E01014023",1280,121,44,77,285,155,187,86,208,127,41,22,19,70
"2011","Herefordshire 008C","E01014081",1092,129,29,100,298,150,187,59,118,67,25,17,8,59
"2011","Herefordshire 008D","E01014082",1397,119,28,91,289,153,117,118,229,261,35,16,19,76
"2011","Herefordshire 009A","E01014027",957,168,44,124,247,97,186,39,99,61,27,19,8,33
"2011","Herefordshire 009B","E01014028",1061,188,49,139,315,105,190,43,88,57,22,14,8,53
"2011","Herefordshire 009C","E01014029",1029,158,27,131,284,104,153,55,107,72,26,15,11,70
"2011","Herefordshire 009D","E01014030",1040,163,36,127,310,99,158,40,131,65,22,12,10,52
"2011","Herefordshire 010A","E01014083",1140,101,31,70,292,164,97,112,185,117,23,17,6,49
"2011","Herefordshire 010B","E01014084",1125,52,15,37,202,140,85,100,262,179,49,34,15,56
"2011","Herefordshire 010C","E01014085",1045,68,26,42,175,135,86,95,216,156,53,31,22,61
"2011","Herefordshire 010D","E01014087",1187,89,23,66,251,143,96,120,277,143,25,17,8,43
"2011","Herefordshire 010E","E01014088",1110,50,20,30,215,169,81,113,269,148,29,15,14,36
"2011","Herefordshire 010F","E01014089",1092,45,9,36,202,151,83,104,231,171,40,29,11,65
"2011","Herefordshire 011A","E01013987",1136,128,32,96,291,153,128,70,143,100,23,16,7,100
"2011","Herefordshire 011B","E01013988",1281,172,43,129,340,159,151,73,150,100,52,39,13,84
"2011","Herefordshire 011C","E01014007",1251,132,45,87,321,175,180,90,163,92,19,12,7,79
"2011","Herefordshire 011D","E01014095",1080,46,14,32,176,142,95,110,229,149,37,26,11,96
"2011","Herefordshire 012A","E01013986",1254,75,22,53,230,131,86,115,252,206,70,51,19,89
"2011","Herefordshire 012B","E01013989",1175,34,11,23,170,77,86,101,244,188,70,53,17,205
"2011","Herefordshire 012C","E01014010",1311,99,28,71,255,104,98,112,266,192,84,54,30,101
"2011","Herefordshire 012D","E01014011",1137,103,18,85,225,112,113,90,217,132,44,32,12,101
"2011","Herefordshire 012E","E01014086",1098,41,12,29,174,100,97,97,267,189,67,43,24,66
"2011","Herefordshire 012F","E01014092",1389,141,26,115,356,148,144,101,217,148,47,26,21,87
"2011","Herefordshire 013A","E01014075",1240,94,19,75,292,165,133,88,191,147,44,35,9,86
"2011","Herefordshire 013B","E01014076",1633,154,40,114,380,184,124,127,300,207,57,37,20,100
"2011","Herefordshire 013C","E01014077",1140,82,18,64,205,160,110,101,210,176,28,16,12,68
"2011","Herefordshire 013D","E01014078",1008,48,10,38,167,107,89,100,245,157,33,25,8,62
"2011","Herefordshire 014A","E01014090",1052,106,27,79,279,168,117,68,140,79,20,13,7,75
"2011","Herefordshire 014B","E01014091",1036,125,28,97,270,168,119,54,125,60,36,27,9,79
"2011","Herefordshire 014C","E01014093",1047,125,44,81,248,152,91,60,169,84,53,35,18,65
"2011","Herefordshire 014D","E01014094",1105,82,20,62,236,149,112,91,191,124,28,18,10,92
"2011","Herefordshire 015A","E01014068",1114,44,10,34,150,128,108,121,244,215,39,28,11,65
"2011","Herefordshire 015B","E01014070",1639,110,27,83,334,218,139,161,306,221,51,26,25,99
"2011","Herefordshire 015C","E01014072",1488,77,26,51,255,202,114,127,329,233,71,45,26,80
"2011","Herefordshire 015D","E01014073",1332,58,16,42,241,165,84,117,265,222,97,73,24,83
"2011","Herefordshire 015E","E01014074",1156,42,7,35,152,92,99,98,299,219,94,61,33,61
"2011","Herefordshire 016A","E01013996",1148,89,32,57,255,154,107,115,242,117,18,8,10,51
"2011","Herefordshire 016B","E01013997",1515,127,34,93,340,202,140,124,285,144,46,31,15,107
"2011","Herefordshire 016C","E01014079",1180,105,32,73,257,140,204,70,180,116,33,23,10,75
"2011","Herefordshire 016D","E01014080",1006,75,17,58,191,125,136,67,191,107,48,35,13,66
"2011","Herefordshire 017A","E01013992",1100,45,11,34,137,89,84,101,294,231,58,37,21,61
"2011","Herefordshire 017B","E01013993",1114,24,9,15,119,84,77,116,295,234,88,54,34,77
"2011","Herefordshire 017C","E01013994",1109,22,10,12,129,86,85,98,297,227,96,64,32,69
"2011","Herefordshire 017D","E01013995",1177,20,8,12,126,82,82,118,319,238,129,74,55,63
"2011","Herefordshire 017E","E01014071",1011,36,9,27,112,85,65,93,267,204,87,57,30,62
"2011","Herefordshire 018A","E01013990",1227,162,40,122,310,154,195,66,145,103,26,18,8,66
"2011","Herefordshire 018B","E01013991",992,107,28,79,250,107,166,57,118,84,38,27,11,65
"2011","Herefordshire 018C","E01014014",1385,198,64,134,357,146,275,63,136,80,40,25,15,90
"2011","Herefordshire 018D","E01014054",1041,126,34,92,260,111,222,66,111,68,20,12,8,57
"2011","Herefordshire 019A","E01014035",1202,76,17,59,208,110,121,117,241,213,51,28,23,65
"2011","Herefordshire 019B","E01014036",1101,151,42,109,245,128,203,50,137,86,31,22,9,70
"2011","Herefordshire 019C","E01014037",994,89,25,64,212,125,110,82,190,124,23,16,7,39
"2011","Herefordshire 019D","E01014038",1047,79,23,56,204,111,112,85,207,160,35,20,15,54
"2011","Herefordshire 019E","E01014039",1243,174,41,133,337,158,105,97,168,104,21,14,7,79
"2011","Herefordshire 019F","E01014040",1144,120,20,100,281,119,142,82,180,135,28,15,13,57
"2011","Herefordshire 020A","E01014018",1082,133,37,96,270,103,294,40,100,57,21,14,7,64
"2011","Herefordshire 020B","E01014019",1144,107,28,79,239,113,239,75,175,104,25,16,9,67
"2011","Herefordshire 020C","E01014020",1128,126,40,86,260,104,375,47,84,41,27,21,6,64
"2011","Herefordshire 020D","E01014021",1011,100,26,74,196,134,248,60,131,76,23,14,9,43
"2011","Herefordshire 021A","E01014026",1585,182,43,139,341,165,317,91,221,146,41,27,14,81
"2011","Herefordshire 021B","E01014059",1483,153,41,112,359,124,401,72,131,117,30,25,5,96
"2011","Herefordshire 021C","E01014060",1151,153,42,111,313,111,202,63,136,76,35,28,7,62
"2011","Herefordshire 021D","E01014069",1359,95,28,67,276,167,127,118,268,184,56,36,20,68
"2011","Herefordshire 021E","E01014098",1119,76,20,56,201,144,150,95,177,143,37,23,14,96
"2011","Herefordshire 021F","E01014099",1317,125,35,90,286,130,314,79,186,67,62,45,17,68
"2011","Herefordshire 022A","E01014061",1048,127,42,85,255,150,125,57,169,87,16,11,5,62
"2011","Herefordshire 022B","E01014062",1181,104,27,77,235,132,143,84,223,151,53,39,14,56
"2011","Herefordshire 022C","E01014063",1212,93,31,62,240,134,132,82,222,174,57,32,25,78
"2011","Herefordshire 022D","E01014064",1173,58,18,40,175,92,105,121,272,212,78,40,38,60
"2011","Herefordshire 022E","E01014065",1112,89,29,60,199,121,133,93,232,140,40,23,17,65
"2011","Herefordshire 022F","E01014066",829,95,25,70,188,92,104,47,143,82,34,26,8,44
"2011","Herefordshire 022G","E01014067",1018,103,27,76,264,131,104,81,169,83,21,11,10,62
"2011","Herefordshire 023A","E01014031",1110,146,42,104,279,104,217,63,119,81,34,15,19,67
"2011","Herefordshire 023B","E01014032",1192,180,49,131,310,117,208,65,136,78,22,11,11,76
"2011","Herefordshire 023C","E01014049",1188,141,38,103,297,137,210,63,139,77,74,60,14,50
"2011","Herefordshire 023D","E01014050",1320,174,45,129,314,125,332,70,127,90,23,12,11,65
"2011","Herefordshire 023E","E01014053",1325,182,47,135,335,116,259,87,151,104,31,21,10,60
"2011","Herefordshire 023F","E01014057",1260,174,48,126,300,139,219,75,164,84,34,28,6,71
"2011","Herefordshire 023G","E01014058",1216,192,53,139,330,144,194,68,130,91,25,17,8,42
"2011","Shropshire 025A","E01028853",1054,58,19,39,168,115,77,110,212,182,56,34,22,76
"2011","Shropshire 025B","E01028854",1163,167,37,130,308,170,97,82,137,122,30,14,16,50
"2011","Shropshire 025C","E01028855",1149,176,54,122,346,169,133,58,129,63,18,8,10,57
"2011","Shropshire 025D","E01028856",938,137,25,112,223,137,91,73,121,76,30,17,13,50
"2011","Shropshire 025E","E01028857",1311,154,55,99,306,165,157,93,185,138,31,19,12,82
"2011","Shropshire 027A","E01028826",1222,138,44,94,319,157,154,88,164,104,37,19,18,61
"2011","Shropshire 027B","E01028827",1070,87,24,63,270,132,77,94,188,126,29,19,10,67
"2011","Shropshire 027C","E01028844",1570,161,93,68,407,463,67,237,96,61,18,14,4,60
"2011","Shropshire 027D","E01028845",1362,201,58,143,376,237,161,67,149,79,19,14,5,73
"2011","Shropshire 029A","E01028838",1055,60,18,42,168,102,108,114,209,185,48,28,20,61
"2011","Shropshire 029B","E01028839",1001,102,36,66,241,156,126,85,124,97,22,14,8,48
"2011","Shropshire 029C","E01028840",993,105,37,68,202,125,98,100,164,123,30,18,12,46
"2011","Shropshire 029D","E01028841",1177,107,33,74,244,114,154,90,190,161,37,19,18,80
"2011","Shropshire 029E","E01028850",1741,232,73,159,416,222,344,95,208,108,34,16,18,82
"2011","Shropshire 029F","E01028851",1214,172,47,125,321,127,232,53,130,79,35,21,14,65
"2011","Shropshire 029G","E01028852",1185,136,39,97,272,94,175,108,172,136,40,28,12,52
"2011","Shropshire 031A","E01028830",1087,165,50,115,282,131,146,63,128,85,28,14,14,59
"2011","Shropshire 031B","E01028831",1090,180,60,120,267,161,122,69,140,71,20,9,11,60
"2011","Shropshire 031C","E01028836",1033,80,29,51,159,103,117,95,184,181,55,30,25,59
"2011","Shropshire 031D","E01028837",1133,112,30,82,203,157,111,108,209,152,23,17,6,58
"2011","Shropshire 033A","E01028832",1296,159,33,126,358,155,183,77,158,122,37,19,18,47
"2011","Shropshire 033B","E01028833",1066,159,50,109,300,124,119,63,136,71,35,28,7,59
"2011","Shropshire 033C","E01028834",1147,86,22,64,220,123,164,123,190,143,41,33,8,57
"2011","Shropshire 033D","E01028835",1124,84,12,72,220,127,119,112,211,155,26,18,8,70
"2011","Shropshire 034A","E01028828",1236,118,43,75,241,133,257,99,173,111,36,20,16,68
"2011","Shropshire 034B","E01028829",999,120,31,89,234,158,117,77,127,83,25,14,11,58
"2011","Shropshire 034C","E01028842",1213,172,59,113,319,137,261,53,111,61,20,16,4,79
"2011","Shropshire 034D","E01028847",1127,137,44,93,275,133,176,65,140,95,37,28,9,69
"2011","Shropshire 034E","E01028859",1212,166,48,118,331,137,203,69,131,91,26,19,7,58
"2011","Shropshire 035A","E01028843",1246,120,45,75,264,142,273,88,156,98,42,31,11,63
"2011","Shropshire 035B","E01028846",1306,170,52,118,315,180,249,71,115,120,35,24,11,51
"2011","Shropshire 035C","E01028848",1243,108,40,68,221,151,163,129,229,151,32,18,14,59
"2011","Shropshire 035D","E01028849",1423,71,21,50,216,133,170,141,280,261,70,33,37,81
"2011","Shropshire 035E","E01028858",1641,184,58,126,378,177,343,115,192,141,34,23,11,77
"2011","Shropshire 001A","E01028891",1231,51,17,34,199,109,131,113,288,195,77,36,41,68
"2011","Shropshire 001B","E01028892",1026,115,31,84,232,119,143,75,158,104,33,28,5,47
"2011","Shropshire 001C","E01028894",1102,69,20,49,186,116,123,98,232,161,56,31,25,61
"2011","Shropshire 001D","E01028895",1206,66,12,54,193,124,147,103,229,184,70,36,34,90
"2011","Shropshire 001E","E01028896",1494,85,20,65,273,168,175,158,265,233,55,28,27,82
"2011","Shropshire 001F","E01028897",1017,78,22,56,189,92,104,76,208,157,36,23,13,77
"2011","Shropshire 002A","E01028880",1138,106,30,76,217,129,181,84,162,128,68,38,30,63
"2011","Shropshire 002B","E01028881",946,91,29,62,232,103,168,74,111,91,19,14,5,57
"2011","Shropshire 002C","E01028882",1167,122,36,86,275,117,239,74,127,108,43,28,15,62
"2011","Shropshire 002D","E01028893",1143,131,38,93,245,128,206,84,161,94,33,25,8,61
"2011","Shropshire 002E","E01028899",1153,175,37,138,312,123,201,55,123,79,26,18,8,59
"2011","Shropshire 004A","E01028864",1099,129,40,89,218,115,193,71,144,131,35,17,18,63
"2011","Shropshire 004B","E01028865",1232,122,36,86,284,164,136,104,201,133,25,12,13,63
"2011","Shropshire 004C","E01028866",959,92,30,62,188,104,194,62,135,96,31,16,15,57
"2011","Shropshire 004D","E01028867",910,31,14,17,126,84,79,78,209,196,47,23,24,60
"2011","Shropshire 004E","E01028872",1207,114,34,80,274,123,176,60,149,86,37,24,13,188
"2011","Shropshire 005A","E01028873",1271,60,17,43,196,118,132,124,300,186,105,63,42,50
"2011","Shropshire 005B","E01028874",996,89,27,62,229,135,102,83,182,97,26,20,6,53
"2011","Shropshire 005C","E01028875",1768,160,57,103,419,230,157,157,318,193,55,28,27,79
"2011","Shropshire 005D","E01028876",1250,80,24,56,197,125,120,109,279,207,67,44,23,66
"2011","Shropshire 005E","E01028877",944,74,30,44,194,122,79,97,180,125,18,9,9,55
"2011","Shropshire 005F","E01028878",1153,113,43,70,239,134,126,97,200,150,26,12,14,68
"2011","Shropshire 005G","E01028879",1151,40,10,30,179,143,94,107,272,196,58,37,21,62
"2011","Shropshire 008A","E01028886",1202,84,28,56,212,132,88,119,250,187,67,48,19,63
"2011","Shropshire 008B","E01028887",920,75,21,54,204,134,106,83,137,97,23,13,10,61
"2011","Shropshire 008C","E01028889",1018,74,24,50,203,132,108,77,158,135,29,15,14,102
"2011","Shropshire 008D","E01028890",997,78,26,52,179,106,118,95,168,151,42,28,14,60
"2011","Shropshire 009A","E01028868",1103,132,47,85,241,133,178,72,155,103,25,14,11,64
"2011","Shropshire 009B","E01028869",1088,134,35,99,223,112,185,54,151,100,51,31,20,78
"2011","Shropshire 009C","E01028871",883,99,25,74,166,103,149,66,125,90,33,22,11,52
"2011","Shropshire 009D","E01028885",2257,154,59,95,464,381,221,166,288,244,223,195,28,116
"2011","Shropshire 010A","E01028860",1332,164,51,113,334,189,155,84,133,92,45,40,5,136
"2011","Shropshire 010B","E01028862",1188,148,38,110,303,148,221,75,119,87,21,15,6,66
"2011","Shropshire 010C","E01028863",1066,109,26,83,325,103,177,56,132,84,22,13,9,58
"2011","Shropshire 010D","E01028888",1198,157,43,114,291,144,239,55,110,76,36,26,10,90
"2011","Shropshire 010E","E01028898",1084,125,37,88,225,109,227,70,136,101,32,25,7,59
"2011","Shropshire 013A","E01028861",946,127,39,88,211,109,142,78,117,95,13,6,7,54
"2011","Shropshire 013B","E01028870",1108,155,44,111,300,118,236,71,109,51,19,18,1,49
"2011","Shropshire 013C","E01028883",1271,259,197,62,296,200,138,85,124,101,18,16,2,50
"2011","Shropshire 013D","E01028884",1080,95,34,61,261,166,91,92,165,129,31,20,11,50
"2011","Shropshire 003A","E01028910",1170,130,36,94,246,103,137,58,102,65,34,26,8,295
"2011","Shropshire 003B","E01028911",993,80,20,60,233,116,112,91,147,126,27,18,9,61
"2011","Shropshire 003C","E01028912",808,37,7,30,123,72,64,68,172,154,68,48,20,50
"2011","Shropshire 003D","E01028920",925,66,15,51,145,108,119,86,150,149,54,39,15,48
"2011","Shropshire 003E","E01028921",1151,79,19,60,237,141,138,105,196,153,39,21,18,63
"2011","Shropshire 003F","E01028925",1087,94,31,63,231,117,141,82,122,115,28,19,9,157
"2011","Shropshire 003G","E01028926",1020,69,21,48,173,133,100,67,195,171,50,31,19,62
"2011","Shropshire 006C","E01028902",790,47,16,31,134,92,92,75,159,114,40,33,7,37
"2011","Shropshire 006D","E01028903",903,41,18,23,130,102,91,70,212,154,57,35,22,46
"2011","Shropshire 006E","E01028904",1064,65,17,48,176,132,85,93,226,161,54,35,19,72
"2011","Shropshire 006F","E01028905",1267,53,14,39,194,119,86,121,297,222,91,59,32,84
"2011","Shropshire 006G","E01028909",1060,48,14,34,175,108,81,95,235,209,45,19,26,64
"2011","Shropshire 006H","E01033528",1915,124,30,94,396,314,152,213,333,214,46,31,15,123
"2011","Shropshire 007A","E01028906",951,52,13,39,153,94,118,62,201,139,86,47,39,46
"2011","Shropshire 007B","E01028907",1204,148,38,110,320,136,137,84,159,105,40,18,22,75
"2011","Shropshire 007C","E01028908",1155,50,6,44,152,88,105,132,244,208,102,59,43,74
"2011","Shropshire 007D","E01028916",1067,123,29,94,285,147,132,83,135,92,30,20,10,40
"2011","Shropshire 007E","E01028917",1083,115,22,93,258,152,106,75,153,78,27,13,14,119
"2011","Shropshire 007F","E01028924",1155,75,22,53,241,166,111,88,218,136,47,29,18,73
"2011","Shropshire 011A","E01028913",1157,124,30,94,273,136,232,45,140,121,32,19,13,54
"2011","Shropshire 011B","E01028918",1066,115,39,76,257,105,181,77,153,93,27,12,15,58
"2011","Shropshire 011C","E01028919",898,100,29,71,232,102,121,68,123,83,17,9,8,52
"2011","Shropshire 011D","E01028927",782,86,16,70,181,110,95,62,107,66,27,24,3,48
"2011","Shropshire 011E","E01028928",1146,81,28,53,250,147,154,103,181,122,38,24,14,70
"2011","Shropshire 012A","E01028914",822,71,16,55,183,82,153,54,115,84,33,21,12,47
"2011","Shropshire 012B","E01028915",1004,90,17,73,244,128,170,68,132,98,20,17,3,54
"2011","Shropshire 012C","E01028922",941,92,20,72,203,110,196,50,121,83,20,13,7,66
"2011","Shropshire 012D","E01028923",1193,157,37,120,320,129,211,65,146,79,23,13,10,63
"2011","Shropshire 014A","E01028929",1113,82,21,61,268,178,96,79,204,121,20,14,6,65
"2011","Shropshire 014B","E01028969",1063,131,36,95,237,119,187,62,125,86,22,15,7,94
"2011","Shropshire 014C","E01028970",926,105,32,73,234,115,143,62,108,77,27,18,9,55
"2011","Shropshire 014D","E01028971",1544,159,40,119,365,216,229,120,192,113,62,41,21,88
"2011","Shropshire 014E","E01028978",1144,107,22,85,254,131,258,72,135,97,34,21,13,56
"2011","Shropshire 014F","E01028979",918,93,27,66,209,114,152,63,141,69,21,10,11,56
"2011","Shropshire 015A","E01028933",1191,41,15,26,183,140,93,137,286,206,48,31,17,57
"2011","Shropshire 015B","E01028934",1047,31,9,22,130,118,70,99,246,215,76,46,30,62
"2011","Shropshire 015C","E01028956",1118,58,19,39,198,199,75,111,208,167,33,15,18,69
"2011","Shropshire 015D","E01028957",1085,28,8,20,104,78,67,103,284,236,109,66,43,76
"2011","Shropshire 015E","E01028958",1366,58,19,39,210,169,119,140,313,217,45,28,17,95
"2011","Shropshire 016A","E01028932",1481,130,31,99,337,204,136,121,286,152,34,15,19,81
"2011","Shropshire 016B","E01028981",1201,69,23,46,227,185,108,111,251,140,37,22,15,73
"2011","Shropshire 016C","E01028982",1137,47,16,31,174,145,89,98,268,210,39,21,18,67
"2011","Shropshire 016D","E01028983",1448,41,13,28,172,138,96,146,355,295,100,68,32,105
"2011","Shropshire 017A","E01028930",1201,125,30,95,310,177,79,95,195,110,39,17,22,71
"2011","Shropshire 017B","E01028931",1483,168,32,136,343,189,115,122,274,149,51,29,22,72
"2011","Shropshire 017C","E01028944",1288,72,22,50,216,162,110,129,258,214,64,30,34,63
"2011","Shropshire 017D","E01028945",1611,141,26,115,391,197,130,132,255,213,79,42,37,73
"2011","Shropshire 018A","E01028965",1022,38,9,29,163,146,78,96,218,158,73,55,18,52
"2011","Shropshire 018B","E01028966",960,62,21,41,199,149,79,97,185,123,12,8,4,54
"2011","Shropshire 018C","E01028967",1075,35,13,22,130,104,95,93,223,208,93,63,30,94
"2011","Shropshire 018D","E01028968",955,35,10,25,146,127,89,93,196,145,55,37,18,69
"2011","Shropshire 018E","E01028988",1247,131,22,109,306,147,115,97,215,118,45,28,17,73
"2011","Shropshire 018F","E01028989",1224,88,22,66,213,145,108,99,262,148,58,39,19,103
"2011","Shropshire 019A","E01028946",1941,246,46,200,478,204,217,134,253,233,81,52,29,95
"2011","Shropshire 019B","E01028972",1211,192,51,141,371,177,116,71,137,65,17,10,7,65
"2011","Shropshire 019C","E01028973",1442,199,46,153,396,190,121,84,194,109,59,31,28,90
"2011","Shropshire 019D","E01028987",1548,197,40,157,435,193,162,108,215,112,46,28,18,80
"2011","Shropshire 020A","E01028941",1393,191,20,171,351,177,89,63,176,102,52,30,22,192
"2011","Shropshire 020B","E01028942",1061,182,42,140,288,142,108,54,110,63,30,26,4,84
"2011","Shropshire 020C","E01028943",1650,160,36,124,404,243,129,139,263,172,66,36,30,74
"2011","Shropshire 020D","E01028951",1056,184,35,149,304,139,98,44,136,67,24,16,8,60
"2011","Shropshire 020E","E01028953",977,141,34,107,298,148,83,48,123,49,20,14,6,67
"2011","Shropshire 021A","E01028947",970,120,29,91,277,157,82,57,114,86,24,19,5,53
"2011","Shropshire 021B","E01028948",1069,89,20,69,251,148,96,71,170,121,47,30,17,76
"2011","Shropshire 021C","E01028949",1078,183,34,149,329,150,102,31,121,76,22,15,7,64
"2011","Shropshire 021D","E01028985",1006,97,29,68,249,176,88,80,156,87,21,14,7,52
"2011","Shropshire 022A","E01028938",1212,165,36,129,337,125,112,74,186,113,38,14,24,62
"2011","Shropshire 022B","E01028939",1185,151,32,119,337,177,87,87,167,88,30,20,10,61
"2011","Shropshire 022C","E01028984",1038,68,14,54,229,160,80,82,188,141,52,37,15,38
"2011","Shropshire 022D","E01028986",1116,110,26,84,246,196,122,90,170,97,16,6,10,69
"2011","Shropshire 023A","E01028940",1148,135,36,99,313,144,115,69,161,90,39,21,18,82
"2011","Shropshire 023B","E01028952",1270,168,38,130,370,197,97,98,158,90,38,22,16,54
"2011","Shropshire 023C","E01028962",1159,29,9,20,138,79,94,132,270,246,95,55,40,76
"2011","Shropshire 023D","E01028963",1164,158,25,133,362,175,114,67,145,54,21,15,6,68
"2011","Shropshire 023E","E01028964",1196,170,40,130,337,190,114,58,146,75,20,14,6,86
"2011","Shropshire 023F","E01028974",1198,166,31,135,326,105,70,28,81,32,14,9,5,376
"2011","Shropshire 024A","E01028935",1095,105,29,76,252,178,109,97,179,90,20,12,8,65
"2011","Shropshire 024B","E01028936",1515,146,33,113,407,217,185,96,229,126,40,32,8,69
"2011","Shropshire 024C","E01028937",1129,86,18,68,276,161,92,82,207,134,19,14,5,72
"2011","Shropshire 024D","E01028959",1904,243,67,176,458,226,298,121,267,159,45,27,18,87
"2011","Shropshire 026A","E01028954",952,123,29,94,246,104,151,59,108,70,25,18,7,66
"2011","Shropshire 026B","E01028955",788,83,22,61,178,94,92,45,129,107,38,26,12,22
"2011","Shropshire 026C","E01028975",1243,95,29,66,230,122,155,109,242,160,42,26,16,88
"2011","Shropshire 026D","E01028976",1262,176,37,139,321,169,222,71,123,75,33,21,12,72
"2011","Shropshire 026E","E01028977",1396,141,37,104,303,150,219,91,223,124,55,41,14,90
"2011","Shropshire 028A","E01028950",1689,265,61,204,432,173,303,80,184,116,39,32,7,97
"2011","Shropshire 028B","E01028960",1003,134,29,105,267,93,261,35,95,53,15,9,6,50
"2011","Shropshire 028C","E01028961",1267,124,29,95,286,98,205,52,81,52,30,20,10,339
"2011","Shropshire 028D","E01028980",1605,244,62,182,375,150,257,102,181,158,44,25,19,94
"2011","Shropshire 030A","E01028991",924,94,22,72,201,90,219,45,127,63,31,26,5,54
"2011","Shropshire 030B","E01028992",1146,62,19,43,213,81,236,73,203,158,56,44,12,64
"2011","Shropshire 030D","E01033529",787,95,21,74,174,72,189,43,107,65,10,5,5,32
"2011","Shropshire 030E","E01033530",1489,134,27,107,342,154,315,102,198,124,39,22,17,81
"2011","Shropshire 032A","E01028990",893,123,29,94,220,80,207,52,90,61,20,10,10,40
"2011","Shropshire 032B","E01028997",1534,241,53,188,428,152,212,80,187,103,47,23,24,84
"2011","Shropshire 032C","E01028998",1643,225,34,191,404,193,272,95,223,108,45,27,18,78
"2011","Shropshire 036A","E01028993",1155,111,34,77,263,125,274,56,145,91,36,22,14,54
"2011","Shropshire 036B","E01029004",817,80,23,57,215,78,190,70,88,53,16,13,3,27
"2011","Shropshire 036C","E01029013",1225,95,26,69,261,130,208,99,175,159,38,24,14,60
"2011","Shropshire 036D","E01029014",818,23,4,19,107,79,95,81,186,165,40,22,18,42
"2011","Shropshire 036E","E01029015",1068,133,30,103,257,83,257,61,127,82,24,14,10,44
"2011","Shropshire 037A","E01028994",898,81,25,56,203,90,158,50,108,102,25,20,5,81
"2011","Shropshire 037B","E01029003",1717,189,48,141,357,162,502,68,183,145,30,22,8,81
"2011","Shropshire 037C","E01029005",901,106,26,80,216,84,261,38,94,59,16,10,6,27
"2011","Shropshire 037D","E01029016",1021,110,29,81,227,113,251,69,120,72,21,13,8,38
"2011","Shropshire 038A","E01029006",1055,79,15,64,214,124,132,90,176,155,46,34,12,39
"2011","Shropshire 038B","E01029007",791,42,12,30,116,66,60,73,161,166,52,33,19,55
"2011","Shropshire 038D","E01029009",832,63,21,42,186,139,93,77,135,98,9,6,3,32
"2011","Shropshire 038E","E01029010",1016,42,6,36,154,107,105,96,201,203,52,36,16,56
"2011","Shropshire 038F","E01029011",1065,75,19,56,176,113,131,101,195,177,50,37,13,47
"2011","Shropshire 038G","E01029012",1332,95,27,68,295,202,180,84,220,155,42,25,17,59
"2011","Shropshire 038H","E01033526",747,63,13,50,134,70,124,61,124,103,41,20,21,27
"2011","Shropshire 038I","E01033527",884,122,33,89,217,103,140,57,111,88,20,13,7,26
"2011","Shropshire 039A","E01028995",1120,97,32,65,192,104,200,90,229,119,28,21,7,61
"2011","Shropshire 039B","E01028996",954,128,29,99,221,116,200,56,112,68,19,11,8,34
"2011","Shropshire 039C","E01028999",1160,116,29,87,202,138,221,92,176,131,36,21,15,48
"2011","Shropshire 039D","E01029000",841,72,19,53,194,79,166,66,122,79,19,15,4,44
"2011","Shropshire 039E","E01029001",1431,166,43,123,357,163,227,81,185,135,24,12,12,93
"2011","Shropshire 039F","E01029002",936,67,17,50,174,85,120,76,163,149,42,24,18,60
"2011","Stoke-on-Trent 001A","E01014257",1097,43,16,27,138,116,89,99,248,257,48,31,17,59
"2011","Stoke-on-Trent 001B","E01014258",1142,113,40,73,235,152,114,97,180,131,27,16,11,93
"2011","Stoke-on-Trent 001C","E01014259",1114,46,15,31,123,142,85,107,258,254,33,26,7,66
"2011","Stoke-on-Trent 001D","E01014260",952,39,19,20,104,100,65,84,209,247,65,43,22,39
"2011","Stoke-on-Trent 001E","E01014264",1390,97,29,68,262,211,125,127,224,200,57,39,18,87
"2011","Stoke-on-Trent 002A","E01014357",1063,39,13,26,130,126,74,102,209,268,70,51,19,45
"2011","Stoke-on-Trent 002B","E01014358",961,30,8,22,88,93,43,79,208,233,112,79,33,75
"2011","Stoke-on-Trent 002C","E01014359",1307,49,14,35,152,156,90,114,267,312,80,58,22,87
"2011","Stoke-on-Trent 002D","E01014360",1458,92,21,71,253,206,116,137,233,278,56,35,21,87
"2011","Stoke-on-Trent 003A","E01014261",956,16,4,12,85,57,52,67,221,253,127,95,32,78
"2011","Stoke-on-Trent 003B","E01014262",943,36,14,22,100,110,52,69,165,242,92,68,24,77
"2011","Stoke-on-Trent 003C","E01014263",1214,29,10,19,140,122,89,94,220,286,132,104,28,102
"2011","Stoke-on-Trent 003D","E01014333",1136,58,27,31,174,150,86,127,226,226,32,22,10,57
"2011","Stoke-on-Trent 003E","E01014334",1055,35,10,25,150,121,67,99,216,270,49,34,15,48
"2011","Stoke-on-Trent 004A","E01014331",1052,30,12,18,105,96,67,104,223,246,108,67,41,73
"2011","Stoke-on-Trent 004B","E01014332",1261,65,18,47,196,175,111,120,242,269,38,27,11,45
"2011","Stoke-on-Trent 004C","E01014335",1235,83,22,61,234,181,144,113,187,181,42,28,14,70
"2011","Stoke-on-Trent 004D","E01014336",1111,24,6,18,121,78,82,79,241,312,99,68,31,75
"2011","Stoke-on-Trent 004E","E01014337",1228,40,20,20,138,129,93,94,256,304,87,57,30,87
"2011","Stoke-on-Trent 005A","E01014354",1221,39,16,23,120,100,89,78,241,303,167,121,46,84
"2011","Stoke-on-Trent 005B","E01014355",1388,61,16,45,162,145,146,98,243,267,170,148,22,96
"2011","Stoke-on-Trent 005C","E01014356",1260,59,21,38,164,143,131,105,215,214,130,98,32,99
"2011","Stoke-on-Trent 005D","E01014361",1135,27,1,26,97,117,85,76,218,227,186,137,49,102
"2011","Stoke-on-Trent 006A","E01014241",1125,35,7,28,135,117,79,94,243,256,70,48,22,96
"2011","Stoke-on-Trent 006B","E01014242",1018,25,12,13,120,102,65,99,184,247,94,72,22,82
"2011","Stoke-on-Trent 006C","E01014243",1090,83,23,60,178,149,93,90,182,183,50,37,13,82
"2011","Stoke-on-Trent 006D","E01014244",1030,14,4,10,78,78,36,93,216,281,151,101,50,83
"2011","Stoke-on-Trent 006E","E01014245",1240,59,24,35,172,171,101,111,228,242,68,48,20,88
"2011","Stoke-on-Trent 006F","E01014248",1124,27,9,18,130,123,66,98,252,257,93,67,26,78
"2011","Stoke-on-Trent 007A","E01014214",1107,111,45,66,252,175,149,82,142,115,20,9,11,61
"2011","Stoke-on-Trent 007B","E01014215",1087,67,23,44,189,153,94,98,175,212,30,17,13,69
"2011","Stoke-on-Trent 007C","E01014216",1020,82,22,60,188,134,110,95,175,162,26,21,5,48
"2011","Stoke-on-Trent 007D","E01014265",1170,100,30,70,255,198,104,100,174,155,17,15,2,67
"2011","Stoke-on-Trent 007E","E01014267",1764,137,26,111,352,257,134,164,310,249,56,34,22,105
"2011","Stoke-on-Trent 007F","E01014272",1068,85,25,60,213,163,114,77,167,153,26,13,13,70
"2011","Stoke-on-Trent 008A","E01014246",1189,43,13,30,150,118,96,102,217,286,90,63,27,87
"2011","Stoke-on-Trent 008B","E01014266",881,30,6,24,102,107,44,82,176,216,72,45,27,52
"2011","Stoke-on-Trent 008C","E01014268",1481,85,16,69,242,203,98,134,274,302,72,48,24,71
"2011","Stoke-on-Trent 008D","E01014270",1123,65,22,43,216,180,98,103,188,180,27,14,13,66
"2011","Stoke-on-Trent 008E","E01014271",1114,57,10,47,179,144,100,98,193,202,52,33,19,89
"2011","Stoke-on-Trent 009A","E01014247",1313,40,7,33,131,152,81,104,243,318,140,102,38,104
"2011","Stoke-on-Trent 009B","E01014250",805,27,8,19,77,70,64,70,138,206,98,75,23,55
"2011","Stoke-on-Trent 009C","E01014251",1390,65,15,50,179,143,99,119,234,283,165,117,48,103
"2011","Stoke-on-Trent 009D","E01014252",1267,38,12,26,163,148,77,125,218,324,90,64,26,84
"2011","Stoke-on-Trent 009E","E01014255",1289,36,3,33,147,116,93,112,192,242,199,165,34,152
"2011","Stoke-on-Trent 010A","E01014269",1097,26,8,18,105,103,70,88,255,271,99,71,28,80
"2011","Stoke-on-Trent 010B","E01014324",1080,52,12,40,161,168,110,106,193,169,44,25,19,77
"2011","Stoke-on-Trent 010C","E01014325",1070,83,31,52,218,176,90,113,162,127,10,4,6,91
"2011","Stoke-on-Trent 010D","E01014326",1177,75,27,48,201,164,101,115,224,176,38,20,18,83
"2011","Stoke-on-Trent 011A","E01014249",1225,27,4,23,104,90,99,102,198,224,248,200,48,133
"2011","Stoke-on-Trent 011B","E01014253",1160,66,29,37,182,135,83,108,237,206,54,37,17,89
"2011","Stoke-on-Trent 011C","E01014254",1115,22,2,20,98,73,114,84,194,198,225,183,42,107
"2011","Stoke-on-Trent 011D","E01014256",1195,25,9,16,128,122,84,101,231,280,129,104,25,95
"2011","Stoke-on-Trent 012A","E01014210",1055,25,7,18,74,90,83,101,184,311,101,67,34,86
"2011","Stoke-on-Trent 012B","E01014211",1062,13,6,7,71,102,59,80,219,329,111,84,27,78
"2011","Stoke-on-Trent 012C","E01014212",959,24,5,19,96,87,57,80,202,248,102,76,26,63
"2011","Stoke-on-Trent 012D","E01014213",925,31,13,18,108,67,62,95,195,230,80,54,26,57
"2011","Stoke-on-Trent 012E","E01014217",972,16,6,10,88,90,55,82,212,242,111,82,29,76
"2011","Stoke-on-Trent 013A","E01014323",974,33,6,27,133,155,63,90,182,201,61,37,24,56
"2011","Stoke-on-Trent 013B","E01014327",1070,46,12,34,151,148,79,103,200,215,69,29,40,59
"2011","Stoke-on-Trent 013C","E01014328",1100,35,7,28,130,144,58,92,194,246,92,66,26,109
"2011","Stoke-on-Trent 013D","E01014329",1103,47,10,37,162,159,80,91,189,249,61,45,16,65
"2011","Stoke-on-Trent 013E","E01014330",1241,30,5,25,123,76,112,81,214,285,204,147,57,116
"2011","Stoke-on-Trent 014A","E01014218",1051,23,9,14,91,87,60,88,248,284,93,57,36,77
"2011","Stoke-on-Trent 014B","E01014219",963,50,18,32,162,130,67,78,198,177,47,30,17,54
"2011","Stoke-on-Trent 014C","E01014225",1131,60,16,44,207,177,124,87,192,192,30,19,11,62
"2011","Stoke-on-Trent 014D","E01014226",992,25,8,17,102,117,74,96,215,258,45,34,11,60
"2011","Stoke-on-Trent 014E","E01014228",1047,48,18,30,156,130,86,117,219,214,27,16,11,50
"2011","Stoke-on-Trent 014F","E01014230",1102,36,8,28,142,151,92,108,220,228,60,30,30,65
"2011","Stoke-on-Trent 015A","E01014281",1396,25,8,17,85,74,92,56,162,177,184,161,23,541
"2011","Stoke-on-Trent 015B","E01014285",1620,86,17,69,247,255,135,86,226,236,178,155,23,171
"2011","Stoke-on-Trent 015C","E01014286",1037,32,11,21,75,67,90,71,143,168,215,186,29,176
"2011","Stoke-on-Trent 015D","E01014287",1258,30,3,27,105,93,107,77,188,195,271,216,55,192
"2011","Stoke-on-Trent 016B","E01014231",1186,58,17,41,172,148,58,90,215,245,101,65,36,99
"2011","Stoke-on-Trent 016D","E01014282",1494,33,3,30,60,43,56,55,98,97,95,75,20,957
"2011","Stoke-on-Trent 016E","E01014283",1789,61,10,51,126,122,71,69,146,137,104,90,14,953
"2011","Stoke-on-Trent 016F","E01014284",1338,11,1,10,40,35,40,29,90,60,80,69,11,953
"2011","Stoke-on-Trent 016G","E01033216",1865,52,13,39,246,242,129,164,362,381,103,57,46,186
"2011","Stoke-on-Trent 017A","E01014220",1115,17,3,14,83,86,71,88,254,304,153,106,47,59
"2011","Stoke-on-Trent 017B","E01014221",1104,19,9,10,95,85,52,80,238,336,119,78,41,80
"2011","Stoke-on-Trent 017C","E01014222",1039,14,3,11,69,65,53,79,230,301,147,97,50,81
"2011","Stoke-on-Trent 017D","E01014223",1156,22,5,17,69,75,73,100,265,356,135,83,52,61
"2011","Stoke-on-Trent 017E","E01014224",1004,20,4,16,56,81,63,78,219,312,105,63,42,70
"2011","Stoke-on-Trent 017F","E01014229",1171,28,7,21,131,128,66,109,266,282,80,55,25,81
"2011","Stoke-on-Trent 018A","E01014288",1261,94,21,73,278,167,86,76,160,150,67,34,33,183
"2011","Stoke-on-Trent 018B","E01014289",1217,130,28,102,304,158,94,79,156,141,39,27,12,116
"2011","Stoke-on-Trent 018C","E01014290",1134,114,10,104,272,124,68,77,129,146,70,48,22,134
"2011","Stoke-on-Trent 018D","E01014291",1051,84,23,61,186,130,82,73,154,167,72,43,29,103
"2011","Stoke-on-Trent 018E","E01014292",1265,134,24,110,288,145,95,77,170,134,60,39,21,162
"2011","Stoke-on-Trent 018F","E01014294",953,80,12,68,165,115,54,70,159,161,39,25,14,110
"2011","Stoke-on-Trent 019A","E01014293",1343,75,18,57,234,128,73,70,203,191,117,81,36,252
"2011","Stoke-on-Trent 019B","E01014295",1226,115,31,84,256,178,103,107,171,157,44,30,14,95
"2011","Stoke-on-Trent 019C","E01014339",1306,41,5,36,173,159,66,100,243,270,116,84,32,138
"2011","Stoke-on-Trent 019D","E01014340",1437,86,15,71,229,147,95,131,262,246,104,57,47,137
"2011","Stoke-on-Trent 019E","E01014345",1337,61,14,47,200,129,81,115,207,257,111,74,37,176
"2011","Stoke-on-Trent 020A","E01014274",1310,44,7,37,171,163,82,105,261,325,98,59,39,61
"2011","Stoke-on-Trent 020B","E01014275",1019,18,6,12,121,102,55,88,186,260,117,83,34,72
"2011","Stoke-on-Trent 020C","E01014276",1206,37,10,27,150,157,78,114,231,272,57,35,22,110
"2011","Stoke-on-Trent 020D","E01014277",1207,40,10,30,161,156,71,123,242,271,54,33,21,89
"2011","Stoke-on-Trent 020E","E01014279",1318,44,15,29,180,157,88,124,254,297,82,54,28,92
"2011","Stoke-on-Trent 021A","E01014273",930,30,7,23,82,98,73,84,204,206,85,62,23,68
"2011","Stoke-on-Trent 021B","E01014278",1036,36,11,25,115,114,57,114,242,258,47,25,22,53
"2011","Stoke-on-Trent 021C","E01014280",1055,34,13,21,138,138,83,101,231,245,32,18,14,53
"2011","Stoke-on-Trent 021D","E01014297",1041,52,21,31,141,150,78,95,207,204,37,24,13,77
"2011","Stoke-on-Trent 022A","E01014296",1108,36,15,21,146,155,58,125,197,259,62,37,25,70
"2011","Stoke-on-Trent 022B","E01014298",1135,21,7,14,125,113,67,107,221,304,90,67,23,87
"2011","Stoke-on-Trent 022C","E01014300",1028,27,13,14,118,100,46,104,198,266,93,64,29,76
"2011","Stoke-on-Trent 022D","E01014302",1340,41,7,34,149,132,95,137,275,350,95,55,40,66
"2011","Stoke-on-Trent 023A","E01014338",1154,97,18,79,231,150,121,92,185,153,42,29,13,83
"2011","Stoke-on-Trent 023B","E01014341",1348,98,17,81,189,125,71,96,246,271,61,38,23,191
"2011","Stoke-on-Trent 023C","E01014342",1011,30,7,23,125,111,56,70,211,237,68,49,19,103
"2011","Stoke-on-Trent 023D","E01014343",1360,78,15,63,275,174,92,104,235,266,63,40,23,73
"2011","Stoke-on-Trent 023E","E01014344",1099,64,15,49,186,126,57,96,210,215,76,41,35,69
"2011","Stoke-on-Trent 024A","E01014363",985,45,16,29,149,139,76,103,186,211,29,20,9,47
"2011","Stoke-on-Trent 024B","E01014364",1045,48,17,31,162,133,73,99,204,195,67,52,15,64
"2011","Stoke-on-Trent 024C","E01014365",1104,47,13,34,184,133,84,113,206,218,53,45,8,66
"2011","Stoke-on-Trent 024D","E01014369",942,47,14,33,135,117,60,101,200,189,39,25,14,54
"2011","Stoke-on-Trent 025A","E01014299",1132,52,18,34,169,177,71,110,232,250,19,11,8,52
"2011","Stoke-on-Trent 025B","E01014301",1300,84,28,56,245,173,105,133,207,217,32,21,11,104
"2011","Stoke-on-Trent 025C","E01014303",1232,65,18,47,191,170,112,107,225,247,31,16,15,84
"2011","Stoke-on-Trent 025D","E01014304",1091,45,16,29,179,130,86,143,200,227,29,20,9,52
"2011","Stoke-on-Trent 025E","E01014362",1072,58,25,33,199,151,94,115,211,186,21,10,11,37
"2011","Stoke-on-Trent 026A","E01014233",1047,65,27,38,160,164,83,81,197,200,36,22,14,61
"2011","Stoke-on-Trent 026B","E01014234",1087,28,9,19,126,73,66,95,245,254,99,61,38,101
"2011","Stoke-on-Trent 026C","E01014239",1089,42,13,29,182,154,65,101,199,221,52,40,12,73
"2011","Stoke-on-Trent 026D","E01014240",1092,48,14,34,131,137,65,77,210,278,67,43,24,79
"2011","Stoke-on-Trent 027A","E01014308",1276,68,15,53,212,159,101,134,243,253,39,26,13,67
"2011","Stoke-on-Trent 027B","E01014309",894,38,5,33,153,82,70,74,164,169,83,60,23,61
"2011","Stoke-on-Trent 027C","E01014311",1016,35,12,23,143,123,81,96,193,222,62,44,18,61
"2011","Stoke-on-Trent 027D","E01014313",1100,27,7,20,101,85,63,128,230,340,69,52,17,57
"2011","Stoke-on-Trent 028A","E01014321",1125,35,9,26,134,126,88,110,257,274,42,30,12,59
"2011","Stoke-on-Trent 028B","E01014366",1258,26,9,17,114,102,76,119,257,310,159,116,43,95
"2011","Stoke-on-Trent 028C","E01014367",1005,13,3,10,67,88,42,86,242,265,130,81,49,72
"2011","Stoke-on-Trent 028D","E01014368",1129,24,8,16,91,115,60,104,252,303,101,64,37,79
"2011","Stoke-on-Trent 029A","E01014305",961,21,2,19,88,82,140,69,121,140,212,185,27,88
"2011","Stoke-on-Trent 029B","E01014306",1001,30,5,25,118,67,101,56,160,218,166,141,25,85
"2011","Stoke-on-Trent 029C","E01014307",918,14,4,10,84,72,150,41,146,132,191,167,24,88
"2011","Stoke-on-Trent 029D","E01014312",1024,53,13,40,182,124,84,85,178,188,57,43,14,73
"2011","Stoke-on-Trent 030A","E01014346",1185,116,36,80,285,196,103,96,172,143,26,18,8,48
"2011","Stoke-on-Trent 030B","E01014348",985,109,24,85,263,183,87,61,120,102,18,10,8,42
"2011","Stoke-on-Trent 030C","E01014349",1016,106,30,76,264,139,90,81,138,101,29,22,7,68
"2011","Stoke-on-Trent 030D","E01014353",1195,74,13,61,215,133,88,107,218,206,74,37,37,80
"2011","Stoke-on-Trent 031A","E01014310",1445,161,46,115,314,198,132,117,182,181,73,59,14,87
"2011","Stoke-on-Trent 031B","E01014314",1075,130,40,90,243,149,126,65,129,97,44,31,13,92
"2011","Stoke-on-Trent 031C","E01014316",1037,19,6,13,88,65,58,81,213,269,167,116,51,77
"2011","Stoke-on-Trent 031D","E01014317",1063,31,12,19,91,94,51,105,236,274,118,75,43,63
"2011","Stoke-on-Trent 031E","E01014322",1203,37,10,27,172,115,95,101,222,256,108,86,22,97
"2011","Stoke-on-Trent 032A","E01014235",1133,56,17,39,134,122,89,97,192,265,86,58,28,92
"2011","Stoke-on-Trent 032B","E01014236",1619,146,27,119,262,165,108,110,255,333,131,95,36,109
"2011","Stoke-on-Trent 032C","E01014237",1151,19,5,14,117,117,54,109,230,287,129,72,57,89
"2011","Stoke-on-Trent 032D","E01014238",1044,16,5,11,86,79,68,95,228,274,118,68,50,80
"2011","Stoke-on-Trent 033A","E01014315",1048,97,32,65,224,164,83,97,168,144,20,18,2,51
"2011","Stoke-on-Trent 033B","E01014318",1113,112,38,74,242,210,75,84,156,137,22,10,12,75
"2011","Stoke-on-Trent 033C","E01014319",1080,98,27,71,243,153,82,71,161,160,36,21,15,76
"2011","Stoke-on-Trent 033D","E01014320",1011,121,35,86,271,185,72,62,118,78,23,18,5,81
"2011","Stoke-on-Trent 034A","E01014347",1144,120,27,93,282,186,85,94,158,124,16,11,5,79
"2011","Stoke-on-Trent 034B","E01014350",1060,125,30,95,282,167,116,65,148,74,13,10,3,70
"2011","Stoke-on-Trent 034C","E01014351",1142,156,38,118,308,186,95,81,96,91,70,66,4,59
"2011","Stoke-on-Trent 034D","E01014352",1087,207,51,156,319,181,84,57,99,57,16,9,7,67
"2011","Telford and Wrekin 001A","E01014171",1054,68,14,54,179,105,88,61,166,166,29,18,11,192
"2011","Telford and Wrekin 001B","E01014172",1085,121,37,84,284,160,80,50,149,67,21,13,8,153
"2011","Telford and Wrekin 001C","E01014173",1149,72,8,64,253,135,87,85,168,157,32,18,14,160
"2011","Telford and Wrekin 001D","E01014174",1157,209,56,153,348,176,84,59,98,51,27,15,12,105
"2011","Telford and Wrekin 002A","E01014112",1206,155,47,108,312,152,116,81,143,116,25,16,9,106
"2011","Telford and Wrekin 002B","E01014131",1860,181,49,132,314,116,170,55,125,86,25,17,8,788
"2011","Telford and Wrekin 002C","E01014132",794,128,34,94,215,82,75,43,68,65,15,10,5,103
"2011","Telford and Wrekin 002D","E01014135",935,111,32,79,207,126,160,58,126,62,26,14,12,59
"2011","Telford and Wrekin 003A","E01014175",852,48,10,38,186,95,69,95,143,116,35,25,10,65
"2011","Telford and Wrekin 003B","E01014176",1111,126,32,94,258,162,94,68,155,90,18,11,7,140
"2011","Telford and Wrekin 003C","E01014177",1045,120,21,99,237,149,66,74,146,95,12,11,1,146
"2011","Telford and Wrekin 003D","E01014178",1171,109,28,81,171,104,84,89,164,139,45,26,19,266
"2011","Telford and Wrekin 004A","E01014111",1121,168,50,118,284,170,136,76,104,91,23,14,9,69
"2011","Telford and Wrekin 004B","E01014167",1395,215,53,162,344,221,120,87,148,104,40,24,16,116
"2011","Telford and Wrekin 004C","E01014168",1031,125,40,85,265,169,68,79,128,91,28,14,14,78
"2011","Telford and Wrekin 004D","E01014170",1087,128,38,90,278,179,84,88,148,95,29,15,14,58
"2011","Telford and Wrekin 005A","E01014125",1144,40,13,27,144,116,60,119,262,261,75,38,37,67
"2011","Telford and Wrekin 005B","E01014126",1046,41,9,32,135,113,68,105,233,234,56,35,21,61
"2011","Telford and Wrekin 005C","E01014127",1225,42,9,33,119,100,62,120,292,289,118,82,36,83
"2011","Telford and Wrekin 005D","E01014128",1500,127,58,69,293,229,70,153,245,239,63,47,16,81
"2011","Telford and Wrekin 005E","E01014169",1259,88,19,69,218,175,70,119,224,181,87,49,38,97
"2011","Telford and Wrekin 006A","E01014129",778,31,10,21,114,88,54,74,165,155,70,44,26,27
"2011","Telford and Wrekin 006B","E01014130",1058,131,23,108,268,163,61,81,155,98,24,16,8,77
"2011","Telford and Wrekin 006C","E01014179",878,67,19,48,194,148,54,87,148,106,27,19,8,47
"2011","Telford and Wrekin 006D","E01014180",937,60,23,37,170,150,50,83,190,142,29,18,11,63
"2011","Telford and Wrekin 006E","E01014189",1138,117,23,94,269,180,81,82,177,104,36,25,11,92
"2011","Telford and Wrekin 006F","E01014190",1304,168,41,127,367,233,87,98,138,91,18,12,6,104
"2011","Telford and Wrekin 007A","E01014102",1366,210,46,164,366,195,119,83,162,89,46,30,16,96
"2011","Telford and Wrekin 007B","E01014103",949,127,29,98,236,169,62,62,130,65,29,22,7,69
"2011","Telford and Wrekin 007C","E01014138",1077,60,18,42,185,153,87,95,200,170,61,48,13,66
"2011","Telford and Wrekin 007D","E01014140",1086,46,10,36,171,110,71,104,212,219,76,58,18,77
"2011","Telford and Wrekin 008A","E01014205",1048,53,15,38,170,163,59,120,219,169,33,21,12,62
"2011","Telford and Wrekin 008B","E01014206",962,37,13,24,125,123,74,100,212,181,46,26,20,64
"2011","Telford and Wrekin 008C","E01014207",973,50,20,30,163,142,62,111,195,158,38,18,20,54
"2011","Telford and Wrekin 008D","E01014208",874,38,16,22,133,88,59,87,176,190,61,36,25,42
"2011","Telford and Wrekin 008E","E01014209",1091,61,12,49,149,127,71,117,223,220,53,41,12,70
"2011","Telford and Wrekin 009A","E01014137",1113,131,40,91,259,149,89,85,141,116,40,32,8,103
"2011","Telford and Wrekin 009B","E01014139",947,45,12,33,131,81,73,80,215,178,82,60,22,62
"2011","Telford and Wrekin 009C","E01014141",2009,99,20,79,336,245,125,194,420,374,109,72,37,107
"2011","Telford and Wrekin 009D","E01014142",894,32,7,25,86,52,54,68,209,186,110,82,28,97
"2011","Telford and Wrekin 009E","E01014143",1062,29,8,21,114,114,75,93,236,229,101,79,22,71
"2011","Telford and Wrekin 010A","E01014136",1165,138,34,104,256,150,187,81,165,120,31,25,6,37
"2011","Telford and Wrekin 010B","E01014148",1207,209,52,157,357,146,177,74,89,67,33,16,17,55
"2011","Telford and Wrekin 010C","E01014149",860,124,36,88,222,97,98,63,84,68,62,56,6,42
"2011","Telford and Wrekin 010D","E01014202",1774,242,73,169,488,265,182,111,182,126,67,43,24,111
"2011","Telford and Wrekin 010E","E01014203",1122,146,43,103,287,179,97,69,153,95,24,15,9,72
"2011","Telford and Wrekin 010F","E01014204",1478,201,56,145,372,205,189,105,166,109,36,24,12,95
"2011","Telford and Wrekin 011A","E01014104",1216,70,16,54,200,131,67,121,268,199,84,66,18,76
"2011","Telford and Wrekin 011B","E01014105",1338,63,15,48,180,130,86,92,284,242,161,114,47,100
"2011","Telford and Wrekin 011C","E01014113",1184,61,12,49,117,82,100,92,219,220,196,152,44,97
"2011","Telford and Wrekin 011D","E01014114",1079,122,31,91,294,146,94,79,118,91,33,22,11,102
"2011","Telford and Wrekin 012A","E01014133",1318,146,44,102,332,174,109,91,185,116,74,54,20,91
"2011","Telford and Wrekin 012B","E01014134",944,140,29,111,261,158,72,63,119,64,15,11,4,52
"2011","Telford and Wrekin 012C","E01014144",1039,56,12,44,168,118,72,102,203,170,88,65,23,62
"2011","Telford and Wrekin 012D","E01014145",1320,110,19,91,264,150,99,97,255,196,71,40,31,78
"2011","Telford and Wrekin 013A","E01014185",1228,51,16,35,178,162,78,110,246,239,92,60,32,72
"2011","Telford and Wrekin 013B","E01014186",1059,70,15,55,197,151,87,108,195,145,44,28,16,62
"2011","Telford and Wrekin 013C","E01014187",1125,84,25,59,201,180,93,90,198,171,50,29,21,58
"2011","Telford and Wrekin 013D","E01014188",1171,95,28,67,231,209,70,118,201,130,27,16,11,90
"2011","Telford and Wrekin 014A","E01014150",1291,137,33,104,273,186,120,116,178,166,30,18,12,85
"2011","Telford and Wrekin 014B","E01014151",1053,58,23,35,160,117,78,116,174,200,96,67,29,54
"2011","Telford and Wrekin 014C","E01014152",969,38,15,23,143,119,43,110,203,189,69,53,16,55
"2011","Telford and Wrekin 014D","E01014153",1316,80,18,62,202,186,107,126,248,208,89,58,31,70
"2011","Telford and Wrekin 014E","E01014154",1291,105,26,79,221,182,86,148,231,210,47,32,15,61
"2011","Telford and Wrekin 014F","E01014155",1190,63,23,40,167,123,96,121,242,238,69,42,27,71
"2011","Telford and Wrekin 015A","E01014181",1457,288,72,216,427,185,137,77,119,56,41,35,6,127
"2011","Telford and Wrekin 015B","E01014182",968,176,50,126,281,150,77,58,73,25,25,15,10,103
"2011","Telford and Wrekin 015C","E01014183",1187,194,56,138,309,196,110,73,119,78,31,17,14,77
"2011","Telford and Wrekin 015D","E01014184",1040,116,44,72,294,145,66,90,139,82,47,28,19,61
"2011","Telford and Wrekin 016A","E01014146",1537,192,58,134,385,223,126,122,213,144,49,38,11,83
"2011","Telford and Wrekin 016B","E01014147",1544,230,66,164,414,226,118,110,175,117,40,30,10,114
"2011","Telford and Wrekin 016C","E01014156",1539,113,22,91,275,163,102,137,283,241,103,61,42,122
"2011","Telford and Wrekin 016D","E01014157",1171,133,40,93,273,178,70,114,144,126,42,30,12,91
"2011","Telford and Wrekin 016E","E01014158",1168,95,30,65,248,166,87,98,211,155,49,33,16,59
"2011","Telford and Wrekin 017A","E01014124",1219,39,13,26,160,133,103,126,258,220,119,75,44,61
"2011","Telford and Wrekin 017B","E01014163",1004,27,5,22,97,93,50,97,225,224,102,65,37,89
"2011","Telford and Wrekin 017C","E01014164",1153,29,10,19,98,101,49,105,259,292,140,76,64,80
"2011","Telford and Wrekin 017D","E01014165",1053,38,10,28,120,106,57,103,235,202,99,53,46,93
"2011","Telford and Wrekin 017E","E01014166",1165,72,20,52,171,146,75,132,252,202,57,35,22,58
"2011","Telford and Wrekin 018A","E01014191",1343,84,14,70,188,142,69,134,318,229,108,69,39,71
"2011","Telford and Wrekin 018B","E01014192",1053,60,16,44,161,115,43,85,242,210,55,32,23,82
"2011","Telford and Wrekin 018C","E01014193",1230,69,22,47,146,138,58,140,244,231,112,79,33,92
"2011","Telford and Wrekin 018D","E01014194",1113,51,10,41,169,134,58,121,243,169,83,51,32,85
"2011","Telford and Wrekin 018E","E01014195",1097,143,44,99,247,162,86,84,168,98,34,19,15,75
"2011","Telford and Wrekin 018F","E01014196",1116,40,6,34,140,123,68,108,255,234,74,44,30,74
"2011","Telford and Wrekin 019A","E01014119",1237,107,29,78,266,156,88,101,222,159,52,35,17,86
"2011","Telford and Wrekin 019B","E01014120",1254,34,13,21,154,132,92,109,253,304,113,71,42,63
"2011","Telford and Wrekin 019C","E01014121",1086,64,15,49,172,136,69,101,219,206,45,23,22,74
"2011","Telford and Wrekin 019D","E01014122",1240,82,12,70,204,181,73,128,253,198,55,27,28,66
"2011","Telford and Wrekin 019E","E01014123",1199,103,26,77,260,191,75,111,202,155,25,15,10,77
"2011","Telford and Wrekin 020A","E01014106",1155,56,13,43,171,154,60,122,249,215,58,38,20,70
"2011","Telford and Wrekin 020B","E01014107",933,97,26,71,219,134,77,97,131,103,23,14,9,52
"2011","Telford and Wrekin 020C","E01014108",1056,21,3,18,91,87,47,90,261,221,164,70,94,74
"2011","Telford and Wrekin 020D","E01014109",881,66,21,45,153,106,54,84,175,147,42,29,13,54
"2011","Telford and Wrekin 020E","E01014110",999,18,7,11,80,79,51,113,209,214,153,97,56,82
"2011","Telford and Wrekin 021A","E01014197",1034,29,8,21,111,86,60,113,223,205,118,84,34,89
"2011","Telford and Wrekin 021B","E01014198",734,17,2,15,50,55,37,74,178,170,101,59,42,52
"2011","Telford and Wrekin 021C","E01014199",1149,57,8,49,180,130,82,100,254,170,89,57,32,87
"2011","Telford and Wrekin 021D","E01014200",848,17,7,10,70,52,48,70,209,203,105,58,47,74
"2011","Telford and Wrekin 021E","E01014201",864,24,12,12,77,58,45,93,194,200,97,47,50,76
"2011","Telford and Wrekin 022A","E01014159",917,59,14,45,128,118,67,90,195,176,38,25,13,46
"2011","Telford and Wrekin 022B","E01014160",1040,132,34,98,231,169,95,69,163,88,30,23,7,63
"2011","Telford and Wrekin 022C","E01014161",892,60,16,44,171,107,75,79,159,140,51,38,13,50
"2011","Telford and Wrekin 022D","E01014162",1193,63,18,45,156,128,101,124,252,194,111,86,25,64
"2011","Telford and Wrekin 023A","E01014115",976,27,6,21,106,90,66,95,235,223,83,43,40,51
"2011","Telford and Wrekin 023B","E01014116",1159,35,13,22,121,98,79,101,295,262,105,62,43,63
"2011","Telford and Wrekin 023C","E01014117",939,94,34,60,191,151,69,81,163,105,29,16,13,56
"2011","Telford and Wrekin 023D","E01014118",829,21,7,14,100,70,38,80,183,185,98,63,35,54
"2011","Cannock Chase 001A","E01029368",987,115,34,81,247,115,110,96,146,94,14,11,3,50
"2011","Cannock Chase 001B","E01029369",937,60,20,40,168,137,95,100,161,136,29,20,9,51
"2011","Cannock Chase 001C","E01029370",1097,113,32,81,264,168,160,95,130,92,17,7,10,58
"2011","Cannock Chase 001D","E01029371",1181,79,18,61,214,169,111,140,196,166,24,12,12,82
"2011","Cannock Chase 001E","E01029402",1463,139,44,95,322,213,123,134,236,181,33,25,8,82
"2011","Cannock Chase 002A","E01029372",984,19,4,15,69,61,54,109,234,259,108,72,36,71
"2011","Cannock Chase 002B","E01029373",1635,99,28,71,278,159,130,160,329,292,87,57,30,101
"2011","Cannock Chase 002C","E01029401",1229,65,22,43,210,159,89,131,246,213,45,26,19,71
"2011","Cannock Chase 002D","E01029403",1107,63,20,43,201,133,106,123,194,175,47,32,15,65
"2011","Cannock Chase 002E","E01029404",1053,66,17,49,162,100,108,105,200,190,80,51,29,42
"2011","Cannock Chase 003A","E01029345",1195,72,17,55,206,136,98,137,217,216,49,24,25,64
"2011","Cannock Chase 003B","E01029346",1152,39,12,27,132,96,79,109,279,244,102,65,37,72
"2011","Cannock Chase 003C","E01029347",1128,70,19,51,193,155,107,115,211,208,27,18,9,42
"2011","Cannock Chase 003D","E01029348",1259,68,22,46,196,147,106,151,252,213,55,33,22,71
"2011","Cannock Chase 003E","E01029374",1726,114,32,82,292,186,160,165,345,286,72,44,28,106
"2011","Cannock Chase 004A","E01029383",1202,89,26,63,269,193,116,87,177,135,40,22,18,96
"2011","Cannock Chase 004B","E01029385",1188,65,19,46,228,152,104,115,227,188,48,25,23,61
"2011","Cannock Chase 004C","E01029388",988,35,14,21,130,118,95,107,204,190,57,32,25,52
"2011","Cannock Chase 004D","E01029390",818,24,5,19,93,72,74,77,166,179,77,42,35,56
"2011","Cannock Chase 005A","E01029384",1446,85,29,56,268,229,155,132,225,214,54,31,23,84
"2011","Cannock Chase 005B","E01029386",1063,49,15,34,171,121,109,96,194,173,82,54,28,68
"2011","Cannock Chase 005C","E01029387",1115,55,10,45,155,112,132,99,197,232,71,51,20,62
"2011","Cannock Chase 005D","E01029389",1279,83,27,56,281,186,140,113,210,173,37,18,19,56
"2011","Cannock Chase 006A","E01029379",1300,120,42,78,310,188,133,91,172,150,41,26,15,95
"2011","Cannock Chase 006B","E01029398",1256,126,39,87,317,157,166,95,167,111,47,27,20,70
"2011","Cannock Chase 006C","E01029399",1202,80,27,53,252,159,147,119,190,154,34,22,12,67
"2011","Cannock Chase 006D","E01029400",1271,104,27,77,239,142,137,104,229,161,59,34,25,96
"2011","Cannock Chase 007A","E01029354",1121,39,20,19,142,121,94,105,248,225,69,40,29,78
"2011","Cannock Chase 007B","E01029355",1118,42,15,27,154,122,118,103,192,237,83,56,27,67
"2011","Cannock Chase 007C","E01029356",1037,23,12,11,128,99,82,103,237,210,87,49,38,68
"2011","Cannock Chase 007D","E01029357",1020,25,6,19,143,98,77,95,221,235,72,42,30,54
"2011","Cannock Chase 007E","E01029358",874,16,7,9,82,81,42,67,202,192,126,78,48,66
"2011","Cannock Chase 008A","E01029349",948,40,8,32,131,116,99,86,196,188,44,22,22,48
"2011","Cannock Chase 008B","E01029350",1134,43,16,27,123,125,107,104,223,274,66,44,22,69
"2011","Cannock Chase 008C","E01029351",1100,33,14,19,103,84,88,89,260,246,112,60,52,85
"2011","Cannock Chase 008D","E01029352",1066,60,19,41,158,143,76,87,206,226,50,32,18,60
"2011","Cannock Chase 008E","E01029393",1301,79,24,55,269,160,135,126,231,181,37,26,11,83
"2011","Cannock Chase 009A","E01029380",1169,94,36,58,267,170,94,127,202,122,23,12,11,70
"2011","Cannock Chase 009B","E01029381",1142,38,12,26,163,136,123,119,228,211,71,45,26,53
"2011","Cannock Chase 009C","E01029382",1230,73,28,45,232,163,145,113,212,173,61,43,18,58
"2011","Cannock Chase 009D","E01029391",1277,111,32,79,287,181,131,114,187,146,27,12,15,93
"2011","Cannock Chase 009E","E01029392",1435,120,29,91,284,240,156,128,216,167,33,16,17,91
"2011","Cannock Chase 010A","E01029375",1855,233,55,178,490,322,173,130,210,150,40,20,20,107
"2011","Cannock Chase 010B","E01029376",1432,133,40,93,332,258,137,84,188,149,46,25,21,105
"2011","Cannock Chase 010C","E01029377",1091,114,26,88,286,185,103,83,142,69,16,6,10,93
"2011","Cannock Chase 010D","E01029378",1307,115,28,87,303,219,126,123,185,127,29,15,14,80
"2011","Cannock Chase 011A","E01029353",1047,57,16,41,206,166,85,113,189,146,43,24,19,42
"2011","Cannock Chase 011B","E01029364",1186,143,38,105,330,169,127,85,152,82,24,13,11,74
"2011","Cannock Chase 011C","E01029365",1156,113,26,87,262,140,126,91,174,136,42,21,21,72
"2011","Cannock Chase 011D","E01029366",1279,171,54,117,347,208,160,65,131,81,33,17,16,83
"2011","Cannock Chase 011E","E01029367",1579,97,36,61,303,234,181,94,259,208,98,66,32,105
"2011","Cannock Chase 012A","E01029359",1191,58,15,43,173,149,104,123,211,235,83,53,30,55
"2011","Cannock Chase 012B","E01029360",1077,51,15,36,177,131,102,90,195,162,63,35,28,106
"2011","Cannock Chase 012C","E01029361",1129,40,13,27,163,127,112,115,210,200,79,49,30,83
"2011","Cannock Chase 012D","E01029362",1141,33,11,22,132,121,85,113,216,239,119,69,50,83
"2011","Cannock Chase 012E","E01029363",1030,47,14,33,155,131,83,104,213,180,64,40,24,53
"2011","Cannock Chase 013A","E01029394",1123,66,15,51,168,147,135,116,229,188,41,24,17,33
"2011","Cannock Chase 013B","E01029395",1251,93,42,51,249,172,143,118,201,164,34,21,13,77
"2011","Cannock Chase 013C","E01029396",1326,97,41,56,236,190,158,107,224,182,56,30,26,76
"2011","Cannock Chase 013D","E01029397",1841,97,30,67,302,221,165,150,342,319,139,87,52,106
"2011","East Staffordshire 001A","E01029405",1200,137,41,96,308,140,203,77,148,94,18,13,5,75
"2011","East Staffordshire 001B","E01029406",931,133,38,95,208,117,194,46,93,66,18,12,6,56
"2011","East Staffordshire 001C","E01029422",975,131,45,86,224,90,131,51,92,88,35,30,5,133
"2011","East Staffordshire 001D","E01029423",1160,61,17,44,195,102,88,104,239,261,40,21,19,70
"2011","East Staffordshire 001E","E01029467",1560,205,68,137,337,152,242,125,177,209,43,28,15,70
"2011","East Staffordshire 002A","E01029430",1119,101,29,72,218,135,92,103,202,171,29,15,14,68
"2011","East Staffordshire 002B","E01029431",1149,47,15,32,138,112,72,116,292,246,53,28,25,73
"2011","East Staffordshire 002C","E01029432",1098,67,24,43,194,107,88,114,232,214,27,18,9,55
"2011","East Staffordshire 002D","E01029433",1131,74,22,52,144,102,99,118,243,234,54,42,12,63
"2011","East Staffordshire 003A","E01029459",1163,162,36,126,280,166,91,96,169,102,19,11,8,78
"2011","East Staffordshire 003B","E01029460",1226,165,43,122,298,162,116,80,183,110,30,18,12,82
"2011","East Staffordshire 003C","E01029461",1390,99,37,62,290,156,113,127,265,204,49,24,25,87
"2011","East Staffordshire 003D","E01029462",1183,116,31,85,210,130,121,107,152,165,115,98,17,67
"2011","East Staffordshire 004A","E01029443",1223,195,49,146,377,176,101,72,123,76,20,16,4,83
"2011","East Staffordshire 004B","E01029444",1152,171,46,125,281,151,100,102,123,114,37,26,11,73
"2011","East Staffordshire 004C","E01029463",892,124,35,89,215,93,147,63,107,79,14,8,6,50
"2011","East Staffordshire 004D","E01029464",1160,99,25,74,227,122,92,108,226,182,41,32,9,63
"2011","East Staffordshire 004E","E01029465",1159,130,30,100,326,143,108,94,165,114,18,9,9,61
"2011","East Staffordshire 004F","E01029466",1091,156,42,114,284,159,99,73,133,88,17,11,6,82
"2011","East Staffordshire 005A","E01029454",1233,175,52,123,311,227,93,91,150,67,21,16,5,98
"2011","East Staffordshire 005B","E01029455",1328,145,33,112,288,209,94,126,188,165,23,17,6,90
"2011","East Staffordshire 005C","E01029456",1064,76,14,62,239,163,86,107,170,150,32,13,19,41
"2011","East Staffordshire 005D","E01029457",1029,102,35,67,243,166,54,124,152,97,17,12,5,74
"2011","East Staffordshire 005E","E01029458",1102,117,32,85,223,176,93,91,181,125,27,20,7,69
"2011","East Staffordshire 006A","E01029411",981,137,47,90,241,114,226,52,97,62,10,7,3,42
"2011","East Staffordshire 006B","E01029412",1004,164,41,123,283,110,138,56,90,68,9,7,2,86
"2011","East Staffordshire 006C","E01029424",761,120,24,96,177,83,125,57,88,44,18,15,3,49
"2011","East Staffordshire 006D","E01029425",1981,178,58,120,357,158,276,176,258,309,196,182,14,73
"2011","East Staffordshire 006E","E01029473",1018,162,47,115,274,121,185,44,84,61,28,22,6,59
"2011","East Staffordshire 006F","E01029474",850,138,39,99,237,99,101,59,88,63,16,7,9,49
"2011","East Staffordshire 007A","E01029434",1104,53,11,42,167,129,72,106,235,204,51,36,15,87
"2011","East Staffordshire 007B","E01029435",1053,97,23,74,204,144,99,77,190,150,22,14,8,70
"2011","East Staffordshire 007C","E01029436",1335,47,11,36,173,152,91,116,267,287,108,77,31,94
"2011","East Staffordshire 007D","E01029437",1599,97,17,80,234,152,86,137,325,343,117,73,44,108
"2011","East Staffordshire 007E","E01029438",1102,55,11,44,217,157,80,97,226,155,39,33,6,76
"2011","East Staffordshire 008A","E01029426",1256,43,8,35,138,109,88,110,253,252,173,146,27,90
"2011","East Staffordshire 008B","E01029427",1073,37,7,30,90,82,75,85,258,266,126,100,26,54
"2011","East Staffordshire 008C","E01029428",1148,88,26,62,232,133,82,108,212,159,67,50,17,67
"2011","East Staffordshire 008D","E01029429",946,38,10,28,118,100,74,69,193,180,115,99,16,59
"2011","East Staffordshire 009A","E01029445",1452,53,12,41,154,141,81,113,324,315,168,138,30,103
"2011","East Staffordshire 009B","E01029446",1266,77,15,62,224,133,91,117,242,229,70,44,26,83
"2011","East Staffordshire 009C","E01029447",1202,34,6,28,119,92,116,73,224,251,189,155,34,104
"2011","East Staffordshire 009D","E01029448",1152,43,11,32,115,130,87,89,259,237,108,87,21,84
"2011","East Staffordshire 010A","E01029468",1134,28,10,18,120,87,70,101,282,260,107,58,49,79
"2011","East Staffordshire 010B","E01029469",1315,137,37,100,297,190,103,118,221,152,41,28,13,56
"2011","East Staffordshire 010C","E01029470",1108,77,16,61,210,123,81,104,202,183,60,35,25,68
"2011","East Staffordshire 010D","E01029471",1294,176,39,137,300,165,116,81,160,141,70,58,12,85
"2011","East Staffordshire 010E","E01029472",1190,88,21,67,179,139,86,98,220,216,88,62,26,76
"2011","East Staffordshire 011A","E01029407",1008,36,17,19,115,97,60,77,183,261,105,81,24,74
"2011","East Staffordshire 011B","E01029408",1572,90,27,63,206,137,89,149,304,341,143,111,32,113
"2011","East Staffordshire 011C","E01029409",1214,35,11,24,119,94,85,101,215,353,143,116,27,69
"2011","East Staffordshire 011D","E01029410",1114,50,8,42,128,83,106,115,203,241,121,97,24,67
"2011","East Staffordshire 011F","E01032896",930,73,11,62,161,94,68,81,175,184,49,41,8,45
"2011","East Staffordshire 011G","E01032897",895,56,14,42,152,115,87,93,177,141,31,21,10,43
"2011","East Staffordshire 011H","E01032898",930,44,8,36,100,77,64,81,160,244,106,72,34,54
"2011","East Staffordshire 012A","E01029418",1647,265,71,194,426,216,124,149,211,120,25,14,11,111
"2011","East Staffordshire 012B","E01029419",1182,133,43,90,257,160,88,102,215,134,25,13,12,68
"2011","East Staffordshire 012C","E01029420",1229,126,40,86,267,177,105,89,206,154,20,14,6,85
"2011","East Staffordshire 013A","E01029413",1151,87,24,63,208,168,72,107,213,189,30,20,10,77
"2011","East Staffordshire 013B","E01029414",1270,136,30,106,251,204,107,108,165,157,55,43,12,87
"2011","East Staffordshire 013C","E01029415",1198,159,43,116,292,179,79,106,144,137,27,17,10,75
"2011","East Staffordshire 013D","E01029416",935,78,26,52,185,122,108,90,158,119,21,16,5,54
"2011","East Staffordshire 013E","E01029417",853,88,29,59,214,126,70,61,144,93,20,10,10,37
"2011","East Staffordshire 014A","E01029449",1284,72,25,47,224,154,83,154,251,200,71,46,25,75
"2011","East Staffordshire 014B","E01029450",1105,19,6,13,97,71,69,114,272,295,90,61,29,78
"2011","East Staffordshire 014C","E01029451",1237,78,19,59,210,152,100,106,254,229,45,24,21,63
"2011","East Staffordshire 014D","E01029452",1159,38,12,26,151,98,87,123,278,252,65,36,29,67
"2011","East Staffordshire 014E","E01029453",1065,15,5,10,104,68,50,88,294,285,100,64,36,61
"2011","East Staffordshire 015A","E01029439",1068,117,34,83,262,155,99,95,139,123,14,8,6,64
"2011","East Staffordshire 015B","E01029440",938,171,52,119,279,111,127,55,86,54,20,15,5,35
"2011","East Staffordshire 015C","E01029441",1103,155,40,115,306,133,128,72,103,111,28,15,13,67
"2011","East Staffordshire 015D","E01029442",930,143,41,102,271,122,95,55,96,63,19,13,6,66
"2011","Lichfield 001A","E01029480",1397,128,40,88,301,179,131,136,189,205,50,27,23,78
"2011","Lichfield 001B","E01029481",1364,109,36,73,262,168,146,135,218,213,65,42,23,48
"2011","Lichfield 001C","E01029482",1209,84,27,57,231,148,118,112,212,173,60,38,22,71
"2011","Lichfield 001D","E01029498",1366,156,46,110,359,158,191,95,154,134,35,20,15,84
"2011","Lichfield 002A","E01029477",1148,205,65,140,354,134,141,53,103,69,20,13,7,69
"2011","Lichfield 002B","E01029478",1102,138,40,98,219,151,116,73,178,119,28,17,11,80
"2011","Lichfield 002C","E01029479",2066,351,103,248,595,255,187,137,197,151,44,21,23,149
"2011","Lichfield 002D","E01029509",1211,196,69,127,309,156,224,51,103,80,22,12,10,70
"2011","Lichfield 003A","E01029486",1119,111,35,76,237,170,121,90,175,133,26,16,10,56
"2011","Lichfield 003B","E01029507",1323,192,75,117,401,211,147,68,134,71,21,14,7,78
"2011","Lichfield 003C","E01029508",1731,245,77,168,505,265,180,108,181,122,37,23,14,88
"2011","Lichfield 003D","E01029515",1412,241,67,174,390,153,239,77,109,96,27,24,3,80
"2011","Lichfield 004A","E01029492",1386,58,14,44,187,102,81,111,325,299,120,73,47,103
"2011","Lichfield 004B","E01029499",1262,46,14,32,140,100,93,113,294,292,96,60,36,88
"2011","Lichfield 004C","E01029501",1106,101,17,84,237,89,81,89,182,183,65,45,20,79
"2011","Lichfield 004E","E01029526",1159,143,32,111,260,131,103,83,169,141,68,40,28,61
"2011","Lichfield 004F","E01032899",991,171,48,123,273,118,77,65,120,75,54,31,23,38
"2011","Lichfield 004G","E01032900",1455,332,71,261,464,168,98,70,136,81,35,17,18,71
"2011","Lichfield 005A","E01029483",1206,241,69,172,413,184,92,49,94,45,22,12,10,66
"2011","Lichfield 005B","E01029484",1337,186,37,149,383,180,131,73,139,130,51,38,13,64
"2011","Lichfield 005C","E01029485",1169,194,50,144,382,199,89,57,109,55,23,9,14,61
"2011","Lichfield 005D","E01029500",1377,150,38,112,317,205,95,99,207,168,32,15,17,104
"2011","Lichfield 005E","E01029520",1190,258,61,197,396,183,89,39,101,37,11,7,4,76
"2011","Lichfield 005F","E01029524",1308,156,39,117,299,164,74,102,197,158,74,47,27,84
"2011","Lichfield 005G","E01029525",1300,135,26,109,321,182,87,108,195,171,36,25,11,65
"2011","Lichfield 006A","E01029487",1221,56,13,43,157,118,122,129,276,215,79,55,24,69
"2011","Lichfield 006B","E01029493",1507,140,39,101,308,203,167,124,240,186,45,22,23,94
"2011","Lichfield 006C","E01029494",1128,67,19,48,184,159,136,114,195,161,39,21,18,73
"2011","Lichfield 006D","E01029495",1266,60,19,41,293,181,147,119,186,167,26,20,6,87
"2011","Lichfield 006E","E01029497",1449,112,37,75,253,195,169,127,244,200,64,34,30,85
"2011","Lichfield 007A","E01029491",1310,156,25,131,302,175,114,86,182,179,44,30,14,72
"2011","Lichfield 007B","E01029511",1177,146,40,106,368,167,93,88,147,65,27,13,14,76
"2011","Lichfield 007C","E01029512",1367,255,64,191,424,199,125,63,123,65,30,16,14,83
"2011","Lichfield 007D","E01029518",1966,381,85,296,680,265,157,77,167,85,42,17,25,112
"2011","Lichfield 007E","E01029519",1587,225,55,170,436,210,125,107,176,153,41,29,12,114
"2011","Lichfield 008A","E01029516",1422,235,69,166,364,172,194,70,132,106,42,21,21,107
"2011","Lichfield 008B","E01029517",1258,210,64,146,317,156,176,71,129,86,28,19,9,85
"2011","Lichfield 008C","E01029530",1243,206,73,133,362,136,128,67,137,107,27,17,10,73
"2011","Lichfield 008D","E01029531",1258,221,65,156,345,176,155,73,95,90,20,12,8,83
"2011","Lichfield 009A","E01029475",1537,122,32,90,349,247,158,136,239,177,41,27,14,68
"2011","Lichfield 009B","E01029476",1067,69,28,41,222,162,93,108,195,124,40,32,8,54
"2011","Lichfield 009C","E01029489",1237,103,36,67,218,200,114,131,217,151,36,22,14,67
"2011","Lichfield 009D","E01029490",1129,72,21,51,210,158,116,142,189,165,22,12,10,55
"2011","Lichfield 009E","E01029505",1177,148,46,102,288,154,176,74,144,108,26,17,9,59
"2011","Lichfield 009F","E01029506",1493,106,45,61,303,228,164,145,258,195,31,24,7,63
"2011","Lichfield 010A","E01029496",1322,52,17,35,161,145,97,124,294,258,101,68,33,90
"2011","Lichfield 010B","E01029527",909,36,13,23,119,97,84,63,213,203,53,31,22,41
"2011","Lichfield 010C","E01029528",948,44,13,31,158,111,87,88,203,150,49,28,21,58
"2011","Lichfield 010D","E01029529",945,52,11,41,164,121,79,107,191,143,47,22,25,41
"2011","Lichfield 011A","E01029513",996,216,75,141,256,122,186,35,44,24,36,24,12,77
"2011","Lichfield 011B","E01029514",1097,233,48,185,274,155,153,25,79,41,35,26,9,102
"2011","Lichfield 011C","E01029521",1269,215,75,140,370,187,174,59,98,53,21,10,11,92
"2011","Lichfield 011D","E01029522",1159,165,41,124,313,131,168,67,110,81,44,33,11,80
"2011","Lichfield 011E","E01029523",1162,159,45,114,322,187,131,75,109,85,21,14,7,73
"2011","Lichfield 012A","E01029488",1924,170,51,119,362,174,255,143,214,285,206,189,17,115
"2011","Lichfield 012B","E01029502",1226,89,31,58,203,159,131,108,193,207,59,36,23,77
"2011","Lichfield 012C","E01029503",1128,98,42,56,234,172,110,115,176,138,31,14,17,54
"2011","Lichfield 012D","E01029504",1179,90,23,67,220,142,103,93,205,211,47,21,26,68
"2011","Newcastle-under-Lyme 001A","E01029562",1012,79,23,56,236,137,84,89,174,125,20,13,7,68
"2011","Newcastle-under-Lyme 001B","E01029565",1001,100,33,67,198,155,72,119,138,127,13,7,6,79
"2011","Newcastle-under-Lyme 001C","E01029581",1197,87,12,75,221,175,118,121,192,177,30,16,14,76
"2011","Newcastle-under-Lyme 001D","E01029582",1397,112,29,83,261,183,176,127,227,217,20,9,11,74
"2011","Newcastle-under-Lyme 001E","E01029586",980,102,34,68,196,163,94,104,144,131,10,3,7,36
"2011","Newcastle-under-Lyme 001F","E01029587",931,67,27,40,178,116,100,76,161,157,23,13,10,53
"2011","Newcastle-under-Lyme 002A","E01029561",1032,29,7,22,119,119,78,121,216,234,49,33,16,67
"2011","Newcastle-under-Lyme 002B","E01029563",1061,68,25,43,164,162,81,103,210,186,22,15,7,65
"2011","Newcastle-under-Lyme 002C","E01029564",965,35,12,23,93,96,79,94,213,211,82,54,28,62
"2011","Newcastle-under-Lyme 002D","E01029588",1191,67,14,53,209,152,104,107,224,196,57,41,16,75
"2011","Newcastle-under-Lyme 003A","E01029540",1051,75,27,48,186,160,90,89,182,161,38,30,8,70
"2011","Newcastle-under-Lyme 003B","E01029541",1110,41,11,30,130,110,79,119,244,215,72,45,27,100
"2011","Newcastle-under-Lyme 003C","E01029542",1036,66,19,47,171,135,88,109,189,174,36,20,16,68
"2011","Newcastle-under-Lyme 003D","E01029543",932,28,9,19,101,81,68,83,203,211,91,69,22,66
"2011","Newcastle-under-Lyme 003E","E01029595",1008,84,29,55,174,143,90,94,203,163,23,18,5,34
"2011","Newcastle-under-Lyme 003F","E01029597",1073,39,7,32,122,98,89,101,243,245,60,41,19,76
"2011","Newcastle-under-Lyme 004A","E01029536",1126,85,27,58,206,174,62,128,188,196,17,11,6,70
"2011","Newcastle-under-Lyme 004B","E01029544",1039,130,43,87,241,146,86,78,134,95,20,14,6,109
"2011","Newcastle-under-Lyme 004C","E01029545",1180,94,27,67,206,142,78,125,211,197,32,17,15,95
"2011","Newcastle-under-Lyme 004D","E01029546",1095,115,28,87,257,183,78,89,132,122,23,14,9,96
"2011","Newcastle-under-Lyme 004E","E01029596",869,53,23,30,150,117,68,86,168,150,37,25,12,40
"2011","Newcastle-under-Lyme 005A","E01029532",1101,138,36,102,228,142,162,65,146,121,25,16,9,74
"2011","Newcastle-under-Lyme 005B","E01029533",1164,113,29,84,233,169,111,95,180,168,32,18,14,63
"2011","Newcastle-under-Lyme 005C","E01029534",1157,87,27,60,244,174,114,107,197,146,19,9,10,69
"2011","Newcastle-under-Lyme 005D","E01029535",1018,64,18,46,164,114,55,85,207,187,65,34,31,77
"2011","Newcastle-under-Lyme 005E","E01029556",1850,149,40,109,366,238,231,152,287,279,44,30,14,104
"2011","Newcastle-under-Lyme 006A","E01029537",1123,54,16,38,191,149,73,90,197,236,62,33,29,71
"2011","Newcastle-under-Lyme 006B","E01029538",1173,50,16,34,140,118,72,124,256,253,98,72,26,62
"2011","Newcastle-under-Lyme 006C","E01029539",1132,95,27,68,208,166,101,94,176,177,46,25,21,69
"2011","Newcastle-under-Lyme 006D","E01029552",1080,48,12,36,163,122,72,108,209,237,45,27,18,76
"2011","Newcastle-under-Lyme 006E","E01029558",1113,40,7,33,130,130,66,91,236,253,91,58,33,76
"2011","Newcastle-under-Lyme 007A","E01029547",1014,25,6,19,96,109,75,91,221,230,101,73,28,66
"2011","Newcastle-under-Lyme 007B","E01029548",1033,15,7,8,96,97,64,105,229,272,99,51,48,56
"2011","Newcastle-under-Lyme 007C","E01029559",1112,45,12,33,162,110,95,109,216,262,55,32,23,58
"2011","Newcastle-under-Lyme 007D","E01029560",1086,21,3,18,111,109,78,87,256,257,101,67,34,66
"2011","Newcastle-under-Lyme 007E","E01029568",1067,38,7,31,101,98,86,104,209,285,61,39,22,85
"2011","Newcastle-under-Lyme 008A","E01029583",1061,97,29,68,245,150,80,77,168,143,30,20,10,71
"2011","Newcastle-under-Lyme 008B","E01029584",877,79,20,59,179,133,85,65,144,114,21,12,9,57
"2011","Newcastle-under-Lyme 008C","E01029585",1128,97,27,70,215,151,94,117,181,159,28,13,15,86
"2011","Newcastle-under-Lyme 008D","E01029609",1247,103,23,80,248,161,89,92,232,194,44,30,14,84
"2011","Newcastle-under-Lyme 008E","E01029611",1175,78,22,56,210,181,65,96,243,187,49,20,29,66
"2011","Newcastle-under-Lyme 009A","E01029577",1131,99,23,76,280,181,103,74,193,113,28,17,11,60
"2011","Newcastle-under-Lyme 009B","E01029579",1224,121,29,92,291,203,117,94,164,145,21,11,10,68
"2011","Newcastle-under-Lyme 009C","E01029580",1083,114,23,91,279,164,106,67,136,99,35,22,13,83
"2011","Newcastle-under-Lyme 009D","E01029610",1012,91,19,72,273,151,105,65,118,111,26,14,12,72
"2011","Newcastle-under-Lyme 009E","E01029612",877,85,14,71,209,140,72,56,126,91,23,15,8,75
"2011","Newcastle-under-Lyme 010A","E01029553",1029,50,14,36,110,93,66,95,213,220,75,57,18,107
"2011","Newcastle-under-Lyme 010B","E01029554",871,20,1,19,63,62,55,55,185,289,78,49,29,64
"2011","Newcastle-under-Lyme 010C","E01029566",822,13,4,9,72,61,42,84,194,217,89,61,28,50
"2011","Newcastle-under-Lyme 010D","E01029567",1204,76,12,64,173,153,79,129,222,230,46,20,26,96
"2011","Newcastle-under-Lyme 010E","E01029598",1311,72,18,54,176,118,68,77,235,221,84,51,33,260
"2011","Newcastle-under-Lyme 010F","E01029599",1042,94,22,72,184,123,65,77,151,173,56,25,31,119
"2011","Newcastle-under-Lyme 011A","E01029555",1384,60,11,49,202,139,81,91,223,242,63,38,25,283
"2011","Newcastle-under-Lyme 011B","E01029578",1176,131,32,99,257,161,112,72,146,153,44,29,15,100
"2011","Newcastle-under-Lyme 011C","E01029602",1550,119,19,100,275,142,69,84,171,154,69,50,19,467
"2011","Newcastle-under-Lyme 011D","E01029603",1172,94,24,70,247,111,75,63,124,148,111,85,26,199
"2011","Newcastle-under-Lyme 011E","E01029604",1312,77,18,59,230,153,59,91,172,209,93,52,41,228
"2011","Newcastle-under-Lyme 012A","E01029576",4124,268,27,241,190,64,83,38,113,64,27,24,3,3277
"2011","Newcastle-under-Lyme 012B","E01029593",1313,48,8,40,141,136,81,120,240,280,92,52,40,175
"2011","Newcastle-under-Lyme 012C","E01029594",1386,90,26,64,178,164,119,137,249,294,49,26,23,106
"2011","Newcastle-under-Lyme 013A","E01029557",938,164,40,124,255,106,136,49,98,62,13,8,5,55
"2011","Newcastle-under-Lyme 013B","E01029573",1092,152,36,116,293,129,113,72,131,79,26,18,8,97
"2011","Newcastle-under-Lyme 013C","E01029574",1026,110,19,91,246,113,136,87,137,104,29,16,13,64
"2011","Newcastle-under-Lyme 013D","E01029575",744,73,15,58,149,78,57,80,119,110,22,9,13,56
"2011","Newcastle-under-Lyme 014A","E01029549",1183,62,16,46,213,133,113,93,236,208,45,21,24,80
"2011","Newcastle-under-Lyme 014B","E01029551",1181,146,28,118,285,186,83,99,168,100,23,17,6,91
"2011","Newcastle-under-Lyme 014C","E01029591",1060,56,11,45,148,110,86,93,215,217,54,33,21,81
"2011","Newcastle-under-Lyme 014D","E01029600",1025,134,23,111,268,143,93,71,127,77,19,11,8,93
"2011","Newcastle-under-Lyme 014E","E01029605",930,175,40,135,288,121,79,43,80,57,13,7,6,74
"2011","Newcastle-under-Lyme 014F","E01029607",1001,114,28,86,186,134,77,65,152,142,56,37,19,75
"2011","Newcastle-under-Lyme 015B","E01029589",946,147,34,113,265,150,70,61,100,59,28,16,12,66
"2011","Newcastle-under-Lyme 015C","E01029590",986,121,15,106,233,146,97,70,126,101,25,19,6,67
"2011","Newcastle-under-Lyme 015E","E01029601",1024,195,41,154,279,120,79,49,99,56,41,35,6,106
"2011","Newcastle-under-Lyme 015F","E01029606",1049,227,46,181,338,146,83,39,71,34,12,9,3,99
"2011","Newcastle-under-Lyme 015G","E01029608",1087,242,65,177,299,182,97,40,58,49,27,18,9,93
"2011","Newcastle-under-Lyme 015H","E01033257",1870,253,51,202,482,305,145,121,220,145,49,33,16,150
"2011","Newcastle-under-Lyme 016A","E01029569",1129,134,37,97,242,131,177,71,157,86,56,47,9,75
"2011","Newcastle-under-Lyme 016B","E01029570",1793,314,85,229,462,222,310,88,162,108,24,18,6,103
"2011","Newcastle-under-Lyme 016C","E01029571",997,171,48,123,259,130,128,51,84,65,33,21,12,76
"2011","Newcastle-under-Lyme 016D","E01029572",1254,229,66,163,359,161,152,66,101,78,23,13,10,85
"2011","South Staffordshire 001A","E01029655",1449,149,35,114,313,212,190,98,206,164,46,28,18,71
"2011","South Staffordshire 001B","E01029656",1385,223,62,161,395,190,202,75,115,71,32,19,13,82
"2011","South Staffordshire 001C","E01029657",1339,205,51,154,340,238,129,76,135,78,22,8,14,116
"2011","South Staffordshire 001D","E01029658",957,79,20,59,212,129,109,67,146,115,37,22,15,63
"2011","South Staffordshire 001E","E01029659",1045,102,37,65,240,172,92,97,154,112,23,15,8,53
"2011","South Staffordshire 001F","E01029660",1615,161,41,120,382,213,214,99,226,161,49,28,21,110
"2011","South Staffordshire 002A","E01029621",1158,90,27,63,232,166,164,97,140,158,44,34,10,67
"2011","South Staffordshire 002B","E01029646",1055,75,25,50,194,147,81,88,185,161,55,40,15,69
"2011","South Staffordshire 002C","E01029647",1621,133,48,85,402,203,213,117,222,172,76,52,24,83
"2011","South Staffordshire 002D","E01029648",1131,56,24,32,180,136,100,89,194,240,73,49,24,63
"2011","South Staffordshire 003A","E01029617",1240,197,56,141,323,186,152,55,130,82,32,23,9,83
"2011","South Staffordshire 003B","E01029618",1098,153,41,112,263,143,117,78,139,94,32,13,19,79
"2011","South Staffordshire 003C","E01029668",952,120,43,77,235,156,129,61,108,77,22,13,9,44
"2011","South Staffordshire 003D","E01029669",971,114,31,83,226,156,103,76,125,85,28,15,13,58
"2011","South Staffordshire 003E","E01029670",1204,164,47,117,343,172,174,69,122,55,43,27,16,62
"2011","South Staffordshire 004A","E01029620",975,46,14,32,186,141,117,89,158,147,35,19,16,56
"2011","South Staffordshire 004B","E01029622",1162,76,26,50,203,179,133,100,198,161,49,29,20,63
"2011","South Staffordshire 004C","E01029623",916,63,23,40,209,154,93,75,111,111,35,24,11,65
"2011","South Staffordshire 004D","E01029624",1166,113,28,85,269,181,100,108,165,121,22,16,6,87
"2011","South Staffordshire 004E","E01029625",845,51,13,38,157,140,78,105,162,98,16,10,6,38
"2011","South Staffordshire 004F","E01029641",1325,107,40,67,306,209,138,112,203,142,27,17,10,81
"2011","South Staffordshire 004G","E01029642",1117,74,25,49,221,175,142,85,177,146,36,20,16,61
"2011","South Staffordshire 005A","E01029638",1524,90,33,57,263,191,164,142,269,231,74,50,24,100
"2011","South Staffordshire 005B","E01029639",1120,115,45,70,222,156,120,86,142,126,34,18,16,119
"2011","South Staffordshire 005C","E01029640",1129,71,22,49,205,147,88,123,212,161,47,24,23,75
"2011","South Staffordshire 005D","E01029643",1054,51,19,32,149,121,93,120,190,197,68,37,31,65
"2011","South Staffordshire 005E","E01029644",1153,76,22,54,214,168,98,113,202,168,40,22,18,74
"2011","South Staffordshire 006A","E01029616",1149,112,31,81,260,165,139,91,154,144,34,16,18,50
"2011","South Staffordshire 006B","E01029619",1411,144,43,101,287,208,141,129,233,151,29,18,11,89
"2011","South Staffordshire 006C","E01029636",1108,106,42,64,263,174,153,73,152,97,14,8,6,76
"2011","South Staffordshire 006D","E01029637",2156,145,46,99,329,246,185,177,286,323,328,303,25,137
"2011","South Staffordshire 007A","E01029632",1284,108,41,67,294,192,184,91,152,118,43,28,15,102
"2011","South Staffordshire 007B","E01029633",1297,131,45,86,272,221,163,91,191,134,32,21,11,62
"2011","South Staffordshire 007C","E01029634",1042,68,23,45,166,142,88,80,211,175,47,21,26,65
"2011","South Staffordshire 007D","E01029635",1265,58,22,36,202,124,113,101,257,241,84,55,29,85
"2011","South Staffordshire 008A","E01029613",1049,78,13,65,227,178,99,100,147,121,31,16,15,68
"2011","South Staffordshire 008B","E01029614",1245,119,30,89,270,178,106,95,202,126,49,28,21,100
"2011","South Staffordshire 008C","E01029615",815,59,16,43,136,101,59,69,149,133,55,32,23,54
"2011","South Staffordshire 008D","E01029627",971,77,17,60,188,131,88,82,169,117,62,37,25,57
"2011","South Staffordshire 009A","E01029626",1048,138,33,105,301,161,110,54,99,76,34,26,8,75
"2011","South Staffordshire 009B","E01029628",878,129,33,96,289,139,68,50,99,40,12,6,6,52
"2011","South Staffordshire 009C","E01029629",863,176,52,124,246,132,98,34,82,38,9,6,3,48
"2011","South Staffordshire 009D","E01029630",988,169,53,116,310,134,113,56,81,50,25,14,11,50
"2011","South Staffordshire 009E","E01029631",1073,134,22,112,263,170,102,94,123,73,31,15,16,83
"2011","South Staffordshire 010A","E01029654",1685,281,63,218,421,249,195,97,183,109,46,29,17,104
"2011","South Staffordshire 010B","E01029661",1539,167,50,117,415,256,170,106,188,107,28,18,10,102
"2011","South Staffordshire 010C","E01029663",1100,154,30,124,334,185,91,80,94,66,17,7,10,79
"2011","South Staffordshire 010D","E01029665",1425,176,49,127,372,263,121,88,179,97,31,13,18,98
"2011","South Staffordshire 011A","E01029662",1743,222,50,172,463,294,129,128,231,119,25,12,13,132
"2011","South Staffordshire 011B","E01029664",1235,116,30,86,303,210,116,81,163,128,39,24,15,79
"2011","South Staffordshire 011C","E01029666",1150,50,14,36,212,162,101,92,208,157,93,33,60,75
"2011","South Staffordshire 012A","E01029671",1052,118,46,72,267,155,86,72,148,107,36,20,16,63
"2011","South Staffordshire 012B","E01029673",1151,130,27,103,260,151,135,70,150,102,64,48,16,89
"2011","South Staffordshire 012C","E01029676",731,86,22,64,193,106,76,45,87,70,21,9,12,47
"2011","South Staffordshire 012D","E01029679",1053,52,15,37,170,112,87,91,224,157,99,62,37,61
"2011","South Staffordshire 012E","E01029680",1143,75,20,55,246,171,103,91,176,158,43,27,16,80
"2011","South Staffordshire 013A","E01029645",1488,148,43,105,322,211,201,118,197,189,41,26,15,61
"2011","South Staffordshire 013B","E01029667",1645,202,72,130,396,205,314,88,171,127,44,32,12,98
"2011","South Staffordshire 013C","E01029672",1143,175,50,125,333,159,166,63,98,65,19,11,8,65
"2011","South Staffordshire 013D","E01029674",1355,197,66,131,363,231,132,76,146,82,25,16,9,103
"2011","South Staffordshire 013E","E01029675",1025,117,39,78,249,183,115,68,137,65,28,19,9,63
"2011","South Staffordshire 013F","E01029677",961,106,30,76,243,180,107,54,98,96,21,8,13,56
"2011","South Staffordshire 013G","E01029678",1375,189,61,128,365,241,116,96,153,105,23,10,13,87
"2011","South Staffordshire 014A","E01029649",874,155,43,112,218,102,91,48,108,89,25,12,13,38
"2011","South Staffordshire 014B","E01029650",1176,202,59,143,320,153,168,44,119,64,42,28,14,64
"2011","South Staffordshire 014C","E01029651",1084,205,70,135,287,150,170,53,85,57,13,7,6,64
"2011","South Staffordshire 014D","E01029652",1333,252,88,164,381,181,192,52,97,42,32,17,15,104
"2011","South Staffordshire 014E","E01029653",904,123,28,95,206,118,106,58,122,87,26,13,13,58
"2011","Stafford 001A","E01029702",1102,105,36,69,235,167,120,71,169,119,53,37,16,63
"2011","Stafford 001B","E01029703",1164,170,49,121,318,161,140,55,117,82,41,27,14,80
"2011","Stafford 001C","E01029704",1020,100,29,71,233,161,124,81,139,124,21,12,9,37
"2011","Stafford 001D","E01029705",1069,109,31,78,281,156,134,74,126,116,22,12,10,51
"2011","Stafford 002A","E01029681",882,75,20,55,143,126,106,75,133,139,31,18,13,54
"2011","Stafford 002B","E01029682",1121,156,57,99,292,147,119,74,146,102,22,17,5,63
"2011","Stafford 002C","E01029683",950,131,32,99,266,112,171,49,74,64,22,15,7,61
"2011","Stafford 002D","E01029748",1033,160,40,120,328,140,118,48,94,57,24,17,7,64
"2011","Stafford 002E","E01029749",1207,183,57,126,275,153,147,85,145,123,39,27,12,57
"2011","Stafford 003A","E01029740",1134,115,34,81,250,138,63,107,176,162,50,30,20,73
"2011","Stafford 003B","E01029744",1722,281,72,209,525,238,139,85,182,131,29,20,9,112
"2011","Stafford 003C","E01029745",1194,155,23,132,270,143,93,111,160,139,55,39,16,68
"2011","Stafford 003D","E01029746",1117,144,33,111,256,116,92,83,175,144,45,28,17,62
"2011","Stafford 003E","E01029753",931,79,17,62,186,127,72,89,167,148,28,17,11,35
"2011","Stafford 003F","E01029756",1252,94,30,64,246,145,99,133,231,193,38,24,14,73
"2011","Stafford 004A","E01029733",1437,230,55,175,372,145,344,66,118,67,19,11,8,76
"2011","Stafford 004B","E01029739",1218,261,68,193,386,163,76,52,123,55,11,5,6,91
"2011","Stafford 004C","E01029741",1263,223,64,159,401,179,85,70,125,74,23,10,13,83
"2011","Stafford 004D","E01029754",1015,132,34,98,270,171,64,72,126,106,14,8,6,60
"2011","Stafford 004E","E01029755",1072,131,31,100,258,162,64,82,184,118,19,11,8,54
"2011","Stafford 005A","E01029695",1488,234,57,177,401,169,196,77,150,131,41,27,14,89
"2011","Stafford 005B","E01029696",1163,191,50,141,240,112,257,64,106,82,36,21,15,75
"2011","Stafford 005C","E01029697",1261,150,42,108,310,138,203,70,143,99,69,61,8,79
"2011","Stafford 005D","E01029698",1142,176,55,121,315,141,134,58,141,95,21,15,6,61
"2011","Stafford 005E","E01029747",1133,170,50,120,313,151,110,71,123,86,23,15,8,86
"2011","Stafford 006A","E01029690",1137,108,30,78,260,154,89,101,183,126,26,13,13,90
"2011","Stafford 006B","E01029718",1482,151,42,109,368,245,87,117,226,168,27,14,13,93
"2011","Stafford 006C","E01029743",1049,119,34,85,274,154,162,61,135,85,10,8,2,49
"2011","Stafford 006D","E01029751",1153,129,38,91,274,188,90,99,160,110,29,14,15,74
"2011","Stafford 007A","E01029719",1105,69,20,49,212,173,65,103,221,169,33,22,11,60
"2011","Stafford 007B","E01029720",1161,67,14,53,169,103,81,92,240,223,81,47,34,105
"2011","Stafford 007C","E01029721",1173,91,25,66,270,161,82,104,189,151,37,26,11,88
"2011","Stafford 007D","E01029750",1105,108,18,90,239,172,71,96,163,148,45,27,18,63
"2011","Stafford 007E","E01029752",908,48,13,35,138,116,46,80,185,149,66,36,30,80
"2011","Stafford 008A","E01029687",1444,248,64,184,414,194,225,73,103,82,20,8,12,85
"2011","Stafford 008B","E01029710",1117,190,48,142,327,164,116,66,105,74,22,10,12,53
"2011","Stafford 008C","E01029711",1151,161,47,114,339,189,144,63,97,72,18,11,7,68
"2011","Stafford 008D","E01029712",1404,161,36,125,410,161,144,110,145,135,33,18,15,105
"2011","Stafford 008E","E01029713",1187,118,30,88,267,146,130,113,169,148,25,15,10,71
"2011","Stafford 009A","E01029692",1121,49,13,36,175,140,67,108,231,194,51,28,23,106
"2011","Stafford 009B","E01029693",1348,83,20,63,225,131,30,83,141,101,58,40,18,496
"2011","Stafford 009C","E01029722",1303,102,21,81,229,156,68,98,205,151,51,32,19,243
"2011","Stafford 009D","E01029725",1916,98,31,67,250,121,161,175,259,350,213,187,26,289
"2011","Stafford 010A","E01029689",1380,118,21,97,275,170,77,109,212,179,49,30,19,191
"2011","Stafford 010B","E01029691",951,58,11,47,172,113,64,61,146,157,68,43,25,112
"2011","Stafford 010C","E01029694",1168,114,19,95,255,134,64,101,145,120,21,13,8,214
"2011","Stafford 010D","E01029699",1452,135,22,113,350,169,101,100,194,139,54,28,26,210
"2011","Stafford 010E","E01029701",1561,199,24,175,310,177,94,108,205,166,80,49,31,222
"2011","Stafford 011A","E01029686",1018,121,30,91,251,169,90,81,121,100,19,12,7,66
"2011","Stafford 011B","E01029700",997,132,34,98,295,165,71,66,119,52,23,8,15,74
"2011","Stafford 011C","E01029723",1217,150,36,114,295,197,74,105,167,98,22,15,7,109
"2011","Stafford 011D","E01029724",1326,165,45,120,326,238,74,91,153,101,34,25,9,144
"2011","Stafford 011E","E01029732",2006,224,98,126,425,277,147,77,119,114,47,40,7,576
"2011","Stafford 012A","E01029714",1245,185,53,132,330,186,93,104,157,79,22,12,10,89
"2011","Stafford 012B","E01029736",1164,210,38,172,368,157,98,64,97,57,23,13,10,90
"2011","Stafford 012C","E01029737",1108,147,37,110,284,137,75,71,145,116,44,22,22,89
"2011","Stafford 012D","E01029738",1002,156,33,123,297,140,89,61,113,65,17,6,11,64
"2011","Stafford 012E","E01029742",1543,212,66,146,412,230,232,92,142,126,21,13,8,76
"2011","Stafford 013A","E01029715",1256,75,21,54,241,178,54,104,272,167,68,39,29,97
"2011","Stafford 013B","E01029716",1122,51,15,36,141,118,67,117,232,227,91,55,36,78
"2011","Stafford 013C","E01029717",1263,34,10,24,132,126,74,112,260,279,144,100,44,102
"2011","Stafford 013D","E01029727",1110,39,8,31,170,105,62,94,256,217,96,61,35,71
"2011","Stafford 013E","E01029728",993,81,22,59,187,159,84,91,157,117,40,23,17,77
"2011","Stafford 014A","E01029684",1049,155,29,126,294,181,74,46,104,64,27,21,6,104
"2011","Stafford 014B","E01029685",1104,164,45,119,293,215,69,68,122,74,18,9,9,81
"2011","Stafford 014C","E01029730",769,142,42,100,228,111,95,39,70,19,18,8,10,47
"2011","Stafford 014D","E01029731",1160,217,55,162,399,153,79,39,105,56,17,12,5,95
"2011","Stafford 014E","E01029757",1170,111,35,76,306,191,79,111,159,102,22,13,9,89
"2011","Stafford 014F","E01029758",1136,178,37,141,343,208,87,62,113,49,24,14,10,72
"2011","Stafford 014G","E01029759",1290,156,38,118,375,227,104,82,156,85,26,20,6,79
"2011","Stafford 014H","E01029760",1079,198,35,163,344,158,80,44,108,50,20,10,10,77
"2011","Stafford 015A","E01029688",1677,259,74,185,445,199,283,77,186,95,42,33,9,91
"2011","Stafford 015B","E01029706",1202,184,40,144,323,151,172,71,129,81,15,8,7,76
"2011","Stafford 015C","E01029707",1011,97,25,72,230,144,119,74,164,107,30,20,10,46
"2011","Stafford 015D","E01029708",1469,214,65,149,355,193,249,69,146,111,27,23,4,105
"2011","Stafford 015E","E01029709",1144,155,32,123,326,153,102,78,143,81,17,8,9,89
"2011","Stafford 016A","E01029726",1254,114,28,86,259,183,71,126,191,170,62,37,25,78
"2011","Stafford 016B","E01029729",1242,102,27,75,224,180,86,124,232,189,61,43,18,44
"2011","Stafford 016C","E01029734",1552,110,24,86,242,147,101,129,257,285,167,109,58,114
"2011","Stafford 016D","E01029735",1753,171,36,135,403,254,139,123,262,210,80,58,22,111
"2011","Staffordshire Moorlands 001A","E01029797",1206,135,32,103,256,97,309,77,139,106,24,14,10,63
"2011","Staffordshire Moorlands 001B","E01029806",1084,88,38,50,208,151,143,91,178,143,36,28,8,46
"2011","Staffordshire Moorlands 001C","E01029808",1019,46,11,35,151,125,101,114,199,197,37,21,16,49
"2011","Staffordshire Moorlands 001D","E01029809",1029,35,9,26,106,99,69,112,237,246,66,47,19,59
"2011","Staffordshire Moorlands 001E","E01029810",946,45,10,35,116,84,72,98,203,216,57,38,19,55
"2011","Staffordshire Moorlands 002A","E01029767",1282,134,49,85,309,171,174,100,155,143,24,18,6,72
"2011","Staffordshire Moorlands 002B","E01029769",1259,172,50,122,336,157,196,82,122,118,21,14,7,55
"2011","Staffordshire Moorlands 002C","E01029770",1511,152,42,110,396,230,131,135,232,143,18,9,9,74
"2011","Staffordshire Moorlands 002D","E01029802",1416,210,57,153,333,162,317,73,109,78,47,38,9,87
"2011","Staffordshire Moorlands 003A","E01029763",1107,43,14,29,137,79,73,126,247,263,72,45,27,67
"2011","Staffordshire Moorlands 003B","E01029764",1272,132,42,90,268,158,115,100,172,171,58,35,23,98
"2011","Staffordshire Moorlands 003C","E01029765",954,22,8,14,89,81,64,94,258,202,67,45,22,77
"2011","Staffordshire Moorlands 003D","E01029766",1098,41,6,35,144,96,89,99,223,252,63,45,18,91
"2011","Staffordshire Moorlands 003E","E01029774",1456,97,27,70,258,178,129,142,284,236,56,31,25,76
"2011","Staffordshire Moorlands 004A","E01029768",1060,96,20,76,188,137,139,82,186,151,33,20,13,48
"2011","Staffordshire Moorlands 004B","E01029771",1144,105,22,83,233,163,140,94,173,156,19,12,7,61
"2011","Staffordshire Moorlands 004C","E01029772",1358,79,23,56,260,186,121,139,264,211,35,18,17,63
"2011","Staffordshire Moorlands 004D","E01029773",1178,120,30,90,225,144,157,91,214,160,17,9,8,50
"2011","Staffordshire Moorlands 005A","E01029804",1369,64,12,52,233,160,138,134,250,250,59,42,17,81
"2011","Staffordshire Moorlands 005B","E01029807",780,87,25,62,158,77,90,71,114,114,29,18,11,40
"2011","Staffordshire Moorlands 005C","E01029811",1112,81,26,55,192,97,111,95,198,217,62,44,18,59
"2011","Staffordshire Moorlands 005D","E01029812",1467,103,23,80,312,157,125,122,259,236,66,34,32,87
"2011","Staffordshire Moorlands 005E","E01029814",1260,104,33,71,305,157,108,108,186,155,51,24,27,86
"2011","Staffordshire Moorlands 006A","E01029792",1752,244,69,175,515,248,191,133,181,122,29,20,9,89
"2011","Staffordshire Moorlands 006B","E01029793",1189,110,34,76,268,167,162,105,146,147,17,6,11,67
"2011","Staffordshire Moorlands 006C","E01029805",1197,159,49,110,281,168,118,81,146,118,40,29,11,86
"2011","Staffordshire Moorlands 006D","E01029813",1577,155,53,102,381,208,166,108,255,184,28,14,14,92
"2011","Staffordshire Moorlands 006E","E01029815",1123,114,30,84,244,180,107,92,144,149,20,14,6,73
"2011","Staffordshire Moorlands 006F","E01029816",1078,125,34,91,225,168,99,84,175,118,22,16,6,62
"2011","Staffordshire Moorlands 007A","E01029801",1382,152,43,109,300,118,325,85,169,147,28,18,10,58
"2011","Staffordshire Moorlands 007B","E01029803",1415,152,43,109,295,139,338,90,153,137,39,20,19,72
"2011","Staffordshire Moorlands 007C","E01029817",1449,151,41,110,289,136,395,86,153,136,41,25,16,62
"2011","Staffordshire Moorlands 008A","E01029762",1174,163,45,118,280,170,213,65,110,81,15,8,7,77
"2011","Staffordshire Moorlands 008B","E01029775",1113,91,31,60,229,188,150,90,157,120,20,16,4,68
"2011","Staffordshire Moorlands 008C","E01029776",1309,170,40,130,346,216,157,69,139,94,16,9,7,102
"2011","Staffordshire Moorlands 008D","E01029777",1070,96,25,71,211,136,124,100,159,144,28,15,13,72
"2011","Staffordshire Moorlands 009A","E01029779",1167,101,28,73,286,170,130,110,163,133,15,8,7,59
"2011","Staffordshire Moorlands 009B","E01029780",1197,93,28,65,246,182,107,102,170,151,76,68,8,70
"2011","Staffordshire Moorlands 009C","E01029794",1073,94,32,62,250,137,183,72,151,108,24,13,11,54
"2011","Staffordshire Moorlands 009D","E01029818",1160,118,33,85,265,218,115,86,156,108,28,19,9,66
"2011","Staffordshire Moorlands 009E","E01029819",1255,96,37,59,277,207,164,111,151,162,25,17,8,62
"2011","Staffordshire Moorlands 010A","E01029761",1056,141,32,109,265,113,177,63,113,99,29,16,13,56
"2011","Staffordshire Moorlands 010B","E01029782",1489,60,21,39,185,161,141,124,321,293,125,95,30,79
"2011","Staffordshire Moorlands 010C","E01029795",1270,145,53,92,267,122,248,113,153,132,15,11,4,75
"2011","Staffordshire Moorlands 010D","E01029796",1130,74,34,40,227,142,146,116,178,160,25,19,6,62
"2011","Staffordshire Moorlands 011A","E01029781",1176,66,20,46,185,145,87,123,248,228,30,16,14,64
"2011","Staffordshire Moorlands 011B","E01029783",1006,52,12,40,144,108,75,83,211,228,38,24,14,67
"2011","Staffordshire Moorlands 011C","E01029786",1116,108,30,78,252,157,158,84,157,104,17,9,8,79
"2011","Staffordshire Moorlands 011D","E01029787",1268,75,10,65,228,131,109,112,232,218,86,62,24,77
"2011","Staffordshire Moorlands 012A","E01029778",1319,124,37,87,288,158,242,115,131,137,44,37,7,80
"2011","Staffordshire Moorlands 012B","E01029789",776,58,19,39,165,99,102,84,103,106,17,7,10,42
"2011","Staffordshire Moorlands 012C","E01029798",1304,108,34,74,259,168,130,121,200,198,40,26,14,80
"2011","Staffordshire Moorlands 012D","E01029799",1390,115,30,85,310,203,148,98,229,191,30,22,8,66
"2011","Staffordshire Moorlands 012E","E01029800",1179,104,37,67,280,174,143,103,171,114,21,16,5,69
"2011","Staffordshire Moorlands 013A","E01029784",1607,134,46,88,319,232,151,151,274,227,37,23,14,82
"2011","Staffordshire Moorlands 013B","E01029785",1355,118,30,88,305,228,143,128,195,146,12,9,3,80
"2011","Staffordshire Moorlands 013C","E01029788",1062,130,34,96,273,150,152,82,112,90,21,12,9,52
"2011","Staffordshire Moorlands 013D","E01029790",1431,123,33,90,306,181,122,127,212,223,33,16,17,104
"2011","Staffordshire Moorlands 013E","E01029791",1104,104,37,67,251,154,120,100,144,145,21,11,10,65
"2011","Tamworth 001A","E01029846",929,49,16,33,155,145,63,76,175,174,40,25,15,52
"2011","Tamworth 001B","E01029847",1046,112,38,74,215,167,93,100,157,122,21,11,10,59
"2011","Tamworth 001C","E01029848",937,94,26,68,198,155,64,87,159,114,18,8,10,48
"2011","Tamworth 001D","E01029852",1179,90,26,64,213,148,116,70,208,195,51,26,25,88
"2011","Tamworth 001E","E01029853",1159,113,26,87,218,135,80,85,226,189,48,40,8,65
"2011","Tamworth 001F","E01029854",1153,113,30,83,246,230,98,88,153,154,9,3,6,62
"2011","Tamworth 002A","E01029835",1208,70,14,56,196,106,87,132,223,262,86,52,34,46
"2011","Tamworth 002B","E01029836",946,79,20,59,186,133,71,89,168,137,47,31,16,36
"2011","Tamworth 002C","E01029849",1015,59,17,42,136,117,52,84,210,210,90,52,38,57
"2011","Tamworth 002D","E01029850",920,44,11,33,124,97,46,92,202,199,61,35,26,55
"2011","Tamworth 002E","E01029851",1568,148,42,106,284,188,122,138,291,226,79,48,31,92
"2011","Tamworth 003A","E01029820",1180,104,28,76,218,142,84,94,209,195,56,37,19,78
"2011","Tamworth 003B","E01029821",1165,84,29,55,214,164,98,111,202,175,58,34,24,59
"2011","Tamworth 003C","E01029822",1143,155,46,109,298,178,91,74,128,94,27,11,16,98
"2011","Tamworth 003D","E01029824",1339,55,13,42,172,149,100,131,265,254,128,79,49,85
"2011","Tamworth 003E","E01029841",1138,68,16,52,205,161,98,104,209,183,39,21,18,71
"2011","Tamworth 004A","E01029823",1136,72,29,43,218,177,87,113,209,175,32,22,10,53
"2011","Tamworth 004B","E01029831",1100,32,10,22,183,144,79,110,229,183,60,37,23,80
"2011","Tamworth 004C","E01029832",1184,72,20,52,185,156,101,123,210,219,39,23,16,79
"2011","Tamworth 004D","E01029834",1096,51,19,32,159,141,73,90,235,237,42,26,16,68
"2011","Tamworth 004E","E01029844",961,68,19,49,197,157,73,94,164,130,32,18,14,46
"2011","Tamworth 005A","E01029833",1312,130,32,98,313,182,110,124,183,162,24,12,12,84
"2011","Tamworth 005B","E01029837",1163,81,20,61,236,205,81,96,196,178,36,21,15,54
"2011","Tamworth 005C","E01029838",1230,106,22,84,254,158,76,111,208,215,42,22,20,60
"2011","Tamworth 005D","E01029839",930,134,42,92,273,166,52,51,119,62,17,10,7,56
"2011","Tamworth 006A","E01029825",1061,75,26,49,189,153,76,104,213,162,26,7,19,63
"2011","Tamworth 006B","E01029826",1166,71,24,47,194,160,98,103,214,214,42,26,16,70
"2011","Tamworth 006C","E01029827",992,31,12,19,110,98,60,101,209,241,75,43,32,67
"2011","Tamworth 006D","E01029828",932,18,3,15,101,71,40,78,226,233,86,54,32,79
"2011","Tamworth 006E","E01029830",901,41,15,26,132,121,62,77,184,166,71,46,25,47
"2011","Tamworth 007A","E01029840",897,19,5,14,88,92,39,85,235,185,87,49,38,67
"2011","Tamworth 007B","E01029842",956,29,7,22,106,93,40,95,220,196,106,60,46,71
"2011","Tamworth 007C","E01029843",1053,34,7,27,107,126,90,103,219,223,86,45,41,65
"2011","Tamworth 007D","E01029845",739,8,1,7,65,65,27,72,170,195,84,48,36,53
"2011","Tamworth 007E","E01029859",1278,28,7,21,158,145,84,99,265,286,135,94,41,78
"2011","Tamworth 008A","E01029855",1125,111,33,78,239,138,78,81,206,139,37,19,18,96
"2011","Tamworth 008B","E01029856",1156,91,22,69,229,172,105,116,182,163,24,9,15,74
"2011","Tamworth 008C","E01029857",1042,53,13,40,170,160,91,90,196,173,55,27,28,54
"2011","Tamworth 008D","E01029858",1246,115,34,81,255,215,127,107,177,152,35,21,14,63
"2011","Tamworth 008E","E01029865",1323,141,39,102,293,204,138,115,161,139,36,21,15,96
"2011","Tamworth 009A","E01029860",1041,78,20,58,208,191,85,112,177,106,19,8,11,65
"2011","Tamworth 009B","E01029861",987,63,17,46,184,155,81,95,188,128,19,12,7,74
"2011","Tamworth 009C","E01029862",1019,103,32,71,245,177,89,91,140,84,15,7,8,75
"2011","Tamworth 009D","E01029863",1348,122,36,86,262,192,91,145,223,209,30,17,13,74
"2011","Tamworth 009E","E01029864",1261,153,47,106,298,199,145,84,173,116,28,15,13,65
"2011","Tamworth 010A","E01029829",1466,102,24,78,260,223,101,144,285,230,35,17,18,86
"2011","Tamworth 010C","E01029867",1208,66,25,41,178,155,93,113,241,238,64,30,34,60
"2011","Tamworth 010D","E01029868",1121,115,31,84,245,196,112,86,153,108,27,21,6,79
"2011","Tamworth 010E","E01029869",1174,85,23,62,196,166,85,121,212,192,40,21,19,77
"2011","Tamworth 010F","E01032901",1165,132,34,98,317,173,91,111,151,112,21,11,10,57
"2011","Tamworth 010G","E01032902",1039,95,19,76,204,179,76,95,171,146,21,12,9,52
"2011","North Warwickshire 001A","E01031035",1453,125,38,87,267,184,181,124,222,213,44,32,12,93
"2011","North Warwickshire 001B","E01031036",1156,166,45,121,296,144,135,60,131,126,23,9,14,75
"2011","North Warwickshire 001C","E01031037",1081,68,16,52,184,137,92,102,212,193,39,26,13,54
"2011","North Warwickshire 001D","E01031038",1445,118,30,88,283,187,134,118,228,238,43,29,14,96
"2011","North Warwickshire 001E","E01031039",1286,82,26,56,244,181,112,130,217,199,29,18,11,92
"2011","North Warwickshire 001F","E01031040",1374,110,33,77,319,196,126,138,199,179,41,21,20,66
"2011","North Warwickshire 002A","E01031016",1160,56,15,41,168,150,120,106,237,210,55,38,17,58
"2011","North Warwickshire 002B","E01031025",1195,58,17,41,217,138,122,94,227,235,55,37,18,49
"2011","North Warwickshire 002C","E01031026",1162,45,19,26,157,103,98,113,225,287,68,45,23,66
"2011","North Warwickshire 002D","E01031031",1856,145,37,108,368,247,179,166,295,282,65,45,20,109
"2011","North Warwickshire 002E","E01031032",971,66,15,51,134,120,88,89,175,205,48,36,12,46
"2011","North Warwickshire 003A","E01031009",1665,99,21,78,255,204,117,166,328,348,83,47,36,65
"2011","North Warwickshire 003B","E01031010",1306,53,16,37,155,124,103,117,297,305,98,60,38,54
"2011","North Warwickshire 003C","E01031011",1468,160,51,109,323,212,121,123,212,174,48,30,18,95
"2011","North Warwickshire 003D","E01031012",1007,30,14,16,109,73,78,102,237,268,62,42,20,48
"2011","North Warwickshire 003E","E01031013",793,89,27,62,136,100,64,65,143,143,16,9,7,37
"2011","North Warwickshire 003F","E01031014",920,107,45,62,189,109,101,63,130,144,27,17,10,50
"2011","North Warwickshire 003G","E01031015",984,40,10,30,123,80,79,86,190,249,82,51,31,55
"2011","North Warwickshire 004A","E01031023",1204,121,36,85,293,193,173,88,135,85,33,17,16,83
"2011","North Warwickshire 004B","E01031024",1265,164,38,126,289,186,246,75,120,100,26,11,15,59
"2011","North Warwickshire 004C","E01031033",1398,98,31,67,231,186,100,133,232,274,52,28,24,92
"2011","North Warwickshire 004D","E01031034",1465,142,45,97,321,241,143,136,207,171,32,18,14,72
"2011","North Warwickshire 005A","E01031005",1036,56,17,39,173,105,99,96,189,187,53,26,27,78
"2011","North Warwickshire 005B","E01031008",1009,54,21,33,157,113,106,90,200,171,63,39,24,55
"2011","North Warwickshire 005C","E01031017",967,78,18,60,205,141,144,91,128,115,21,8,13,44
"2011","North Warwickshire 005D","E01031018",827,63,27,36,175,106,134,70,122,101,15,11,4,41
"2011","North Warwickshire 005E","E01031029",1104,89,22,67,233,132,95,81,178,180,42,31,11,74
"2011","North Warwickshire 005F","E01031030",1696,125,45,80,252,221,190,125,311,318,70,40,30,84
"2011","North Warwickshire 006A","E01031019",1274,107,37,70,283,273,128,105,146,130,21,12,9,81
"2011","North Warwickshire 006B","E01031020",1156,84,25,59,269,214,104,96,158,144,24,13,11,63
"2011","North Warwickshire 006C","E01031021",1186,107,22,85,285,186,118,81,168,148,39,20,19,54
"2011","North Warwickshire 006D","E01031022",1219,126,29,97,275,172,144,87,162,124,61,45,16,68
"2011","North Warwickshire 006E","E01031041",1302,129,37,92,341,205,135,101,159,108,33,16,17,91
"2011","North Warwickshire 006F","E01031042",1277,146,47,99,293,221,132,97,161,125,25,15,10,77
"2011","North Warwickshire 007A","E01031006",1089,71,21,50,212,120,111,91,193,184,46,29,17,61
"2011","North Warwickshire 007B","E01031007",930,125,34,91,226,126,137,64,104,96,16,11,5,36
"2011","North Warwickshire 007C","E01031027",1081,132,46,86,239,136,211,71,116,88,31,22,9,57
"2011","North Warwickshire 007D","E01031028",1403,188,54,134,347,165,228,104,131,124,37,23,14,79
"2011","Nuneaton and Bedworth 001A","E01031110",1090,154,37,117,317,156,81,74,103,111,23,11,12,71
"2011","Nuneaton and Bedworth 001B","E01031111",879,143,28,115,253,138,77,36,90,52,19,11,8,71
"2011","Nuneaton and Bedworth 001C","E01031112",1154,107,23,84,276,173,110,88,158,142,32,18,14,68
"2011","Nuneaton and Bedworth 001D","E01031113",1053,90,25,65,261,178,86,92,132,126,22,15,7,66
"2011","Nuneaton and Bedworth 001E","E01031114",1129,87,25,62,215,180,83,93,181,175,44,26,18,71
"2011","Nuneaton and Bedworth 002C","E01031073",1352,69,12,57,247,169,103,127,236,248,69,50,19,84
"2011","Nuneaton and Bedworth 002D","E01031074",1146,50,15,35,150,152,77,104,203,277,93,51,42,40
"2011","Nuneaton and Bedworth 002E","E01031075",1181,34,12,22,123,134,76,101,249,296,105,64,41,63
"2011","Nuneaton and Bedworth 002F","E01032890",1517,39,16,23,152,110,71,126,316,405,175,101,74,123
"2011","Nuneaton and Bedworth 003A","E01031100",1047,141,38,103,278,181,94,67,117,76,12,8,4,81
"2011","Nuneaton and Bedworth 003B","E01031101",1080,183,55,128,267,195,80,72,95,64,22,12,10,102
"2011","Nuneaton and Bedworth 003C","E01031102",1008,106,26,80,251,169,84,73,124,101,44,29,15,56
"2011","Nuneaton and Bedworth 003D","E01031103",996,148,35,113,302,142,94,55,99,63,12,9,3,81
"2011","Nuneaton and Bedworth 003E","E01031104",1034,126,34,92,271,164,83,89,124,95,16,12,4,66
"2011","Nuneaton and Bedworth 004A","E01031081",1221,74,21,53,215,169,84,109,193,228,65,38,27,84
"2011","Nuneaton and Bedworth 004B","E01031082",1070,109,33,76,212,175,80,99,152,120,27,10,17,96
"2011","Nuneaton and Bedworth 004C","E01031083",1155,91,27,64,247,159,103,98,184,168,38,18,20,67
"2011","Nuneaton and Bedworth 004D","E01031084",1657,133,26,107,376,228,128,135,285,222,48,31,17,102
"2011","Nuneaton and Bedworth 004E","E01031085",1090,90,29,61,224,152,70,100,189,182,22,15,7,61
"2011","Nuneaton and Bedworth 005A","E01031043",1289,50,13,37,183,131,93,123,221,278,139,90,49,71
"2011","Nuneaton and Bedworth 005B","E01031044",1258,45,9,36,141,135,77,114,257,280,130,76,54,79
"2011","Nuneaton and Bedworth 005C","E01031045",1268,90,21,69,243,165,88,122,217,198,76,54,22,69
"2011","Nuneaton and Bedworth 005D","E01031046",1320,54,7,47,187,140,68,101,263,262,151,115,36,94
"2011","Nuneaton and Bedworth 005E","E01031047",1433,85,13,72,225,196,88,120,257,266,97,63,34,99
"2011","Nuneaton and Bedworth 006A","E01031057",1066,16,3,13,76,94,35,90,248,293,139,86,53,75
"2011","Nuneaton and Bedworth 006B","E01031058",1090,49,22,27,156,115,61,104,217,256,67,36,31,65
"2011","Nuneaton and Bedworth 006C","E01031059",1076,58,17,41,171,154,64,90,207,210,62,43,19,60
"2011","Nuneaton and Bedworth 006D","E01031060",1101,42,10,32,153,133,74,110,241,256,33,21,12,59
"2011","Nuneaton and Bedworth 006E","E01031061",1144,91,26,65,220,170,71,123,175,169,42,20,22,83
"2011","Nuneaton and Bedworth 007A","E01031090",1036,25,9,16,104,100,64,105,222,260,99,53,46,57
"2011","Nuneaton and Bedworth 007B","E01031091",1064,63,16,47,188,151,90,105,191,190,34,24,10,52
"2011","Nuneaton and Bedworth 007C","E01031092",1041,35,11,24,140,122,43,113,190,261,71,39,32,66
"2011","Nuneaton and Bedworth 007D","E01031093",1048,58,17,41,163,125,73,104,203,203,46,25,21,73
"2011","Nuneaton and Bedworth 007E","E01031094",837,25,3,22,130,112,53,91,162,170,52,25,27,42
"2011","Nuneaton and Bedworth 008A","E01031048",981,54,12,42,171,154,67,103,180,167,26,14,12,59
"2011","Nuneaton and Bedworth 008B","E01031049",1615,122,36,86,363,200,145,144,252,246,46,29,17,97
"2011","Nuneaton and Bedworth 008C","E01031050",1423,121,26,95,310,216,120,122,191,199,62,38,24,82
"2011","Nuneaton and Bedworth 008D","E01031051",1056,50,10,40,197,168,75,108,192,178,44,22,22,44
"2011","Nuneaton and Bedworth 009A","E01031115",1285,51,16,35,205,166,69,81,243,256,110,83,27,104
"2011","Nuneaton and Bedworth 009B","E01031116",1139,36,14,22,141,100,58,110,241,236,135,84,51,82
"2011","Nuneaton and Bedworth 009C","E01031117",995,34,8,26,119,109,59,94,200,239,70,46,24,71
"2011","Nuneaton and Bedworth 009D","E01031118",863,27,7,20,68,83,49,81,190,237,60,43,17,68
"2011","Nuneaton and Bedworth 009E","E01031119",1178,49,14,35,170,134,79,97,203,232,139,102,37,75
"2011","Nuneaton and Bedworth 010A","E01031052",1105,64,17,47,169,157,66,100,175,224,69,36,33,81
"2011","Nuneaton and Bedworth 010B","E01031053",989,70,18,52,161,137,78,76,173,163,58,43,15,73
"2011","Nuneaton and Bedworth 010C","E01031054",1145,61,17,44,202,140,85,103,190,210,60,32,28,94
"2011","Nuneaton and Bedworth 010D","E01031055",1214,163,40,123,317,189,87,69,145,132,43,28,15,69
"2011","Nuneaton and Bedworth 010E","E01031056",1080,85,22,63,252,133,83,90,152,160,45,18,27,80
"2011","Nuneaton and Bedworth 011A","E01031120",1106,139,42,97,277,206,89,72,142,102,18,10,8,61
"2011","Nuneaton and Bedworth 011B","E01031121",945,153,40,113,263,149,76,60,97,65,15,12,3,67
"2011","Nuneaton and Bedworth 011C","E01031122",1129,131,32,99,301,218,71,81,133,99,29,16,13,66
"2011","Nuneaton and Bedworth 011D","E01031123",971,155,44,111,291,155,82,59,81,67,22,16,6,59
"2011","Nuneaton and Bedworth 011E","E01031124",1129,157,38,119,313,162,86,81,133,95,27,22,5,75
"2011","Nuneaton and Bedworth 012A","E01031105",1029,64,17,47,174,182,80,98,185,148,34,20,14,64
"2011","Nuneaton and Bedworth 012B","E01031106",1091,97,28,69,227,169,101,89,156,155,37,20,17,60
"2011","Nuneaton and Bedworth 012C","E01031107",897,39,11,28,147,146,50,93,196,154,31,17,14,41
"2011","Nuneaton and Bedworth 012D","E01031108",1071,91,23,68,207,181,81,109,178,139,23,11,12,62
"2011","Nuneaton and Bedworth 012E","E01031109",1184,65,14,51,190,161,91,122,236,214,44,20,24,61
"2011","Nuneaton and Bedworth 013A","E01031062",951,57,14,43,153,173,68,76,203,150,28,13,15,43
"2011","Nuneaton and Bedworth 013B","E01031063",974,34,11,23,131,134,68,90,210,175,78,51,27,54
"2011","Nuneaton and Bedworth 013C","E01031064",845,40,4,36,120,114,66,76,191,144,39,21,18,55
"2011","Nuneaton and Bedworth 013D","E01031065",1117,33,8,25,133,117,97,114,232,225,83,45,38,83
"2011","Nuneaton and Bedworth 013E","E01031066",941,33,12,21,81,85,55,92,224,228,94,61,33,49
"2011","Nuneaton and Bedworth 014A","E01031067",1097,74,25,49,193,140,106,99,185,193,51,30,21,56
"2011","Nuneaton and Bedworth 014B","E01031068",1193,99,27,72,243,199,106,104,195,148,40,31,9,59
"2011","Nuneaton and Bedworth 014C","E01031069",1064,127,53,74,255,155,113,85,123,134,32,23,9,40
"2011","Nuneaton and Bedworth 014D","E01031070",1194,113,44,69,240,180,111,124,206,135,28,13,15,57
"2011","Nuneaton and Bedworth 015A","E01031095",884,27,11,16,112,101,44,106,194,194,54,33,21,52
"2011","Nuneaton and Bedworth 015B","E01031096",1078,56,16,40,213,167,82,95,211,175,31,23,8,48
"2011","Nuneaton and Bedworth 015C","E01031097",1211,55,15,40,179,161,71,107,253,233,93,61,32,59
"2011","Nuneaton and Bedworth 015D","E01031098",1121,68,22,46,160,139,88,114,199,211,67,49,18,75
"2011","Nuneaton and Bedworth 015E","E01031099",1775,193,42,151,381,295,144,128,236,239,62,30,32,97
"2011","Nuneaton and Bedworth 016A","E01031086",1298,72,22,50,205,181,94,112,259,265,64,36,28,46
"2011","Nuneaton and Bedworth 016B","E01031087",1559,131,38,93,292,209,102,139,273,221,93,53,40,99
"2011","Nuneaton and Bedworth 016C","E01031088",1440,120,21,99,280,166,94,147,257,217,68,47,21,91
"2011","Nuneaton and Bedworth 016D","E01031089",1077,76,21,55,209,158,93,120,193,161,25,18,7,42
"2011","Nuneaton and Bedworth 018A","E01031077",1025,47,12,35,164,140,59,107,174,208,49,24,25,77
"2011","Nuneaton and Bedworth 018B","E01031078",1494,112,37,75,267,220,150,118,243,229,59,37,22,96
"2011","Nuneaton and Bedworth 018C","E01031079",1093,64,17,47,162,157,79,98,224,208,42,21,21,59
"2011","Nuneaton and Bedworth 018D","E01031080",1111,41,14,27,160,166,84,107,224,195,75,47,28,59
"2011","Nuneaton and Bedworth 018E","E01032588",998,78,18,60,183,161,103,78,169,132,17,10,7,77
"2011","Rugby 001B","E01031129",832,113,29,84,222,112,97,63,75,92,20,15,5,38
"2011","Rugby 001C","E01031159",1209,165,51,114,274,171,185,96,123,110,22,19,3,63
"2011","Rugby 001D","E01031160",1610,245,56,189,440,171,220,93,161,156,26,20,6,98
"2011","Rugby 001E","E01031182",1816,231,85,146,499,294,249,127,157,134,45,32,13,80
"2011","Rugby 001F","E01032891",1301,286,65,221,414,148,82,71,104,92,31,17,14,73
"2011","Rugby 001G","E01032892",1443,229,66,163,362,154,224,91,129,113,58,41,17,83
"2011","Rugby 002A","E01031137",918,76,15,61,182,124,40,87,151,193,29,21,8,36
"2011","Rugby 002B","E01031138",932,112,27,85,230,129,53,76,124,110,28,17,11,70
"2011","Rugby 002C","E01031139",1437,242,64,178,361,210,118,92,151,129,32,19,13,102
"2011","Rugby 002D","E01031140",1013,69,18,51,181,158,73,116,151,175,37,21,16,53
"2011","Rugby 002E","E01031141",1332,121,26,95,239,172,82,115,205,258,64,50,14,76
"2011","Rugby 002F","E01031142",1173,53,11,42,157,93,49,122,196,311,112,67,45,80
"2011","Rugby 003A","E01031171",1091,77,11,66,174,126,74,122,188,202,53,38,15,75
"2011","Rugby 003B","E01031172",1143,53,17,36,181,116,92,112,220,260,53,27,26,56
"2011","Rugby 003C","E01031173",1355,90,15,75,189,130,95,124,219,321,123,64,59,64
"2011","Rugby 003D","E01031174",1305,93,10,83,200,126,79,96,245,265,107,78,29,94
"2011","Rugby 004A","E01031151",1138,139,37,102,254,181,122,96,116,120,41,25,16,69
"2011","Rugby 004B","E01031152",866,89,32,57,193,132,80,94,119,89,24,17,7,46
"2011","Rugby 004C","E01031153",1009,105,23,82,203,143,110,87,145,108,44,28,16,64
"2011","Rugby 004D","E01031154",1342,190,50,140,366,213,142,99,154,85,21,13,8,72
"2011","Rugby 004E","E01031181",1344,188,43,145,311,169,140,115,169,145,35,24,11,72
"2011","Rugby 005A","E01031130",1369,97,21,76,267,152,99,113,222,284,58,36,22,77
"2011","Rugby 005B","E01031131",1239,99,19,80,188,123,83,107,213,285,63,41,22,78
"2011","Rugby 005C","E01031132",1513,148,23,125,309,154,83,118,226,301,79,41,38,95
"2011","Rugby 005D","E01031133",1172,80,22,58,182,119,72,87,198,271,87,47,40,76
"2011","Rugby 006A","E01031167",1020,105,25,80,241,134,78,85,138,130,56,46,10,53
"2011","Rugby 006B","E01031168",1960,151,39,112,320,252,120,201,338,388,77,48,29,113
"2011","Rugby 006C","E01031169",1556,99,17,82,264,170,105,144,254,393,69,44,25,58
"2011","Rugby 006D","E01031170",1198,80,16,64,174,114,77,102,218,295,64,37,27,74
"2011","Rugby 007A","E01031125",1136,104,20,84,241,161,79,118,220,156,21,12,9,36
"2011","Rugby 007C","E01031127",1082,76,17,59,180,140,70,112,199,174,64,29,35,67
"2011","Rugby 007D","E01031164",1505,180,37,143,349,204,133,134,190,193,42,25,17,80
"2011","Rugby 007E","E01031165",1120,119,17,102,198,135,116,120,172,164,48,25,23,48
"2011","Rugby 007F","E01032893",1241,310,77,233,347,170,91,48,82,46,25,13,12,122
"2011","Rugby 007G","E01032894",930,179,42,137,281,122,55,59,92,70,15,11,4,57
"2011","Rugby 007H","E01032895",1077,136,27,109,242,158,95,102,148,116,13,6,7,67
"2011","Rugby 008A","E01031155",1028,140,26,114,280,171,85,74,117,73,19,10,9,69
"2011","Rugby 008B","E01031156",1096,124,23,101,272,155,88,101,149,125,26,14,12,56
"2011","Rugby 008C","E01031157",1404,187,48,139,352,197,111,109,158,137,35,23,12,118
"2011","Rugby 008D","E01031158",743,63,27,36,186,122,60,72,108,88,9,5,4,35
"2011","Rugby 009A","E01031143",1190,195,54,141,297,195,75,78,145,113,16,7,9,76
"2011","Rugby 009B","E01031144",911,120,26,94,234,97,82,52,102,117,32,21,11,75
"2011","Rugby 009C","E01031145",1030,70,10,60,185,60,59,69,97,83,20,14,6,387
"2011","Rugby 009D","E01031146",1036,121,26,95,215,121,84,76,149,157,44,31,13,69
"2011","Rugby 010A","E01031161",1456,123,24,99,277,200,111,171,267,198,33,23,10,76
"2011","Rugby 010B","E01031162",1289,148,33,115,258,191,133,112,174,167,34,21,13,72
"2011","Rugby 010C","E01031163",1117,86,33,53,200,129,88,107,204,199,57,30,27,47
"2011","Rugby 010D","E01031179",1231,125,32,93,296,192,124,102,163,119,17,13,4,93
"2011","Rugby 010E","E01031180",1403,142,31,111,288,187,100,131,222,211,45,22,23,77
"2011","Rugby 011A","E01031134",1167,201,44,157,292,203,86,65,125,94,29,17,12,72
"2011","Rugby 011B","E01031135",1151,146,30,116,271,210,78,89,155,127,15,8,7,60
"2011","Rugby 011C","E01031136",1190,145,36,109,291,182,96,94,165,135,29,14,15,53
"2011","Rugby 011D","E01031175",968,159,47,112,252,143,78,58,121,74,34,27,7,49
"2011","Rugby 011E","E01031176",1067,78,17,61,160,135,66,92,192,211,56,37,19,77
"2011","Rugby 011F","E01031177",1013,60,14,46,162,113,60,103,207,179,65,46,19,64
"2011","Rugby 011G","E01031178",994,80,11,69,232,125,57,78,186,139,35,21,14,62
"2011","Rugby 012A","E01031147",1046,228,64,164,275,149,135,55,84,42,17,10,7,61
"2011","Rugby 012B","E01031148",1143,206,56,150,309,167,102,64,114,90,35,27,8,56
"2011","Rugby 012C","E01031149",1120,204,55,149,326,130,134,64,93,84,19,11,8,66
"2011","Rugby 012D","E01031150",852,148,33,115,218,111,115,54,75,52,20,15,5,59
"2011","Rugby 012E","E01031166",1387,273,75,198,405,151,247,53,109,66,21,16,5,62
"2011","Stratford-on-Avon 001A","E01031213",1390,266,88,178,339,169,251,58,129,82,18,13,5,78
"2011","Stratford-on-Avon 001B","E01031243",1443,259,77,182,379,187,242,78,123,63,29,25,4,83
"2011","Stratford-on-Avon 001C","E01031244",1382,255,64,191,394,159,243,57,113,64,20,14,6,77
"2011","Stratford-on-Avon 002A","E01031195",1596,319,90,229,431,196,235,79,139,91,35,18,17,71
"2011","Stratford-on-Avon 002B","E01031202",1070,232,65,167,322,133,163,33,88,45,12,6,6,42
"2011","Stratford-on-Avon 002C","E01031203",1075,133,38,95,247,137,122,66,143,112,38,27,11,77
"2011","Stratford-on-Avon 002D","E01031204",939,120,35,85,209,120,161,73,128,84,13,10,3,31
"2011","Stratford-on-Avon 003A","E01031239",1188,164,42,122,290,156,144,85,152,99,27,16,11,71
"2011","Stratford-on-Avon 003B","E01031240",967,76,21,55,191,129,95,76,184,132,27,14,13,57
"2011","Stratford-on-Avon 003C","E01031241",1040,107,23,84,233,146,103,88,159,109,33,20,13,62
"2011","Stratford-on-Avon 003D","E01031242",1063,98,30,68,195,134,104,77,187,162,39,20,19,67
"2011","Stratford-on-Avon 004A","E01031219",1050,166,36,130,246,141,95,76,132,90,21,7,14,83
"2011","Stratford-on-Avon 004B","E01031220",1116,107,24,83,215,172,115,92,174,149,19,12,7,73
"2011","Stratford-on-Avon 004C","E01031221",1095,76,19,57,193,141,89,105,223,187,31,13,18,50
"2011","Stratford-on-Avon 004D","E01031222",1472,206,48,158,365,200,164,110,175,137,29,23,6,86
"2011","Stratford-on-Avon 004E","E01031223",1001,128,37,91,231,124,97,85,142,120,17,12,5,57
"2011","Stratford-on-Avon 004F","E01031224",855,158,44,114,219,84,138,42,80,55,13,8,5,66
"2011","Stratford-on-Avon 005A","E01031197",912,164,45,119,254,80,172,44,71,49,28,23,5,50
"2011","Stratford-on-Avon 005B","E01031198",910,177,44,133,251,104,107,51,89,83,13,8,5,35
"2011","Stratford-on-Avon 005C","E01031199",1110,136,38,98,249,120,178,76,144,93,50,39,11,64
"2011","Stratford-on-Avon 005D","E01031200",1208,167,42,125,297,168,114,104,170,114,23,12,11,51
"2011","Stratford-on-Avon 005E","E01031201",1157,256,56,200,331,149,130,59,101,55,17,6,11,59
"2011","Stratford-on-Avon 005F","E01031210",938,173,32,141,257,121,138,49,76,45,15,6,9,64
"2011","Stratford-on-Avon 005G","E01031211",753,93,27,66,174,84,87,55,111,89,21,9,12,39
"2011","Stratford-on-Avon 006A","E01031183",1249,166,49,117,322,180,163,72,168,96,31,17,14,51
"2011","Stratford-on-Avon 006B","E01031184",1079,155,47,108,320,143,123,59,114,77,12,2,10,76
"2011","Stratford-on-Avon 006C","E01031185",998,59,20,39,128,118,95,106,191,192,59,45,14,50
"2011","Stratford-on-Avon 006D","E01031186",1064,71,20,51,194,138,122,93,192,148,52,34,18,54
"2011","Stratford-on-Avon 007A","E01031187",1390,242,58,184,390,176,202,64,139,82,21,12,9,74
"2011","Stratford-on-Avon 007B","E01031188",1660,262,75,187,427,185,252,87,183,112,36,30,6,116
"2011","Stratford-on-Avon 007C","E01031208",1535,233,56,177,397,221,211,80,164,105,38,30,8,86
"2011","Stratford-on-Avon 008A","E01031217",869,173,47,126,198,114,129,50,90,54,14,7,7,47
"2011","Stratford-on-Avon 008B","E01031218",887,176,50,126,235,105,130,52,78,47,18,10,8,46
"2011","Stratford-on-Avon 008C","E01031249",886,90,29,61,174,117,81,82,150,113,29,16,13,50
"2011","Stratford-on-Avon 008D","E01031250",1088,165,41,124,273,172,126,67,132,74,11,9,2,68
"2011","Stratford-on-Avon 008E","E01031251",863,155,35,120,224,145,82,54,103,40,12,6,6,48
"2011","Stratford-on-Avon 008F","E01031252",1038,172,49,123,253,91,121,38,79,66,22,12,10,196
"2011","Stratford-on-Avon 008G","E01031253",1079,129,30,99,275,150,108,73,148,120,19,14,5,57
"2011","Stratford-on-Avon 009A","E01031228",1176,187,39,148,308,177,135,76,140,76,20,7,13,57
"2011","Stratford-on-Avon 009B","E01031229",1366,196,42,154,400,142,134,99,175,126,32,15,17,62
"2011","Stratford-on-Avon 009C","E01031230",1781,245,56,189,422,252,126,136,284,184,44,27,17,88
"2011","Stratford-on-Avon 009D","E01031231",1641,140,23,117,315,190,135,149,308,232,87,53,34,85
"2011","Stratford-on-Avon 009E","E01031236",1233,127,33,94,274,178,123,93,197,137,29,22,7,75
"2011","Stratford-on-Avon 009F","E01031238",998,51,14,37,139,119,93,98,212,177,47,31,16,62
"2011","Stratford-on-Avon 010A","E01031225",1149,239,55,184,330,127,116,46,126,43,38,26,12,84
"2011","Stratford-on-Avon 010C","E01031227",1366,240,70,170,378,165,177,81,143,83,19,9,10,80
"2011","Stratford-on-Avon 010D","E01033250",985,203,49,154,321,150,75,46,72,27,25,17,8,66
"2011","Stratford-on-Avon 010E","E01033251",841,165,32,133,230,106,84,53,92,61,10,5,5,40
"2011","Stratford-on-Avon 010F","E01033252",903,205,64,141,292,126,94,32,69,27,14,12,2,44
"2011","Stratford-on-Avon 011A","E01031232",1859,291,73,218,478,245,174,75,187,95,21,11,10,293
"2011","Stratford-on-Avon 011B","E01031233",1189,159,34,125,273,140,143,88,164,105,28,21,7,89
"2011","Stratford-on-Avon 011C","E01031234",1201,171,31,140,366,147,164,61,115,102,28,15,13,47
"2011","Stratford-on-Avon 011D","E01031235",1257,172,33,139,343,152,137,89,176,115,24,18,6,49
"2011","Stratford-on-Avon 011E","E01031237",1076,119,23,96,275,167,103,80,166,92,23,14,9,51
"2011","Stratford-on-Avon 012A","E01031189",1109,113,31,82,232,137,160,88,184,114,25,16,9,56
"2011","Stratford-on-Avon 012B","E01031190",1246,108,22,86,237,137,144,128,206,165,48,35,13,73
"2011","Stratford-on-Avon 012C","E01031191",1352,212,59,153,353,188,176,85,134,88,30,21,9,86
"2011","Stratford-on-Avon 012D","E01031192",1386,180,45,135,331,197,191,100,186,102,33,15,18,66
"2011","Stratford-on-Avon 012E","E01031248",1550,261,71,190,418,193,252,80,135,86,27,15,12,98
"2011","Stratford-on-Avon 013A","E01031194",1794,284,91,193,529,246,214,121,175,132,21,9,12,72
"2011","Stratford-on-Avon 013B","E01031205",1160,219,62,157,329,130,165,63,119,63,20,15,5,52
"2011","Stratford-on-Avon 013C","E01031206",1024,178,42,136,203,105,128,83,125,114,26,14,12,62
"2011","Stratford-on-Avon 013D","E01031207",965,140,27,113,191,134,114,69,123,100,36,20,16,58
"2011","Stratford-on-Avon 013E","E01031247",1715,298,70,228,406,197,304,86,172,124,23,15,8,105
"2011","Stratford-on-Avon 014A","E01031196",1716,309,98,211,481,200,280,86,128,106,32,16,16,94
"2011","Stratford-on-Avon 014B","E01031212",1906,240,75,165,477,220,286,140,257,166,40,21,19,80
"2011","Stratford-on-Avon 014C","E01031245",890,135,53,82,228,108,148,41,86,73,16,11,5,55
"2011","Stratford-on-Avon 014D","E01031246",790,127,27,100,223,91,134,27,89,51,13,6,7,35
"2011","Stratford-on-Avon 015A","E01031193",1565,226,49,177,389,152,344,87,176,92,28,19,9,71
"2011","Stratford-on-Avon 015B","E01031209",1556,275,78,197,422,148,284,77,125,123,38,25,13,64
"2011","Stratford-on-Avon 015C","E01031214",1262,203,56,147,315,190,177,66,133,90,14,8,6,74
"2011","Stratford-on-Avon 015D","E01031215",1271,137,33,104,275,154,167,132,182,142,31,19,12,51
"2011","Stratford-on-Avon 015E","E01031216",1035,83,20,63,196,128,150,79,166,153,30,18,12,50
"2011","Warwick 001A","E01031254",1122,253,51,202,301,144,151,51,91,47,12,7,5,72
"2011","Warwick 001B","E01031255",1068,241,51,190,334,167,93,45,61,40,16,6,10,71
"2011","Warwick 001C","E01031256",1161,307,54,253,350,151,114,34,74,35,19,9,10,77
"2011","Warwick 001D","E01031257",1069,170,35,135,257,113,85,89,133,81,37,21,16,104
"2011","Warwick 001E","E01031258",1056,219,36,183,315,112,98,54,108,46,20,12,8,84
"2011","Warwick 002A","E01031296",1234,270,53,217,346,186,85,72,120,48,23,11,12,84
"2011","Warwick 002B","E01031297",1409,254,38,216,381,163,131,71,153,120,31,15,16,105
"2011","Warwick 002C","E01031298",1136,240,42,198,317,170,96,52,122,49,18,9,9,72
"2011","Warwick 002D","E01031299",1030,260,75,185,320,148,90,33,58,39,10,7,3,72
"2011","Warwick 002E","E01031300",1259,307,63,244,370,161,136,54,99,45,10,7,3,77
"2011","Warwick 003A","E01031303",1046,160,33,127,252,139,95,61,123,97,51,42,9,68
"2011","Warwick 003B","E01031304",1020,144,27,117,269,160,80,69,133,85,15,9,6,65
"2011","Warwick 003C","E01031305",1002,249,64,185,324,138,90,36,67,24,8,6,2,66
"2011","Warwick 003D","E01031306",1063,190,45,145,264,128,98,74,134,79,19,8,11,77
"2011","Warwick 003E","E01031307",991,192,35,157,293,143,98,55,81,44,18,8,10,67
"2011","Warwick 004A","E01031281",1129,236,58,178,330,139,168,49,77,46,18,14,4,66
"2011","Warwick 004B","E01031282",1093,202,58,144,294,122,192,53,93,47,23,14,9,67
"2011","Warwick 004C","E01031283",982,190,45,145,285,103,154,34,90,56,12,6,6,58
"2011","Warwick 004D","E01031284",908,221,53,168,237,139,125,34,64,29,12,8,4,47
"2011","Warwick 005A","E01031277",1077,157,38,119,288,151,119,71,117,76,33,20,13,65
"2011","Warwick 005B","E01031278",1046,199,56,143,282,161,118,53,98,38,17,9,8,80
"2011","Warwick 005C","E01031279",940,113,16,97,217,147,111,83,121,90,19,12,7,39
"2011","Warwick 005D","E01031280",1015,204,40,164,334,127,124,39,62,42,27,22,5,56
"2011","Warwick 005E","E01031301",1065,191,46,145,288,144,157,62,100,51,19,11,8,53
"2011","Warwick 005F","E01031302",770,113,21,92,174,102,82,48,105,80,25,14,11,41
"2011","Warwick 005G","E01031308",3013,329,62,267,322,177,158,77,116,65,38,21,17,1731
"2011","Warwick 006A","E01031273",1013,46,12,34,137,103,82,77,215,188,108,58,50,57
"2011","Warwick 006B","E01031274",993,94,23,71,161,119,102,69,185,124,51,36,15,88
"2011","Warwick 006C","E01031275",923,130,23,107,221,143,88,66,112,84,15,8,7,64
"2011","Warwick 006D","E01031276",1114,98,11,87,159,118,93,92,230,169,62,46,16,93
"2011","Warwick 007B","E01031272",1427,293,56,237,338,120,105,56,111,81,32,20,12,291
"2011","Warwick 007C","E01031285",1553,414,77,337,434,176,130,50,96,47,33,22,11,173
"2011","Warwick 007D","E01031286",1042,205,37,168,262,112,62,66,125,97,24,17,7,89
"2011","Warwick 007E","E01031287",1090,198,29,169,304,166,75,72,102,58,17,10,7,98
"2011","Warwick 007F","E01031288",1187,264,74,190,358,141,107,41,94,42,57,47,10,83
"2011","Warwick 007G","E01031289",1089,180,27,153,307,150,104,46,114,70,38,27,11,80
"2011","Warwick 007H","E01033253",1274,240,40,200,240,95,84,34,81,47,26,16,10,427
"2011","Warwick 007I","E01033256",1099,226,31,195,248,78,57,37,75,46,37,12,25,295
"2011","Warwick 008A","E01031309",1245,154,24,130,255,152,99,99,207,153,46,32,14,80
"2011","Warwick 008B","E01031310",978,115,17,98,226,144,95,78,136,89,35,22,13,60
"2011","Warwick 008C","E01031311",942,98,21,77,180,123,73,83,168,122,44,30,14,51
"2011","Warwick 008D","E01031312",897,70,12,58,152,131,61,76,198,128,37,22,15,44
"2011","Warwick 008E","E01031313",1050,134,28,106,277,171,75,88,148,91,18,13,5,48
"2011","Warwick 008F","E01031314",1037,123,16,107,241,190,64,94,147,111,20,11,9,47
"2011","Warwick 009A","E01031290",1368,349,56,293,379,138,108,48,87,68,42,32,10,149
"2011","Warwick 009B","E01031291",1319,231,30,201,269,101,74,45,116,67,37,14,23,379
"2011","Warwick 009C","E01031292",1110,221,39,182,355,131,86,65,99,56,25,14,11,72
"2011","Warwick 009D","E01031293",1244,274,55,219,294,112,84,54,126,66,58,39,19,176
"2011","Warwick 009E","E01031294",1109,296,45,251,273,85,73,28,85,55,28,18,10,186
"2011","Warwick 009F","E01031295",841,202,36,166,276,96,69,25,68,25,20,13,7,60
"2011","Warwick 010A","E01031271",1330,250,41,209,333,87,95,74,127,99,31,13,18,234
"2011","Warwick 010B","E01031332",1016,57,9,48,118,71,58,115,247,228,54,33,21,68
"2011","Warwick 010C","E01031333",1025,58,9,49,139,116,76,87,211,195,54,40,14,89
"2011","Warwick 010D","E01031334",1143,121,17,104,208,162,88,86,215,161,23,11,12,79
"2011","Warwick 010E","E01031335",1240,229,33,196,283,89,73,51,118,68,54,31,23,275
"2011","Warwick 010F","E01031336",1915,201,22,179,247,94,81,65,116,75,60,24,36,976
"2011","Warwick 010G","E01031337",1235,220,39,181,317,95,87,58,117,75,30,10,20,236
"2011","Warwick 011A","E01031321",934,54,14,40,151,94,52,101,178,167,64,32,32,73
"2011","Warwick 011B","E01031322",1439,234,43,191,352,198,98,109,208,130,49,32,17,61
"2011","Warwick 011C","E01031323",1192,193,26,167,332,155,83,69,138,110,30,16,14,82
"2011","Warwick 011D","E01031324",1662,321,57,264,505,202,126,94,177,115,51,25,26,71
"2011","Warwick 011E","E01031325",1007,101,20,81,201,125,96,73,171,148,42,21,21,50
"2011","Warwick 011G","E01033254",1060,246,54,192,342,144,67,61,99,41,13,10,3,47
"2011","Warwick 011H","E01033255",1218,211,48,163,330,147,92,74,137,103,37,22,15,87
"2011","Warwick 012A","E01031315",1571,354,79,275,398,187,130,88,160,89,38,22,16,127
"2011","Warwick 012B","E01031316",1015,176,36,140,266,116,80,61,134,107,35,19,16,40
"2011","Warwick 012C","E01031317",1102,266,54,212,329,136,124,30,86,39,16,10,6,76
"2011","Warwick 012D","E01031318",1299,299,63,236,393,179,103,55,101,77,15,9,6,77
"2011","Warwick 012E","E01031319",1457,276,44,232,399,179,114,80,148,89,59,32,27,113
"2011","Warwick 012F","E01031320",1114,217,29,188,280,155,84,66,126,75,40,24,16,71
"2011","Warwick 013A","E01031261",1224,59,5,54,134,88,65,82,248,154,67,45,22,327
"2011","Warwick 013B","E01031262",1134,114,17,97,195,101,90,87,152,139,50,26,24,206
"2011","Warwick 013C","E01031263",1567,106,11,95,173,91,54,77,187,168,63,39,24,648
"2011","Warwick 013D","E01031264",1191,56,5,51,141,117,69,90,255,196,72,50,22,195
"2011","Warwick 013E","E01031265",1084,45,10,35,146,92,69,75,225,157,63,38,25,212
"2011","Warwick 013F","E01031266",1734,157,21,136,224,105,78,83,170,160,73,38,35,684
"2011","Warwick 014A","E01031259",1020,189,37,152,282,146,80,58,114,68,21,16,5,62
"2011","Warwick 014B","E01031260",863,108,17,91,175,123,84,79,133,98,23,14,9,40
"2011","Warwick 014C","E01031267",1339,247,64,183,337,193,157,97,140,80,20,10,10,68
"2011","Warwick 014D","E01031268",1991,463,104,359,626,258,188,90,139,94,26,16,10,107
"2011","Warwick 014E","E01031269",1237,280,68,212,351,150,158,59,90,54,22,13,9,73
"2011","Warwick 015A","E01031327",1073,90,30,60,182,131,81,99,194,138,57,36,21,101
"2011","Warwick 015B","E01031328",1642,201,45,156,338,271,132,155,252,172,31,17,14,90
"2011","Warwick 015C","E01031329",1808,304,63,241,422,267,161,113,219,147,49,29,20,126
"2011","Warwick 015D","E01031330",1044,101,12,89,202,179,87,85,199,100,32,17,15,59
"2011","Warwick 015E","E01031331",1310,160,24,136,289,198,123,97,216,118,25,19,6,84
"2011","Birmingham 001A","E01009417",1016,183,49,134,242,166,85,58,101,64,33,26,7,84
"2011","Birmingham 001B","E01009418",1026,127,35,92,276,166,90,69,120,61,47,26,21,70
"2011","Birmingham 001C","E01009419",925,140,38,102,253,132,91,52,106,72,16,11,5,63
"2011","Birmingham 001D","E01009433",1264,253,64,189,396,187,121,45,107,44,30,17,13,81
"2011","Birmingham 002A","E01009415",1127,232,58,174,342,167,101,40,108,49,22,13,9,66
"2011","Birmingham 002B","E01009422",1293,226,53,173,372,203,135,64,103,73,34,21,13,83
"2011","Birmingham 002C","E01009423",1180,129,31,98,273,159,93,68,179,136,71,44,27,72
"2011","Birmingham 002D","E01009425",1113,181,52,129,309,168,129,45,109,62,41,17,24,69
"2011","Birmingham 003A","E01009416",1851,372,101,271,568,268,176,81,148,74,50,31,19,114
"2011","Birmingham 003B","E01009420",1050,138,26,112,304,153,82,66,124,85,31,23,8,67
"2011","Birmingham 003C","E01009426",964,149,38,111,278,166,104,49,83,51,12,7,5,72
"2011","Birmingham 003D","E01009429",1028,200,54,146,356,158,89,43,81,29,23,13,10,49
"2011","Birmingham 003E","E01009431",1082,244,64,180,313,187,73,42,79,46,18,9,9,80
"2011","Birmingham 004A","E01009421",1193,291,80,211,332,178,145,32,73,26,20,15,5,96
"2011","Birmingham 004B","E01009424",1064,209,42,167,304,148,100,60,103,41,30,15,15,69
"2011","Birmingham 004C","E01009427",1103,231,66,165,318,156,98,41,91,41,50,36,14,77
"2011","Birmingham 004D","E01009428",1176,246,63,183,351,203,114,43,71,43,18,12,6,87
"2011","Birmingham 004E","E01009430",1178,290,82,208,342,149,142,34,63,35,29,27,2,94
"2011","Birmingham 004F","E01009468",1052,195,52,143,300,167,107,49,81,44,29,17,12,80
"2011","Birmingham 005A","E01009445",1106,60,14,46,165,128,81,63,200,208,108,73,35,93
"2011","Birmingham 005B","E01009446",1723,246,56,190,463,296,130,101,192,117,67,47,20,111
"2011","Birmingham 005C","E01009447",1060,121,27,94,248,157,84,71,158,107,47,36,11,67
"2011","Birmingham 005D","E01009448",1156,79,17,62,182,151,87,112,211,156,79,55,24,99
"2011","Birmingham 005E","E01009452",1175,136,30,106,280,182,88,85,168,94,50,28,22,92
"2011","Birmingham 005F","E01009455",1002,79,25,54,203,140,68,81,165,128,86,42,44,52
"2011","Birmingham 006A","E01009432",1054,151,22,129,257,149,66,69,139,92,66,48,18,65
"2011","Birmingham 006B","E01009435",1378,248,57,191,415,213,113,74,124,69,28,15,13,94
"2011","Birmingham 006C","E01009437",1264,197,40,157,377,207,126,64,101,73,39,25,14,80
"2011","Birmingham 006D","E01009444",1073,176,45,131,325,179,97,43,108,56,20,14,6,69
"2011","Birmingham 006E","E01009454",1147,168,41,127,310,198,106,66,129,56,28,12,16,86
"2011","Birmingham 007A","E01009221",1076,66,14,52,171,185,97,99,186,142,68,47,21,62
"2011","Birmingham 007B","E01009464",990,112,38,74,244,157,94,70,118,97,23,14,9,75
"2011","Birmingham 007C","E01009465",1009,141,38,103,240,177,87,61,126,66,35,24,11,76
"2011","Birmingham 007D","E01009467",1143,130,29,101,264,170,118,79,165,99,38,29,9,80
"2011","Birmingham 008A","E01009220",1102,47,14,33,183,150,78,96,222,161,83,47,36,82
"2011","Birmingham 008B","E01009222",1074,25,8,17,132,112,60,92,228,197,131,82,49,97
"2011","Birmingham 008C","E01009224",1003,62,13,49,147,150,89,93,174,157,57,36,21,74
"2011","Birmingham 008D","E01009233",1062,30,8,22,124,139,61,89,204,208,128,79,49,79
"2011","Birmingham 009A","E01009449",1391,261,55,206,400,194,113,77,122,75,64,50,14,85
"2011","Birmingham 009B","E01009451",1035,147,27,120,298,138,102,63,98,76,46,35,11,67
"2011","Birmingham 009C","E01009453",1083,131,25,106,296,157,94,81,119,71,40,30,10,94
"2011","Birmingham 009D","E01009466",1221,257,46,211,400,180,111,44,89,41,24,13,11,75
"2011","Birmingham 009E","E01009471",1312,240,52,188,376,191,118,58,93,76,62,51,11,98
"2011","Birmingham 010A","E01009135",1133,117,21,96,240,169,112,73,165,113,48,34,14,96
"2011","Birmingham 010B","E01009469",1075,159,39,120,318,176,100,60,96,65,35,19,16,66
"2011","Birmingham 010C","E01009470",1058,187,36,151,300,170,100,49,76,62,35,29,6,79
"2011","Birmingham 010D","E01009472",1155,165,41,124,318,185,122,55,114,77,34,20,14,85
"2011","Birmingham 010E","E01009473",1146,151,34,117,283,190,91,87,153,80,32,24,8,79
"2011","Birmingham 010F","E01009474",1148,168,42,126,342,147,112,61,127,67,29,23,6,95
"2011","Birmingham 011A","E01009127",1058,19,1,18,100,98,75,81,226,185,183,116,67,91
"2011","Birmingham 011B","E01009128",949,20,5,15,114,88,56,85,207,165,139,86,53,75
"2011","Birmingham 011C","E01009130",1059,38,7,31,118,104,53,88,245,195,133,93,40,85
"2011","Birmingham 011D","E01009131",996,19,4,15,99,116,55,73,218,206,111,73,38,99
"2011","Birmingham 011E","E01009133",1024,24,7,17,109,88,52,90,217,209,149,97,52,86
"2011","Birmingham 011F","E01009134",1077,19,5,14,106,121,67,80,239,213,148,105,43,84
"2011","Birmingham 011G","E01009137",1077,21,6,15,122,105,69,84,263,174,130,69,61,109
"2011","Birmingham 012A","E01009434",1148,185,42,143,343,182,107,55,114,43,30,19,11,89
"2011","Birmingham 012B","E01009436",1046,190,54,136,309,183,100,45,82,40,24,15,9,73
"2011","Birmingham 012C","E01009438",1133,185,30,155,326,189,89,66,112,73,27,20,7,66
"2011","Birmingham 012D","E01009440",1100,162,39,123,277,209,101,56,120,75,34,23,11,66
"2011","Birmingham 012E","E01009450",1181,117,31,86,297,204,135,98,130,85,25,10,15,90
"2011","Birmingham 013A","E01009223",1170,78,28,50,218,191,89,104,209,137,66,43,23,78
"2011","Birmingham 013B","E01009225",1046,44,14,30,161,166,73,94,209,158,66,40,26,75
"2011","Birmingham 013C","E01009227",1203,90,30,60,204,200,88,127,208,147,51,29,22,88
"2011","Birmingham 013D","E01009228",1174,41,13,28,208,188,78,108,215,191,64,39,25,81
"2011","Birmingham 014A","E01009121",1559,76,13,63,255,186,88,116,301,228,161,118,43,148
"2011","Birmingham 014B","E01009122",1091,20,3,17,116,121,61,83,237,205,167,109,58,81
"2011","Birmingham 014C","E01009129",1081,29,4,25,99,98,50,67,233,214,198,142,56,93
"2011","Birmingham 014D","E01009132",1035,22,5,17,125,94,52,96,222,196,140,93,47,88
"2011","Birmingham 014E","E01009136",1152,62,16,46,180,122,67,85,221,195,139,94,45,81
"2011","Birmingham 015A","E01009457",1109,188,53,135,323,179,140,52,78,55,18,7,11,76
"2011","Birmingham 015B","E01009459",1208,248,63,185,378,180,117,39,88,47,33,23,10,78
"2011","Birmingham 015C","E01009461",996,178,40,138,295,154,100,43,76,52,25,16,9,73
"2011","Birmingham 015D","E01009463",1091,205,44,161,332,138,109,47,107,50,34,21,13,69
"2011","Birmingham 016A","E01009235",1184,73,14,59,212,208,86,87,207,138,54,35,19,119
"2011","Birmingham 016B","E01009243",1093,67,22,45,219,198,82,94,162,142,49,34,15,80
"2011","Birmingham 016C","E01009245",1034,99,17,82,195,168,76,66,172,119,57,37,20,82
"2011","Birmingham 016D","E01009246",1170,81,30,51,219,213,84,107,198,124,60,41,19,84
"2011","Birmingham 016E","E01009247",1084,81,24,57,203,180,68,97,175,125,48,25,23,107
"2011","Birmingham 017A","E01009226",1071,55,11,44,200,159,90,90,208,147,52,32,20,70
"2011","Birmingham 017B","E01009229",1162,75,16,59,201,199,93,103,211,143,50,27,23,87
"2011","Birmingham 017C","E01009230",1118,85,18,67,204,167,88,90,223,147,38,24,14,76
"2011","Birmingham 017D","E01009231",1354,85,25,60,221,221,124,127,235,181,64,45,19,96
"2011","Birmingham 018A","E01009001",1145,90,18,72,241,178,97,90,190,139,65,36,29,55
"2011","Birmingham 018B","E01009003",1248,105,20,85,275,162,136,86,180,96,110,73,37,98
"2011","Birmingham 018C","E01009456",1190,227,53,174,403,149,86,50,85,63,35,19,16,92
"2011","Birmingham 018D","E01009458",993,107,25,82,227,136,74,74,145,134,39,30,9,57
"2011","Birmingham 018E","E01009460",1286,152,32,120,340,194,121,90,154,121,45,22,23,69
"2011","Birmingham 018F","E01009462",1274,200,26,174,347,169,107,64,143,101,54,34,20,89
"2011","Birmingham 019A","E01009234",1133,66,22,44,232,186,72,100,189,138,56,22,34,94
"2011","Birmingham 019B","E01009236",1120,73,13,60,202,211,77,89,189,139,54,33,21,86
"2011","Birmingham 019C","E01009244",1025,53,20,33,191,182,78,97,204,120,30,22,8,70
"2011","Birmingham 019D","E01009248",1322,73,19,54,252,216,71,122,252,164,68,44,24,104
"2011","Birmingham 020A","E01009403",1055,46,17,29,131,139,63,95,216,154,110,68,42,101
"2011","Birmingham 020B","E01009404",1089,38,10,28,144,120,73,107,227,179,116,65,51,85
"2011","Birmingham 020C","E01009405",1000,51,12,39,176,127,61,76,194,153,102,71,31,60
"2011","Birmingham 020D","E01009406",1155,50,12,38,185,153,89,85,236,156,117,78,39,84
"2011","Birmingham 020E","E01009407",1243,52,11,41,222,140,79,99,212,172,172,124,48,95
"2011","Birmingham 021A","E01009439",970,143,35,108,285,147,105,54,103,66,21,8,13,46
"2011","Birmingham 021B","E01009441",1109,48,14,34,199,154,98,98,223,183,52,24,28,54
"2011","Birmingham 021C","E01009442",1010,99,26,73,239,166,89,99,132,89,31,18,13,66
"2011","Birmingham 021D","E01009443",935,86,27,59,259,171,71,75,138,67,31,17,14,37
"2011","Birmingham 022A","E01009123",999,48,16,32,159,140,45,76,195,150,95,64,31,91
"2011","Birmingham 022B","E01009124",1022,18,3,15,89,107,57,58,198,163,213,147,66,119
"2011","Birmingham 022C","E01009125",1197,44,4,40,155,150,57,81,257,186,169,109,60,98
"2011","Birmingham 022D","E01009232",1074,64,16,48,190,160,82,85,185,159,62,43,19,87
"2011","Birmingham 023A","E01009002",968,37,7,30,148,98,62,64,166,157,162,100,62,74
"2011","Birmingham 023C","E01009006",1190,108,28,80,289,171,92,95,173,129,82,45,37,51
"2011","Birmingham 023D","E01009007",1191,64,15,49,201,146,61,87,243,163,104,57,47,122
"2011","Birmingham 023F","E01033632",1549,118,22,96,287,170,93,94,268,189,181,103,78,149
"2011","Birmingham 024A","E01009237",1003,56,12,44,174,151,58,73,163,148,88,57,31,92
"2011","Birmingham 024B","E01009238",1149,98,23,75,211,176,116,94,155,114,86,64,22,99
"2011","Birmingham 024C","E01009240",1113,93,25,68,188,173,86,58,185,141,78,52,26,111
"2011","Birmingham 024D","E01009241",1193,80,19,61,213,170,86,80,178,120,115,85,30,151
"2011","Birmingham 024E","E01009242",1269,70,15,55,206,152,71,54,180,152,97,80,17,287
"2011","Birmingham 025A","E01009005",971,72,9,63,209,183,74,74,137,88,70,53,17,64
"2011","Birmingham 025B","E01009009",1094,113,17,96,234,157,81,83,161,131,62,41,21,72
"2011","Birmingham 025C","E01009098",1479,94,18,76,269,196,113,79,278,228,130,71,59,92
"2011","Birmingham 025D","E01009100",1419,120,24,96,265,168,104,130,232,169,113,75,38,118
"2011","Birmingham 025E","E01009105",1177,82,18,64,235,179,84,88,203,153,81,50,31,72
"2011","Birmingham 026A","E01009126",1018,65,14,51,197,177,93,69,166,116,49,29,20,86
"2011","Birmingham 026B","E01009408",1217,40,6,34,147,140,82,100,240,204,143,96,47,121
"2011","Birmingham 026C","E01009409",1168,68,14,54,230,147,70,72,220,156,101,71,30,104
"2011","Birmingham 026D","E01009410",1270,66,13,53,237,142,93,99,200,173,139,99,40,121
"2011","Birmingham 028A","E01009008",1072,89,19,70,253,142,77,79,175,108,55,42,13,94
"2011","Birmingham 028B","E01009011",1291,73,16,57,247,155,107,98,231,206,94,65,29,80
"2011","Birmingham 028C","E01009012",1093,74,14,60,217,175,73,87,165,133,59,28,31,110
"2011","Birmingham 028D","E01009102",1048,58,16,42,126,118,68,86,213,171,127,86,41,81
"2011","Birmingham 028E","E01009104",1050,24,5,19,132,125,78,88,196,181,131,80,51,95
"2011","Birmingham 029A","E01009096",1171,41,12,29,149,125,59,99,263,242,120,73,47,73
"2011","Birmingham 029B","E01009097",1345,28,12,16,134,130,52,103,307,263,201,147,54,127
"2011","Birmingham 029C","E01009099",1217,28,11,17,148,150,38,85,301,233,144,84,60,90
"2011","Birmingham 029D","E01009101",1053,27,10,17,125,129,53,78,240,194,110,76,34,97
"2011","Birmingham 029E","E01009103",1043,13,2,11,110,103,41,91,278,204,122,82,40,81
"2011","Birmingham 029F","E01009106",969,33,9,24,117,121,67,93,237,168,72,49,23,61
"2011","Birmingham 030A","E01008915",929,31,4,27,103,108,70,61,154,139,144,112,32,119
"2011","Birmingham 030B","E01009411",1391,81,25,56,286,208,91,119,248,194,83,54,29,81
"2011","Birmingham 030C","E01009412",1256,66,7,59,197,118,91,74,180,167,161,127,34,202
"2011","Birmingham 030D","E01009413",1224,55,16,39,195,148,98,92,177,160,168,118,50,131
"2011","Birmingham 030E","E01009414",1425,79,21,58,281,166,107,81,226,182,159,114,45,144
"2011","Birmingham 031A","E01008998",1222,45,10,35,147,129,92,81,226,166,195,148,47,141
"2011","Birmingham 031B","E01008999",1128,58,10,48,182,121,81,70,175,141,148,120,28,152
"2011","Birmingham 031C","E01009000",1315,95,15,80,252,139,100,82,187,175,168,128,40,117
"2011","Birmingham 031D","E01009013",1427,101,11,90,253,178,100,99,250,182,136,86,50,128
"2011","Birmingham 031E","E01009400",1045,48,9,39,141,100,76,77,177,139,187,140,47,100
"2011","Birmingham 031F","E01009401",1185,42,3,39,143,122,79,74,197,155,164,125,39,209
"2011","Birmingham 031H","E01033630",944,98,24,74,204,121,27,54,150,110,87,57,30,93
"2011","Birmingham 031I","E01033646",1225,87,17,70,185,117,54,61,196,202,194,138,56,129
"2011","Birmingham 032A","E01009049",1159,85,20,65,170,131,103,52,143,134,164,119,45,177
"2011","Birmingham 032B","E01009056",1471,75,11,64,217,148,129,76,184,168,262,183,79,212
"2011","Birmingham 032C","E01009263",1218,108,18,90,190,145,93,55,176,116,128,86,42,207
"2011","Birmingham 032D","E01009264",1215,58,6,52,148,106,59,57,128,114,74,42,32,471
"2011","Birmingham 032E","E01009265",1309,118,17,101,220,112,118,68,166,153,195,167,28,159
"2011","Birmingham 033A","E01009051",1145,36,6,30,80,80,75,65,168,101,246,214,32,294
"2011","Birmingham 033B","E01009053",966,22,5,17,77,53,40,57,118,118,260,222,38,221
"2011","Birmingham 033C","E01009054",1132,59,9,50,132,120,75,52,168,121,223,190,33,182
"2011","Birmingham 033D","E01009058",1101,32,2,30,78,101,68,47,141,121,264,222,42,249
"2011","Birmingham 033E","E01009061",1199,50,3,47,102,79,77,56,151,119,357,313,44,208
"2011","Birmingham 033F","E01009239",1593,44,6,38,115,74,51,47,109,93,117,80,37,943
"2011","Birmingham 034A","E01009266",1252,54,8,46,166,103,87,67,192,226,187,148,39,170
"2011","Birmingham 034B","E01009269",1041,40,6,34,109,82,65,68,161,201,201,155,46,114
"2011","Birmingham 034C","E01009270",1348,43,9,34,132,106,71,67,211,196,310,237,73,212
"2011","Birmingham 034D","E01009271",1030,27,8,19,112,97,60,52,161,202,197,133,64,122
"2011","Birmingham 034E","E01009273",1126,41,5,36,111,110,90,68,177,184,213,170,43,132
"2011","Birmingham 035A","E01009050",1314,31,4,27,134,110,89,63,184,176,243,200,43,284
"2011","Birmingham 035D","E01009057",1323,40,6,34,104,106,88,70,178,172,343,287,56,222
"2011","Birmingham 035E","E01009059",1176,32,8,24,112,84,75,52,143,178,281,237,44,219
"2011","Birmingham 035F","E01009060",1049,23,3,20,72,79,66,58,160,123,278,246,32,190
"2011","Birmingham 035G","E01033621",1976,61,6,55,208,168,140,76,255,226,418,358,60,424
"2011","Birmingham 036A","E01009268",1098,56,14,42,138,147,94,39,176,187,135,110,25,126
"2011","Birmingham 036B","E01009272",958,43,5,38,107,99,54,58,142,133,152,106,46,170
"2011","Birmingham 036C","E01009274",1506,47,7,40,177,129,102,81,237,227,272,200,72,234
"2011","Birmingham 036D","E01009349",1118,35,7,28,105,88,80,56,172,204,230,179,51,148
"2011","Birmingham 036E","E01009351",1139,27,1,26,88,87,86,64,183,195,252,195,57,157
"2011","Birmingham 036F","E01009354",997,34,5,29,93,74,54,52,160,176,207,167,40,147
"2011","Birmingham 037A","E01008899",818,12,0,12,53,64,31,34,156,156,211,168,43,101
"2011","Birmingham 037C","E01008901",1122,21,3,18,111,90,52,57,184,176,276,225,51,155
"2011","Birmingham 037E","E01008916",933,24,4,20,63,68,68,57,152,104,279,241,38,118
"2011","Birmingham 037F","E01033636",2143,55,2,53,142,136,151,131,279,230,662,589,73,357
"2011","Birmingham 038A","E01009079",1126,26,3,23,109,99,34,89,223,219,215,131,84,112
"2011","Birmingham 038B","E01009080",712,16,2,14,84,70,36,48,133,122,135,87,48,68
"2011","Birmingham 038C","E01009081",883,23,2,21,105,92,54,64,177,126,147,100,47,95
"2011","Birmingham 038D","E01009083",903,34,5,29,122,85,49,41,167,145,150,113,37,110
"2011","Birmingham 039A","E01009275",1060,26,3,23,98,89,77,67,165,171,222,181,41,145
"2011","Birmingham 039B","E01009350",1027,23,1,22,87,85,66,52,146,158,269,220,49,141
"2011","Birmingham 039C","E01009352",1173,39,7,32,106,77,87,60,176,161,308,260,48,159
"2011","Birmingham 039D","E01009353",1121,24,4,20,95,77,65,61,169,182,285,249,36,163
"2011","Birmingham 039E","E01009355",1119,36,5,31,91,87,90,43,170,150,256,205,51,196
"2011","Birmingham 039H","E01033635",1987,48,7,41,172,162,121,128,337,358,371,310,61,290
"2011","Birmingham 040A","E01008905",1075,27,8,19,77,88,91,69,112,105,336,294,42,170
"2011","Birmingham 040B","E01008907",1124,24,2,22,89,88,67,57,165,161,291,238,53,182
"2011","Birmingham 040C","E01009047",1228,44,3,41,111,87,103,62,169,155,314,262,52,183
"2011","Birmingham 040D","E01009048",1274,51,7,44,109,86,111,54,162,187,324,273,51,190
"2011","Birmingham 040E","E01009062",1091,23,5,18,77,92,74,63,162,116,289,251,38,195
"2011","Birmingham 041D","E01008909",989,23,4,19,80,99,60,52,156,137,228,182,46,154
"2011","Birmingham 041F","E01033628",1550,34,0,34,117,136,102,90,225,201,438,374,64,207
"2011","Birmingham 041G","E01033637",1821,45,6,39,158,141,112,107,275,190,509,443,66,284
"2011","Birmingham 042A","E01009084",1126,58,11,47,159,149,106,58,146,126,175,147,28,149
"2011","Birmingham 042B","E01009085",1278,61,6,55,161,151,155,57,163,96,250,225,25,184
"2011","Birmingham 042C","E01009087",1053,55,13,42,167,157,65,98,184,125,110,88,22,92
"2011","Birmingham 042D","E01009089",1008,50,12,38,165,145,97,70,157,95,135,114,21,94
"2011","Birmingham 042E","E01009090",1217,72,15,57,159,136,148,62,149,120,217,195,22,154
"2011","Birmingham 043A","E01009201",1153,12,0,12,130,118,67,73,190,209,230,176,54,124
"2011","Birmingham 043B","E01009202",991,27,4,23,113,75,50,58,189,183,186,149,37,110
"2011","Birmingham 043C","E01009203",1759,25,4,21,126,129,70,108,266,296,484,352,132,255
"2011","Birmingham 044A","E01009082",948,28,12,16,115,109,62,70,193,179,83,58,25,109
"2011","Birmingham 044B","E01009086",1237,59,7,52,169,156,130,72,166,150,205,179,26,130
"2011","Birmingham 044C","E01009480",1094,25,8,17,84,101,91,90,182,159,241,195,46,121
"2011","Birmingham 044D","E01009481",1417,40,9,31,129,152,128,80,217,179,323,288,35,169
"2011","Birmingham 044E","E01009486",1289,34,6,28,113,118,109,83,196,173,312,274,38,151
"2011","Birmingham 044F","E01009487",1356,42,13,29,115,127,129,55,204,167,347,306,41,170
"2011","Birmingham 045A","E01009088",1094,53,11,42,186,155,76,77,216,158,97,70,27,76
"2011","Birmingham 045B","E01009091",1098,39,14,25,147,159,67,103,226,172,110,74,36,75
"2011","Birmingham 045C","E01009305",1088,23,4,19,122,144,62,90,225,211,139,80,59,72
"2011","Birmingham 045D","E01009307",1060,22,3,19,118,123,55,89,253,216,125,76,49,59
"2011","Birmingham 045E","E01009309",961,20,7,13,109,102,63,105,185,195,122,75,47,60
"2011","Birmingham 046A","E01009304",1255,40,13,27,176,157,78,106,241,232,154,103,51,71
"2011","Birmingham 046B","E01009306",1078,36,9,27,145,141,61,92,233,193,115,72,43,62
"2011","Birmingham 046C","E01009308",1244,33,11,22,166,137,79,96,268,210,149,98,51,106
"2011","Birmingham 046D","E01009310",1250,31,5,26,149,158,84,101,257,227,149,104,45,94
"2011","Birmingham 047A","E01009348",1427,78,16,62,219,179,61,86,220,199,191,125,66,194
"2011","Birmingham 047B","E01009358",1476,36,3,33,135,112,97,79,208,234,367,300,67,208
"2011","Birmingham 047C","E01009359",1404,36,9,27,113,137,72,70,238,211,324,271,53,203
"2011","Birmingham 047D","E01009360",1675,55,8,47,192,165,116,100,253,237,319,253,66,238
"2011","Birmingham 047E","E01009361",1422,31,4,27,140,115,88,74,235,229,301,230,71,209
"2011","Birmingham 048A","E01009478",1170,25,8,17,101,122,83,63,215,174,274,222,52,113
"2011","Birmingham 048B","E01009479",1377,26,4,22,99,109,104,63,188,181,407,357,50,200
"2011","Birmingham 048C","E01009482",1083,15,1,14,69,65,67,57,135,125,362,320,42,188
"2011","Birmingham 048D","E01009484",1122,19,6,13,49,64,64,56,152,157,372,318,54,189
"2011","Birmingham 048E","E01009485",1145,21,4,17,87,80,96,64,152,117,344,303,41,184
"2011","Birmingham 049A","E01008906",1083,25,3,22,76,74,58,94,134,121,332,286,46,169
"2011","Birmingham 049B","E01008911",1004,16,4,12,83,64,45,42,166,140,270,212,58,178
"2011","Birmingham 049D","E01009347",1235,30,5,25,137,95,47,73,219,231,238,173,65,165
"2011","Birmingham 049E","E01033559",1191,303,35,268,330,127,46,41,69,51,47,24,23,177
"2011","Birmingham 049F","E01033638",1098,29,2,27,90,87,47,70,168,153,280,217,63,174
"2011","Birmingham 050A","E01008910",1149,25,2,23,76,75,64,80,162,168,299,226,73,200
"2011","Birmingham 050B","E01008913",1035,12,5,7,77,87,48,49,184,163,263,185,78,152
"2011","Birmingham 050C","E01008914",2141,69,9,60,156,114,55,78,209,194,302,219,83,964
"2011","Birmingham 050E","E01033561",2686,33,5,28,74,62,21,37,99,93,120,86,34,2147
"2011","Birmingham 050F","E01033617",2925,44,3,41,66,25,13,12,37,18,58,47,11,2652
"2011","Birmingham 051A","E01009194",1804,61,9,52,113,124,133,75,211,174,600,535,65,313
"2011","Birmingham 051B","E01009483",1129,11,1,10,46,68,99,47,138,127,396,356,40,197
"2011","Birmingham 051C","E01009488",1338,31,6,25,96,111,93,82,206,185,376,318,58,158
"2011","Birmingham 051D","E01009489",1222,36,9,27,76,75,89,53,158,141,411,351,60,183
"2011","Birmingham 051E","E01009491",1131,24,4,20,51,69,88,52,140,156,386,342,44,165
"2011","Birmingham 052B","E01009192",1680,50,8,42,121,110,155,54,191,141,572,518,54,286
"2011","Birmingham 052D","E01009199",1001,76,16,60,151,112,76,64,123,97,168,123,45,134
"2011","Birmingham 052E","E01009204",1148,19,5,14,80,96,51,55,180,200,270,212,58,197
"2011","Birmingham 052F","E01033644",1892,45,11,34,137,121,121,84,223,187,664,570,94,310
"2011","Birmingham 053A","E01009151",1291,48,5,43,131,106,115,57,185,157,295,244,51,197
"2011","Birmingham 053B","E01009152",1513,50,5,45,127,114,133,68,174,162,350,301,49,335
"2011","Birmingham 053C","E01009153",1601,89,17,72,229,152,68,105,205,188,218,154,64,347
"2011","Birmingham 053D","E01009345",1696,27,3,24,117,99,112,138,264,329,473,395,78,137
"2011","Birmingham 053E","E01009346",1104,32,6,26,107,90,67,58,161,139,283,233,50,167
"2011","Birmingham 054A","E01009092",1039,18,2,16,128,99,54,79,229,177,160,117,43,95
"2011","Birmingham 054B","E01009093",1059,19,7,12,119,119,57,101,218,190,166,114,52,70
"2011","Birmingham 054C","E01009094",958,30,10,20,110,104,50,76,207,162,136,104,32,83
"2011","Birmingham 054D","E01009298",1026,28,12,16,120,119,44,87,194,172,166,113,53,96
"2011","Birmingham 054E","E01009311",1087,24,5,19,122,137,55,86,234,193,140,103,37,96
"2011","Birmingham 054F","E01009511",952,25,7,18,81,70,75,70,174,176,185,144,41,96
"2011","Birmingham 055A","E01009475",1249,33,7,26,100,103,100,63,164,172,336,279,57,178
"2011","Birmingham 055B","E01009476",1134,39,3,36,91,81,94,49,162,140,323,286,37,155
"2011","Birmingham 055C","E01009477",1108,27,4,23,124,80,89,62,175,153,253,202,51,145
"2011","Birmingham 055D","E01009490",1269,38,7,31,104,106,116,79,209,165,302,235,67,150
"2011","Birmingham 055E","E01009492",1088,17,6,11,72,84,101,49,166,163,293,252,41,143
"2011","Birmingham 056A","E01009095",1183,60,12,48,181,156,103,99,209,122,143,108,35,110
"2011","Birmingham 056B","E01009507",1038,35,7,28,131,124,76,50,164,161,191,140,51,106
"2011","Birmingham 056C","E01009508",1103,65,15,50,152,148,101,83,185,155,125,93,32,89
"2011","Birmingham 056D","E01009509",1234,63,9,54,164,150,103,84,219,125,189,146,43,137
"2011","Birmingham 056E","E01009510",1035,23,6,17,121,117,71,67,199,170,172,124,48,95
"2011","Birmingham 057A","E01009297",1168,51,13,38,150,135,70,137,220,223,106,73,33,76
"2011","Birmingham 057B","E01009299",1101,24,8,16,131,126,48,90,239,195,170,117,53,78
"2011","Birmingham 057C","E01009300",1224,25,8,17,132,144,56,107,222,227,195,135,60,116
"2011","Birmingham 057D","E01009301",1117,26,3,23,120,141,68,97,238,210,150,93,57,67
"2011","Birmingham 057E","E01009303",1068,44,12,32,130,139,75,90,223,206,111,69,42,50
"2011","Birmingham 058A","E01009195",1579,45,6,39,91,103,153,57,201,169,510,452,58,250
"2011","Birmingham 058C","E01009197",1025,34,3,31,108,95,75,39,136,118,271,240,31,149
"2011","Birmingham 058D","E01009198",997,23,3,20,65,56,88,54,109,115,290,256,34,197
"2011","Birmingham 058E","E01033647",810,20,3,17,73,63,73,47,104,107,217,191,26,106
"2011","Birmingham 058F","E01033649",1027,20,2,18,79,92,85,54,150,146,250,220,30,151
"2011","Birmingham 060A","E01009138",1223,90,6,84,192,121,96,63,155,145,157,123,34,204
"2011","Birmingham 060B","E01009139",1194,134,20,114,237,126,58,83,131,133,113,86,27,179
"2011","Birmingham 060C","E01009140",1509,160,10,150,273,137,99,93,165,156,153,103,50,273
"2011","Birmingham 060D","E01009145",1475,199,31,168,282,132,130,73,139,152,166,137,29,202
"2011","Birmingham 060E","E01009147",1297,181,17,164,265,127,110,67,142,87,154,112,42,164
"2011","Birmingham 062A","E01009512",1127,31,11,20,156,147,68,89,215,210,104,66,38,107
"2011","Birmingham 062B","E01009514",996,35,8,27,91,118,56,91,192,174,151,105,46,88
"2011","Birmingham 062C","E01009516",983,41,14,27,148,127,66,83,190,143,109,79,30,76
"2011","Birmingham 062D","E01009517",1180,38,10,28,161,157,85,109,219,196,120,78,42,95
"2011","Birmingham 063A","E01009325",1076,20,4,16,78,87,101,51,143,121,283,239,44,192
"2011","Birmingham 063D","E01009342",1119,45,6,39,137,104,119,49,119,98,277,232,45,171
"2011","Birmingham 063E","E01009343",1094,30,3,27,82,89,99,58,152,119,306,251,55,159
"2011","Birmingham 063F","E01033642",1910,54,6,48,128,148,176,85,256,209,525,460,65,329
"2011","Birmingham 064A","E01008986",1438,200,38,162,294,146,96,75,161,117,106,67,39,243
"2011","Birmingham 064B","E01008987",1296,68,11,57,158,77,46,56,123,134,101,77,24,533
"2011","Birmingham 064C","E01008988",1727,281,41,240,381,159,119,76,168,102,159,113,46,282
"2011","Birmingham 064D","E01008989",1411,216,34,182,316,120,94,60,144,103,103,75,28,255
"2011","Birmingham 064E","E01008990",922,263,32,231,182,75,59,16,43,9,29,25,4,246
"2011","Birmingham 064F","E01008991",1071,357,45,312,272,99,129,23,54,26,42,36,6,69
"2011","Birmingham 066A","E01008882",1150,37,7,30,114,119,89,85,197,207,219,175,44,83
"2011","Birmingham 066B","E01008896",1038,26,5,21,117,98,73,70,206,178,169,124,45,101
"2011","Birmingham 066C","E01008898",1076,32,7,25,117,111,69,69,211,157,193,146,47,117
"2011","Birmingham 066D","E01009326",1193,39,4,35,108,120,92,80,216,144,252,207,45,142
"2011","Birmingham 066E","E01009341",1007,27,5,22,102,87,73,47,167,139,250,204,46,115
"2011","Birmingham 066F","E01009513",1122,31,6,25,136,127,76,66,195,196,177,128,49,118
"2011","Birmingham 067A","E01008881",1057,46,10,36,137,156,84,59,190,153,131,93,38,101
"2011","Birmingham 067B","E01008897",1179,37,7,30,160,159,96,81,207,157,175,134,41,107
"2011","Birmingham 067C","E01009515",1080,61,10,51,160,158,87,86,184,138,130,111,19,76
"2011","Birmingham 067D","E01009518",1156,94,14,80,203,224,100,79,146,137,87,64,23,86
"2011","Birmingham 067E","E01009521",1197,88,23,65,224,183,125,90,204,117,73,55,18,93
"2011","Birmingham 069A","E01009302",1067,63,24,39,171,168,83,109,189,161,63,43,20,60
"2011","Birmingham 069B","E01009314",1082,43,13,30,169,161,79,95,209,163,92,67,25,71
"2011","Birmingham 069C","E01009321",1179,32,7,25,129,137,67,87,244,222,165,114,51,96
"2011","Birmingham 069D","E01009322",956,17,3,14,92,124,65,80,203,163,140,82,58,72
"2011","Birmingham 069E","E01009323",1021,36,9,27,116,153,64,80,199,177,104,74,30,92
"2011","Birmingham 070A","E01009329",1548,45,4,41,100,137,126,81,188,139,471,414,57,261
"2011","Birmingham 070B","E01009334",1204,40,8,32,79,99,125,56,141,103,371,341,30,190
"2011","Birmingham 070C","E01009337",1107,25,3,22,57,81,94,74,186,119,292,263,29,179
"2011","Birmingham 070D","E01009338",1014,34,7,27,86,78,79,55,122,111,297,262,35,152
"2011","Birmingham 070E","E01009380",1028,25,2,23,82,65,69,63,146,125,315,274,41,138
"2011","Birmingham 071A","E01009362",878,18,5,13,75,53,44,46,135,126,234,181,53,147
"2011","Birmingham 071B","E01009363",1063,27,6,21,84,101,73,57,176,164,242,197,45,139
"2011","Birmingham 071C","E01009364",872,20,5,15,73,71,31,54,122,137,232,187,45,132
"2011","Birmingham 071D","E01009365",1196,22,4,18,67,73,77,43,170,171,370,307,63,203
"2011","Birmingham 071E","E01009379",1104,16,6,10,76,82,84,72,185,169,288,240,48,132
"2011","Birmingham 072A","E01009312",1126,95,31,64,217,200,102,93,164,130,50,29,21,75
"2011","Birmingham 072B","E01009324",1178,77,24,53,221,204,91,107,195,144,60,38,22,79
"2011","Birmingham 072C","E01009519",1105,74,13,61,194,211,87,106,190,134,48,32,16,61
"2011","Birmingham 072D","E01009520",1260,115,22,93,238,227,109,105,181,130,64,44,20,91
"2011","Birmingham 073A","E01009066",1136,343,50,293,296,111,93,27,64,48,51,29,22,103
"2011","Birmingham 073B","E01009070",1172,302,31,271,340,141,63,38,99,60,40,25,15,89
"2011","Birmingham 073C","E01009252",1180,333,50,283,309,113,89,38,80,51,47,26,21,120
"2011","Birmingham 073D","E01009260",1106,273,35,238,268,126,125,35,89,57,36,28,8,97
"2011","Birmingham 073E","E01009261",1162,179,34,145,300,163,109,67,125,76,50,32,18,93
"2011","Birmingham 074A","E01008984",1742,126,19,107,153,93,65,64,128,122,172,119,53,819
"2011","Birmingham 074B","E01008994",1365,266,39,227,273,109,58,39,78,66,87,58,29,389
"2011","Birmingham 074C","E01008996",1009,62,7,55,123,94,61,68,131,105,202,158,44,163
"2011","Birmingham 074D","E01008997",1073,273,25,248,203,103,80,36,71,63,105,78,27,139
"2011","Birmingham 075A","E01009065",1291,382,50,332,312,121,97,36,79,54,91,41,50,119
"2011","Birmingham 075B","E01009067",1064,358,38,320,337,103,52,28,51,23,20,13,7,92
"2011","Birmingham 075C","E01009068",1213,395,27,368,323,97,53,28,58,38,31,18,13,190
"2011","Birmingham 075D","E01009069",1296,380,46,334,384,130,71,43,66,39,44,30,14,139
"2011","Birmingham 075E","E01009072",1291,350,27,323,385,138,76,40,78,55,56,41,15,113
"2011","Birmingham 076A","E01008885",933,47,14,33,160,167,86,73,172,104,53,40,13,71
"2011","Birmingham 076B","E01008886",1137,66,13,53,193,164,78,106,230,188,58,37,21,54
"2011","Birmingham 076C","E01008888",1194,77,16,61,201,207,93,108,206,159,62,41,21,81
"2011","Birmingham 076D","E01009313",1112,81,17,64,194,194,86,91,176,135,71,51,20,84
"2011","Birmingham 077A","E01009368",997,31,3,28,81,64,73,37,134,106,307,263,44,164
"2011","Birmingham 077D","E01009371",1144,27,3,24,67,68,86,51,144,94,380,340,40,227
"2011","Birmingham 077E","E01009397",1114,32,5,27,82,65,82,45,147,129,342,316,26,190
"2011","Birmingham 077F","E01033650",1635,40,6,34,102,111,114,79,205,188,537,489,48,259
"2011","Birmingham 078A","E01008883",1251,39,6,33,168,140,97,102,201,176,194,156,38,134
"2011","Birmingham 078B","E01008884",1216,44,8,36,157,122,91,84,183,198,215,154,61,122
"2011","Birmingham 078C","E01008887",1048,39,5,34,134,127,74,103,209,183,107,73,34,72
"2011","Birmingham 078D","E01008889",1275,84,17,67,190,142,82,101,202,157,221,181,40,96
"2011","Birmingham 079A","E01008982",1166,232,22,210,268,105,59,46,71,61,79,50,29,245
"2011","Birmingham 079C","E01008992",1501,279,44,235,210,76,68,16,40,26,35,29,6,751
"2011","Birmingham 079E","E01009283",1150,250,27,223,300,95,61,19,67,31,84,68,16,243
"2011","Birmingham 079F","E01033631",4484,428,38,390,332,123,131,27,81,43,82,72,10,3237
"2011","Birmingham 080A","E01009249",1087,100,20,80,242,165,75,83,173,117,64,36,28,68
"2011","Birmingham 080B","E01009250",1206,116,22,94,277,205,107,80,164,120,71,43,28,66
"2011","Birmingham 080C","E01009251",1110,148,28,120,311,181,95,73,94,90,41,26,15,77
"2011","Birmingham 080D","E01009253",1111,116,29,87,287,177,84,62,140,96,62,47,15,87
"2011","Birmingham 080E","E01009255",1082,68,7,61,215,156,83,72,173,135,87,56,31,93
"2011","Birmingham 080F","E01009257",1027,49,17,32,188,146,58,71,175,141,108,59,49,91
"2011","Birmingham 081A","E01009315",1160,54,8,46,189,165,97,118,217,179,84,52,32,57
"2011","Birmingham 081B","E01009316",1180,68,16,52,196,209,102,102,208,150,73,48,25,72
"2011","Birmingham 081C","E01009317",1176,65,18,47,171,177,50,117,232,177,102,54,48,85
"2011","Birmingham 081D","E01009318",1135,75,18,57,245,202,100,111,168,141,36,16,20,57
"2011","Birmingham 081E","E01009319",1215,95,22,73,247,204,107,121,185,131,44,26,18,81
"2011","Birmingham 081F","E01009320",1138,75,15,60,200,185,94,99,202,130,62,43,19,91
"2011","Birmingham 082A","E01009372",1143,24,3,21,93,81,86,54,130,114,368,326,42,193
"2011","Birmingham 082B","E01009373",1170,24,3,21,78,73,85,54,143,131,366,328,38,216
"2011","Birmingham 082D","E01009396",1451,38,3,35,121,97,125,63,203,137,433,392,41,234
"2011","Birmingham 082F","E01033643",1956,39,5,34,147,149,161,92,218,228,619,541,78,303
"2011","Birmingham 083A","E01009367",1106,33,3,30,88,83,94,51,148,148,320,275,45,141
"2011","Birmingham 083B","E01009375",1223,29,7,22,102,85,73,60,163,140,381,331,50,190
"2011","Birmingham 083C","E01009377",837,18,2,16,68,49,58,30,107,108,294,242,52,105
"2011","Birmingham 083D","E01009383",1031,62,11,51,122,82,65,47,118,94,253,220,33,188
"2011","Birmingham 083E","E01009399",978,29,2,27,69,75,72,47,109,86,308,267,41,183
"2011","Birmingham 084A","E01009366",1006,23,6,17,89,84,55,54,177,129,263,220,43,132
"2011","Birmingham 084B","E01009374",735,23,1,22,83,60,39,37,117,102,183,161,22,91
"2011","Birmingham 084C","E01009376",1086,41,7,34,120,74,76,54,128,114,289,250,39,190
"2011","Birmingham 084F","E01033648",1802,84,8,76,213,148,117,90,227,168,464,384,80,291
"2011","Birmingham 085A","E01009073",1013,34,4,30,112,85,46,55,192,142,231,170,61,116
"2011","Birmingham 085B","E01009074",1143,71,3,68,162,116,45,67,198,156,183,135,48,145
"2011","Birmingham 085C","E01009254",1111,86,12,74,208,130,72,87,179,134,85,63,22,130
"2011","Birmingham 085D","E01009256",1101,105,24,81,230,146,68,85,181,121,82,58,24,83
"2011","Birmingham 085E","E01009258",1045,30,4,26,167,125,51,84,188,197,116,71,45,87
"2011","Birmingham 087B","E01009071",1176,263,32,231,261,113,85,42,90,66,86,71,15,170
"2011","Birmingham 087C","E01009075",1266,145,13,132,190,73,65,54,116,122,108,69,39,393
"2011","Birmingham 087E","E01009078",1183,150,13,137,170,118,45,44,110,72,75,58,17,399
"2011","Birmingham 087F","E01033562",1992,305,23,282,277,155,87,72,164,136,170,116,54,626
"2011","Birmingham 088C","E01009183",1208,369,35,334,277,87,107,26,70,37,101,89,12,134
"2011","Birmingham 088D","E01009186",1268,312,48,264,339,117,101,47,95,57,93,70,23,107
"2011","Birmingham 088E","E01033645",2386,110,16,94,248,182,176,80,270,212,632,562,70,476
"2011","Birmingham 089A","E01008890",1239,89,18,71,224,164,109,84,198,162,111,81,30,98
"2011","Birmingham 089B","E01008891",1156,77,20,57,201,181,122,86,196,142,67,40,27,84
"2011","Birmingham 089C","E01008892",1089,47,4,43,150,124,73,72,183,169,162,126,36,109
"2011","Birmingham 089D","E01008893",1303,132,30,102,290,183,85,82,185,135,104,72,32,107
"2011","Birmingham 089E","E01008894",1000,75,9,66,176,121,74,64,175,138,95,64,31,82
"2011","Birmingham 089F","E01008895",1378,123,22,101,303,177,111,107,215,159,92,64,28,91
"2011","Birmingham 089G","E01009015",1270,117,17,100,202,166,74,99,206,172,120,89,31,114
"2011","Birmingham 090A","E01009014",1337,56,8,48,171,154,100,84,219,177,214,178,36,162
"2011","Birmingham 090B","E01009018",1215,86,15,71,203,147,99,76,203,173,129,95,34,99
"2011","Birmingham 090C","E01009026",1017,19,6,13,98,77,63,64,214,229,172,137,35,81
"2011","Birmingham 090D","E01009028",1111,34,8,26,115,103,84,85,209,201,195,151,44,85
"2011","Birmingham 090E","E01009029",992,49,7,42,135,128,70,58,175,140,142,114,28,95
"2011","Birmingham 092A","E01009182",1265,118,6,112,196,127,82,62,155,109,299,227,72,117
"2011","Birmingham 092B","E01009184",1269,281,39,242,336,140,104,40,71,88,94,62,32,115
"2011","Birmingham 092C","E01009187",1192,263,33,230,362,95,91,31,74,61,73,57,16,142
"2011","Birmingham 092D","E01009188",1163,243,35,208,350,108,97,27,86,78,82,59,23,92
"2011","Birmingham 092E","E01009384",1061,126,18,108,224,97,75,58,116,100,133,89,44,132
"2011","Birmingham 092F","E01009385",1026,174,19,155,257,103,70,60,96,45,144,111,33,77
"2011","Birmingham 093A","E01009185",1237,262,31,231,353,129,127,38,94,45,82,66,16,107
"2011","Birmingham 093B","E01009389",1264,85,13,72,164,99,114,43,135,126,291,254,37,207
"2011","Birmingham 093C","E01009390",1235,140,10,130,272,109,88,51,114,110,227,175,52,124
"2011","Birmingham 093D","E01009394",1333,225,30,195,320,151,132,54,112,71,155,131,24,113
"2011","Birmingham 094A","E01008918",1167,32,9,23,147,125,76,74,236,221,164,103,61,92
"2011","Birmingham 094B","E01008920",1025,62,13,49,189,192,55,104,176,127,48,33,15,72
"2011","Birmingham 094C","E01008921",1052,67,15,52,194,164,66,97,182,125,82,52,30,75
"2011","Birmingham 094D","E01008931",990,29,7,22,166,115,36,93,210,158,113,74,39,70
"2011","Birmingham 094E","E01009259",1104,27,6,21,167,134,51,74,205,186,167,103,64,93
"2011","Birmingham 095A","E01008919",1148,121,28,93,180,134,83,107,162,153,106,75,31,102
"2011","Birmingham 095B","E01009064",1055,84,9,75,190,126,83,77,179,129,86,58,28,101
"2011","Birmingham 095C","E01009077",1186,203,19,184,229,146,82,85,138,91,74,49,25,138
"2011","Birmingham 095D","E01009291",1090,102,14,88,194,136,58,70,155,143,124,79,45,108
"2011","Birmingham 095E","E01009500",1068,55,8,47,146,101,55,82,181,180,154,118,36,114
"2011","Birmingham 096A","E01009284",2060,70,4,66,146,101,41,42,123,80,81,57,24,1376
"2011","Birmingham 096C","E01009286",2075,55,4,51,67,32,15,17,28,28,29,19,10,1804
"2011","Birmingham 096E","E01009289",1993,25,3,22,63,38,12,15,67,39,47,33,14,1687
"2011","Birmingham 096F","E01009290",1922,20,2,18,54,32,27,11,30,43,26,21,5,1679
"2011","Birmingham 096G","E01033634",3871,37,4,33,66,47,22,24,68,57,59,44,15,3491
"2011","Birmingham 097A","E01009017",1120,64,9,55,131,120,90,65,176,159,161,139,22,154
"2011","Birmingham 097B","E01009043",1356,55,5,50,199,140,105,73,192,152,241,210,31,199
"2011","Birmingham 097C","E01009044",1051,58,4,54,132,103,102,40,148,88,224,197,27,156
"2011","Birmingham 097D","E01009045",1140,111,16,95,160,115,124,62,164,100,168,139,29,136
"2011","Birmingham 097E","E01009046",1240,158,21,137,266,164,112,52,140,100,125,109,16,123
"2011","Birmingham 097F","E01009395",1192,93,7,86,176,97,122,54,166,107,240,214,26,137
"2011","Birmingham 098A","E01009016",1076,49,8,41,146,113,69,83,214,200,113,86,27,89
"2011","Birmingham 098B","E01009022",1244,88,15,73,205,127,95,78,203,175,130,98,32,143
"2011","Birmingham 098C","E01009023",1139,110,21,89,237,167,116,57,186,92,84,68,16,90
"2011","Birmingham 098D","E01009030",1045,96,15,81,169,142,97,71,138,85,126,95,31,121
"2011","Birmingham 099A","E01009281",983,221,22,199,261,119,61,45,98,52,38,25,13,88
"2011","Birmingham 099B","E01009292",1265,194,25,169,270,144,83,65,127,88,59,38,21,235
"2011","Birmingham 099C","E01009294",1325,209,34,175,346,158,62,55,143,81,123,78,45,148
"2011","Birmingham 099D","E01009295",1371,156,26,130,234,129,57,45,102,76,71,50,21,501
"2011","Birmingham 100A","E01009280",983,156,25,131,192,108,53,56,107,76,48,37,11,187
"2011","Birmingham 100B","E01009282",1312,136,17,119,236,143,68,70,131,111,126,105,21,291
"2011","Birmingham 100C","E01009288",871,221,22,199,186,55,67,22,46,37,63,45,18,174
"2011","Birmingham 100D","E01009293",1210,136,17,119,197,121,63,37,105,88,77,63,14,386
"2011","Birmingham 100E","E01009296",1240,109,16,93,274,105,63,46,132,102,101,75,26,308
"2011","Birmingham 101A","E01008924",1000,95,22,73,222,158,69,96,129,98,73,55,18,60
"2011","Birmingham 101B","E01009501",1084,27,5,22,140,147,56,92,200,176,131,85,46,115
"2011","Birmingham 101C","E01009502",1015,44,11,33,149,133,55,70,199,183,116,77,39,66
"2011","Birmingham 101D","E01009503",1101,59,6,53,163,126,71,92,199,159,132,81,51,100
"2011","Birmingham 101E","E01009505",1112,67,15,52,184,131,62,72,203,153,125,81,44,115
"2011","Birmingham 102A","E01008917",1008,87,15,72,212,173,57,85,150,109,51,34,17,84
"2011","Birmingham 102B","E01008923",905,33,6,27,106,115,52,81,193,153,111,72,39,61
"2011","Birmingham 102C","E01008925",1035,69,21,48,225,197,60,87,156,121,46,33,13,74
"2011","Birmingham 102D","E01008927",1013,31,9,22,146,119,73,77,201,185,100,57,43,81
"2011","Birmingham 102E","E01008928",1025,34,7,27,127,123,59,101,224,186,100,66,34,71
"2011","Birmingham 103A","E01009019",1088,32,7,25,123,119,66,73,215,180,174,141,33,106
"2011","Birmingham 103B","E01009020",1076,60,9,51,139,118,59,95,193,193,113,85,28,106
"2011","Birmingham 103C","E01009021",1102,45,8,37,123,120,64,100,227,185,140,107,33,98
"2011","Birmingham 103D","E01009024",1086,48,5,43,115,106,71,108,215,179,146,106,40,98
"2011","Birmingham 103E","E01009025",1047,30,3,27,153,127,62,76,201,163,119,88,31,116
"2011","Birmingham 103F","E01009033",1202,72,15,57,153,146,93,84,204,175,183,138,45,92
"2011","Birmingham 104A","E01009175",1140,173,28,145,363,119,66,56,116,81,69,44,25,97
"2011","Birmingham 104B","E01009177",1179,191,27,164,361,147,67,55,114,60,100,88,12,84
"2011","Birmingham 104C","E01009178",1191,162,26,136,363,142,82,64,124,89,85,63,22,80
"2011","Birmingham 104D","E01009179",1255,172,19,153,343,148,103,56,124,91,97,75,22,121
"2011","Birmingham 104E","E01009189",1098,208,28,180,361,119,82,39,83,53,63,44,19,90
"2011","Birmingham 105A","E01008933",1104,92,19,73,219,147,89,58,153,108,109,85,24,129
"2011","Birmingham 105B","E01008934",997,127,16,111,214,158,114,52,114,66,77,65,12,75
"2011","Birmingham 105C","E01009031",1176,146,20,126,287,144,109,69,129,82,88,70,18,122
"2011","Birmingham 105D","E01009037",1160,145,27,118,273,169,125,68,145,89,64,55,9,82
"2011","Birmingham 105E","E01009176",1187,171,26,145,251,155,99,62,130,90,115,87,28,114
"2011","Birmingham 106C","E01008929",1005,42,13,29,140,135,51,81,187,160,126,89,37,83
"2011","Birmingham 106D","E01008930",1073,61,13,48,219,178,52,78,166,127,88,50,38,104
"2011","Birmingham 106E","E01009495",819,52,7,45,143,109,44,48,162,94,97,69,28,70
"2011","Birmingham 106F","E01033629",1875,74,26,48,227,231,108,129,325,248,179,113,66,354
"2011","Birmingham 107A","E01008953",1165,88,19,69,209,159,87,77,181,147,106,73,33,111
"2011","Birmingham 107B","E01008963",1003,94,17,77,202,114,63,70,187,115,70,52,18,88
"2011","Birmingham 107C","E01008964",1019,83,18,65,192,113,57,83,166,143,90,59,31,92
"2011","Birmingham 107D","E01008965",1123,141,22,119,286,139,87,74,154,103,60,42,18,79
"2011","Birmingham 107E","E01008966",1167,102,17,85,216,119,74,64,176,147,141,103,38,128
"2011","Birmingham 108A","E01009032",1258,112,23,89,248,161,119,91,166,124,100,75,25,137
"2011","Birmingham 108B","E01009034",1173,124,21,103,262,161,89,59,149,103,97,83,14,129
"2011","Birmingham 108C","E01009035",1278,109,19,90,253,185,118,65,169,135,118,97,21,126
"2011","Birmingham 108D","E01009036",1099,132,21,111,236,150,114,60,162,92,76,66,10,77
"2011","Birmingham 109A","E01009494",982,33,7,26,125,118,51,59,185,152,147,98,49,112
"2011","Birmingham 109B","E01009496",1052,103,18,85,244,171,67,81,144,103,54,37,17,85
"2011","Birmingham 109C","E01009497",1202,100,16,84,238,175,83,93,192,132,73,52,21,116
"2011","Birmingham 109D","E01009504",973,171,28,143,259,113,66,58,106,72,51,33,18,77
"2011","Birmingham 109E","E01009506",1075,173,25,148,279,149,74,59,130,70,41,28,13,100
"2011","Birmingham 110A","E01008967",1225,161,18,143,308,186,98,70,138,86,61,39,22,117
"2011","Birmingham 110B","E01008968",1183,183,30,153,363,151,101,49,113,73,53,38,15,97
"2011","Birmingham 110C","E01008970",1069,86,24,62,198,150,76,79,166,120,107,74,33,87
"2011","Birmingham 110D","E01008981",1111,191,36,155,316,124,102,46,97,67,77,56,21,91
"2011","Birmingham 111A","E01008932",1094,45,11,34,168,137,67,75,198,173,117,80,37,114
"2011","Birmingham 111B","E01008935",1131,41,10,31,149,118,86,79,201,160,206,152,54,91
"2011","Birmingham 111C","E01008936",1102,116,21,95,225,157,84,56,139,111,123,91,32,91
"2011","Birmingham 111D","E01008938",1094,31,6,25,137,116,79,65,221,175,150,104,46,120
"2011","Birmingham 111E","E01008939",1092,71,12,59,195,146,74,95,207,146,86,64,22,72
"2011","Birmingham 112A","E01008951",1001,205,37,168,308,108,59,32,103,62,36,20,16,88
"2011","Birmingham 112B","E01008952",1302,172,21,151,342,169,75,83,143,114,77,53,24,127
"2011","Birmingham 112C","E01008955",1200,187,24,163,299,169,81,69,147,101,38,30,8,109
"2011","Birmingham 112D","E01008956",1029,186,26,160,300,115,75,39,102,74,38,33,5,100
"2011","Birmingham 112E","E01008957",1277,122,14,108,270,192,68,81,189,143,109,67,42,103
"2011","Birmingham 113A","E01008950",1044,136,28,108,238,140,46,68,162,102,81,51,30,71
"2011","Birmingham 113B","E01008954",979,138,28,110,213,142,53,65,149,105,44,27,17,70
"2011","Birmingham 113C","E01008958",1099,84,24,60,195,163,64,87,206,116,91,60,31,93
"2011","Birmingham 113D","E01009493",1156,146,15,131,189,108,57,51,153,127,198,116,82,127
"2011","Birmingham 115A","E01008937",1028,55,13,42,191,121,65,79,182,121,112,78,34,102
"2011","Birmingham 115B","E01008940",996,50,11,39,146,116,67,69,177,161,125,87,38,85
"2011","Birmingham 115C","E01008941",1022,33,5,28,128,122,72,91,214,163,117,84,33,82
"2011","Birmingham 115D","E01008944",1216,70,12,58,204,165,72,116,214,174,122,85,37,79
"2011","Birmingham 116A","E01008959",1166,163,32,131,296,181,88,63,130,99,55,35,20,91
"2011","Birmingham 116B","E01008960",1169,198,31,167,357,128,88,50,126,82,41,26,15,99
"2011","Birmingham 116C","E01008961",1145,159,15,144,309,144,78,69,149,104,47,30,17,86
"2011","Birmingham 116D","E01008962",1345,83,19,64,226,166,79,88,223,190,152,91,61,138
"2011","Birmingham 117A","E01008942",1125,45,12,33,164,129,75,101,227,189,96,60,36,99
"2011","Birmingham 117B","E01008943",1053,45,8,37,164,114,82,74,203,161,137,110,27,73
"2011","Birmingham 117C","E01008969",1175,168,31,137,314,148,119,61,143,90,59,38,21,73
"2011","Birmingham 117D","E01008971",1226,128,24,104,271,188,108,91,149,92,84,55,29,115
"2011","Birmingham 118A","E01008972",1269,72,18,54,208,158,71,94,229,166,146,107,39,125
"2011","Birmingham 118B","E01008973",1410,113,23,90,312,194,122,111,219,159,85,59,26,95
"2011","Birmingham 118C","E01008974",2060,266,58,208,516,320,136,133,232,181,103,66,37,173
"2011","Birmingham 118D","E01008975",1159,110,26,84,286,186,81,90,151,117,76,58,18,62
"2011","Birmingham 119A","E01009172",965,25,5,20,142,121,32,72,216,163,103,62,41,91
"2011","Birmingham 119B","E01009173",1201,31,8,23,150,121,59,102,261,210,145,98,47,122
"2011","Birmingham 119C","E01009174",883,40,7,33,131,116,59,63,185,126,97,50,47,66
"2011","Birmingham 119D","E01009498",1152,32,5,27,150,129,66,77,233,209,166,114,52,90
"2011","Birmingham 119E","E01009499",1251,59,15,44,195,133,73,118,223,191,131,92,39,128
"2011","Birmingham 120A","E01009205",1107,127,28,99,280,192,70,75,153,91,42,26,16,77
"2011","Birmingham 120B","E01009206",1180,130,36,94,248,198,99,94,168,103,48,32,16,92
"2011","Birmingham 120C","E01009211",1164,117,24,93,280,216,98,91,166,88,43,21,22,65
"2011","Birmingham 120D","E01009218",1039,206,46,160,296,154,78,36,87,56,47,23,24,79
"2011","Birmingham 120E","E01009219",1071,79,18,61,210,165,76,71,176,106,88,61,27,100
"2011","Birmingham 121A","E01008976",1062,49,11,38,146,139,74,84,208,182,102,80,22,78
"2011","Birmingham 121B","E01008978",940,18,3,15,67,73,52,64,197,151,236,140,96,82
"2011","Birmingham 121C","E01008979",1148,40,9,31,149,125,65,104,254,210,125,81,44,76
"2011","Birmingham 121D","E01008980",1109,27,10,17,102,110,61,92,260,211,152,96,56,94
"2011","Birmingham 122A","E01008945",1320,69,13,56,202,189,82,116,255,210,90,54,36,107
"2011","Birmingham 122B","E01008946",1065,51,18,33,146,147,96,81,225,153,76,49,27,90
"2011","Birmingham 122C","E01008947",991,52,10,42,169,168,69,81,200,127,45,22,23,80
"2011","Birmingham 122D","E01008948",1050,74,21,53,187,172,113,96,176,152,33,22,11,47
"2011","Birmingham 122E","E01008949",949,86,17,69,204,159,72,88,167,83,29,15,14,61
"2011","Birmingham 123A","E01008977",1154,87,19,68,226,159,86,78,208,140,93,58,35,77
"2011","Birmingham 123B","E01009109",815,29,6,23,87,65,39,75,146,108,173,117,56,93
"2011","Birmingham 123C","E01009119",1042,99,20,79,242,180,87,72,135,97,59,32,27,71
"2011","Birmingham 123D","E01009120",1043,79,19,60,200,177,65,97,176,123,69,45,24,57
"2011","Birmingham 124A","E01009162",1172,76,12,64,245,210,86,90,188,141,58,36,22,78
"2011","Birmingham 124B","E01009207",1215,90,15,75,276,213,95,99,180,139,47,30,17,76
"2011","Birmingham 124C","E01009208",1126,99,22,77,246,205,76,89,199,109,28,16,12,75
"2011","Birmingham 124D","E01009209",1583,117,29,88,347,257,106,107,257,186,91,62,29,115
"2011","Birmingham 124E","E01009213",1088,67,15,52,178,176,89,91,198,134,74,48,26,81
"2011","Birmingham 125B","E01009155",1006,31,6,25,135,109,51,94,209,187,134,87,47,56
"2011","Birmingham 125D","E01009157",1075,43,11,32,128,131,66,84,193,214,123,93,30,93
"2011","Birmingham 125E","E01009160",1124,22,9,13,122,126,56,70,257,188,199,114,85,84
"2011","Birmingham 125F","E01009161",1032,46,12,34,169,155,57,73,215,166,92,62,30,59
"2011","Birmingham 125G","E01033633",1689,62,24,38,270,177,69,138,310,290,235,162,73,138
"2011","Birmingham 126A","E01009117",1281,45,8,37,146,177,69,81,245,180,205,142,63,133
"2011","Birmingham 126B","E01009210",1334,73,15,58,238,225,88,93,241,147,109,66,43,120
"2011","Birmingham 126C","E01009212",1183,46,11,35,171,174,101,84,254,155,107,71,36,91
"2011","Birmingham 126D","E01009214",1154,46,7,39,158,152,54,98,228,186,144,84,60,88
"2011","Birmingham 126E","E01009215",1217,41,9,32,164,158,57,108,239,186,187,106,81,77
"2011","Birmingham 127A","E01009108",960,99,27,72,193,155,79,69,151,97,52,29,23,65
"2011","Birmingham 127B","E01009111",1069,78,18,60,222,175,87,89,159,115,62,38,24,82
"2011","Birmingham 127C","E01009112",997,64,18,46,181,150,99,87,155,120,85,55,30,56
"2011","Birmingham 127D","E01009116",1023,187,32,155,298,143,81,46,88,54,48,38,10,78
"2011","Birmingham 127E","E01009118",1110,94,28,66,209,178,75,106,176,118,80,60,20,74
"2011","Birmingham 128A","E01009107",1186,55,15,40,156,121,97,89,194,178,200,133,67,96
"2011","Birmingham 128B","E01009110",1134,57,7,50,182,141,65,84,200,176,124,78,46,105
"2011","Birmingham 128C","E01009113",970,27,5,22,116,110,50,77,191,197,130,87,43,72
"2011","Birmingham 128D","E01009114",1124,39,13,26,150,139,79,77,226,196,137,91,46,81
"2011","Birmingham 128E","E01009115",1027,52,13,39,147,108,83,70,199,173,104,63,41,91
"2011","Birmingham 129A","E01009158",1326,110,29,81,252,189,82,113,206,145,146,90,56,83
"2011","Birmingham 129B","E01009163",1053,64,20,44,191,133,74,75,174,155,99,51,48,88
"2011","Birmingham 129C","E01009165",969,52,8,44,172,133,57,82,179,134,93,55,38,67
"2011","Birmingham 129D","E01009169",1167,75,22,53,201,167,101,117,215,141,61,40,21,89
"2011","Birmingham 130A","E01009159",1301,147,39,108,332,199,83,97,170,113,65,46,19,95
"2011","Birmingham 130B","E01009164",1088,71,23,48,243,161,79,78,186,129,69,37,32,72
"2011","Birmingham 130C","E01009167",1101,62,16,46,206,177,80,95,211,129,58,34,24,83
"2011","Birmingham 130D","E01009171",1120,80,13,67,226,149,94,86,176,131,92,45,47,86
"2011","Birmingham 131A","E01009166",946,43,9,34,186,169,46,71,177,135,62,33,29,57
"2011","Birmingham 131B","E01009168",1124,73,19,54,215,188,88,124,172,164,39,20,19,61
"2011","Birmingham 131C","E01009170",1095,68,24,44,227,193,72,108,182,142,24,17,7,79
"2011","Birmingham 131D","E01009216",1417,94,23,71,266,218,100,122,257,153,93,66,27,114
"2011","Birmingham 131E","E01009217",1203,79,23,56,241,199,86,108,220,152,33,14,19,85
"2011","Birmingham 132A","E01009039",1214,128,19,109,287,192,132,60,180,82,51,40,11,102
"2011","Birmingham 132B","E01009040",1234,156,33,123,303,192,132,73,136,68,68,52,16,106
"2011","Birmingham 132C","E01009041",1182,122,27,95,254,211,95,65,188,109,62,43,19,76
"2011","Birmingham 132D","E01009042",996,97,13,84,203,170,78,82,141,117,49,24,25,59
"2011","Birmingham 132E","E01032589",987,100,17,83,220,133,80,69,140,92,66,46,20,87
"2011","Birmingham 133A","E01009262",1329,153,26,127,270,186,142,51,141,103,115,90,25,168
"2011","Birmingham 133B","E01009267",1285,131,29,102,216,150,144,78,162,158,111,82,29,135
"2011","Birmingham 133C","E01009276",1184,94,21,73,216,166,120,54,166,129,106,82,24,133
"2011","Birmingham 133D","E01009278",1269,138,18,120,278,158,111,54,146,130,80,55,25,174
"2011","Birmingham 133E","E01009279",1091,126,14,112,214,153,102,43,134,80,110,85,25,129
"2011","Birmingham 133F","E01032591",1228,113,22,91,208,149,133,66,178,137,107,83,24,137
"2011","Birmingham 134A","E01008995",1414,58,9,49,145,94,55,65,153,165,188,116,72,491
"2011","Birmingham 134B","E01033557",1995,346,32,314,325,135,36,38,61,39,43,27,16,972
"2011","Birmingham 134C","E01033624",786,111,11,100,195,84,22,37,69,46,66,40,26,156
"2011","Birmingham 134D","E01033626",862,131,6,125,178,87,32,31,76,51,80,56,24,196
"2011","Birmingham 134E","E01033640",885,45,2,43,104,87,43,56,127,123,179,119,60,121
"2011","Birmingham 135A","E01009378",1650,157,23,134,374,170,66,104,196,155,201,137,64,227
"2011","Birmingham 135B","E01033567",1125,208,17,191,222,87,31,47,53,24,49,34,15,404
"2011","Birmingham 135C","E01033615",970,227,22,205,214,82,38,29,34,23,32,19,13,291
"2011","Birmingham 135D","E01033616",934,97,11,86,153,81,32,54,109,123,121,55,66,164
"2011","Birmingham 136A","E01009143",978,34,5,29,66,64,47,55,143,166,241,149,92,162
"2011","Birmingham 136B","E01009146",1730,66,11,55,159,100,57,83,176,149,207,114,93,733
"2011","Birmingham 136C","E01033564",1136,281,20,261,253,107,47,44,55,43,54,42,12,252
"2011","Birmingham 136D","E01033639",1351,114,19,95,221,111,49,96,175,127,204,147,57,254
"2011","Birmingham 137A","E01009141",1258,62,15,47,134,112,71,106,215,185,220,163,57,153
"2011","Birmingham 137B","E01033565",993,245,31,214,285,111,44,40,36,21,30,14,16,181
"2011","Birmingham 137C","E01033618",1128,429,46,383,298,80,47,28,39,20,35,25,10,152
"2011","Birmingham 137D","E01033619",989,268,35,233,265,82,39,32,60,45,63,44,19,135
"2011","Birmingham 137E","E01033627",842,128,18,110,161,55,40,49,94,75,104,77,27,136
"2011","Birmingham 138A","E01033620",985,192,18,174,181,63,22,30,43,36,32,17,15,386
"2011","Birmingham 138B","E01033622",1641,361,40,321,376,123,71,46,72,48,61,34,27,483
"2011","Birmingham 138C","E01033623",1080,219,27,192,289,101,54,41,78,55,61,28,33,182
"2011","Birmingham 138D","E01033625",1632,509,43,466,369,103,63,30,50,22,46,41,5,440
"2011","Birmingham 139A","E01009200",1179,54,7,47,131,109,85,51,159,151,268,200,68,171
"2011","Birmingham 139B","E01009327",946,23,4,19,66,76,87,36,122,99,293,277,16,144
"2011","Birmingham 139C","E01009328",1508,44,3,41,109,109,138,60,174,119,520,461,59,235
"2011","Birmingham 139D","E01009331",1327,39,3,36,90,99,117,63,178,156,373,341,32,212
"2011","Birmingham 139E","E01009332",1102,26,1,25,74,89,80,70,154,146,298,251,47,165
"2011","Birmingham 139F","E01009333",969,22,2,20,46,61,91,49,114,118,312,274,38,156
"2011","Birmingham 139G","E01009335",1185,29,5,24,86,111,117,62,152,125,332,302,30,171
"2011","Birmingham 139H","E01009344",958,19,2,17,62,79,65,42,125,133,269,240,29,164
"2011","Birmingham 140A","E01009339",944,36,7,29,65,78,70,40,137,136,252,212,40,130
"2011","Birmingham 140B","E01009340",1766,53,8,45,196,191,112,134,316,265,323,276,47,176
"2011","Birmingham 140C","E01009382",1225,31,7,24,90,91,106,53,160,122,373,327,46,199
"2011","Birmingham 140D","E01009391",1041,38,5,33,79,87,93,60,167,150,240,209,31,127
"2011","Birmingham 140E","E01009392",1218,58,9,49,125,127,115,44,154,101,287,260,27,207
"2011","Birmingham 140F","E01009393",1001,35,6,29,94,86,75,45,146,125,256,219,37,139
"2011","Birmingham 140G","E01033641",2099,73,9,64,181,186,177,117,299,277,501,431,70,288
"2011","Coventry 001A","E01009589",1038,48,12,36,169,142,78,95,185,173,71,47,24,77
"2011","Coventry 001F","E01032536",1417,104,27,77,228,203,108,108,235,246,93,69,24,92
"2011","Coventry 001G","E01032537",1449,91,16,75,222,208,83,136,259,249,97,74,23,104
"2011","Coventry 001H","E01032538",1584,79,11,68,255,202,112,117,299,252,153,114,39,115
"2011","Coventry 002A","E01009590",953,66,22,44,191,128,95,83,137,130,44,35,9,79
"2011","Coventry 002B","E01009591",1117,78,16,62,177,176,60,120,178,172,65,48,17,91
"2011","Coventry 002C","E01009593",1191,55,9,46,166,159,92,111,229,230,71,51,20,78
"2011","Coventry 002D","E01009598",1165,79,13,66,181,183,75,94,236,177,44,29,15,96
"2011","Coventry 004A","E01009604",1032,49,10,39,134,138,76,93,208,161,73,51,22,100
"2011","Coventry 004B","E01009605",1057,39,12,27,105,112,43,90,210,225,145,99,46,88
"2011","Coventry 004C","E01009607",1097,23,4,19,107,103,42,66,244,257,180,116,64,75
"2011","Coventry 004D","E01009608",1080,37,8,29,132,131,68,98,234,206,91,59,32,83
"2011","Coventry 004E","E01009610",1040,28,10,18,113,115,74,92,218,204,101,67,34,95
"2011","Coventry 005A","E01009564",1079,34,6,28,103,99,64,79,176,204,203,161,42,117
"2011","Coventry 005B","E01009575",882,34,5,29,105,100,45,45,175,168,129,87,42,81
"2011","Coventry 005C","E01009606",999,45,12,33,133,113,68,75,212,203,84,67,17,66
"2011","Coventry 005D","E01009609",1044,27,5,22,114,113,65,61,204,211,135,99,36,114
"2011","Coventry 006A","E01009524",1013,78,17,61,206,140,65,98,167,135,55,44,11,69
"2011","Coventry 006B","E01009525",1001,65,13,52,190,144,89,97,156,149,31,23,8,80
"2011","Coventry 006C","E01009527",1163,83,27,56,228,180,85,109,187,160,46,32,14,85
"2011","Coventry 006D","E01009594",1020,82,16,66,205,161,69,91,168,133,41,24,17,70
"2011","Coventry 007A","E01009577",845,25,5,20,69,62,28,50,178,187,146,107,39,100
"2011","Coventry 007B","E01009579",1104,21,5,16,104,81,52,69,238,248,185,141,44,106
"2011","Coventry 007C","E01009581",1037,29,6,23,110,108,51,77,224,207,123,93,30,108
"2011","Coventry 007D","E01009584",978,46,18,28,156,140,102,72,156,168,78,50,28,60
"2011","Coventry 007E","E01009585",655,4,0,4,31,53,21,44,151,131,137,106,31,83
"2011","Coventry 007F","E01009709",675,19,8,11,46,39,27,50,119,162,124,82,42,89
"2011","Coventry 008A","E01009576",1149,90,14,76,245,177,78,99,168,155,67,46,21,70
"2011","Coventry 008B","E01009578",1112,133,25,108,261,178,97,88,160,99,34,23,11,62
"2011","Coventry 008C","E01009582",1258,131,36,95,252,196,76,103,178,174,57,39,18,91
"2011","Coventry 008D","E01009583",1139,100,20,80,252,141,69,94,196,130,60,44,16,97
"2011","Coventry 008E","E01009586",1210,77,19,58,232,173,75,113,196,187,56,30,26,101
"2011","Coventry 009A","E01009565",1079,33,4,29,96,100,119,37,139,180,242,222,20,133
"2011","Coventry 009B","E01009566",1074,40,7,33,98,82,63,79,186,153,199,168,31,174
"2011","Coventry 009C","E01009567",1236,43,8,35,97,81,98,56,202,226,272,231,41,161
"2011","Coventry 009D","E01009568",1195,39,3,36,89,120,97,57,172,215,233,189,44,173
"2011","Coventry 010A","E01009523",1128,144,42,102,265,174,187,66,113,77,20,12,8,82
"2011","Coventry 010B","E01009526",1126,124,31,93,295,196,90,75,123,80,47,32,15,96
"2011","Coventry 010C","E01009528",1137,133,42,91,270,200,105,93,141,91,26,13,13,78
"2011","Coventry 010D","E01009531",1069,116,30,86,230,190,98,85,142,92,37,27,10,79
"2011","Coventry 011A","E01009587",1073,43,10,33,129,116,84,88,189,207,107,85,22,110
"2011","Coventry 011B","E01009624",1140,44,4,40,132,141,74,90,253,188,102,77,25,116
"2011","Coventry 011C","E01009625",1659,141,31,110,240,210,135,121,267,255,123,95,28,167
"2011","Coventry 011D","E01009626",1162,72,21,51,175,155,76,101,223,182,77,61,16,101
"2011","Coventry 012A","E01009622",1175,36,6,30,162,142,51,98,227,223,137,94,43,99
"2011","Coventry 012B","E01009623",1097,46,7,39,138,147,70,91,223,184,102,63,39,96
"2011","Coventry 012C","E01009627",1158,46,7,39,150,159,73,78,231,211,117,75,42,93
"2011","Coventry 012D","E01009628",1079,77,15,62,168,137,88,78,183,160,71,43,28,117
"2011","Coventry 013A","E01009599",901,30,9,21,107,111,48,84,211,195,63,45,18,52
"2011","Coventry 013B","E01009663",990,61,11,50,141,160,83,82,185,157,54,38,16,67
"2011","Coventry 013C","E01009710",1028,81,17,64,214,166,71,93,173,115,33,19,14,82
"2011","Coventry 013D","E01009711",946,56,12,44,141,142,46,97,169,172,54,35,19,69
"2011","Coventry 014A","E01009522",981,75,16,59,184,146,69,82,175,140,46,29,17,64
"2011","Coventry 014B","E01009529",1135,75,17,58,234,171,78,118,188,124,34,14,20,113
"2011","Coventry 014C","E01009530",983,88,27,61,217,181,84,78,124,103,31,20,11,77
"2011","Coventry 014D","E01009645",1065,80,17,63,210,164,93,91,172,126,43,28,15,86
"2011","Coventry 015A","E01009569",896,30,5,25,78,79,39,55,162,185,158,129,29,110
"2011","Coventry 015B","E01009570",1265,50,7,43,81,94,94,74,218,205,282,240,42,167
"2011","Coventry 015C","E01009571",1074,21,2,19,73,71,67,67,186,221,230,177,53,138
"2011","Coventry 015D","E01009572",1452,31,3,28,106,114,98,81,209,246,337,266,71,230
"2011","Coventry 015E","E01009573",1063,29,3,26,78,88,70,58,150,180,235,197,38,175
"2011","Coventry 015F","E01009574",1086,22,3,19,77,73,84,61,152,171,254,208,46,192
"2011","Coventry 016A","E01009655",1309,66,12,54,174,167,52,88,226,268,124,76,48,144
"2011","Coventry 016B","E01009656",1156,47,12,35,127,114,81,103,212,253,104,73,31,115
"2011","Coventry 016C","E01009659",1278,27,6,21,121,104,73,81,224,258,164,116,48,226
"2011","Coventry 016D","E01009662",1115,68,7,61,160,130,72,68,216,193,116,77,39,92
"2011","Coventry 016E","E01009664",1077,30,7,23,147,159,84,79,216,194,68,47,21,100
"2011","Coventry 017A","E01009643",1086,103,19,84,253,176,96,107,126,117,30,15,15,78
"2011","Coventry 017B","E01009644",1214,114,28,86,257,201,92,104,166,140,41,25,16,99
"2011","Coventry 017C","E01009647",1272,108,22,86,268,192,109,85,180,141,60,43,17,129
"2011","Coventry 017D","E01009648",1103,113,21,92,268,161,106,76,156,117,29,20,9,77
"2011","Coventry 017E","E01009652",993,110,25,85,210,165,84,92,143,97,29,14,15,63
"2011","Coventry 017F","E01009653",1063,85,18,67,249,190,72,104,148,122,28,11,17,65
"2011","Coventry 018A","E01009613",968,80,18,62,161,165,69,71,153,130,39,27,12,100
"2011","Coventry 018B","E01009657",1228,68,12,56,218,175,90,104,209,171,61,44,17,132
"2011","Coventry 018C","E01009712",1117,74,15,59,229,173,83,82,189,152,47,31,16,88
"2011","Coventry 018D","E01009714",1075,63,17,46,181,179,67,86,204,150,41,25,16,104
"2011","Coventry 018E","E01009716",1185,73,16,57,212,188,90,91,221,158,53,33,20,99
"2011","Coventry 019A","E01009580",873,92,12,80,182,115,63,90,133,113,36,23,13,49
"2011","Coventry 019B","E01009713",1008,51,13,38,183,161,69,100,167,141,54,30,24,82
"2011","Coventry 019C","E01009715",1003,89,14,75,189,161,45,69,145,156,61,36,25,88
"2011","Coventry 019D","E01009717",1087,130,26,104,236,170,89,74,150,128,40,23,17,70
"2011","Coventry 019E","E01009718",1237,52,11,41,163,134,43,113,225,259,137,80,57,111
"2011","Coventry 020A","E01009629",2052,160,18,142,307,201,145,116,280,295,226,178,48,322
"2011","Coventry 020B","E01009630",1219,75,15,60,169,123,54,90,223,186,124,92,32,175
"2011","Coventry 020C","E01009631",968,30,9,21,124,88,45,79,194,178,83,48,35,147
"2011","Coventry 020D","E01009632",1368,72,7,65,180,134,40,79,189,190,174,131,43,310
"2011","Coventry 020E","E01009650",1427,72,8,64,155,111,59,58,153,133,91,53,38,595
"2011","Coventry 021A","E01009614",1041,62,13,49,226,174,88,86,144,126,44,31,13,91
"2011","Coventry 021B","E01009654",1268,66,12,54,234,209,74,124,222,174,63,38,25,102
"2011","Coventry 021C","E01009658",1126,60,8,52,210,139,86,100,170,179,82,56,26,100
"2011","Coventry 021D","E01009660",1322,71,13,58,151,142,104,79,198,229,108,82,26,240
"2011","Coventry 022A","E01009646",1113,122,24,98,252,180,88,97,151,101,36,25,11,86
"2011","Coventry 022B","E01009692",861,89,22,67,179,149,50,90,118,97,32,22,10,57
"2011","Coventry 022C","E01009693",1052,90,17,73,243,188,61,81,181,122,33,20,13,53
"2011","Coventry 022D","E01009694",974,97,23,74,213,175,80,90,142,76,21,11,10,80
"2011","Coventry 023A","E01009695",1093,116,23,93,259,225,81,108,152,84,17,8,9,51
"2011","Coventry 023B","E01009696",1095,106,21,85,248,215,95,103,164,81,27,13,14,56
"2011","Coventry 023C","E01009704",1186,191,53,138,276,197,77,98,143,95,26,14,12,83
"2011","Coventry 023D","E01009705",1115,152,40,112,250,201,96,93,137,88,22,15,7,76
"2011","Coventry 024A","E01009636",1770,67,9,58,146,128,94,100,231,259,181,146,35,564
"2011","Coventry 024B","E01009637",963,23,4,19,46,68,60,55,136,147,249,213,36,179
"2011","Coventry 024C","E01009638",1075,19,2,17,81,57,61,56,132,211,282,215,67,176
"2011","Coventry 024D","E01009639",1195,56,5,51,94,77,70,73,171,208,258,224,34,188
"2011","Coventry 024E","E01009640",1242,28,3,25,83,96,51,79,192,233,237,191,46,243
"2011","Coventry 024F","E01009641",2501,46,8,38,102,74,43,57,162,200,198,155,43,1619
"2011","Coventry 025A","E01009697",1076,112,27,85,220,207,76,99,168,111,25,13,12,58
"2011","Coventry 025B","E01009698",1133,132,39,93,247,217,84,87,150,106,22,8,14,88
"2011","Coventry 025C","E01009703",1928,277,58,219,447,286,112,149,223,182,98,67,31,154
"2011","Coventry 025D","E01009706",1080,109,24,85,242,198,86,87,160,95,31,20,11,72
"2011","Coventry 026A","E01009649",1016,108,20,88,223,161,77,73,125,88,38,28,10,123
"2011","Coventry 026B","E01009684",1055,65,14,51,164,141,63,96,168,179,71,46,25,108
"2011","Coventry 026C","E01009685",1221,96,17,79,285,194,93,100,178,136,39,29,10,100
"2011","Coventry 026D","E01009686",1239,168,29,139,280,163,109,98,140,101,35,22,13,145
"2011","Coventry 026E","E01009687",1073,132,26,106,260,155,65,67,141,95,36,19,17,122
"2011","Coventry 027A","E01009615",1363,129,21,108,253,126,71,83,147,187,70,53,17,297
"2011","Coventry 027B","E01009616",1139,70,10,60,235,145,61,79,176,168,55,38,17,150
"2011","Coventry 027C","E01009617",913,70,18,52,185,136,79,72,123,99,54,29,25,95
"2011","Coventry 027D","E01009618",1121,107,21,86,234,163,86,101,150,144,45,28,17,91
"2011","Coventry 027E","E01009620",1019,91,26,65,190,122,79,75,176,158,51,37,14,77
"2011","Coventry 027F","E01009621",981,63,11,52,147,121,47,82,162,186,66,49,17,107
"2011","Coventry 028A","E01009633",1425,46,3,43,121,107,60,81,174,200,116,87,29,520
"2011","Coventry 028B","E01009634",1387,46,8,38,127,114,60,63,146,173,81,55,26,577
"2011","Coventry 028C","E01009635",2935,39,4,35,131,94,50,57,176,170,133,93,40,2085
"2011","Coventry 028D","E01009661",1473,48,10,38,151,124,66,77,199,254,123,75,48,431
"2011","Coventry 029A","E01009674",1180,81,11,70,134,132,74,86,198,172,102,53,49,201
"2011","Coventry 029B","E01009699",1005,92,17,75,181,174,73,96,165,128,51,37,14,45
"2011","Coventry 029C","E01009700",1212,47,10,37,107,132,62,104,254,262,148,88,60,96
"2011","Coventry 029D","E01009701",1091,86,18,68,194,128,61,95,197,179,80,43,37,71
"2011","Coventry 029E","E01009702",1039,60,13,47,138,121,51,89,190,167,120,74,46,103
"2011","Coventry 030A","E01009688",1231,95,20,75,188,91,65,52,119,90,73,47,26,458
"2011","Coventry 030B","E01009689",1295,97,18,79,233,130,61,74,129,90,53,30,23,428
"2011","Coventry 030C","E01009690",1235,139,29,110,230,102,62,45,111,92,51,28,23,403
"2011","Coventry 030D","E01009691",1178,119,6,113,224,114,52,58,112,83,34,24,10,382
"2011","Coventry 031A","E01009548",1843,257,43,214,331,160,112,88,157,126,100,72,28,512
"2011","Coventry 031B","E01009553",1888,76,11,65,174,85,39,46,90,69,84,59,25,1225
"2011","Coventry 031C","E01009642",2580,101,7,94,132,77,42,50,105,103,117,84,33,1853
"2011","Coventry 031D","E01009651",1318,52,8,44,130,86,52,58,226,249,170,106,64,295
"2011","Coventry 032A","E01009676",1110,87,14,73,223,160,80,91,171,139,40,28,12,119
"2011","Coventry 032B","E01009681",964,94,23,71,174,132,82,95,129,107,40,24,16,111
"2011","Coventry 032C","E01009682",1141,92,22,70,218,155,98,125,185,121,26,15,11,121
"2011","Coventry 032D","E01009683",979,60,12,48,166,141,46,66,181,154,42,27,15,123
"2011","Coventry 033A","E01009532",967,90,16,74,200,171,58,90,173,106,29,19,10,50
"2011","Coventry 033B","E01009535",962,62,11,51,180,175,65,98,178,128,27,17,10,49
"2011","Coventry 033C","E01009536",1071,96,21,75,218,186,94,85,179,120,24,22,2,69
"2011","Coventry 033D","E01009543",1338,225,55,170,325,230,119,86,134,84,39,24,15,96
"2011","Coventry 033E","E01009707",1358,165,23,142,334,226,100,118,175,119,34,19,15,87
"2011","Coventry 033F","E01009708",1104,81,7,74,229,168,78,94,200,154,36,20,16,64
"2011","Coventry 034A","E01009554",1018,166,28,138,301,117,49,47,76,54,31,23,8,177
"2011","Coventry 034B","E01009555",1116,197,44,153,289,130,98,63,100,73,27,18,9,139
"2011","Coventry 034C","E01009556",1226,200,29,171,304,125,78,50,81,85,57,45,12,246
"2011","Coventry 034D","E01009557",1016,208,46,162,301,120,103,41,64,29,29,21,8,121
"2011","Coventry 034E","E01009558",1201,205,24,181,362,119,80,44,95,58,37,25,12,201
"2011","Coventry 034F","E01009559",972,204,35,169,280,83,81,26,54,36,26,19,7,182
"2011","Coventry 035C","E01009537",1028,64,13,51,153,144,54,85,219,141,82,55,27,86
"2011","Coventry 035D","E01009538",1033,40,9,31,145,145,52,99,200,188,91,65,26,73
"2011","Coventry 035E","E01009611",1376,85,15,70,159,112,63,76,223,287,197,143,54,174
"2011","Coventry 035F","E01009612",965,39,4,35,78,106,51,61,186,210,124,85,39,110
"2011","Coventry 035G","E01032527",1130,71,18,53,139,150,69,98,227,186,93,60,33,97
"2011","Coventry 035H","E01032528",1101,56,10,46,174,140,46,91,206,191,82,63,19,115
"2011","Coventry 036C","E01009679",1073,39,6,33,88,81,46,67,176,184,115,81,34,277
"2011","Coventry 036E","E01032531",1733,62,10,52,196,159,88,134,331,347,205,135,70,211
"2011","Coventry 036F","E01032532",951,110,27,83,205,129,91,71,126,76,34,22,12,109
"2011","Coventry 036G","E01032533",1399,327,55,272,323,175,128,60,95,65,43,29,14,183
"2011","Coventry 037B","E01009549",1194,164,28,136,309,164,98,74,119,95,39,27,12,132
"2011","Coventry 037C","E01009550",1399,133,18,115,305,188,105,99,187,147,70,56,14,165
"2011","Coventry 037E","E01009552",1107,116,22,94,228,144,83,74,175,134,62,49,13,91
"2011","Coventry 037F","E01032534",1302,101,13,88,197,152,94,85,237,173,157,122,35,106
"2011","Coventry 037G","E01032535",874,128,20,108,197,135,52,75,101,83,35,25,10,68
"2011","Coventry 038A","E01009544",1122,123,25,98,197,144,91,73,178,165,80,54,26,71
"2011","Coventry 038D","E01009619",1491,106,13,93,227,155,54,83,202,233,117,84,33,314
"2011","Coventry 038E","E01032529",972,76,11,65,144,158,52,102,179,160,55,37,18,46
"2011","Coventry 038F","E01032530",1333,121,27,94,288,223,101,120,194,141,52,35,17,93
"2011","Coventry 039A","E01009539",1092,26,4,22,79,104,53,91,233,284,150,90,60,72
"2011","Coventry 039B","E01009540",1236,31,7,24,121,91,55,90,249,261,206,139,67,132
"2011","Coventry 039C","E01009541",1180,55,15,40,156,152,64,117,238,203,108,61,47,87
"2011","Coventry 039D","E01009542",1288,61,12,49,125,113,71,124,238,257,203,135,68,96
"2011","Coventry 040A","E01009560",1097,219,43,176,299,181,93,50,96,55,20,11,9,84
"2011","Coventry 040B","E01009561",1106,130,25,105,250,181,86,77,139,109,53,33,20,81
"2011","Coventry 040C","E01009562",1154,161,32,129,276,217,74,63,132,94,58,44,14,79
"2011","Coventry 040D","E01009563",1138,196,29,167,320,171,99,72,95,74,21,11,10,90
"2011","Coventry 040E","E01009672",1454,252,43,209,376,224,128,80,148,95,36,27,9,115
"2011","Coventry 041A","E01009666",933,151,32,119,232,159,67,44,88,81,16,9,7,95
"2011","Coventry 041B","E01009667",945,121,18,103,237,155,89,60,110,72,31,23,8,70
"2011","Coventry 041C","E01009668",1150,132,30,102,270,202,90,67,130,83,33,26,7,143
"2011","Coventry 041D","E01009670",1166,168,39,129,281,202,106,73,120,90,31,21,10,95
"2011","Coventry 042A","E01009665",882,167,28,139,214,104,83,35,72,53,21,18,3,133
"2011","Coventry 042B","E01009669",914,145,24,121,240,135,67,51,110,48,27,17,10,91
"2011","Coventry 042C","E01009671",3896,227,25,202,238,107,130,28,58,35,49,37,12,3024
"2011","Coventry 042F","E01033058",2215,179,26,153,261,178,104,83,149,147,102,82,20,1012
"2011","Coventry 043A","E01009588",1055,34,14,20,120,133,57,81,224,230,90,65,25,86
"2011","Coventry 043B","E01009592",1124,41,13,28,131,155,59,85,234,237,117,85,32,65
"2011","Coventry 043C","E01009596",1079,53,14,39,131,98,79,84,199,196,114,83,31,125
"2011","Coventry 043D","E01009597",1235,68,16,52,163,157,89,78,241,204,108,75,33,127
"2011","Coventry 043E","E01032587",1226,66,15,51,178,152,62,80,261,211,109,76,33,107
"2011","Dudley 001A","E01009763",1295,48,12,36,175,170,89,96,278,220,131,82,49,88
"2011","Dudley 001B","E01009764",1109,74,28,46,149,169,92,93,223,176,56,31,25,77
"2011","Dudley 001C","E01009767",1030,37,16,21,165,121,79,96,200,216,67,28,39,49
"2011","Dudley 001D","E01009769",1084,23,8,15,108,100,55,96,257,229,145,88,57,71
"2011","Dudley 001E","E01009770",1054,53,21,32,135,131,83,96,217,194,78,50,28,67
"2011","Dudley 002A","E01009773",1071,62,18,44,148,162,89,88,181,193,69,43,26,79
"2011","Dudley 002B","E01009777",1060,64,18,46,148,117,75,100,215,203,61,26,35,77
"2011","Dudley 002C","E01009778",1122,86,22,64,205,165,118,99,191,137,39,24,15,82
"2011","Dudley 002D","E01009895",994,94,29,65,196,151,83,71,171,115,59,35,24,54
"2011","Dudley 003A","E01009896",1059,114,24,90,242,186,76,90,154,87,40,22,18,70
"2011","Dudley 003B","E01009897",1024,121,41,80,247,216,83,66,121,79,18,11,7,73
"2011","Dudley 003C","E01009898",1063,124,46,78,229,189,91,80,138,102,31,16,15,79
"2011","Dudley 003D","E01009901",1028,92,30,62,271,199,98,65,126,93,31,21,10,53
"2011","Dudley 003E","E01009902",988,123,38,85,244,191,69,74,128,92,19,11,8,48
"2011","Dudley 004A","E01009765",1190,75,29,46,191,198,87,118,230,170,47,27,20,74
"2011","Dudley 004B","E01009766",1184,61,21,40,172,165,84,108,242,213,70,37,33,69
"2011","Dudley 004C","E01009768",975,53,10,43,164,156,92,79,170,129,57,35,22,75
"2011","Dudley 004D","E01009771",924,65,10,55,171,154,68,111,160,129,21,9,12,45
"2011","Dudley 004E","E01009775",1130,57,18,39,168,132,82,83,217,207,100,69,31,84
"2011","Dudley 004F","E01009776",1095,67,25,42,199,163,96,104,192,144,42,24,18,88
"2011","Dudley 005A","E01009758",1173,24,7,17,144,104,87,105,248,258,124,87,37,79
"2011","Dudley 005B","E01009760",918,36,10,26,115,124,63,85,182,185,60,42,18,68
"2011","Dudley 005C","E01009772",960,57,15,42,169,125,57,73,170,130,92,57,35,87
"2011","Dudley 005D","E01009774",1102,83,19,64,215,179,91,97,188,143,43,20,23,63
"2011","Dudley 005E","E01009788",1165,48,6,42,167,145,76,94,232,225,93,52,41,85
"2011","Dudley 006B","E01009756",1019,24,4,20,92,70,63,96,231,227,127,83,44,89
"2011","Dudley 006C","E01009757",1180,67,15,52,192,153,107,105,186,180,104,69,35,86
"2011","Dudley 006D","E01009759",1000,58,16,42,177,165,71,107,172,151,39,23,16,60
"2011","Dudley 006F","E01009762",927,16,5,11,57,60,54,63,219,205,165,116,49,88
"2011","Dudley 006G","E01033187",1498,29,14,15,120,99,88,115,343,356,232,155,77,116
"2011","Dudley 007A","E01009781",1409,96,32,64,251,181,127,113,235,234,99,49,50,73
"2011","Dudley 007B","E01009786",1057,34,13,21,125,125,90,81,225,222,98,57,41,57
"2011","Dudley 007C","E01009789",1172,100,32,68,263,186,93,114,180,136,29,12,17,71
"2011","Dudley 007D","E01009790",1129,41,12,29,141,144,82,86,248,234,78,33,45,75
"2011","Dudley 008A","E01009779",1039,67,17,50,196,160,100,96,168,170,41,19,22,41
"2011","Dudley 008B","E01009782",1108,36,9,27,124,124,68,110,232,275,76,46,30,63
"2011","Dudley 008C","E01009783",1050,43,15,28,134,105,85,97,221,222,74,45,29,69
"2011","Dudley 008D","E01009785",1062,77,35,42,217,180,121,103,164,118,15,7,8,67
"2011","Dudley 008E","E01009899",1018,101,35,66,190,202,76,98,169,112,17,3,14,53
"2011","Dudley 008F","E01009900",1044,108,42,66,204,202,97,91,143,119,25,13,12,55
"2011","Dudley 009A","E01009780",1548,181,52,129,403,275,112,98,202,129,32,23,9,116
"2011","Dudley 009B","E01009784",1280,142,41,101,339,242,93,98,141,106,15,10,5,104
"2011","Dudley 009C","E01009787",1209,160,49,111,267,208,106,79,157,98,28,17,11,106
"2011","Dudley 009D","E01009880",1151,118,18,100,278,173,97,77,149,117,58,38,20,84
"2011","Dudley 009E","E01009882",1035,67,17,50,199,130,75,97,176,134,72,48,24,85
"2011","Dudley 010A","E01009891",1149,44,7,37,161,109,58,71,230,221,156,119,37,99
"2011","Dudley 010B","E01009892",1082,43,13,30,116,85,80,70,190,194,203,134,69,101
"2011","Dudley 010C","E01009893",1114,23,6,17,111,87,87,76,209,211,195,137,58,115
"2011","Dudley 010D","E01009894",1258,82,25,57,224,156,107,86,237,169,112,81,31,85
"2011","Dudley 011A","E01009844",996,31,7,24,127,88,69,76,201,179,158,123,35,67
"2011","Dudley 011B","E01009879",1470,140,37,103,299,184,100,85,239,174,138,85,53,111
"2011","Dudley 011C","E01009881",1507,79,17,62,199,127,119,101,302,255,226,140,86,99
"2011","Dudley 011D","E01009885",1119,61,15,46,153,111,72,87,220,200,122,95,27,93
"2011","Dudley 012A","E01009816",1109,105,34,71,238,208,84,98,165,134,23,8,15,54
"2011","Dudley 012B","E01009817",892,112,31,81,224,160,95,38,118,71,21,17,4,53
"2011","Dudley 012C","E01009819",1190,139,38,101,326,224,96,85,131,99,34,18,16,56
"2011","Dudley 012D","E01009820",1126,96,36,60,215,189,129,94,166,147,31,18,13,59
"2011","Dudley 013A","E01009748",1159,37,9,28,91,109,75,95,261,259,144,101,43,88
"2011","Dudley 013B","E01009839",1145,46,16,30,150,135,82,92,202,201,142,110,32,95
"2011","Dudley 013C","E01009883",932,35,14,21,121,102,48,88,213,201,49,20,29,75
"2011","Dudley 013D","E01009884",1098,121,10,111,161,117,71,67,199,185,93,60,33,84
"2011","Dudley 013E","E01009886",1106,26,11,15,134,119,75,120,236,258,93,59,34,45
"2011","Dudley 014A","E01009814",950,97,27,70,221,168,93,66,119,78,45,36,9,63
"2011","Dudley 014B","E01009815",994,130,51,79,282,179,80,53,113,55,16,10,6,86
"2011","Dudley 014C","E01009818",825,65,18,47,144,121,83,61,135,124,34,19,15,58
"2011","Dudley 014D","E01009821",1010,115,37,78,259,183,83,69,158,73,20,8,12,50
"2011","Dudley 014E","E01009822",1050,142,52,90,245,178,109,71,148,82,32,11,21,43
"2011","Dudley 015A","E01009887",1266,50,16,34,190,149,131,80,229,200,150,116,34,87
"2011","Dudley 015B","E01009888",1149,81,20,61,235,173,94,96,197,147,70,50,20,56
"2011","Dudley 015C","E01009889",1276,60,14,46,141,88,95,73,199,203,280,242,38,137
"2011","Dudley 015D","E01009890",1144,37,15,22,129,91,73,96,259,198,156,113,43,105
"2011","Dudley 016A","E01009749",1099,87,27,60,211,185,110,86,154,141,53,36,17,72
"2011","Dudley 016B","E01009750",1127,43,18,25,115,130,72,114,234,264,91,49,42,64
"2011","Dudley 016C","E01009823",1088,116,51,65,237,178,85,90,163,125,26,12,14,68
"2011","Dudley 016D","E01009824",1103,53,17,36,148,159,88,80,238,203,59,32,27,75
"2011","Dudley 017A","E01009751",1095,33,13,20,129,104,61,86,278,237,100,60,40,67
"2011","Dudley 017B","E01009752",1040,23,6,17,109,117,56,92,245,235,92,64,28,71
"2011","Dudley 017C","E01009753",1062,16,5,11,103,101,55,96,246,245,122,70,52,78
"2011","Dudley 017D","E01009754",1204,52,14,38,130,145,74,119,279,238,99,65,34,68
"2011","Dudley 017E","E01009841",1087,30,8,22,108,93,83,73,255,264,107,62,45,74
"2011","Dudley 018A","E01009840",964,38,9,29,107,106,89,66,178,162,151,116,35,67
"2011","Dudley 018B","E01009842",1381,42,6,36,136,152,118,115,285,259,202,101,101,72
"2011","Dudley 018C","E01009843",1160,58,22,36,210,165,94,115,209,177,51,28,23,81
"2011","Dudley 018D","E01009871",1418,74,24,50,257,179,98,121,260,258,86,54,32,85
"2011","Dudley 018E","E01009875",1105,40,10,30,129,138,56,100,249,233,87,54,33,73
"2011","Dudley 019A","E01009825",1050,94,30,64,234,169,91,75,146,129,42,19,23,70
"2011","Dudley 019B","E01009826",1100,126,46,80,307,181,71,86,130,114,29,16,13,56
"2011","Dudley 019C","E01009827",1118,160,57,103,324,193,99,56,99,83,21,13,8,83
"2011","Dudley 019D","E01009828",1055,67,25,42,180,162,85,100,197,156,42,24,18,66
"2011","Dudley 019E","E01009829",1108,154,43,111,270,205,105,75,119,95,22,12,10,63
"2011","Dudley 019F","E01009830",1155,121,35,86,268,223,110,77,146,99,27,10,17,84
"2011","Dudley 020A","E01009872",1071,36,10,26,117,127,75,82,237,204,106,59,47,87
"2011","Dudley 020B","E01009873",1133,54,18,36,171,156,100,118,237,156,63,40,23,78
"2011","Dudley 020C","E01009874",1144,42,8,34,130,110,79,96,255,260,92,66,26,80
"2011","Dudley 020D","E01009876",1204,52,15,37,152,135,87,112,257,254,80,50,30,75
"2011","Dudley 020E","E01009877",1047,33,10,23,112,105,58,87,268,225,105,61,44,54
"2011","Dudley 021A","E01009911",1099,101,30,71,187,211,81,86,212,136,25,13,12,60
"2011","Dudley 021B","E01009912",1251,154,41,113,342,207,117,81,149,96,42,25,17,63
"2011","Dudley 021C","E01009913",1126,40,18,22,174,169,104,114,230,184,47,21,26,64
"2011","Dudley 021D","E01009914",1062,111,49,62,249,184,101,75,164,116,22,14,8,40
"2011","Dudley 021E","E01009915",1313,127,34,93,297,218,114,84,218,116,62,46,16,77
"2011","Dudley 021F","E01009916",1273,72,23,49,268,187,109,100,233,162,61,28,33,81
"2011","Dudley 022A","E01009741",1776,52,12,40,206,175,105,140,401,355,244,139,105,98
"2011","Dudley 022B","E01009744",1422,64,16,48,196,163,91,127,310,249,146,88,58,76
"2011","Dudley 022C","E01009746",1152,44,10,34,141,106,90,81,226,206,175,127,48,83
"2011","Dudley 022D","E01009747",1124,28,7,21,143,136,73,110,259,229,91,60,31,55
"2011","Dudley 023A","E01009731",1195,117,32,85,296,210,89,92,178,115,46,24,22,52
"2011","Dudley 023B","E01009740",1202,36,8,28,181,144,89,113,242,234,85,44,41,78
"2011","Dudley 023C","E01009742",1072,38,9,29,127,116,88,109,235,209,84,49,35,66
"2011","Dudley 023D","E01009743",1210,31,10,21,110,101,70,103,282,293,135,64,71,85
"2011","Dudley 023E","E01009745",1293,81,30,51,275,185,102,109,234,185,49,27,22,73
"2011","Dudley 024A","E01009917",971,68,23,45,196,159,82,97,180,127,20,5,15,42
"2011","Dudley 024B","E01009918",1009,30,12,18,143,121,92,76,235,174,68,36,32,70
"2011","Dudley 024C","E01009919",974,74,27,47,203,182,75,100,142,126,25,13,12,47
"2011","Dudley 024D","E01009920",1089,97,30,67,255,189,81,90,198,115,27,13,14,37
"2011","Dudley 025A","E01009864",1182,56,22,34,173,142,86,114,233,215,83,53,30,80
"2011","Dudley 025B","E01009865",975,28,4,24,108,104,90,92,212,210,71,38,33,60
"2011","Dudley 025C","E01009866",1227,59,17,42,195,167,118,109,243,193,71,39,32,72
"2011","Dudley 025D","E01009867",1258,73,27,46,174,175,115,99,272,204,73,42,31,73
"2011","Dudley 025E","E01009878",1432,78,23,55,269,199,146,127,252,210,72,43,29,79
"2011","Dudley 026A","E01009791",1073,101,31,70,202,198,95,90,164,103,65,32,33,55
"2011","Dudley 026B","E01009792",1124,51,13,38,197,164,76,79,201,160,99,68,31,97
"2011","Dudley 026C","E01009795",1247,73,25,48,220,169,113,84,199,183,120,93,27,86
"2011","Dudley 026D","E01009796",1144,80,20,60,242,182,107,70,185,118,72,57,15,88
"2011","Dudley 026E","E01009798",1267,96,29,67,234,190,108,118,190,168,84,54,30,79
"2011","Dudley 027A","E01009719",1103,56,20,36,190,139,87,112,233,168,50,31,19,68
"2011","Dudley 027B","E01009722",1053,81,28,53,196,211,91,95,180,124,21,9,12,54
"2011","Dudley 027C","E01009727",1072,90,30,60,215,174,91,88,194,117,22,12,10,81
"2011","Dudley 027D","E01009728",1027,78,25,53,191,194,100,103,161,123,24,11,13,53
"2011","Dudley 027E","E01009729",1152,66,29,37,193,158,93,94,225,184,60,39,21,79
"2011","Dudley 028A","E01009720",1100,131,40,91,274,202,108,76,140,68,13,7,6,88
"2011","Dudley 028B","E01009723",990,112,41,71,222,190,92,72,137,79,14,9,5,72
"2011","Dudley 028C","E01009724",1178,105,40,65,274,230,121,98,154,104,22,12,10,70
"2011","Dudley 028D","E01009730",1141,142,39,103,293,213,105,74,141,75,28,13,15,70
"2011","Dudley 029A","E01009903",1059,153,49,104,302,166,150,61,103,50,23,11,12,51
"2011","Dudley 029B","E01009904",994,126,35,91,261,155,102,65,120,72,37,24,13,56
"2011","Dudley 029C","E01009909",986,67,21,46,219,150,87,77,162,140,37,19,18,47
"2011","Dudley 029D","E01009910",1077,64,20,44,159,124,104,88,216,161,86,39,47,75
"2011","Dudley 030A","E01009793",1008,81,20,61,226,183,98,78,141,100,37,22,15,64
"2011","Dudley 030B","E01009794",1005,96,22,74,222,205,65,78,140,102,29,18,11,68
"2011","Dudley 030C","E01009797",961,65,23,42,209,174,68,69,140,117,39,27,12,80
"2011","Dudley 030D","E01009801",1222,154,40,114,307,210,119,87,140,83,32,20,12,90
"2011","Dudley 031A","E01009721",1413,129,34,95,311,235,110,95,230,149,85,63,22,69
"2011","Dudley 031B","E01009725",1049,46,8,38,124,110,74,91,231,196,102,62,40,75
"2011","Dudley 031C","E01009726",1033,77,16,61,191,188,72,107,190,124,18,12,6,66
"2011","Dudley 031D","E01009834",1147,57,16,41,178,130,90,87,240,193,95,55,40,77
"2011","Dudley 032A","E01009833",947,24,8,16,92,83,97,58,173,151,169,118,51,100
"2011","Dudley 032B","E01009835",1121,58,15,43,156,129,146,77,162,138,161,128,33,94
"2011","Dudley 032C","E01009869",1229,79,31,48,225,199,108,115,220,165,40,17,23,78
"2011","Dudley 032D","E01009870",1199,85,33,52,230,207,104,124,195,161,50,19,31,43
"2011","Dudley 033A","E01009809",1144,44,14,30,153,150,73,81,243,193,113,80,33,94
"2011","Dudley 033B","E01009813",1129,45,17,28,171,152,107,80,220,174,84,61,23,96
"2011","Dudley 033C","E01009861",1124,77,15,62,194,140,95,82,210,181,74,49,25,71
"2011","Dudley 033D","E01009862",1271,62,12,50,198,160,100,118,235,216,106,58,48,76
"2011","Dudley 033E","E01009863",1311,92,22,70,247,184,97,114,223,171,87,59,28,96
"2011","Dudley 033F","E01009868",1129,74,14,60,189,161,94,107,191,164,91,62,29,58
"2011","Dudley 034A","E01009734",1082,74,18,56,186,167,93,66,209,149,60,37,23,78
"2011","Dudley 034B","E01009735",1137,124,33,91,292,226,77,84,160,81,16,6,10,77
"2011","Dudley 034C","E01009736",1047,103,30,73,216,200,90,74,159,90,47,32,15,68
"2011","Dudley 034D","E01009737",1106,90,19,71,219,205,97,83,167,139,36,21,15,70
"2011","Dudley 034E","E01009738",1075,69,16,53,180,157,85,82,193,145,63,41,22,101
"2011","Dudley 035A","E01009856",1421,132,36,96,336,176,118,103,202,156,97,59,38,101
"2011","Dudley 035B","E01009905",1082,112,23,89,282,150,118,64,147,107,46,29,17,56
"2011","Dudley 035C","E01009906",1189,69,17,52,234,126,109,81,222,207,83,36,47,58
"2011","Dudley 035D","E01009907",1078,109,22,87,289,132,88,66,150,101,53,35,18,90
"2011","Dudley 035E","E01009908",1214,164,36,128,408,147,112,55,116,74,50,29,21,88
"2011","Dudley 036A","E01009800",1090,156,37,119,302,166,84,78,122,95,19,13,6,68
"2011","Dudley 036B","E01009802",1136,96,31,65,242,187,97,83,148,134,54,32,22,95
"2011","Dudley 036C","E01009803",1172,195,64,131,294,239,112,57,107,63,22,10,12,83
"2011","Dudley 036D","E01009804",1046,167,49,118,275,176,105,49,105,74,19,10,9,76
"2011","Dudley 037A","E01009831",1087,43,15,28,122,90,93,82,249,245,83,54,29,80
"2011","Dudley 037B","E01009836",1275,41,12,29,117,107,111,102,241,240,236,180,56,80
"2011","Dudley 037C","E01009837",1192,60,15,45,159,128,139,71,199,176,176,137,39,84
"2011","Dudley 037D","E01009838",1188,54,24,30,151,104,94,112,252,247,103,53,50,71
"2011","Dudley 038A","E01009847",1085,79,22,57,251,155,94,75,170,133,55,28,27,73
"2011","Dudley 038B","E01009848",1036,81,18,63,248,134,106,66,168,113,44,24,20,76
"2011","Dudley 038C","E01009849",1128,79,23,56,224,137,116,85,207,133,65,36,29,82
"2011","Dudley 038D","E01009851",1074,138,35,103,289,170,103,60,107,100,42,30,12,65
"2011","Dudley 039A","E01009732",1278,77,29,48,232,171,117,94,214,172,115,97,18,86
"2011","Dudley 039B","E01009733",1270,43,10,33,169,143,79,83,264,213,204,132,72,72
"2011","Dudley 039C","E01009739",1120,66,14,52,219,154,92,98,188,176,57,32,25,70
"2011","Dudley 039D","E01009799",1066,128,34,94,263,212,83,65,146,81,34,15,19,54
"2011","Dudley 039E","E01009805",1118,131,24,107,241,197,78,67,173,94,56,32,24,81
"2011","Dudley 039F","E01009806",1146,130,37,93,280,243,87,58,151,98,37,15,22,62
"2011","Dudley 040A","E01009854",1135,213,54,159,335,195,113,32,88,62,31,19,12,66
"2011","Dudley 040B","E01009857",1178,86,18,68,209,122,128,89,202,168,100,61,39,74
"2011","Dudley 040C","E01009858",1005,122,20,102,267,135,65,38,94,41,46,28,18,197
"2011","Dudley 040D","E01009859",1158,218,54,164,346,163,141,42,102,51,30,14,16,65
"2011","Dudley 041A","E01009845",1115,243,63,180,314,165,135,43,75,37,23,15,8,80
"2011","Dudley 041B","E01009846",1048,125,39,86,280,151,120,54,117,92,27,14,13,82
"2011","Dudley 041C","E01009850",1068,181,49,132,324,147,112,50,108,57,32,19,13,57
"2011","Dudley 041D","E01009852",1055,174,56,118,283,200,105,43,112,46,22,14,8,70
"2011","Dudley 042A","E01009832",1091,45,10,35,126,105,83,103,246,208,88,50,38,87
"2011","Dudley 042B","E01009853",947,149,44,105,254,169,108,48,102,56,12,7,5,49
"2011","Dudley 042C","E01009855",1159,233,76,157,331,191,124,38,73,45,37,27,10,87
"2011","Dudley 042D","E01009860",1138,145,42,103,281,200,112,59,141,99,43,20,23,58
"2011","Dudley 043A","E01009807",1219,140,32,108,313,247,106,74,151,85,23,6,17,80
"2011","Dudley 043B","E01009808",1120,147,41,106,276,224,102,71,132,83,18,6,12,67
"2011","Dudley 043C","E01009810",1220,140,34,106,271,213,113,91,160,103,59,28,31,70
"2011","Dudley 043D","E01009811",1105,114,37,77,244,198,102,76,148,105,43,23,20,75
"2011","Dudley 043E","E01009812",1145,154,42,112,305,193,134,46,129,69,27,17,10,88
"2011","Sandwell 001A","E01010085",1159,60,18,42,215,164,80,83,194,182,101,71,30,80
"2011","Sandwell 001B","E01010086",1242,49,8,41,170,133,78,89,285,210,139,90,49,89
"2011","Sandwell 001C","E01010087",1221,51,21,30,147,138,82,102,248,219,120,84,36,114
"2011","Sandwell 001D","E01010088",1122,38,8,30,128,118,89,118,230,204,106,73,33,91
"2011","Sandwell 001E","E01010089",1310,57,23,34,173,130,99,92,271,223,142,99,43,123
"2011","Sandwell 002A","E01009969",1361,85,24,61,210,189,93,100,265,185,134,71,63,100
"2011","Sandwell 002B","E01009970",1020,48,16,32,149,144,69,90,208,181,65,37,28,66
"2011","Sandwell 002C","E01009971",1091,39,8,31,181,146,62,93,199,191,87,59,28,93
"2011","Sandwell 002D","E01009973",1785,132,21,111,295,224,145,110,273,274,157,121,36,175
"2011","Sandwell 003A","E01009960",1100,18,5,13,127,104,80,107,253,238,105,75,30,68
"2011","Sandwell 003B","E01009961",948,44,12,32,152,162,74,98,179,136,33,14,19,70
"2011","Sandwell 003C","E01009966",848,39,16,23,94,104,52,76,184,148,97,59,38,54
"2011","Sandwell 003D","E01009967",1271,74,19,55,202,186,85,97,242,232,77,45,32,76
"2011","Sandwell 003E","E01010092",1363,72,17,55,218,158,88,125,265,225,111,74,37,101
"2011","Sandwell 004A","E01009962",924,12,2,10,79,76,55,68,238,211,118,80,38,67
"2011","Sandwell 004B","E01009963",946,17,3,14,68,77,54,76,223,222,136,91,45,73
"2011","Sandwell 004C","E01009964",1066,11,3,8,95,66,49,97,234,281,155,97,58,78
"2011","Sandwell 004D","E01009965",969,8,2,6,76,64,41,83,218,257,153,108,45,69
"2011","Sandwell 005A","E01010090",1189,38,7,31,133,128,77,84,256,272,132,86,46,69
"2011","Sandwell 005B","E01010091",1130,71,23,48,172,124,61,94,205,173,137,93,44,93
"2011","Sandwell 005C","E01010096",1076,50,15,35,136,146,71,106,215,225,75,46,29,52
"2011","Sandwell 005D","E01010097",1321,62,14,48,188,170,87,116,272,230,117,87,30,79
"2011","Sandwell 006A","E01009968",1116,125,37,88,268,171,149,56,133,74,34,16,18,106
"2011","Sandwell 006B","E01009972",1301,119,32,87,304,211,127,89,172,141,40,31,9,98
"2011","Sandwell 006C","E01009974",1086,110,28,82,245,184,120,79,127,96,32,22,10,93
"2011","Sandwell 006D","E01009975",1166,113,35,78,251,179,127,82,170,121,47,35,12,76
"2011","Sandwell 007A","E01010030",1050,29,13,16,84,76,50,77,282,248,143,100,43,61
"2011","Sandwell 007B","E01010034",1124,61,19,42,197,193,91,104,214,155,37,24,13,72
"2011","Sandwell 007C","E01010035",1102,75,31,44,190,173,87,112,212,168,30,13,17,55
"2011","Sandwell 007D","E01010036",1156,41,13,28,167,150,55,82,240,212,123,79,44,86
"2011","Sandwell 009A","E01009982",1088,49,17,32,113,104,62,85,224,216,140,86,54,95
"2011","Sandwell 009B","E01009983",1064,34,15,19,98,97,58,105,251,246,111,83,28,64
"2011","Sandwell 009C","E01010029",917,14,5,9,56,63,38,62,238,222,175,116,59,49
"2011","Sandwell 009D","E01010037",746,17,5,12,54,61,36,54,174,181,109,71,38,60
"2011","Sandwell 010A","E01009991",1507,64,16,48,181,173,95,99,310,288,167,118,49,130
"2011","Sandwell 010B","E01009994",1108,41,9,32,138,114,76,109,222,218,114,75,39,76
"2011","Sandwell 010C","E01009995",1123,47,16,31,160,147,76,104,226,195,94,59,35,74
"2011","Sandwell 010D","E01009996",1144,25,11,14,102,95,65,100,271,260,146,98,48,80
"2011","Sandwell 010E","E01009997",1235,38,9,29,151,130,83,99,264,222,159,117,42,89
"2011","Sandwell 010F","E01009998",1353,36,9,27,160,154,76,116,296,252,148,89,59,115
"2011","Sandwell 011A","E01010008",1092,76,24,52,201,161,62,91,187,121,78,49,29,115
"2011","Sandwell 011B","E01010010",981,36,9,27,159,135,45,83,205,180,80,52,28,58
"2011","Sandwell 011C","E01010011",1171,101,23,78,248,191,85,81,207,131,47,31,16,80
"2011","Sandwell 011D","E01010012",1011,69,25,44,200,178,90,89,151,113,43,31,12,78
"2011","Sandwell 012A","E01010007",934,51,18,33,173,148,61,61,174,144,53,31,22,69
"2011","Sandwell 012B","E01010009",987,63,13,50,154,155,80,73,171,144,60,43,17,87
"2011","Sandwell 012C","E01010013",908,62,17,45,200,153,64,72,155,92,41,33,8,69
"2011","Sandwell 012D","E01010014",1188,96,28,68,268,198,104,92,176,119,54,35,19,81
"2011","Sandwell 013A","E01010093",802,26,2,24,103,74,40,56,178,177,91,58,33,57
"2011","Sandwell 013B","E01010094",1109,55,13,42,125,122,73,67,228,226,111,83,28,102
"2011","Sandwell 013C","E01010095",973,22,10,12,92,69,51,77,220,249,107,65,42,86
"2011","Sandwell 013D","E01010098",1180,40,13,27,131,119,62,95,262,252,135,88,47,84
"2011","Sandwell 013E","E01010099",1202,50,21,29,159,156,98,135,269,184,84,54,30,67
"2011","Sandwell 013F","E01010100",1345,63,10,53,199,200,84,97,223,281,117,79,38,81
"2011","Sandwell 014A","E01009978",1295,28,6,22,119,114,75,113,330,285,135,87,48,96
"2011","Sandwell 014B","E01010031",1143,33,12,21,92,98,40,87,284,291,155,86,69,63
"2011","Sandwell 014C","E01010032",901,8,0,8,67,63,37,54,200,221,168,109,59,83
"2011","Sandwell 014D","E01010033",1131,20,5,15,108,112,59,86,310,242,135,86,49,59
"2011","Sandwell 014E","E01010074",1648,75,15,60,285,199,92,154,337,301,122,87,35,83
"2011","Sandwell 015A","E01010066",1031,37,17,20,125,102,66,84,195,214,128,85,43,80
"2011","Sandwell 015B","E01010067",1068,32,5,27,126,99,80,77,187,193,186,127,59,88
"2011","Sandwell 015C","E01010068",1145,72,18,54,177,158,71,81,212,204,96,58,38,74
"2011","Sandwell 015D","E01010070",1151,58,18,40,190,161,85,102,249,175,70,46,24,61
"2011","Sandwell 015E","E01010075",1027,58,14,44,186,149,85,81,177,128,78,62,16,85
"2011","Sandwell 015F","E01010076",885,31,9,22,102,75,38,73,227,195,85,54,31,59
"2011","Sandwell 016A","E01009976",1887,114,33,81,415,292,125,137,305,260,117,68,49,122
"2011","Sandwell 016B","E01009977",1290,53,15,38,190,164,82,110,262,248,106,56,50,75
"2011","Sandwell 016C","E01009979",1129,21,7,14,100,100,39,93,264,259,193,114,79,60
"2011","Sandwell 016D","E01009980",1626,74,18,56,228,201,77,136,301,311,184,125,59,114
"2011","Sandwell 016E","E01010069",1354,85,20,65,218,166,79,96,258,213,107,70,37,132
"2011","Sandwell 016F","E01010071",1269,56,21,35,177,140,70,92,222,218,168,121,47,126
"2011","Sandwell 017A","E01009947",1370,92,29,63,249,187,99,83,236,209,109,58,51,106
"2011","Sandwell 017B","E01009992",1213,43,12,31,143,138,79,82,215,242,151,110,41,120
"2011","Sandwell 017C","E01009993",1264,48,9,39,144,153,79,87,212,247,190,136,54,104
"2011","Sandwell 017D","E01010103",1383,50,15,35,138,140,69,135,262,280,207,139,68,102
"2011","Sandwell 017E","E01010104",1208,54,11,43,175,154,97,79,260,202,129,88,41,58
"2011","Sandwell 017F","E01010105",1122,74,13,61,165,153,105,56,160,201,109,81,28,99
"2011","Sandwell 018A","E01009981",1244,29,8,21,124,130,88,103,291,281,130,87,43,68
"2011","Sandwell 018C","E01009985",1193,28,6,22,112,100,96,105,259,241,143,96,47,109
"2011","Sandwell 018E","E01032887",1881,41,10,31,136,146,107,131,364,460,338,259,79,158
"2011","Sandwell 019A","E01009986",961,24,2,22,82,78,71,65,183,178,163,136,27,117
"2011","Sandwell 019B","E01009987",837,17,3,14,76,59,48,64,164,198,144,110,34,67
"2011","Sandwell 019C","E01009989",1129,32,11,21,122,115,71,84,216,235,157,115,42,97
"2011","Sandwell 019D","E01010106",1093,43,6,37,111,100,102,78,157,182,222,189,33,98
"2011","Sandwell 020A","E01009988",1207,37,6,31,114,116,84,104,272,248,134,96,38,98
"2011","Sandwell 020B","E01010101",1417,20,9,11,137,117,59,132,302,362,206,128,78,82
"2011","Sandwell 020C","E01010102",1220,29,8,21,111,100,98,78,248,287,153,113,40,116
"2011","Sandwell 020D","E01010107",1259,35,6,29,121,93,88,62,228,249,256,199,57,127
"2011","Sandwell 021A","E01010015",1210,56,21,35,173,160,118,91,224,194,90,63,27,104
"2011","Sandwell 021B","E01010016",1146,53,14,39,142,128,94,84,194,186,151,112,39,114
"2011","Sandwell 021C","E01010018",1494,84,28,56,312,200,78,114,249,214,132,84,48,111
"2011","Sandwell 021D","E01010072",1611,97,29,68,279,217,91,128,253,276,168,116,52,102
"2011","Sandwell 021E","E01010073",1139,36,6,30,143,148,77,78,233,205,134,85,49,85
"2011","Sandwell 022A","E01010077",1082,33,16,17,112,111,50,112,254,225,123,85,38,62
"2011","Sandwell 022B","E01010079",1168,65,22,43,195,194,83,114,238,143,63,38,25,73
"2011","Sandwell 022C","E01010080",1205,38,11,27,128,135,67,102,247,229,175,120,55,84
"2011","Sandwell 022D","E01010081",1178,61,20,41,183,192,104,116,225,183,36,15,21,78
"2011","Sandwell 022E","E01010082",1675,127,38,89,310,235,121,151,303,231,84,45,39,113
"2011","Sandwell 022F","E01010083",1161,44,15,29,158,151,76,109,250,201,84,53,31,88
"2011","Sandwell 022G","E01010084",1026,32,8,24,107,103,40,85,235,193,145,90,55,86
"2011","Sandwell 023A","E01010046",1353,57,9,48,123,102,87,99,172,189,325,280,45,199
"2011","Sandwell 023B","E01010047",1283,52,16,36,132,104,107,59,211,220,254,214,40,144
"2011","Sandwell 023C","E01010048",1211,40,7,33,98,87,96,54,202,258,199,158,41,177
"2011","Sandwell 023D","E01010049",1195,33,6,27,91,94,96,53,215,252,219,177,42,142
"2011","Sandwell 023E","E01010050",1121,47,4,43,131,127,76,67,160,237,135,106,29,141
"2011","Sandwell 023F","E01010052",934,18,1,17,59,63,59,97,150,197,195,168,27,96
"2011","Sandwell 023G","E01010053",1234,37,5,32,100,101,87,61,183,188,289,245,44,188
"2011","Sandwell 024A","E01010017",1353,51,9,42,167,153,88,97,247,269,192,129,63,89
"2011","Sandwell 024B","E01010019",1176,35,5,30,100,112,83,75,192,221,248,200,48,110
"2011","Sandwell 024C","E01010020",1306,53,13,40,151,125,89,91,267,230,170,129,41,130
"2011","Sandwell 024D","E01010021",1249,64,16,48,157,136,81,98,227,189,182,139,43,115
"2011","Sandwell 025A","E01010039",922,31,13,18,108,84,52,77,210,190,85,54,31,85
"2011","Sandwell 025B","E01010043",1097,88,37,51,198,184,83,89,197,153,42,21,21,63
"2011","Sandwell 025C","E01010044",1007,60,18,42,134,126,72,99,197,185,68,40,28,66
"2011","Sandwell 025D","E01010078",946,76,25,51,183,165,100,86,160,110,22,13,9,44
"2011","Sandwell 026A","E01010059",1329,45,5,40,155,112,96,66,204,201,259,216,43,191
"2011","Sandwell 026B","E01010061",1221,26,2,24,107,71,126,48,197,176,258,220,38,212
"2011","Sandwell 026C","E01010062",1094,29,6,23,101,80,69,63,213,219,199,157,42,121
"2011","Sandwell 026D","E01010063",1397,22,3,19,90,91,67,76,237,236,374,289,85,204
"2011","Sandwell 026E","E01010064",1188,54,16,38,132,99,83,62,209,193,202,165,37,154
"2011","Sandwell 026F","E01010065",1780,101,13,88,263,121,132,87,277,213,335,266,69,251
"2011","Sandwell 027A","E01009934",1013,49,13,36,111,120,45,84,216,204,98,65,33,86
"2011","Sandwell 027B","E01009935",1370,38,13,25,135,135,79,122,315,279,173,108,65,94
"2011","Sandwell 027C","E01009936",1228,52,12,40,214,179,90,125,251,202,40,21,19,75
"2011","Sandwell 027D","E01010004",1161,50,13,37,165,145,53,115,230,212,112,72,40,79
"2011","Sandwell 028A","E01010054",1300,42,10,32,162,114,70,87,252,217,260,207,53,96
"2011","Sandwell 028B","E01010055",1217,56,11,45,193,122,76,79,194,234,144,111,33,119
"2011","Sandwell 028C","E01010056",1097,43,12,31,136,140,71,69,214,203,124,88,36,97
"2011","Sandwell 028D","E01010057",1291,35,5,30,138,100,101,54,239,201,271,222,49,152
"2011","Sandwell 028E","E01010060",1393,63,9,54,146,95,104,71,248,211,290,228,62,165
"2011","Sandwell 029A","E01010038",1253,38,13,25,157,134,99,92,307,229,102,67,35,95
"2011","Sandwell 029B","E01010040",1058,71,22,49,159,156,71,76,202,183,66,40,26,74
"2011","Sandwell 029C","E01010041",1217,51,17,34,149,138,82,104,259,227,129,82,47,78
"2011","Sandwell 029D","E01010045",1142,40,13,27,131,141,62,123,255,212,91,59,32,87
"2011","Sandwell 030A","E01010000",1156,97,29,68,210,180,97,99,176,157,55,27,28,85
"2011","Sandwell 030B","E01010002",1541,104,29,75,275,233,99,136,294,198,89,44,45,113
"2011","Sandwell 030C","E01010003",1133,39,12,27,139,160,61,90,244,186,135,83,52,79
"2011","Sandwell 030D","E01010005",1086,55,14,41,189,138,107,91,178,151,99,58,41,78
"2011","Sandwell 030E","E01010006",1223,78,16,62,216,176,97,103,221,153,68,49,19,111
"2011","Sandwell 031A","E01009938",1218,58,14,44,166,171,63,105,253,224,84,56,28,94
"2011","Sandwell 031B","E01009943",996,27,7,20,118,121,65,72,206,160,127,91,36,100
"2011","Sandwell 031C","E01009944",1048,35,8,27,118,140,72,88,220,171,95,63,32,109
"2011","Sandwell 031D","E01010051",865,41,7,34,112,96,34,62,170,165,95,71,24,90
"2011","Sandwell 031E","E01010058",1147,46,11,35,121,128,78,98,217,239,123,86,37,97
"2011","Sandwell 032A","E01009937",1083,31,8,23,128,142,57,102,236,214,93,59,34,80
"2011","Sandwell 032B","E01009939",1252,95,23,72,256,180,101,106,183,170,82,59,23,79
"2011","Sandwell 032C","E01009940",1057,45,13,32,155,146,63,91,201,172,103,65,38,81
"2011","Sandwell 032D","E01009941",1083,61,16,45,153,156,72,103,207,174,81,60,21,76
"2011","Sandwell 032E","E01009942",1204,42,10,32,137,142,80,84,248,254,117,76,41,100
"2011","Sandwell 033A","E01009929",1180,29,11,18,118,117,73,118,295,230,110,69,41,90
"2011","Sandwell 033B","E01009930",1071,57,16,41,135,114,76,93,225,213,79,46,33,79
"2011","Sandwell 033C","E01009931",1706,153,49,104,384,292,157,130,267,170,58,43,15,95
"2011","Sandwell 033D","E01009932",1194,47,13,34,178,128,90,83,261,190,124,99,25,93
"2011","Sandwell 033E","E01009999",1007,47,12,35,140,121,70,91,211,170,78,52,26,79
"2011","Sandwell 034A","E01009921",1220,115,21,94,289,147,85,73,173,147,88,53,35,103
"2011","Sandwell 034B","E01009922",922,55,11,44,156,138,52,68,163,149,60,36,24,81
"2011","Sandwell 034C","E01009924",1037,166,22,144,346,117,58,49,113,85,38,23,15,65
"2011","Sandwell 034D","E01009925",1029,190,40,150,345,119,73,43,78,76,29,12,17,76
"2011","Sandwell 034E","E01009926",1069,140,21,119,294,147,67,40,139,99,60,39,21,83
"2011","Sandwell 034F","E01009927",1194,165,26,139,316,136,74,74,144,106,75,46,29,104
"2011","Sandwell 034G","E01009928",1310,107,16,91,290,159,105,92,198,149,121,75,46,89
"2011","Sandwell 035A","E01009933",1047,50,17,33,143,126,70,84,196,195,112,82,30,71
"2011","Sandwell 035B","E01009952",1426,65,20,45,211,151,64,106,278,246,197,113,84,108
"2011","Sandwell 035C","E01009955",1344,60,9,51,196,151,119,98,248,224,169,110,59,79
"2011","Sandwell 035D","E01009956",1132,72,19,53,188,130,59,90,217,215,92,50,42,69
"2011","Sandwell 035E","E01009959",1102,130,34,96,284,175,85,65,150,114,20,9,11,79
"2011","Sandwell 035F","E01010042",1270,64,22,42,194,164,91,103,258,223,102,72,30,71
"2011","Sandwell 036A","E01009923",1052,94,22,72,226,138,74,65,165,139,61,37,24,90
"2011","Sandwell 036B","E01010024",1100,109,31,78,268,169,116,61,148,110,36,19,17,83
"2011","Sandwell 036C","E01010026",1214,76,19,57,219,216,79,100,226,147,61,36,25,90
"2011","Sandwell 036D","E01010027",1091,131,36,95,244,164,99,67,129,115,55,31,24,87
"2011","Sandwell 037A","E01010001",1175,37,12,25,165,160,75,97,255,200,81,55,26,105
"2011","Sandwell 037B","E01010022",1096,88,22,66,234,181,100,81,174,115,48,34,14,75
"2011","Sandwell 037C","E01010023",1282,121,37,84,277,227,107,88,192,131,51,26,25,88
"2011","Sandwell 037D","E01010025",1027,44,10,34,139,134,72,104,207,166,75,50,25,86
"2011","Sandwell 037E","E01010028",996,42,10,32,141,129,41,85,192,191,86,48,38,89
"2011","Sandwell 038A","E01009953",1253,63,19,44,192,161,92,76,264,240,94,62,32,71
"2011","Sandwell 038B","E01009954",1163,51,14,37,172,140,78,91,241,226,98,61,37,66
"2011","Sandwell 038C","E01009957",1139,36,13,23,120,95,87,89,257,208,152,104,48,95
"2011","Sandwell 038D","E01009958",1183,145,49,96,263,182,108,55,172,120,32,20,12,106
"2011","Sandwell 039A","E01009946",1202,89,26,63,238,181,93,90,211,182,50,27,23,68
"2011","Sandwell 039B","E01009948",1173,65,24,41,201,221,74,114,201,160,45,28,17,92
"2011","Sandwell 039C","E01009949",1136,136,22,114,263,181,130,85,121,108,46,32,14,66
"2011","Sandwell 039D","E01009950",1236,83,22,61,194,182,114,95,198,206,84,53,31,80
"2011","Sandwell 039E","E01009951",1433,54,14,40,149,162,70,96,288,278,244,135,109,92
"2011","Sandwell 039F","E01032592",1262,103,24,79,238,189,105,84,221,167,69,46,23,86
"2011","Solihull 001A","E01010118",1042,55,15,40,202,166,91,94,171,122,62,49,13,79
"2011","Solihull 001B","E01010120",1000,62,14,48,167,164,77,82,189,166,36,17,19,57
"2011","Solihull 001C","E01010121",1008,94,30,64,219,176,99,90,145,87,38,29,9,60
"2011","Solihull 001D","E01010122",1054,91,31,60,241,178,112,84,143,93,48,25,23,64
"2011","Solihull 002A","E01010235",1056,29,6,23,116,118,52,86,213,218,121,77,44,103
"2011","Solihull 002B","E01010236",1050,30,6,24,105,118,58,87,243,199,141,78,63,69
"2011","Solihull 002C","E01010239",1115,39,11,28,143,147,61,91,250,206,87,51,36,91
"2011","Solihull 002D","E01010240",967,27,12,15,115,111,55,87,242,154,87,50,37,89
"2011","Solihull 003A","E01010117",1087,84,17,67,217,215,95,104,161,99,32,17,15,80
"2011","Solihull 003B","E01010119",1052,76,22,54,189,201,92,104,175,114,26,15,11,75
"2011","Solihull 003C","E01010123",1012,67,23,44,181,191,93,109,164,107,19,10,9,81
"2011","Solihull 003D","E01010124",1135,98,31,67,221,193,109,102,190,114,36,21,15,72
"2011","Solihull 004A","E01010146",1155,35,9,26,158,138,77,84,234,214,108,75,33,107
"2011","Solihull 004B","E01010234",883,17,3,14,86,126,56,67,200,150,124,84,40,57
"2011","Solihull 004C","E01010237",1380,55,15,40,214,180,83,121,318,211,108,68,40,90
"2011","Solihull 004D","E01010238",1046,26,12,14,124,101,57,94,247,221,125,75,50,51
"2011","Solihull 005A","E01010145",1026,62,22,40,143,154,102,103,190,155,56,30,26,61
"2011","Solihull 005B","E01010147",999,36,9,27,117,105,50,75,224,182,135,76,59,75
"2011","Solihull 005C","E01010148",1205,33,10,23,140,130,72,87,261,224,150,76,74,108
"2011","Solihull 005D","E01010149",1088,48,10,38,155,177,80,111,211,181,50,30,20,75
"2011","Solihull 006A","E01010125",1071,22,6,16,118,112,62,107,224,232,142,90,52,52
"2011","Solihull 006B","E01010129",1105,39,15,24,124,125,51,97,229,239,122,84,38,79
"2011","Solihull 006C","E01010139",769,27,12,15,95,119,38,86,174,145,43,27,16,42
"2011","Solihull 006D","E01010141",1016,31,6,25,108,123,63,81,211,191,133,74,59,75
"2011","Solihull 007A","E01010140",1088,25,10,15,108,131,79,86,251,210,119,79,40,79
"2011","Solihull 007B","E01010142",992,24,6,18,92,103,43,96,242,193,116,77,39,83
"2011","Solihull 007C","E01010143",1023,15,2,13,120,113,54,100,244,195,111,62,49,71
"2011","Solihull 007D","E01010144",1200,44,14,30,184,194,56,131,258,197,67,33,34,69
"2011","Solihull 008A","E01010111",1041,33,9,24,117,125,55,90,234,206,117,68,49,64
"2011","Solihull 008B","E01010126",1080,28,6,22,125,115,58,94,233,251,117,58,59,59
"2011","Solihull 008C","E01010127",1279,64,16,48,209,178,70,134,229,216,95,58,37,84
"2011","Solihull 008D","E01010128",1048,29,5,24,116,141,60,107,234,204,82,55,27,75
"2011","Solihull 008E","E01010130",1249,34,8,26,126,126,55,114,274,280,162,95,67,78
"2011","Solihull 008F","E01010131",997,30,5,25,105,116,48,80,215,224,117,75,42,62
"2011","Solihull 009A","E01010109",1062,86,23,63,250,196,118,85,135,94,34,26,8,64
"2011","Solihull 009B","E01010110",1256,137,27,110,252,204,107,93,114,81,174,157,17,94
"2011","Solihull 009C","E01010112",1197,111,23,88,214,200,71,90,187,169,79,41,38,76
"2011","Solihull 009D","E01010113",944,45,10,35,156,129,57,75,192,159,73,43,30,58
"2011","Solihull 009E","E01010114",1338,106,23,83,273,232,149,111,182,155,54,37,17,76
"2011","Solihull 010A","E01010157",1056,88,18,70,251,184,82,85,154,113,44,25,19,55
"2011","Solihull 010B","E01010159",999,82,15,67,216,144,90,83,152,81,66,45,21,85
"2011","Solihull 010C","E01010162",1084,101,24,77,217,187,96,98,153,122,31,23,8,79
"2011","Solihull 010D","E01010163",1043,101,19,82,234,193,80,79,134,94,49,33,16,79
"2011","Solihull 011A","E01010132",975,76,23,53,190,186,82,79,157,97,31,20,11,77
"2011","Solihull 011B","E01010133",1006,83,16,67,213,165,116,84,137,87,43,25,18,78
"2011","Solihull 011C","E01010134",961,86,23,63,202,177,83,105,144,73,33,16,17,58
"2011","Solihull 011D","E01010135",1066,125,25,100,202,177,81,114,149,107,40,23,17,71
"2011","Solihull 011E","E01010138",1037,86,28,58,212,191,76,103,154,112,41,21,20,62
"2011","Solihull 012A","E01010136",905,101,22,79,231,162,81,59,130,57,24,11,13,60
"2011","Solihull 012B","E01010137",939,60,7,53,159,141,77,85,183,130,43,18,25,61
"2011","Solihull 012C","E01010158",1003,65,17,48,163,151,63,81,182,144,80,56,24,74
"2011","Solihull 012D","E01010160",1109,102,27,75,245,174,94,87,162,110,49,40,9,86
"2011","Solihull 012E","E01010161",1086,142,34,108,269,174,82,63,145,79,43,27,16,89
"2011","Solihull 013A","E01010174",1229,142,34,108,284,202,72,76,177,121,47,30,17,108
"2011","Solihull 013B","E01010175",1229,256,50,206,340,167,110,49,114,52,38,24,14,103
"2011","Solihull 013C","E01010177",949,109,25,84,170,165,92,84,141,92,29,24,5,67
"2011","Solihull 013D","E01010178",1273,162,28,134,265,172,88,67,178,157,111,81,30,73
"2011","Solihull 014A","E01010172",1093,195,46,149,335,172,101,58,77,44,23,14,9,88
"2011","Solihull 014B","E01010173",1011,215,52,163,292,150,101,45,70,39,26,19,7,73
"2011","Solihull 014C","E01010176",970,215,50,165,288,117,101,29,85,26,38,22,16,71
"2011","Solihull 014D","E01010179",1085,167,43,124,305,158,93,58,123,70,52,39,13,59
"2011","Solihull 015A","E01010115",1133,169,39,130,269,177,112,77,133,105,23,15,8,68
"2011","Solihull 015B","E01010116",1153,207,43,164,300,201,106,68,113,49,19,8,11,90
"2011","Solihull 015C","E01010227",1370,246,59,187,395,229,145,56,112,79,27,18,9,81
"2011","Solihull 015D","E01010228",1164,151,32,119,245,201,94,99,170,80,38,26,12,86
"2011","Solihull 015E","E01010232",1484,182,38,144,362,221,105,105,239,140,53,27,26,77
"2011","Solihull 016A","E01010195",1094,278,60,218,311,157,84,31,68,45,36,24,12,84
"2011","Solihull 016B","E01010226",989,222,42,180,282,128,89,50,80,51,46,34,12,41
"2011","Solihull 016C","E01010229",1017,213,53,160,294,138,87,30,91,48,46,34,12,70
"2011","Solihull 016D","E01010230",1243,192,42,150,300,195,106,71,164,83,60,45,15,72
"2011","Solihull 016E","E01010231",1192,277,44,233,322,163,130,41,91,38,36,27,9,94
"2011","Solihull 016F","E01010233",1322,201,35,166,323,180,99,83,185,114,59,47,12,78
"2011","Solihull 017A","E01010108",1433,358,95,263,405,157,169,60,101,58,34,19,15,91
"2011","Solihull 017B","E01010164",1206,205,53,152,304,148,159,72,115,95,58,44,14,50
"2011","Solihull 017C","E01010165",1052,127,32,95,246,135,110,91,157,107,33,23,10,46
"2011","Solihull 017D","E01010167",1147,191,63,128,313,136,178,67,96,82,22,16,6,62
"2011","Solihull 018A","E01010199",1213,180,36,144,300,217,116,67,143,68,29,20,9,93
"2011","Solihull 018B","E01010200",934,107,26,81,186,153,79,71,154,74,37,25,12,73
"2011","Solihull 018C","E01010201",1158,177,31,146,273,181,107,81,123,65,43,26,17,108
"2011","Solihull 018D","E01010204",936,77,15,62,163,132,64,70,178,116,73,44,29,63
"2011","Solihull 018E","E01010205",1059,181,40,141,299,167,83,49,86,45,26,19,7,123
"2011","Solihull 018F","E01010206",1175,180,36,144,311,194,92,65,130,79,38,22,16,86
"2011","Solihull 019A","E01010192",1162,264,41,223,316,140,114,39,98,41,32,23,9,118
"2011","Solihull 019B","E01010196",1171,251,61,190,329,182,131,40,83,32,19,13,6,104
"2011","Solihull 019C","E01010197",1169,299,70,229,353,165,99,23,66,27,32,24,8,105
"2011","Solihull 019D","E01010198",1071,259,67,192,350,130,104,35,73,28,29,20,9,63
"2011","Solihull 021A","E01010218",939,51,13,38,165,152,89,82,165,105,62,39,23,68
"2011","Solihull 021B","E01010219",1179,128,32,96,244,208,110,97,171,108,32,20,12,81
"2011","Solihull 021C","E01010221",1034,111,35,76,231,197,82,77,165,93,21,12,9,57
"2011","Solihull 021D","E01010222",1135,114,28,86,227,206,93,83,186,111,46,33,13,69
"2011","Solihull 022A","E01010191",1358,262,49,213,385,197,125,49,117,62,45,26,19,116
"2011","Solihull 022B","E01010202",1096,206,38,168,325,179,76,48,105,40,38,21,17,79
"2011","Solihull 022C","E01010203",1220,152,32,120,297,211,114,72,147,93,38,29,9,96
"2011","Solihull 022D","E01010209",1269,136,27,109,290,187,144,76,180,127,29,20,9,100
"2011","Solihull 022E","E01010213",1140,99,17,82,237,155,105,96,185,130,48,32,16,85
"2011","Solihull 023A","E01010208",1062,125,26,99,257,186,109,67,148,53,36,24,12,81
"2011","Solihull 023B","E01010210",1168,178,39,139,285,209,110,67,137,63,19,11,8,100
"2011","Solihull 023C","E01010211",1044,114,26,88,207,176,103,73,152,126,27,16,11,66
"2011","Solihull 023D","E01010217",1088,147,35,112,285,197,96,79,139,63,17,8,9,65
"2011","Solihull 024A","E01010190",1235,291,72,219,382,175,89,36,91,36,26,11,15,109
"2011","Solihull 024B","E01010193",1057,235,71,164,333,153,80,41,69,26,11,10,1,109
"2011","Solihull 024C","E01010194",1219,241,62,179,342,226,101,42,113,37,25,16,9,92
"2011","Solihull 024D","E01010207",1102,182,37,145,286,196,112,47,112,55,26,14,12,86
"2011","Solihull 025A","E01010166",1016,217,57,160,270,137,158,37,68,38,16,12,4,75
"2011","Solihull 025B","E01010168",1330,294,87,207,389,190,148,60,96,49,29,13,16,75
"2011","Solihull 025C","E01010169",1136,260,64,196,337,167,108,41,79,44,16,10,6,84
"2011","Solihull 025D","E01010170",1135,283,85,198,342,166,88,41,87,16,22,17,5,90
"2011","Solihull 025E","E01010171",995,201,61,140,282,113,103,48,93,52,20,10,10,83
"2011","Solihull 026A","E01010151",1085,206,54,152,286,164,118,55,113,60,30,21,9,53
"2011","Solihull 026B","E01010152",1042,254,53,201,301,159,66,41,83,38,11,9,2,89
"2011","Solihull 026C","E01010153",1097,256,76,180,359,116,114,42,71,29,41,34,7,69
"2011","Solihull 026D","E01010154",1111,277,80,197,325,148,126,42,69,29,22,14,8,73
"2011","Solihull 026E","E01010155",1065,231,50,181,306,160,110,32,95,49,18,15,3,64
"2011","Solihull 026F","E01010156",1135,242,70,172,359,190,98,39,76,37,18,10,8,76
"2011","Solihull 027A","E01010212",1073,229,46,183,315,158,91,27,87,43,22,17,5,101
"2011","Solihull 027B","E01010214",959,187,40,147,251,165,78,48,108,52,15,4,11,55
"2011","Solihull 027C","E01010215",1251,220,43,177,345,207,108,53,127,70,28,14,14,93
"2011","Solihull 027D","E01010216",1161,236,56,180,353,158,93,40,109,63,31,22,9,78
"2011","Solihull 028A","E01010150",1146,297,72,225,330,182,108,29,99,33,6,3,3,62
"2011","Solihull 028B","E01010184",997,133,24,109,292,148,96,51,107,55,42,31,11,73
"2011","Solihull 028C","E01010185",1062,276,62,214,331,139,100,23,65,23,21,16,5,84
"2011","Solihull 028D","E01010186",1316,289,63,226,417,181,112,48,92,52,25,11,14,100
"2011","Solihull 028E","E01010187",1058,272,70,202,323,132,87,29,65,26,13,6,7,111
"2011","Solihull 028F","E01010188",1169,322,73,249,338,161,130,22,61,33,13,2,11,89
"2011","Solihull 029A","E01010180",965,134,38,96,270,162,100,71,102,59,18,11,7,49
"2011","Solihull 029B","E01010181",1412,286,78,208,471,178,150,44,117,55,28,16,12,83
"2011","Solihull 029D","E01010183",1009,178,46,132,290,127,130,46,97,66,15,9,6,60
"2011","Solihull 029E","E01010189",1164,239,54,185,329,180,138,49,98,55,11,9,2,65
"2011","Solihull 029F","E01032885",1010,268,54,214,356,133,84,30,53,27,22,9,13,37
"2011","Solihull 029G","E01032886",1471,329,83,246,443,193,168,44,97,51,33,24,9,113
"2011","Solihull 030A","E01010220",1186,157,30,127,287,183,118,96,138,88,34,15,19,85
"2011","Solihull 030B","E01010223",868,92,17,75,201,138,76,64,118,89,37,20,17,53
"2011","Solihull 030C","E01010225",1057,121,27,94,244,183,99,81,152,72,32,14,18,73
"2011","Solihull 030D","E01032590",1264,139,34,105,283,184,107,90,178,102,60,42,18,121
"2011","Walsall 001A","E01010301",1099,41,14,27,154,103,98,93,260,200,94,58,36,56
"2011","Walsall 001B","E01010303",1143,49,19,30,157,130,113,102,248,203,74,48,26,67
"2011","Walsall 001C","E01010306",1470,112,32,80,303,194,136,125,229,210,88,62,26,73
"2011","Walsall 001D","E01010307",1279,119,41,78,291,216,125,96,190,117,27,11,16,98
"2011","Walsall 002A","E01010302",1106,29,10,19,114,89,110,103,260,235,96,63,33,70
"2011","Walsall 002B","E01010304",1275,75,22,53,216,170,102,146,226,207,77,43,34,56
"2011","Walsall 002C","E01010305",994,35,11,24,93,105,85,68,231,202,94,62,32,81
"2011","Walsall 002D","E01010308",927,42,12,30,122,92,66,84,204,169,112,67,45,36
"2011","Walsall 003A","E01010345",837,69,16,53,181,138,83,72,127,114,18,10,8,35
"2011","Walsall 003B","E01010346",1040,79,25,54,224,186,78,101,163,118,26,16,10,65
"2011","Walsall 003C","E01010347",1042,50,17,33,120,109,85,76,215,218,113,66,47,56
"2011","Walsall 003D","E01010350",1054,100,37,63,227,162,84,80,159,132,41,22,19,69
"2011","Walsall 004A","E01010249",1312,77,24,53,231,180,131,117,240,188,85,40,45,63
"2011","Walsall 004B","E01010250",1037,71,27,44,212,144,96,80,155,162,47,25,22,70
"2011","Walsall 004C","E01010252",1275,67,16,51,206,135,135,115,251,209,82,45,37,75
"2011","Walsall 004D","E01010254",1090,49,11,38,182,131,90,96,221,186,75,46,29,60
"2011","Walsall 005A","E01010348",1013,64,24,40,174,124,84,92,188,171,58,29,29,58
"2011","Walsall 005B","E01010349",891,53,19,34,136,116,89,80,191,131,47,29,18,48
"2011","Walsall 005C","E01010351",1230,95,34,61,240,196,123,98,183,167,60,34,26,68
"2011","Walsall 005D","E01010352",1169,111,46,65,256,190,127,95,165,119,36,23,13,70
"2011","Walsall 006A","E01010284",1071,42,13,29,138,128,83,94,229,204,96,65,31,57
"2011","Walsall 006B","E01010285",1211,85,33,52,213,183,142,103,205,161,60,40,20,59
"2011","Walsall 006C","E01010286",1147,30,8,22,93,92,89,94,246,258,181,111,70,64
"2011","Walsall 006D","E01010290",1193,47,17,30,169,133,105,108,242,209,108,62,46,72
"2011","Walsall 007A","E01010251",1079,149,40,109,282,168,119,57,117,85,27,16,11,75
"2011","Walsall 007B","E01010253",891,50,12,38,150,87,85,82,166,157,57,43,14,57
"2011","Walsall 007C","E01010255",957,118,37,81,252,169,90,67,138,71,18,8,10,34
"2011","Walsall 007D","E01010256",1127,88,21,67,216,183,95,100,181,140,60,31,29,64
"2011","Walsall 007E","E01010257",907,100,31,69,242,159,88,58,125,62,18,9,9,55
"2011","Walsall 008A","E01010292",1240,32,14,18,150,116,110,97,251,267,170,99,71,47
"2011","Walsall 008B","E01010294",1072,19,7,12,120,77,76,91,246,245,119,81,38,79
"2011","Walsall 008C","E01010296",1158,137,43,94,286,200,102,81,138,90,28,17,11,96
"2011","Walsall 008D","E01010297",1054,148,55,93,269,168,110,65,119,91,22,16,6,62
"2011","Walsall 009A","E01010291",949,18,6,12,103,72,64,73,221,210,122,67,55,66
"2011","Walsall 009B","E01010293",1079,44,16,28,140,111,74,92,220,243,98,59,39,57
"2011","Walsall 009C","E01010298",866,40,7,33,130,97,73,83,176,162,58,40,18,47
"2011","Walsall 009D","E01010299",1043,28,12,16,91,87,82,105,237,224,97,51,46,92
"2011","Walsall 009E","E01010300",1011,24,6,18,95,85,66,97,232,239,120,68,52,53
"2011","Walsall 010A","E01010319",1102,93,25,68,247,189,110,73,157,89,42,23,19,102
"2011","Walsall 010B","E01010321",1127,47,14,33,159,125,113,89,210,210,96,52,44,78
"2011","Walsall 010C","E01010353",1093,67,22,45,188,163,92,68,175,212,61,40,21,67
"2011","Walsall 010D","E01010354",1109,65,14,51,179,185,78,103,180,185,75,53,22,59
"2011","Walsall 011A","E01010395",1093,97,37,60,216,162,105,78,185,116,43,26,17,91
"2011","Walsall 011B","E01010397",1157,29,11,18,135,134,81,92,247,234,132,81,51,73
"2011","Walsall 011C","E01010398",1272,106,32,74,313,224,117,94,167,117,38,27,11,96
"2011","Walsall 011D","E01010399",1224,72,22,50,232,192,115,104,213,151,66,34,32,79
"2011","Walsall 012A","E01010282",903,18,7,11,94,91,53,68,195,194,115,69,46,75
"2011","Walsall 012B","E01010287",1023,42,10,32,125,106,76,95,213,195,109,75,34,62
"2011","Walsall 012C","E01010288",1145,25,6,19,104,96,62,92,265,278,147,82,65,76
"2011","Walsall 012D","E01010289",1134,21,7,14,109,83,57,94,224,275,206,151,55,65
"2011","Walsall 013B","E01010277",1141,38,14,24,139,117,75,88,225,225,143,101,42,91
"2011","Walsall 013D","E01010283",1307,31,12,19,136,105,90,101,254,289,205,126,79,96
"2011","Walsall 013E","E01032889",1304,27,8,19,109,89,109,114,258,301,203,145,58,94
"2011","Walsall 014A","E01010393",1138,55,16,39,191,155,98,117,227,163,57,35,22,75
"2011","Walsall 014B","E01010394",1087,67,14,53,175,162,101,102,185,191,45,36,9,59
"2011","Walsall 014C","E01010396",1124,43,16,27,161,126,91,109,219,228,77,52,25,70
"2011","Walsall 014D","E01010400",1339,40,12,28,178,146,92,119,286,277,157,98,59,44
"2011","Walsall 015A","E01010241",1595,196,51,145,424,265,143,101,178,137,61,39,22,90
"2011","Walsall 015B","E01010242",1128,52,13,39,168,136,89,111,209,224,82,44,38,57
"2011","Walsall 015C","E01010243",987,106,30,76,220,149,75,86,162,102,28,16,12,59
"2011","Walsall 015D","E01010244",1001,45,13,32,170,100,58,85,168,186,131,82,49,58
"2011","Walsall 016A","E01010320",987,44,11,33,151,132,71,87,189,185,72,47,25,56
"2011","Walsall 016B","E01010322",1092,55,9,46,182,161,84,98,207,194,53,33,20,58
"2011","Walsall 016C","E01010323",1054,60,19,41,160,129,100,104,194,197,56,28,28,54
"2011","Walsall 016D","E01010324",1117,73,17,56,230,152,108,81,185,139,77,46,31,72
"2011","Walsall 017A","E01010271",1243,26,9,17,139,112,74,88,255,305,145,90,55,99
"2011","Walsall 017B","E01010272",1111,26,6,20,86,81,41,95,258,262,196,124,72,66
"2011","Walsall 017C","E01010273",1036,24,6,18,72,94,66,78,240,241,147,87,60,74
"2011","Walsall 017D","E01010295",1061,19,7,12,97,78,58,91,251,269,130,76,54,68
"2011","Walsall 018B","E01010279",1169,57,16,41,146,105,83,109,210,235,170,112,58,54
"2011","Walsall 018D","E01010374",1194,24,4,20,87,100,92,75,242,231,230,164,66,113
"2011","Walsall 018E","E01010375",1445,51,9,42,158,117,120,81,206,226,320,254,66,166
"2011","Walsall 018F","E01032888",1810,31,11,20,146,125,96,135,405,439,323,217,106,110
"2011","Walsall 019A","E01010378",982,48,16,32,149,160,61,112,197,153,45,28,17,57
"2011","Walsall 019B","E01010379",1008,73,22,51,150,166,89,102,194,148,33,22,11,53
"2011","Walsall 019C","E01010382",1171,49,26,23,175,151,79,113,262,191,76,41,35,75
"2011","Walsall 019D","E01010383",1015,44,21,23,132,107,73,87,246,186,81,45,36,59
"2011","Walsall 020A","E01010376",1114,74,17,57,184,186,75,100,217,154,40,25,15,84
"2011","Walsall 020B","E01010377",1072,70,20,50,145,138,93,104,225,183,49,30,19,65
"2011","Walsall 020C","E01010380",1149,87,28,59,222,179,96,117,208,149,30,15,15,61
"2011","Walsall 020D","E01010381",1110,55,22,33,164,115,82,99,248,180,103,43,60,64
"2011","Walsall 021A","E01010267",1244,65,27,38,220,177,121,104,254,193,60,44,16,50
"2011","Walsall 021B","E01010268",1176,30,7,23,124,79,85,80,221,203,250,199,51,104
"2011","Walsall 021C","E01010274",1101,18,9,9,93,80,56,101,256,264,155,100,55,78
"2011","Walsall 021D","E01010275",1038,25,8,17,107,89,69,96,240,231,121,75,46,60
"2011","Walsall 022A","E01010245",1093,111,35,76,292,188,108,73,151,68,23,10,13,79
"2011","Walsall 022B","E01010246",1136,101,32,69,267,178,109,88,170,93,43,23,20,87
"2011","Walsall 022C","E01010247",1140,91,18,73,278,175,103,101,152,109,46,29,17,85
"2011","Walsall 022D","E01010248",1182,158,51,107,313,200,154,69,118,60,26,15,11,84
"2011","Walsall 022E","E01010388",1118,171,48,123,288,194,134,60,104,57,30,23,7,80
"2011","Walsall 023A","E01010258",1164,31,7,24,118,90,50,91,271,278,145,91,54,90
"2011","Walsall 023B","E01010259",1141,47,16,31,168,163,67,97,259,190,67,51,16,83
"2011","Walsall 023C","E01010260",1116,44,13,31,150,140,72,102,225,211,104,61,43,68
"2011","Walsall 023D","E01010266",988,23,7,16,114,96,64,80,197,221,111,73,38,82
"2011","Walsall 024A","E01010317",1171,178,32,146,325,169,124,50,107,77,62,45,17,79
"2011","Walsall 024B","E01010318",1168,77,22,55,171,124,67,84,206,178,153,90,63,108
"2011","Walsall 024C","E01010325",1239,136,35,101,311,155,96,84,157,108,103,78,25,89
"2011","Walsall 024D","E01010369",1425,90,14,76,208,141,83,89,231,210,234,158,76,139
"2011","Walsall 025A","E01010401",1049,34,16,18,122,108,49,86,236,209,132,78,54,73
"2011","Walsall 025B","E01010403",1228,50,9,41,160,143,78,76,261,200,151,82,69,109
"2011","Walsall 025C","E01010404",1296,52,20,32,156,168,82,99,284,208,138,88,50,109
"2011","Walsall 025D","E01010407",1206,55,16,39,180,135,81,124,255,201,84,64,20,91
"2011","Walsall 025E","E01010408",1128,49,15,34,134,115,74,99,239,227,135,87,48,56
"2011","Walsall 026A","E01010269",1036,24,5,19,87,84,74,71,151,181,271,226,45,93
"2011","Walsall 026B","E01010270",1282,51,13,38,160,140,109,107,249,216,141,102,39,109
"2011","Walsall 026C","E01010362",1165,32,7,25,122,114,77,76,222,206,195,137,58,121
"2011","Walsall 026D","E01010363",1347,63,7,56,194,129,95,97,217,223,213,160,53,116
"2011","Walsall 027A","E01010402",1237,77,20,57,212,169,105,108,211,202,80,55,25,73
"2011","Walsall 027B","E01010405",1254,71,21,50,196,144,101,121,237,182,114,72,42,88
"2011","Walsall 027C","E01010406",1878,116,33,83,294,206,122,142,374,307,198,118,80,119
"2011","Walsall 027D","E01010409",1214,53,15,38,162,149,68,91,258,231,123,67,56,79
"2011","Walsall 028A","E01010385",1158,222,65,157,346,162,145,29,93,34,37,25,12,90
"2011","Walsall 028B","E01010386",1064,159,48,111,309,159,112,65,108,64,23,11,12,65
"2011","Walsall 028C","E01010387",1138,130,37,93,259,205,102,95,142,82,29,16,13,94
"2011","Walsall 028D","E01010392",1107,157,48,109,313,182,112,70,119,50,28,15,13,76
"2011","Walsall 029A","E01010326",1211,161,30,131,290,134,152,45,128,95,97,71,26,109
"2011","Walsall 029B","E01010327",1125,70,13,57,184,107,102,58,159,143,186,152,34,116
"2011","Walsall 029C","E01010328",1039,165,36,129,268,165,125,45,89,58,42,34,8,82
"2011","Walsall 029D","E01010330",1031,108,33,75,211,113,97,56,140,88,116,91,25,102
"2011","Walsall 030A","E01010368",1467,55,10,45,197,113,88,86,258,281,290,179,111,99
"2011","Walsall 030B","E01010370",1351,91,14,77,213,122,70,81,202,209,248,194,54,115
"2011","Walsall 030C","E01010371",1619,38,7,31,135,97,89,120,259,273,392,309,83,216
"2011","Walsall 030D","E01010372",1161,62,18,44,177,86,88,73,183,145,205,153,52,142
"2011","Walsall 030E","E01010373",1449,156,28,128,240,126,117,51,116,79,84,69,15,480
"2011","Walsall 031A","E01010361",1103,56,14,42,195,161,86,96,201,143,86,67,19,79
"2011","Walsall 031B","E01010364",1021,36,5,31,85,84,73,64,175,193,191,148,43,120
"2011","Walsall 031C","E01010365",1035,30,2,28,89,92,71,56,193,169,219,182,37,116
"2011","Walsall 031D","E01010366",1211,35,9,26,102,88,88,77,240,228,227,162,65,126
"2011","Walsall 031E","E01010367",1163,32,4,28,87,100,63,75,231,248,220,167,53,107
"2011","Walsall 032A","E01010384",1096,117,27,90,262,184,98,80,157,96,28,18,10,74
"2011","Walsall 032B","E01010389",1098,167,56,111,287,154,120,46,123,62,53,39,14,86
"2011","Walsall 032C","E01010390",1318,135,37,98,313,233,123,96,188,123,32,22,10,75
"2011","Walsall 032D","E01010391",1474,150,37,113,330,264,160,116,203,129,30,21,9,92
"2011","Walsall 033A","E01010261",1149,24,7,17,121,143,72,104,288,205,110,68,42,82
"2011","Walsall 033B","E01010263",1151,43,12,31,125,96,84,84,190,193,239,191,48,97
"2011","Walsall 033C","E01010264",1139,52,15,37,157,106,75,91,254,175,133,104,29,96
"2011","Walsall 033D","E01010265",1282,35,3,32,139,111,88,79,254,224,232,186,46,120
"2011","Walsall 034A","E01010336",1137,61,9,52,159,95,92,95,165,159,189,145,44,122
"2011","Walsall 034B","E01010340",1178,31,5,26,105,86,93,66,183,151,328,276,52,135
"2011","Walsall 034C","E01010341",1124,35,1,34,100,76,84,65,192,124,313,261,52,135
"2011","Walsall 034D","E01010342",1076,31,5,26,92,77,99,54,167,133,248,215,33,175
"2011","Walsall 034E","E01010343",1023,35,3,32,97,84,74,74,168,131,241,202,39,119
"2011","Walsall 034F","E01010344",1107,33,8,25,125,87,71,96,187,176,209,167,42,123
"2011","Walsall 035A","E01010331",1222,171,33,138,316,187,120,56,159,80,43,35,8,90
"2011","Walsall 035B","E01010332",1305,227,40,187,321,174,186,40,109,72,73,51,22,103
"2011","Walsall 035C","E01010333",1184,159,38,121,317,189,108,60,120,81,53,36,17,97
"2011","Walsall 035D","E01010334",1126,213,40,173,293,150,142,43,87,51,45,37,8,102
"2011","Walsall 036A","E01010262",1139,53,12,41,170,116,90,105,227,206,105,66,39,67
"2011","Walsall 036B","E01010309",1319,50,16,34,160,132,80,116,339,211,139,81,58,92
"2011","Walsall 036C","E01010311",1157,48,15,33,133,111,79,86,265,208,143,96,47,84
"2011","Walsall 036D","E01010316",1144,28,6,22,105,96,68,93,291,260,136,81,55,67
"2011","Walsall 037A","E01010335",1145,48,14,34,124,114,70,79,247,191,166,105,61,106
"2011","Walsall 037B","E01010337",1009,65,10,55,178,132,73,76,167,132,104,73,31,82
"2011","Walsall 037C","E01010338",1231,47,12,35,147,113,124,67,205,187,201,165,36,140
"2011","Walsall 037D","E01010339",1077,83,20,63,208,104,96,80,177,129,95,80,15,105
"2011","Walsall 038A","E01010310",1201,43,10,33,116,128,71,98,253,268,114,77,37,110
"2011","Walsall 038B","E01010312",1198,42,13,29,159,123,67,116,239,239,122,80,42,91
"2011","Walsall 038C","E01010313",1038,21,9,12,101,111,55,101,256,225,94,60,34,74
"2011","Walsall 038D","E01010314",1125,26,7,19,115,82,56,100,263,260,129,89,40,94
"2011","Walsall 038E","E01010315",955,52,13,39,123,105,55,73,186,201,103,65,38,57
"2011","Walsall 039A","E01010329",1106,133,31,102,301,177,121,56,111,70,31,18,13,106
"2011","Walsall 039B","E01010355",995,60,13,47,165,191,90,77,162,154,36,22,14,60
"2011","Walsall 039C","E01010356",1092,85,25,60,205,170,102,86,179,157,31,21,10,77
"2011","Walsall 039D","E01010357",1380,174,43,131,291,245,107,102,232,116,31,15,16,82
"2011","Walsall 039E","E01010358",1059,59,21,38,190,162,80,104,197,160,30,18,12,77
"2011","Walsall 039F","E01010359",1123,74,28,46,215,175,87,97,232,127,33,19,14,83
"2011","Walsall 039G","E01010360",1068,75,22,53,185,198,99,87,183,122,38,21,17,81
"2011","Wolverhampton 001A","E01010434",1233,55,13,42,200,166,68,118,242,204,93,55,38,87
"2011","Wolverhampton 001B","E01010436",1104,92,22,70,226,177,82,88,208,119,29,16,13,83
"2011","Wolverhampton 001C","E01010437",1000,97,28,69,218,172,90,84,159,100,18,10,8,62
"2011","Wolverhampton 001D","E01010438",1026,63,24,39,185,155,69,94,196,147,52,34,18,65
"2011","Wolverhampton 001E","E01010439",936,32,14,18,110,112,53,57,226,161,100,58,42,85
"2011","Wolverhampton 001F","E01010440",1073,23,13,10,118,108,63,87,243,224,114,68,46,93
"2011","Wolverhampton 001G","E01010441",998,26,9,17,123,99,52,69,241,193,113,77,36,82
"2011","Wolverhampton 002A","E01010495",1181,44,11,33,189,154,87,92,246,214,86,57,29,69
"2011","Wolverhampton 002B","E01010497",966,90,27,63,240,140,92,72,133,83,33,24,9,83
"2011","Wolverhampton 002C","E01010499",985,61,11,50,184,123,65,80,198,126,67,45,22,81
"2011","Wolverhampton 002D","E01010500",934,21,4,17,103,89,65,63,194,166,129,87,42,104
"2011","Wolverhampton 003A","E01010496",1025,62,17,45,171,153,64,74,188,146,87,35,52,80
"2011","Wolverhampton 003B","E01010498",1176,86,23,63,294,211,71,89,178,136,30,16,14,81
"2011","Wolverhampton 003C","E01010541",1064,26,7,19,111,106,65,91,238,206,135,65,70,86
"2011","Wolverhampton 003D","E01010543",1023,29,5,24,133,102,47,104,213,184,138,80,58,73
"2011","Wolverhampton 004A","E01010456",943,14,5,9,70,47,31,61,193,212,211,149,62,104
"2011","Wolverhampton 004B","E01010457",1105,46,15,31,213,158,105,99,207,153,59,40,19,65
"2011","Wolverhampton 004C","E01010462",1099,22,4,18,113,106,60,82,227,245,155,110,45,89
"2011","Wolverhampton 004D","E01010481",1053,26,6,20,95,77,43,88,255,214,157,103,54,98
"2011","Wolverhampton 005A","E01010555",1050,34,5,29,98,125,51,94,264,218,97,56,41,69
"2011","Wolverhampton 005B","E01010556",1061,51,19,32,166,151,71,94,205,188,62,40,22,73
"2011","Wolverhampton 005C","E01010557",1092,66,19,47,175,187,85,112,207,154,38,20,18,68
"2011","Wolverhampton 005D","E01010559",999,30,9,21,103,121,53,93,264,204,75,47,28,56
"2011","Wolverhampton 005E","E01010560",1152,35,12,23,134,110,73,116,292,251,68,32,36,73
"2011","Wolverhampton 006A","E01010435",959,36,8,28,134,76,51,74,206,159,149,105,44,74
"2011","Wolverhampton 006B","E01010501",1006,40,12,28,148,127,77,98,196,165,81,42,39,74
"2011","Wolverhampton 006C","E01010502",973,58,15,43,199,122,91,80,175,111,56,31,25,81
"2011","Wolverhampton 006D","E01010503",993,58,10,48,146,97,80,85,196,156,94,55,39,81
"2011","Wolverhampton 007A","E01010482",913,20,5,15,83,89,52,63,209,177,127,82,45,93
"2011","Wolverhampton 007B","E01010483",934,13,6,7,78,65,35,55,218,209,164,109,55,97
"2011","Wolverhampton 007C","E01010484",961,23,6,17,91,84,52,69,215,191,154,101,53,82
"2011","Wolverhampton 007D","E01010485",1112,34,6,28,131,97,69,64,222,182,220,174,46,93
"2011","Wolverhampton 008A","E01010458",1223,39,8,31,142,181,82,108,273,246,76,44,32,76
"2011","Wolverhampton 008B","E01010459",1208,66,20,46,193,159,85,88,244,194,78,48,30,101
"2011","Wolverhampton 008C","E01010460",1186,67,18,49,222,179,80,108,199,183,49,33,16,99
"2011","Wolverhampton 008D","E01010461",1150,93,21,72,188,174,90,104,186,172,55,33,22,88
"2011","Wolverhampton 008E","E01010566",1236,44,8,36,172,166,102,129,252,194,99,68,31,78
"2011","Wolverhampton 009A","E01010539",1177,115,26,89,284,179,105,87,145,117,69,42,27,76
"2011","Wolverhampton 009B","E01010540",973,198,59,139,297,133,92,31,75,46,32,19,13,69
"2011","Wolverhampton 009C","E01010542",1097,70,18,52,231,163,82,99,161,138,75,45,30,78
"2011","Wolverhampton 009D","E01010544",1022,98,22,76,246,171,110,70,125,93,35,23,12,74
"2011","Wolverhampton 009E","E01010545",1199,112,24,88,272,182,102,92,180,126,64,41,23,69
"2011","Wolverhampton 010A","E01010554",1012,71,18,53,169,142,90,98,185,156,41,27,14,60
"2011","Wolverhampton 010B","E01010558",1203,64,19,45,200,192,78,114,238,186,54,34,20,77
"2011","Wolverhampton 010C","E01010562",1133,58,22,36,161,172,76,119,212,184,98,50,48,53
"2011","Wolverhampton 010D","E01010563",1081,32,9,23,141,126,68,99,217,221,110,52,58,67
"2011","Wolverhampton 010E","E01010567",1052,30,9,21,135,124,59,82,242,229,92,51,41,59
"2011","Wolverhampton 011A","E01010478",996,21,7,14,65,59,59,62,229,210,181,135,46,110
"2011","Wolverhampton 011B","E01010479",1148,45,10,35,148,119,69,92,219,208,147,95,52,101
"2011","Wolverhampton 011C","E01010480",901,36,10,26,157,105,63,78,176,139,74,41,33,73
"2011","Wolverhampton 011D","E01010486",1131,18,2,16,94,66,48,77,235,234,227,157,70,132
"2011","Wolverhampton 012A","E01010474",1140,32,12,20,129,130,87,95,229,225,114,78,36,99
"2011","Wolverhampton 012B","E01010561",1181,82,30,52,208,195,100,106,218,148,44,27,17,80
"2011","Wolverhampton 012C","E01010564",1450,77,15,62,208,153,101,101,266,269,159,108,51,116
"2011","Wolverhampton 012D","E01010565",1414,117,35,82,260,224,111,121,254,176,66,44,22,85
"2011","Wolverhampton 013A","E01010522",1208,60,9,51,125,106,80,80,191,191,222,169,53,153
"2011","Wolverhampton 013B","E01010523",1194,84,18,66,198,105,99,64,192,195,113,72,41,144
"2011","Wolverhampton 013C","E01010524",1069,47,14,33,125,71,66,80,203,175,176,136,40,126
"2011","Wolverhampton 013D","E01010525",1000,44,7,37,135,71,58,66,207,174,141,104,37,104
"2011","Wolverhampton 014A","E01010546",1026,209,59,150,289,136,132,27,70,51,26,23,3,86
"2011","Wolverhampton 014B","E01010547",1101,178,36,142,290,167,131,52,107,62,36,21,15,78
"2011","Wolverhampton 014C","E01010548",903,125,30,95,204,103,80,47,147,101,46,32,14,50
"2011","Wolverhampton 014D","E01010549",1108,112,18,94,238,145,105,71,152,119,69,39,30,97
"2011","Wolverhampton 014E","E01010553",1105,181,46,135,288,140,127,50,108,83,56,29,27,72
"2011","Wolverhampton 015A","E01010471",1259,30,4,26,117,109,80,87,263,264,211,132,79,98
"2011","Wolverhampton 015B","E01010472",1380,58,6,52,154,122,80,74,306,236,194,125,69,156
"2011","Wolverhampton 015C","E01010473",1739,30,8,22,127,87,70,109,394,331,404,269,135,187
"2011","Wolverhampton 015D","E01010475",1207,82,21,61,219,124,100,73,211,214,74,57,17,110
"2011","Wolverhampton 015E","E01010476",1404,52,15,37,222,110,73,113,311,273,151,96,55,99
"2011","Wolverhampton 015F","E01010477",1244,39,7,32,174,123,67,83,266,216,161,113,48,115
"2011","Wolverhampton 016A","E01010526",1040,22,6,16,93,71,65,54,180,172,194,154,40,189
"2011","Wolverhampton 016B","E01010527",1370,24,4,20,117,78,114,79,237,236,272,217,55,213
"2011","Wolverhampton 016C","E01010528",1621,22,2,20,84,23,43,44,128,127,153,93,60,997
"2011","Wolverhampton 016D","E01010529",1317,45,10,35,90,56,60,59,178,160,216,154,62,453
"2011","Wolverhampton 017A","E01010506",1395,129,29,100,331,177,103,79,156,134,117,58,59,169
"2011","Wolverhampton 017B","E01010508",1161,103,15,88,192,122,80,91,162,146,119,71,48,146
"2011","Wolverhampton 017C","E01010510",1266,125,18,107,295,140,104,84,206,97,103,55,48,112
"2011","Wolverhampton 017D","E01010511",1209,81,15,66,187,96,72,57,196,164,161,120,41,195
"2011","Wolverhampton 017E","E01010512",1080,105,23,82,255,121,66,54,145,99,110,86,24,125
"2011","Wolverhampton 018A","E01010442",953,29,6,23,103,88,60,77,204,203,119,84,35,70
"2011","Wolverhampton 018B","E01010443",1139,14,6,8,113,90,45,84,267,253,163,100,63,110
"2011","Wolverhampton 018C","E01010444",1035,34,11,23,134,107,62,84,203,241,94,63,31,76
"2011","Wolverhampton 018D","E01010445",954,32,16,16,81,74,57,52,192,202,167,118,49,97
"2011","Wolverhampton 018E","E01010447",1336,36,11,25,174,146,78,122,290,262,131,71,60,97
"2011","Wolverhampton 018F","E01010448",1116,41,13,28,143,125,59,108,236,218,122,78,44,64
"2011","Wolverhampton 019A","E01010509",1056,79,20,59,195,163,90,79,169,148,67,33,34,66
"2011","Wolverhampton 019B","E01010550",1185,236,81,155,315,155,144,45,114,57,29,21,8,90
"2011","Wolverhampton 019C","E01010551",1204,204,51,153,359,154,124,69,118,70,38,25,13,68
"2011","Wolverhampton 019D","E01010552",1292,103,33,70,290,174,127,86,194,170,61,37,24,87
"2011","Wolverhampton 020A","E01010463",1245,78,15,63,177,123,79,84,190,184,219,129,90,111
"2011","Wolverhampton 020B","E01010464",1146,31,5,26,142,99,69,65,227,183,248,164,84,82
"2011","Wolverhampton 020C","E01010465",1138,63,13,50,179,127,82,81,177,160,158,101,57,111
"2011","Wolverhampton 020D","E01010466",1068,34,9,25,113,84,83,55,176,194,199,141,58,130
"2011","Wolverhampton 020E","E01010470",1033,44,11,33,129,102,63,69,186,181,167,104,63,92
"2011","Wolverhampton 020F","E01010521",2214,130,16,114,274,178,67,84,199,163,189,122,67,930
"2011","Wolverhampton 021A","E01010487",1107,112,30,82,300,178,113,77,128,78,45,21,24,76
"2011","Wolverhampton 021B","E01010488",1011,73,22,51,211,144,96,82,157,130,50,30,20,68
"2011","Wolverhampton 021C","E01010493",1095,146,32,114,309,153,98,69,115,68,43,26,17,94
"2011","Wolverhampton 021D","E01010504",978,154,25,129,267,119,98,41,80,64,38,29,9,117
"2011","Wolverhampton 021E","E01010505",971,156,22,134,305,123,78,37,108,58,35,23,12,71
"2011","Wolverhampton 021F","E01010507",1010,145,28,117,296,152,106,45,97,66,39,28,11,64
"2011","Wolverhampton 022A","E01010418",1168,81,20,61,185,163,79,109,244,179,56,31,25,72
"2011","Wolverhampton 022B","E01010421",1120,23,6,17,126,104,42,70,236,244,172,110,62,103
"2011","Wolverhampton 022C","E01010423",1127,17,8,9,112,106,57,79,278,251,134,89,45,93
"2011","Wolverhampton 022D","E01010424",1180,68,20,48,178,138,90,123,241,190,74,44,30,78
"2011","Wolverhampton 023A","E01010417",1178,31,12,19,134,111,43,100,298,249,146,89,57,66
"2011","Wolverhampton 023B","E01010419",1016,40,14,26,131,120,54,81,233,183,102,65,37,72
"2011","Wolverhampton 023C","E01010420",928,38,12,26,99,85,52,95,191,212,91,51,40,65
"2011","Wolverhampton 023D","E01010425",983,24,6,18,125,102,54,79,234,210,82,53,29,73
"2011","Wolverhampton 023E","E01010446",1194,45,15,30,162,144,95,112,252,198,96,59,37,90
"2011","Wolverhampton 026A","E01010467",1181,107,28,79,245,142,110,59,160,124,130,88,42,104
"2011","Wolverhampton 026B","E01010468",1064,91,18,73,255,124,71,79,170,124,69,43,26,81
"2011","Wolverhampton 026C","E01010469",1090,80,16,64,281,156,102,64,149,119,63,44,19,76
"2011","Wolverhampton 026D","E01010516",1074,120,25,95,295,170,100,62,115,76,44,35,9,92
"2011","Wolverhampton 026E","E01010518",1145,148,16,132,300,124,99,68,154,91,62,48,14,99
"2011","Wolverhampton 027A","E01010414",1405,47,6,41,138,105,79,95,295,310,235,138,97,101
"2011","Wolverhampton 027B","E01010415",1166,43,9,34,124,105,67,76,238,229,171,118,53,113
"2011","Wolverhampton 027C","E01010416",1171,29,4,25,140,95,67,72,240,245,201,151,50,82
"2011","Wolverhampton 027D","E01010422",1232,75,24,51,162,131,112,92,239,200,123,83,40,98
"2011","Wolverhampton 028A","E01010489",1120,72,15,57,203,160,81,86,185,157,81,47,34,95
"2011","Wolverhampton 028B","E01010490",1233,40,11,29,172,115,104,102,280,208,146,77,69,66
"2011","Wolverhampton 028C","E01010491",1039,47,13,34,164,112,78,97,200,183,89,53,36,69
"2011","Wolverhampton 028D","E01010492",1037,109,28,81,237,181,90,79,142,83,35,17,18,81
"2011","Wolverhampton 028E","E01010494",1131,137,41,96,305,158,107,75,130,86,43,27,16,90
"2011","Wolverhampton 029A","E01010449",1690,73,8,65,231,174,83,87,314,289,276,181,95,163
"2011","Wolverhampton 029B","E01010450",1215,23,4,19,158,114,61,92,254,248,188,127,61,77
"2011","Wolverhampton 029C","E01010451",1183,73,17,56,188,146,82,76,221,188,117,83,34,92
"2011","Wolverhampton 029D","E01010452",1118,30,9,21,133,95,62,84,278,223,134,93,41,79
"2011","Wolverhampton 029E","E01010455",1313,35,9,26,138,89,73,110,259,279,223,143,80,107
"2011","Wolverhampton 030A","E01010427",1222,86,16,70,180,126,106,64,231,178,147,107,40,104
"2011","Wolverhampton 030B","E01010431",1209,99,19,80,211,128,134,47,201,147,105,79,26,137
"2011","Wolverhampton 030C","E01010432",1172,97,17,80,191,137,97,62,201,185,82,56,26,120
"2011","Wolverhampton 030D","E01010519",1166,163,33,130,271,133,89,64,132,107,88,64,24,119
"2011","Wolverhampton 030E","E01010520",1206,143,29,114,298,179,86,59,162,124,52,32,20,103
"2011","Wolverhampton 031A","E01010513",1028,147,40,107,260,159,107,49,125,69,48,38,10,64
"2011","Wolverhampton 031B","E01010514",1182,125,37,88,314,190,111,82,139,104,44,20,24,73
"2011","Wolverhampton 031C","E01010515",1198,147,39,108,337,191,113,69,135,78,46,26,20,82
"2011","Wolverhampton 031D","E01010517",1179,92,14,78,258,177,78,72,170,127,99,67,32,106
"2011","Wolverhampton 032A","E01010533",1177,56,10,46,150,119,62,117,240,195,146,86,60,92
"2011","Wolverhampton 032B","E01010535",1043,33,18,15,104,107,60,87,207,239,118,62,56,88
"2011","Wolverhampton 032C","E01010536",1158,107,29,78,180,174,65,97,211,170,72,43,29,82
"2011","Wolverhampton 032D","E01010537",1073,72,19,53,182,216,82,111,190,136,28,15,13,56
"2011","Wolverhampton 033A","E01010410",1194,24,10,14,141,114,68,83,270,272,157,87,70,65
"2011","Wolverhampton 033B","E01010411",1162,48,14,34,139,122,81,112,231,224,119,68,51,86
"2011","Wolverhampton 033C","E01010412",1469,72,14,58,199,166,81,113,330,280,144,97,47,84
"2011","Wolverhampton 033D","E01010413",1155,31,8,23,100,98,82,106,286,240,140,90,50,72
"2011","Wolverhampton 034A","E01010531",1212,41,16,25,161,137,87,99,284,228,93,55,38,82
"2011","Wolverhampton 034B","E01010532",1201,28,13,15,143,142,91,90,246,219,160,104,56,82
"2011","Wolverhampton 034C","E01010534",1196,91,21,70,195,150,120,76,188,166,101,65,36,109
"2011","Wolverhampton 034D","E01010538",1150,57,14,43,153,143,76,106,238,203,91,45,46,83
"2011","Wolverhampton 035A","E01010426",1121,73,27,46,157,124,78,51,181,149,125,91,34,183
"2011","Wolverhampton 035B","E01010428",1064,28,5,23,87,66,56,75,204,184,193,158,35,171
"2011","Wolverhampton 035C","E01010429",921,36,7,29,105,72,43,48,191,183,130,103,27,113
"2011","Wolverhampton 035D","E01010430",1253,38,8,30,120,129,69,62,267,254,171,106,65,143
"2011","Wolverhampton 035E","E01010433",795,16,4,12,53,45,58,54,156,150,156,126,30,107
"2011","Wolverhampton 035F","E01010453",1290,27,5,22,152,109,56,88,268,267,196,125,71,127
"2011","Wolverhampton 035G","E01010454",1159,44,10,34,107,93,47,74,234,211,210,138,72,139
"2011","Wolverhampton 035H","E01010530",993,41,13,28,94,71,42,50,169,222,197,150,47,107
"2011","Bromsgrove 001A","E01032138",937,196,54,142,310,125,120,25,60,26,11,8,3,64
"2011","Bromsgrove 001B","E01032139",1092,225,48,177,359,166,111,45,68,31,16,7,9,71
"2011","Bromsgrove 001C","E01032140",1113,224,52,172,310,177,109,44,80,53,17,12,5,99
"2011","Bromsgrove 001D","E01032141",1034,224,57,167,281,128,138,36,71,37,32,19,13,87
"2011","Bromsgrove 002A","E01032136",956,193,56,137,277,125,136,32,62,28,16,9,7,87
"2011","Bromsgrove 002B","E01032137",1059,210,68,142,292,130,151,48,73,56,34,25,9,65
"2011","Bromsgrove 002C","E01032168",782,93,23,70,213,99,101,47,81,70,30,11,19,48
"2011","Bromsgrove 002D","E01032169",830,124,42,82,202,121,139,48,88,51,26,13,13,31
"2011","Bromsgrove 002E","E01032176",1640,269,100,169,434,223,298,74,130,86,29,15,14,97
"2011","Bromsgrove 003A","E01032126",1535,181,50,131,315,271,157,119,204,158,42,29,13,88
"2011","Bromsgrove 003B","E01032170",1063,92,25,67,225,178,104,86,159,106,32,16,16,81
"2011","Bromsgrove 003C","E01032171",1033,87,33,54,237,165,99,88,168,90,19,15,4,80
"2011","Bromsgrove 003D","E01032172",1092,62,20,42,244,168,97,92,175,140,48,27,21,66
"2011","Bromsgrove 004A","E01032133",1148,83,22,61,246,175,122,81,185,140,51,32,19,65
"2011","Bromsgrove 004B","E01032135",1265,191,49,142,333,206,140,75,139,54,34,20,14,93
"2011","Bromsgrove 004C","E01032145",1062,162,36,126,275,174,129,67,112,62,25,19,6,56
"2011","Bromsgrove 004D","E01032147",832,88,28,60,186,144,88,54,114,88,18,15,3,52
"2011","Bromsgrove 005A","E01032134",1180,119,35,84,269,181,164,97,128,89,64,56,8,69
"2011","Bromsgrove 005B","E01032146",1193,160,51,109,314,196,144,76,131,76,26,22,4,70
"2011","Bromsgrove 005C","E01032177",843,151,38,113,215,150,91,57,81,36,19,11,8,43
"2011","Bromsgrove 005D","E01032178",929,129,29,100,218,152,140,47,110,64,13,10,3,56
"2011","Bromsgrove 006A","E01032142",1137,165,32,133,313,180,131,71,108,69,23,16,7,77
"2011","Bromsgrove 006B","E01032143",1059,257,57,200,297,133,137,37,68,35,27,20,7,68
"2011","Bromsgrove 006C","E01032144",1201,329,70,259,354,143,139,43,69,29,15,12,3,80
"2011","Bromsgrove 006D","E01032149",898,229,69,160,278,112,110,29,40,35,12,9,3,53
"2011","Bromsgrove 007A","E01032127",1210,134,38,96,280,179,133,88,171,114,43,31,12,68
"2011","Bromsgrove 007B","E01032128",1085,87,29,58,228,152,129,86,168,137,40,22,18,58
"2011","Bromsgrove 007C","E01032129",1002,95,26,69,194,134,87,84,138,131,49,21,28,90
"2011","Bromsgrove 007D","E01032152",944,67,16,51,191,114,89,87,159,150,38,23,15,49
"2011","Bromsgrove 008A","E01032148",777,152,49,103,233,109,109,28,44,33,15,9,6,54
"2011","Bromsgrove 008B","E01032150",1118,189,49,140,310,182,116,60,107,54,30,21,9,70
"2011","Bromsgrove 008C","E01032151",1037,146,45,101,289,144,143,58,100,70,21,11,10,66
"2011","Bromsgrove 008D","E01032153",1105,140,37,103,276,159,96,81,157,89,51,35,16,56
"2011","Bromsgrove 008E","E01032155",1240,184,55,129,347,188,138,79,127,68,13,8,5,96
"2011","Bromsgrove 009A","E01032122",1539,245,64,181,375,165,233,81,157,119,73,57,16,91
"2011","Bromsgrove 009B","E01032123",1133,184,47,137,287,145,189,56,101,84,27,18,9,60
"2011","Bromsgrove 009C","E01032124",1093,171,36,135,257,168,110,74,123,106,27,13,14,57
"2011","Bromsgrove 009D","E01032125",1003,158,31,127,275,153,93,56,113,80,19,13,6,56
"2011","Bromsgrove 010A","E01032154",1326,197,47,150,381,187,119,88,146,97,23,14,9,88
"2011","Bromsgrove 010B","E01032159",1242,111,16,95,266,121,111,101,235,184,42,27,15,71
"2011","Bromsgrove 010C","E01032160",1265,146,45,101,319,159,117,110,172,132,47,27,20,63
"2011","Bromsgrove 010D","E01032161",1044,64,17,47,174,98,77,97,236,171,53,34,19,74
"2011","Bromsgrove 011A","E01032156",1313,108,26,82,253,137,103,86,172,121,47,22,25,286
"2011","Bromsgrove 011B","E01032157",1049,116,27,89,241,116,113,78,158,140,51,34,17,36
"2011","Bromsgrove 011C","E01032173",1253,114,24,90,310,184,103,107,181,151,28,16,12,75
"2011","Bromsgrove 011D","E01032175",1221,120,34,86,278,184,111,111,180,123,34,21,13,80
"2011","Bromsgrove 012A","E01032158",1077,183,36,147,331,164,92,66,117,60,16,10,6,48
"2011","Bromsgrove 012B","E01032162",1332,204,51,153,396,196,111,65,158,102,20,8,12,80
"2011","Bromsgrove 012D","E01033059",1125,246,62,184,324,184,86,57,92,55,12,9,3,69
"2011","Bromsgrove 012E","E01033061",1289,273,63,210,371,201,102,62,101,77,19,10,9,83
"2011","Bromsgrove 013A","E01032130",1980,257,63,194,528,255,160,132,258,199,63,33,30,128
"2011","Bromsgrove 013B","E01032131",1212,100,33,67,184,103,94,97,226,204,97,46,51,107
"2011","Bromsgrove 013C","E01032132",1466,72,13,59,216,144,116,157,297,282,82,49,33,100
"2011","Bromsgrove 013D","E01032174",1134,122,29,93,246,137,74,84,180,143,71,35,36,77
"2011","Bromsgrove 014C","E01032166",1571,185,59,126,372,196,197,145,212,168,28,13,15,68
"2011","Bromsgrove 014E","E01033060",1844,171,53,118,295,120,286,144,173,304,275,244,31,76
"2011","Bromsgrove 014F","E01033062",1861,289,79,210,511,302,163,125,181,106,29,17,12,155
"2011","Bromsgrove 014G","E01033243",1004,125,35,90,285,148,123,76,87,81,15,9,6,64
"2011","Malvern Hills 001A","E01032193",1648,250,60,190,381,142,327,106,186,133,34,21,13,89
"2011","Malvern Hills 001B","E01032212",1417,204,59,145,362,147,308,64,140,103,26,20,6,63
"2011","Malvern Hills 001C","E01032213",1191,145,41,104,289,126,259,48,96,76,22,15,7,130
"2011","Malvern Hills 001D","E01032214",1499,91,27,64,256,134,203,141,309,218,69,41,28,78
"2011","Malvern Hills 002A","E01032181",1534,246,64,182,364,182,288,87,152,116,31,17,14,68
"2011","Malvern Hills 002B","E01032190",1335,165,50,115,357,179,215,71,149,98,27,20,7,74
"2011","Malvern Hills 002C","E01032199",1246,179,50,129,319,148,197,80,121,86,35,18,17,81
"2011","Malvern Hills 002D","E01032223",1506,222,66,156,441,167,269,73,143,86,18,10,8,87
"2011","Malvern Hills 003A","E01032179",1257,230,51,179,341,125,239,52,110,69,32,24,8,59
"2011","Malvern Hills 003B","E01032180",1379,219,69,150,371,157,225,76,137,99,38,19,19,57
"2011","Malvern Hills 003C","E01032182",1407,198,54,144,398,181,204,89,141,80,25,18,7,91
"2011","Malvern Hills 003D","E01032183",1019,102,33,69,244,134,128,76,156,84,29,18,11,66
"2011","Malvern Hills 004A","E01032194",1046,76,16,60,196,94,105,87,195,163,66,48,18,64
"2011","Malvern Hills 004B","E01032195",1127,156,24,132,263,140,121,80,176,109,30,20,10,52
"2011","Malvern Hills 004C","E01032196",1119,135,29,106,272,144,130,76,167,94,38,21,17,63
"2011","Malvern Hills 004D","E01032197",1070,142,32,110,277,134,111,54,141,95,40,25,15,76
"2011","Malvern Hills 005A","E01032205",775,114,36,78,208,79,136,49,77,55,19,10,9,38
"2011","Malvern Hills 005B","E01032206",875,91,24,67,226,108,118,52,138,84,17,7,10,41
"2011","Malvern Hills 005C","E01032207",1034,186,51,135,314,133,119,57,102,49,20,9,11,54
"2011","Malvern Hills 005D","E01032217",1115,153,38,115,309,105,185,53,129,73,47,37,10,61
"2011","Malvern Hills 006A","E01032188",1377,112,25,87,259,161,129,111,271,176,58,39,19,100
"2011","Malvern Hills 006B","E01032189",1407,177,39,138,339,204,133,123,216,105,35,19,16,75
"2011","Malvern Hills 006C","E01032220",1131,204,30,174,332,120,136,58,107,66,33,13,20,75
"2011","Malvern Hills 006D","E01032221",1087,204,32,172,284,103,121,35,84,57,24,12,12,175
"2011","Malvern Hills 006E","E01032222",1021,128,24,104,238,112,89,81,171,110,23,14,9,69
"2011","Malvern Hills 007A","E01032201",1066,118,24,94,205,125,83,100,189,102,72,56,16,72
"2011","Malvern Hills 007B","E01032202",1188,62,13,49,152,87,107,120,274,188,105,67,38,93
"2011","Malvern Hills 007C","E01032203",1087,108,11,97,230,112,123,82,177,137,46,27,19,72
"2011","Malvern Hills 007D","E01032204",1066,30,8,22,112,67,63,102,269,233,109,73,36,81
"2011","Malvern Hills 008A","E01032191",1700,243,77,166,411,253,267,100,198,101,25,10,15,102
"2011","Malvern Hills 008B","E01032192",1117,142,32,110,275,170,127,57,136,104,28,14,14,78
"2011","Malvern Hills 008C","E01032211",1283,187,51,136,306,179,221,82,145,89,20,9,11,54
"2011","Malvern Hills 009A","E01032184",1045,145,27,118,263,149,100,68,126,110,23,14,9,61
"2011","Malvern Hills 009B","E01032185",996,161,26,135,270,149,106,45,116,62,25,14,11,62
"2011","Malvern Hills 009C","E01032186",980,142,27,115,232,89,88,43,105,53,32,29,3,196
"2011","Malvern Hills 009D","E01032187",1165,113,18,95,206,117,102,80,231,188,64,39,25,64
"2011","Malvern Hills 010A","E01032208",1037,182,27,155,326,122,111,53,109,36,39,17,22,59
"2011","Malvern Hills 010B","E01032209",1068,148,31,117,288,70,83,36,49,32,29,21,8,333
"2011","Malvern Hills 010C","E01032210",769,93,12,81,201,126,89,45,103,60,20,10,10,32
"2011","Malvern Hills 010D","E01032218",1173,211,46,165,314,129,159,36,118,61,31,21,10,114
"2011","Malvern Hills 010E","E01032219",1230,241,44,197,360,159,157,61,114,59,28,12,16,51
"2011","Malvern Hills 011A","E01032198",1522,230,50,180,369,167,286,76,136,81,52,40,12,125
"2011","Malvern Hills 011B","E01032200",1485,237,60,177,363,162,274,91,170,90,29,23,6,69
"2011","Malvern Hills 011C","E01032215",796,55,18,37,166,84,97,74,128,116,32,19,13,44
"2011","Malvern Hills 011D","E01032216",1117,136,34,102,275,141,180,67,151,98,22,19,3,47
"2011","Redditch 001A","E01032226",1508,174,48,126,361,261,136,105,201,140,38,18,20,92
"2011","Redditch 001B","E01032227",843,122,33,89,248,148,74,41,97,50,15,9,6,48
"2011","Redditch 001C","E01032243",1147,156,41,115,300,210,96,86,123,73,11,7,4,92
"2011","Redditch 001D","E01032244",946,79,18,61,168,141,72,85,184,129,26,17,9,62
"2011","Redditch 002A","E01032240",1010,44,16,28,123,121,78,103,224,212,49,30,19,56
"2011","Redditch 002B","E01032241",1002,45,16,29,116,104,59,99,239,198,62,28,34,80
"2011","Redditch 002C","E01032242",1046,66,14,52,161,142,77,116,224,171,38,21,17,51
"2011","Redditch 002D","E01032245",1036,44,18,26,114,102,56,108,251,207,81,40,41,73
"2011","Redditch 003A","E01032232",1213,42,12,30,145,123,82,108,300,218,106,48,58,89
"2011","Redditch 003B","E01032233",2212,340,91,249,654,352,161,128,258,156,47,23,24,116
"2011","Redditch 003C","E01032234",1210,46,17,29,153,105,81,99,290,245,110,78,32,81
"2011","Redditch 003D","E01032235",1203,35,13,22,133,135,78,114,309,220,100,53,47,79
"2011","Redditch 004A","E01032224",1312,70,19,51,178,137,112,97,262,212,139,95,44,105
"2011","Redditch 004B","E01032225",819,20,5,15,97,74,48,89,206,161,78,46,32,46
"2011","Redditch 004C","E01032239",1303,70,17,53,175,108,98,102,252,262,143,110,33,93
"2011","Redditch 004D","E01032262",1544,50,15,35,194,117,123,133,375,307,127,93,34,118
"2011","Redditch 005A","E01032273",1105,126,39,87,266,182,99,90,150,99,21,10,11,72
"2011","Redditch 005B","E01032275",1056,85,29,56,204,152,66,90,193,167,45,24,21,54
"2011","Redditch 005C","E01032277",1010,47,17,30,153,103,86,92,206,200,52,27,25,71
"2011","Redditch 005D","E01032278",1199,41,12,29,137,106,65,138,304,235,91,51,40,82
"2011","Redditch 006A","E01032236",1342,67,13,54,235,131,105,117,270,232,105,77,28,80
"2011","Redditch 006B","E01032237",1163,131,37,94,292,159,120,74,154,119,38,25,13,76
"2011","Redditch 006C","E01032238",1042,85,21,64,215,117,109,96,167,105,76,57,19,72
"2011","Redditch 006D","E01032264",1284,69,23,46,181,150,77,133,284,234,59,36,23,97
"2011","Redditch 007A","E01032255",996,77,24,53,185,126,85,94,187,151,26,19,7,65
"2011","Redditch 007B","E01032263",1316,102,26,76,226,174,103,119,262,172,58,38,20,100
"2011","Redditch 007C","E01032266",1261,124,26,98,291,194,87,100,217,149,24,5,19,75
"2011","Redditch 007D","E01032274",1021,83,25,58,212,174,76,92,186,128,20,7,13,50
"2011","Redditch 008A","E01032259",1021,115,41,74,253,143,134,64,130,78,40,34,6,64
"2011","Redditch 008B","E01032269",1222,142,44,98,278,174,128,83,177,145,26,16,10,69
"2011","Redditch 008C","E01032270",1003,131,39,92,252,148,92,76,121,86,18,14,4,79
"2011","Redditch 008D","E01032271",1008,169,51,118,264,160,115,56,96,54,18,10,8,76
"2011","Redditch 008E","E01032272",939,117,24,93,234,180,94,51,117,73,21,9,12,52
"2011","Redditch 009A","E01032253",994,139,30,109,213,139,82,72,157,103,23,15,8,66
"2011","Redditch 009B","E01032265",1136,46,12,34,172,136,70,97,258,196,47,27,20,114
"2011","Redditch 009C","E01032267",1228,71,31,40,187,137,77,115,274,232,50,28,22,85
"2011","Redditch 009D","E01032268",979,75,19,56,184,164,77,90,173,133,18,10,8,65
"2011","Redditch 009E","E01032276",1171,101,35,66,239,219,76,124,191,144,25,8,17,52
"2011","Redditch 010A","E01032250",988,24,6,18,99,74,65,89,233,247,86,62,24,71
"2011","Redditch 010B","E01032251",1316,55,14,41,202,184,88,106,291,232,70,34,36,88
"2011","Redditch 010C","E01032252",983,31,12,19,96,77,54,84,242,220,91,52,39,88
"2011","Redditch 010D","E01032254",1144,54,18,36,142,141,83,109,291,197,52,30,22,75
"2011","Redditch 011A","E01032256",1130,101,32,69,208,179,92,85,203,141,38,20,18,83
"2011","Redditch 011B","E01032257",1119,138,51,87,272,174,99,93,155,79,27,12,15,82
"2011","Redditch 011C","E01032258",1093,84,22,62,224,158,97,84,209,143,34,17,17,60
"2011","Redditch 011D","E01032260",996,49,16,33,164,122,71,79,232,156,56,32,24,67
"2011","Redditch 012A","E01032246",1041,107,36,71,234,179,123,85,152,81,18,12,6,62
"2011","Redditch 012B","E01032247",1044,101,32,69,219,145,100,79,176,123,40,20,20,61
"2011","Redditch 012C","E01032248",1120,192,56,136,310,179,93,50,119,50,25,15,10,102
"2011","Redditch 012D","E01032249",1184,131,33,98,271,178,116,119,159,120,27,21,6,63
"2011","Redditch 012E","E01032261",1027,89,28,61,217,165,116,105,158,99,23,16,7,55
"2011","Redditch 013A","E01032228",1031,210,60,150,282,128,180,47,68,50,12,6,6,54
"2011","Redditch 013B","E01032229",1132,130,29,101,246,144,129,55,195,132,44,29,15,57
"2011","Redditch 013C","E01032230",1092,184,58,126,288,165,123,53,112,74,23,10,13,70
"2011","Redditch 013D","E01032231",1233,170,42,128,303,163,144,88,140,114,26,15,11,85
"2011","Worcester 001A","E01032296",1207,169,37,132,326,159,109,76,174,88,45,19,26,61
"2011","Worcester 001B","E01032297",1145,146,33,113,288,183,118,68,164,97,18,8,10,63
"2011","Worcester 001C","E01032298",1273,164,38,126,326,234,109,114,175,72,12,5,7,67
"2011","Worcester 001D","E01032299",1146,159,32,127,331,147,110,71,153,88,20,12,8,67
"2011","Worcester 001E","E01032300",1118,210,33,177,346,165,116,59,91,57,19,14,5,55
"2011","Worcester 002A","E01032303",800,25,7,18,69,68,43,74,185,197,80,48,32,59
"2011","Worcester 002B","E01032304",985,31,10,21,103,80,52,109,237,239,84,50,34,50
"2011","Worcester 002C","E01032331",1040,39,11,28,115,109,54,106,229,229,101,70,31,58
"2011","Worcester 002D","E01032332",870,23,8,15,80,63,58,81,192,232,104,61,43,37
"2011","Worcester 003A","E01032330",946,57,11,46,172,172,52,104,175,150,28,11,17,36
"2011","Worcester 003B","E01032334",1793,262,52,210,482,283,127,128,230,126,40,16,24,115
"2011","Worcester 003C","E01032335",1143,209,44,165,344,203,98,62,89,65,19,12,7,54
"2011","Worcester 003D","E01032336",1214,211,52,159,373,206,79,68,121,67,17,7,10,72
"2011","Worcester 004A","E01032279",960,88,19,69,244,118,53,76,160,118,43,16,27,60
"2011","Worcester 004B","E01032312",1145,93,19,74,233,150,74,100,229,156,44,26,18,66
"2011","Worcester 004C","E01032327",1201,128,37,91,267,167,89,89,213,132,42,27,15,74
"2011","Worcester 004D","E01032328",1098,78,27,51,217,141,77,100,187,171,51,34,17,76
"2011","Worcester 004E","E01032329",1513,157,38,119,361,254,124,120,233,132,41,28,13,91
"2011","Worcester 005A","E01032301",1056,50,12,38,161,129,86,104,233,194,54,39,15,45
"2011","Worcester 005B","E01032302",906,31,5,26,71,79,65,78,209,198,110,74,36,65
"2011","Worcester 005C","E01032310",1090,61,8,53,160,99,81,100,232,238,58,37,21,61
"2011","Worcester 005D","E01032311",1075,31,8,23,133,95,71,96,239,229,91,61,30,90
"2011","Worcester 005E","E01032313",921,24,2,22,121,64,48,77,206,195,105,78,27,81
"2011","Worcester 005F","E01032333",1295,45,15,30,175,126,59,113,324,257,128,85,43,68
"2011","Worcester 006A","E01032314",880,85,16,69,180,104,64,45,106,71,20,12,8,205
"2011","Worcester 006B","E01032315",1819,84,18,66,188,98,63,68,123,89,53,28,25,1053
"2011","Worcester 006C","E01032316",842,97,25,72,203,116,92,57,117,73,13,11,2,74
"2011","Worcester 006D","E01032317",1122,101,36,65,251,165,93,59,145,120,20,13,7,168
"2011","Worcester 007A","E01032280",1216,179,36,143,323,142,110,69,166,99,40,28,12,88
"2011","Worcester 007B","E01032281",1086,122,26,96,304,138,82,70,151,94,40,22,18,85
"2011","Worcester 007C","E01032282",1468,146,23,123,351,136,86,79,211,163,74,48,26,222
"2011","Worcester 007E","E01033246",908,133,27,106,303,70,70,53,101,73,45,25,20,60
"2011","Worcester 007F","E01033247",1016,97,15,82,194,81,50,56,104,80,44,23,21,310
"2011","Worcester 008A","E01032337",1463,222,50,172,395,225,112,102,182,88,36,22,14,101
"2011","Worcester 008B","E01032338",1501,225,54,171,411,233,99,97,195,97,28,18,10,116
"2011","Worcester 008C","E01032339",1175,218,58,160,357,183,81,68,115,61,15,6,9,77
"2011","Worcester 009A","E01032318",1049,28,7,21,103,87,67,100,250,193,96,54,42,125
"2011","Worcester 009B","E01032319",1302,81,17,64,229,167,97,106,188,162,35,18,17,237
"2011","Worcester 009C","E01032320",1392,101,21,80,262,133,85,73,165,111,59,42,17,403
"2011","Worcester 009D","E01032321",1072,41,10,31,148,108,105,100,205,182,58,33,25,125
"2011","Worcester 009E","E01032322",1368,106,19,87,241,139,90,89,218,151,50,38,12,284
"2011","Worcester 010A","E01032305",1257,86,26,60,233,181,90,111,236,183,44,26,18,93
"2011","Worcester 010B","E01032306",1115,58,16,42,199,123,58,102,228,192,65,47,18,90
"2011","Worcester 010C","E01032307",1254,73,10,63,169,119,85,98,252,239,115,70,45,104
"2011","Worcester 010D","E01032309",1040,66,14,52,226,134,67,82,170,160,60,38,22,75
"2011","Worcester 011A","E01032285",1197,183,36,147,376,126,107,45,149,89,45,32,13,77
"2011","Worcester 011B","E01032292",1226,90,17,73,203,112,116,92,186,153,152,104,48,122
"2011","Worcester 011D","E01032294",1028,112,18,94,225,119,120,61,149,104,72,54,18,66
"2011","Worcester 011E","E01033248",882,74,7,67,165,94,61,62,142,122,54,31,23,108
"2011","Worcester 011F","E01033249",1009,102,22,80,202,99,73,75,154,128,85,50,35,91
"2011","Worcester 012A","E01032286",1279,125,23,102,295,152,131,118,197,119,35,12,23,107
"2011","Worcester 012B","E01032287",1168,114,22,92,281,167,101,91,167,117,27,17,10,103
"2011","Worcester 012C","E01032288",1111,117,28,89,275,123,99,89,178,125,29,18,11,76
"2011","Worcester 012D","E01032289",1105,140,28,112,258,175,104,67,158,96,31,23,8,76
"2011","Worcester 012E","E01032290",1116,107,25,82,263,186,103,85,182,110,19,11,8,61
"2011","Worcester 013A","E01032283",1164,112,19,93,258,170,108,76,178,117,58,42,16,87
"2011","Worcester 013B","E01032284",1437,261,55,206,390,189,130,86,149,72,28,21,7,132
"2011","Worcester 013C","E01032295",1919,301,64,237,526,230,151,138,225,149,95,54,41,104
"2011","Worcester 013D","E01032308",1142,129,37,92,267,182,87,86,146,121,40,29,11,84
"2011","Worcester 014A","E01032323",1067,188,47,141,303,179,74,54,112,60,26,15,11,71
"2011","Worcester 014B","E01032324",1048,136,31,105,312,171,74,70,133,59,23,15,8,70
"2011","Worcester 014C","E01032325",1178,139,38,101,359,178,82,76,155,85,24,13,11,80
"2011","Worcester 014D","E01032326",1021,138,33,105,247,177,71,68,147,91,17,10,7,65
"2011","Wychavon 001A","E01032354",1778,226,68,158,408,219,238,114,216,189,50,39,11,118
"2011","Wychavon 001B","E01032386",1018,148,45,103,273,128,169,51,98,75,24,16,8,52
"2011","Wychavon 001C","E01032387",1026,122,46,76,241,125,153,56,132,102,37,25,12,58
"2011","Wychavon 001D","E01032401",1055,174,43,131,284,116,207,51,90,59,22,15,7,52
"2011","Wychavon 002A","E01032368",910,36,10,26,102,77,57,96,199,214,74,46,28,55
"2011","Wychavon 002B","E01032369",1069,54,11,43,171,111,66,97,227,221,60,35,25,62
"2011","Wychavon 002C","E01032370",942,93,30,63,196,117,83,83,155,134,35,21,14,46
"2011","Wychavon 002D","E01032371",995,70,28,42,184,151,89,80,185,148,44,16,28,44
"2011","Wychavon 003A","E01032359",1170,122,31,91,221,145,114,77,219,177,57,38,19,38
"2011","Wychavon 003B","E01032360",1383,138,38,100,290,184,123,111,216,189,53,41,12,79
"2011","Wychavon 003C","E01032361",1296,180,51,129,362,211,111,98,156,102,23,11,12,53
"2011","Wychavon 004A","E01032357",853,64,19,45,173,99,66,89,155,126,31,18,13,50
"2011","Wychavon 004B","E01032358",1079,72,16,56,216,111,112,89,177,175,57,31,26,70
"2011","Wychavon 004C","E01032365",1272,68,19,49,209,168,110,121,259,210,47,25,22,80
"2011","Wychavon 004D","E01032367",1017,180,43,137,257,141,93,58,129,72,23,15,8,64
"2011","Wychavon 005A","E01032362",1400,222,56,166,414,210,135,74,132,82,43,32,11,88
"2011","Wychavon 005B","E01032363",1198,159,43,116,347,207,103,80,141,87,12,5,7,62
"2011","Wychavon 005C","E01032364",1255,241,58,183,390,211,106,53,105,46,19,11,8,84
"2011","Wychavon 005D","E01032366",1155,133,38,95,320,175,92,67,170,111,25,15,10,62
"2011","Wychavon 006A","E01032399",1219,168,46,122,274,192,140,95,145,87,46,26,20,72
"2011","Wychavon 006B","E01032400",1607,280,78,202,438,231,197,86,155,95,42,18,24,83
"2011","Wychavon 006C","E01032404",1769,270,78,192,411,199,313,101,174,148,43,28,15,110
"2011","Wychavon 007A","E01032345",1063,197,58,139,292,134,195,35,72,52,23,10,13,63
"2011","Wychavon 007B","E01032346",981,202,55,147,312,116,141,41,66,37,15,10,5,51
"2011","Wychavon 007C","E01032395",919,159,51,108,231,94,200,40,80,50,13,7,6,52
"2011","Wychavon 007D","E01032417",1100,179,46,133,276,151,168,59,120,66,17,9,8,64
"2011","Wychavon 008A","E01032392",1160,177,53,124,259,158,251,45,113,69,23,14,9,65
"2011","Wychavon 008B","E01032393",1130,206,49,157,327,159,135,55,107,62,16,11,5,63
"2011","Wychavon 008C","E01032394",912,148,48,100,259,99,185,35,83,34,15,8,7,54
"2011","Wychavon 008D","E01032416",823,154,53,101,230,109,148,25,55,36,17,8,9,49
"2011","Wychavon 009A","E01032355",983,132,35,97,238,127,146,75,99,70,36,20,16,60
"2011","Wychavon 009B","E01032356",821,94,25,69,218,113,102,51,114,75,19,10,9,35
"2011","Wychavon 009C","E01032402",1038,167,51,116,338,168,98,38,95,43,10,4,6,81
"2011","Wychavon 009D","E01032403",1056,170,37,133,270,155,146,59,104,71,23,17,6,58
"2011","Wychavon 010A","E01032375",817,145,39,106,200,94,148,33,82,46,19,11,8,50
"2011","Wychavon 010B","E01032382",923,114,28,86,239,120,150,50,95,72,16,11,5,67
"2011","Wychavon 010C","E01032383",1082,183,50,133,253,123,162,49,98,74,21,14,7,119
"2011","Wychavon 010D","E01032410",1034,177,52,125,285,125,152,54,100,68,22,10,12,51
"2011","Wychavon 010E","E01032411",1086,130,32,98,251,120,130,71,166,106,41,27,14,71
"2011","Wychavon 011A","E01032390",1013,136,38,98,237,120,169,71,122,81,22,10,12,55
"2011","Wychavon 011B","E01032391",827,65,28,37,156,98,95,83,116,124,32,17,15,58
"2011","Wychavon 011C","E01032414",1111,153,42,111,258,133,161,71,135,106,29,18,11,65
"2011","Wychavon 011D","E01032415",1348,100,29,71,258,156,177,92,176,228,86,66,20,75
"2011","Wychavon 012A","E01032405",965,114,31,83,207,131,100,71,146,132,24,6,18,40
"2011","Wychavon 012B","E01032406",980,68,14,54,195,93,116,86,188,138,45,13,32,51
"2011","Wychavon 012C","E01032407",1021,121,33,88,211,107,102,77,161,127,37,20,17,78
"2011","Wychavon 012D","E01032408",973,110,38,72,239,156,109,76,147,87,15,4,11,34
"2011","Wychavon 012E","E01032409",1102,69,9,60,177,127,128,93,207,178,62,42,20,61
"2011","Wychavon 013A","E01032340",1023,77,21,56,171,125,136,94,161,159,41,27,14,59
"2011","Wychavon 013B","E01032341",1015,120,31,89,248,142,140,76,128,91,17,12,5,53
"2011","Wychavon 013C","E01032349",1141,111,39,72,221,157,172,85,159,144,29,21,8,63
"2011","Wychavon 013D","E01032350",774,85,24,61,147,94,113,62,132,77,26,17,9,38
"2011","Wychavon 013E","E01032388",967,114,34,80,262,151,126,63,111,74,21,10,11,45
"2011","Wychavon 013F","E01032389",903,97,29,68,156,90,143,74,132,112,44,32,12,55
"2011","Wychavon 014A","E01032343",1825,107,31,76,327,198,168,200,372,298,82,46,36,73
"2011","Wychavon 014B","E01032377",1309,72,23,49,180,139,109,135,291,245,62,28,34,76
"2011","Wychavon 014C","E01032378",1207,76,23,53,176,145,101,107,271,204,54,25,29,73
"2011","Wychavon 015A","E01032376",1124,153,46,107,227,162,123,96,139,115,26,19,7,83
"2011","Wychavon 015B","E01032384",984,67,22,45,167,101,120,99,164,172,34,21,13,60
"2011","Wychavon 015C","E01032385",879,72,20,52,187,105,119,73,156,113,23,16,7,31
"2011","Wychavon 015D","E01032396",1203,140,39,101,263,192,114,112,177,114,22,11,11,69
"2011","Wychavon 016A","E01032342",1132,77,21,56,209,146,89,121,227,160,51,35,16,52
"2011","Wychavon 016B","E01032344",1037,127,35,92,234,150,130,78,133,91,25,16,9,69
"2011","Wychavon 016C","E01032379",1441,120,40,80,322,229,123,123,221,173,26,16,10,104
"2011","Wychavon 016D","E01032380",1121,115,28,87,242,153,108,90,184,134,36,18,18,59
"2011","Wychavon 017A","E01032381",1408,64,23,41,198,157,138,143,301,236,71,47,24,100
"2011","Wychavon 017B","E01032397",1266,79,24,55,188,138,114,131,266,226,67,42,25,57
"2011","Wychavon 017C","E01032398",1327,115,41,74,272,181,83,156,223,168,39,20,19,90
"2011","Wychavon 018A","E01032351",985,131,38,93,252,117,187,55,109,81,12,4,8,41
"2011","Wychavon 018B","E01032352",1129,150,39,111,270,137,187,71,145,89,31,19,12,49
"2011","Wychavon 018C","E01032353",1104,93,21,72,229,130,177,85,182,122,46,25,21,40
"2011","Wychavon 018D","E01032374",976,131,28,103,240,113,147,54,123,77,29,18,11,62
"2011","Wychavon 019A","E01032347",900,126,38,88,237,131,97,59,107,72,11,3,8,60
"2011","Wychavon 019B","E01032348",871,170,47,123,265,128,109,29,79,38,8,5,3,45
"2011","Wychavon 019C","E01032372",1073,186,47,139,265,140,171,52,106,82,23,12,11,48
"2011","Wychavon 019D","E01032373",955,150,52,98,288,118,130,55,85,49,11,6,5,69
"2011","Wychavon 019E","E01032412",892,129,35,94,245,111,146,40,101,72,15,11,4,33
"2011","Wychavon 019F","E01032413",776,168,54,114,204,79,114,35,71,42,10,9,1,53
"2011","Wyre Forest 001A","E01032431",1083,181,62,119,260,97,230,65,98,81,25,16,9,46
"2011","Wyre Forest 001B","E01032432",1009,107,41,66,238,87,148,49,117,93,34,19,15,136
"2011","Wyre Forest 001C","E01032433",921,206,66,140,272,121,128,36,59,41,13,9,4,45
"2011","Wyre Forest 001D","E01032439",996,105,26,79,242,136,140,79,126,95,26,11,15,47
"2011","Wyre Forest 001E","E01032440",812,61,21,40,159,96,95,67,121,133,39,28,11,41
"2011","Wyre Forest 001F","E01032479",1558,186,60,126,349,168,224,99,229,171,61,44,17,71
"2011","Wyre Forest 002A","E01032441",992,62,17,45,173,165,99,94,173,161,12,8,4,53
"2011","Wyre Forest 002B","E01032442",1136,77,21,56,218,185,87,103,229,163,27,13,14,47
"2011","Wyre Forest 002C","E01032443",987,63,20,43,209,148,120,88,163,123,34,24,10,39
"2011","Wyre Forest 002D","E01032444",893,42,9,33,163,121,84,88,164,160,23,13,10,48
"2011","Wyre Forest 002E","E01032445",1077,61,19,42,173,138,101,71,202,191,74,47,27,66
"2011","Wyre Forest 003A","E01032436",1166,94,24,70,216,137,111,125,201,174,24,9,15,84
"2011","Wyre Forest 003B","E01032438",1174,106,17,89,269,182,131,82,160,142,31,18,13,71
"2011","Wyre Forest 003C","E01032446",1020,109,39,70,223,135,101,61,159,142,29,17,12,61
"2011","Wyre Forest 003D","E01032447",1117,113,25,88,278,148,113,84,149,130,43,23,20,59
"2011","Wyre Forest 003E","E01032448",896,78,18,60,195,138,114,57,139,109,17,11,6,49
"2011","Wyre Forest 004A","E01032434",1198,31,5,26,137,100,79,81,257,267,166,96,70,80
"2011","Wyre Forest 004B","E01032435",1070,48,15,33,145,99,105,95,221,204,82,53,29,71
"2011","Wyre Forest 004C","E01032437",1304,82,20,62,219,122,114,88,242,248,107,59,48,82
"2011","Wyre Forest 004D","E01032450",1663,118,34,84,288,188,132,157,296,267,139,89,50,78
"2011","Wyre Forest 005A","E01032430",1240,143,41,102,304,119,203,80,163,131,30,22,8,67
"2011","Wyre Forest 005B","E01032480",1355,135,48,87,324,194,139,107,182,164,32,16,16,78
"2011","Wyre Forest 005C","E01032481",1297,95,30,65,235,135,167,99,208,225,72,51,21,61
"2011","Wyre Forest 005D","E01032482",1043,144,34,110,270,162,125,66,133,75,22,9,13,46
"2011","Wyre Forest 006A","E01032451",1125,141,45,96,284,180,106,79,127,122,28,15,13,58
"2011","Wyre Forest 006B","E01032452",1116,111,39,72,258,166,115,89,151,130,47,32,15,49
"2011","Wyre Forest 006C","E01032453",1126,40,11,29,126,80,82,125,261,254,94,58,36,64
"2011","Wyre Forest 006D","E01032454",1216,112,40,72,268,154,98,99,199,154,71,55,16,61
"2011","Wyre Forest 007A","E01032449",1232,79,23,56,228,147,98,106,228,192,83,56,27,71
"2011","Wyre Forest 007B","E01032464",1098,49,15,34,182,111,86,76,252,213,82,48,34,47
"2011","Wyre Forest 007C","E01032465",1005,47,11,36,124,91,77,71,233,222,76,50,26,64
"2011","Wyre Forest 007D","E01032466",1041,143,42,101,227,135,103,58,151,129,42,26,16,53
"2011","Wyre Forest 007E","E01032467",878,120,33,87,259,115,96,64,87,86,17,7,10,34
"2011","Wyre Forest 007F","E01032468",908,78,21,57,202,132,86,76,147,122,21,15,6,44
"2011","Wyre Forest 008A","E01032474",1305,72,21,51,213,153,87,121,256,218,112,69,43,73
"2011","Wyre Forest 008B","E01032475",1265,86,27,59,242,165,104,119,228,202,48,19,29,71
"2011","Wyre Forest 008C","E01032476",1003,60,11,49,209,121,94,89,166,173,31,18,13,60
"2011","Wyre Forest 008D","E01032477",893,95,25,70,237,133,106,54,103,106,20,11,9,39
"2011","Wyre Forest 008E","E01032478",1095,56,21,35,144,106,94,100,239,221,59,37,22,76
"2011","Wyre Forest 009A","E01032469",1234,24,8,16,109,81,71,115,289,342,128,96,32,75
"2011","Wyre Forest 009B","E01032470",1291,62,16,46,202,110,130,95,256,268,97,67,30,71
"2011","Wyre Forest 009C","E01032471",1118,18,7,11,85,52,66,83,250,275,216,162,54,73
"2011","Wyre Forest 010A","E01032418",1056,79,17,62,227,146,83,103,167,155,29,17,12,67
"2011","Wyre Forest 010B","E01032419",953,157,47,110,252,167,78,39,107,81,17,8,9,55
"2011","Wyre Forest 010C","E01032420",993,118,40,78,246,131,91,77,133,103,31,14,17,63
"2011","Wyre Forest 010D","E01032421",973,136,43,93,262,154,84,64,116,63,21,9,12,73
"2011","Wyre Forest 010E","E01032422",1070,64,15,49,178,144,77,101,215,148,65,33,32,78
"2011","Wyre Forest 011A","E01032427",1148,116,29,87,255,149,121,89,169,152,29,15,14,68
"2011","Wyre Forest 011B","E01032428",1314,140,41,99,352,131,207,81,155,150,47,21,26,51
"2011","Wyre Forest 011C","E01032429",1132,143,33,110,332,143,110,65,155,100,34,15,19,50
"2011","Wyre Forest 011D","E01032472",928,137,43,94,263,104,178,46,79,53,22,9,13,46
"2011","Wyre Forest 011E","E01032473",910,107,34,73,200,114,142,54,109,101,40,29,11,43
"2011","Wyre Forest 012A","E01032455",1093,100,30,70,196,170,98,88,198,140,28,12,16,75
"2011","Wyre Forest 012B","E01032456",871,43,9,34,128,90,89,72,171,174,55,28,27,49
"2011","Wyre Forest 012C","E01032457",902,58,13,45,199,125,88,93,136,114,39,32,7,50
"2011","Wyre Forest 012D","E01032458",995,93,27,66,217,148,102,95,145,142,18,10,8,35
"2011","Wyre Forest 012E","E01032459",1026,70,21,49,209,133,97,103,193,140,23,13,10,58
"2011","Wyre Forest 013A","E01032460",1301,104,43,61,243,169,120,112,257,189,51,24,27,56
"2011","Wyre Forest 013B","E01032461",1574,157,54,103,327,174,183,128,234,222,79,42,37,70
"2011","Wyre Forest 013C","E01032462",1624,167,54,113,384,207,192,139,215,206,39,22,17,75
"2011","Wyre Forest 013D","E01032463",1186,139,44,95,267,199,117,88,160,130,35,23,12,51
"2011","Wyre Forest 014A","E01032423",1147,67,25,42,208,106,107,96,223,226,62,41,21,52
"2011","Wyre Forest 014B","E01032424",1013,33,8,25,107,83,61,101,249,229,95,59,36,55
"2011","Wyre Forest 014C","E01032425",1044,73,27,46,242,141,123,92,165,147,22,14,8,39
"2011","Wyre Forest 014D","E01032426",1122,91,33,58,208,151,114,110,193,165,42,30,12,48
"2011","Bedford 001A","E01017540",1109,222,59,163,306,149,174,58,82,50,10,6,4,58
"2011","Bedford 001B","E01017541",934,144,32,112,243,129,123,48,98,57,28,19,9,64
"2011","Bedford 001C","E01017544",998,159,38,121,291,148,103,53,108,57,18,13,5,61
"2011","Bedford 001D","E01017545",1080,210,54,156,283,152,152,27,82,59,36,27,9,79
"2011","Bedford 002A","E01017464",1034,207,38,169,302,135,134,36,96,54,11,5,6,59
"2011","Bedford 002B","E01017465",1024,210,42,168,287,153,127,50,65,51,23,18,5,58
"2011","Bedford 002C","E01017503",941,105,32,73,225,111,109,60,117,92,29,20,9,93
"2011","Bedford 002D","E01017504",1352,267,46,221,389,173,173,58,98,77,32,17,15,85
"2011","Bedford 002E","E01017546",894,160,31,129,247,136,104,34,87,61,13,9,4,52
"2011","Bedford 002F","E01017547",1175,151,38,113,311,172,178,60,125,82,25,14,11,71
"2011","Bedford 003A","E01017478",1273,201,48,153,355,179,158,68,133,79,26,18,8,74
"2011","Bedford 003B","E01017479",918,117,21,96,203,112,107,71,137,94,29,19,10,48
"2011","Bedford 003C","E01017480",1485,157,34,123,324,203,137,110,208,134,105,84,21,107
"2011","Bedford 003D","E01017481",833,60,19,41,192,107,70,72,149,103,29,11,18,51
"2011","Bedford 003E","E01017528",1778,266,67,199,482,284,202,105,186,98,32,19,13,123
"2011","Bedford 004B","E01017495",1467,177,49,128,363,244,177,108,184,122,24,12,12,68
"2011","Bedford 004C","E01017496",1105,176,45,131,284,164,154,61,106,77,23,15,8,60
"2011","Bedford 004D","E01017542",1079,142,46,96,260,136,155,81,131,98,19,12,7,57
"2011","Bedford 004E","E01017543",1125,173,37,136,264,126,187,85,96,85,55,45,10,54
"2011","Bedford 004F","E01033431",909,143,39,104,231,146,69,46,103,61,35,24,11,75
"2011","Bedford 004G","E01033432",1586,240,67,173,430,252,184,93,151,87,41,26,15,108
"2011","Bedford 005A","E01017453",938,62,9,53,195,154,82,65,156,117,57,29,28,50
"2011","Bedford 005B","E01017454",1088,156,41,115,285,186,103,53,131,76,26,15,11,72
"2011","Bedford 005C","E01017455",1058,116,26,90,250,189,91,65,129,112,35,22,13,71
"2011","Bedford 005D","E01017456",994,165,33,132,286,134,97,52,100,53,31,26,5,76
"2011","Bedford 005E","E01017457",830,86,16,70,203,125,50,52,122,85,40,25,15,67
"2011","Bedford 005F","E01017458",955,126,26,100,222,181,78,71,117,75,29,13,16,56
"2011","Bedford 006A","E01017529",951,94,24,70,201,157,90,70,144,94,29,14,15,72
"2011","Bedford 006B","E01017530",1023,150,30,120,275,207,76,63,117,62,18,9,9,55
"2011","Bedford 006C","E01017531",965,92,15,77,161,137,85,69,155,123,56,39,17,87
"2011","Bedford 006D","E01017532",862,135,28,107,230,148,67,52,99,51,18,13,5,62
"2011","Bedford 006E","E01017533",905,174,36,138,249,146,75,35,104,52,17,8,9,53
"2011","Bedford 006F","E01017534",1067,131,34,97,252,194,101,78,132,93,20,14,6,66
"2011","Bedford 007A","E01017488",977,87,20,67,171,169,99,90,156,101,29,20,9,75
"2011","Bedford 007B","E01017489",1047,43,12,31,152,96,84,78,220,193,82,53,29,99
"2011","Bedford 007C","E01017490",954,33,11,22,106,135,69,55,226,166,80,47,33,84
"2011","Bedford 007D","E01017491",1087,97,23,74,209,150,88,84,192,115,42,25,17,110
"2011","Bedford 007E","E01017492",1025,45,13,32,176,127,61,63,199,165,103,65,38,86
"2011","Bedford 007F","E01017493",1167,113,24,89,240,179,87,71,179,128,65,38,27,105
"2011","Bedford 008A","E01017459",1206,198,40,158,400,182,106,63,103,60,35,25,10,59
"2011","Bedford 008B","E01017460",1172,276,78,198,372,147,127,37,71,31,21,13,8,90
"2011","Bedford 008C","E01017461",1402,302,87,215,461,194,115,41,98,63,27,20,7,101
"2011","Bedford 008D","E01017462",1136,217,60,157,348,168,96,65,94,47,26,22,4,75
"2011","Bedford 008E","E01017463",936,125,28,97,238,167,104,58,119,53,15,10,5,57
"2011","Bedford 009A","E01017482",970,153,28,125,227,126,86,45,90,78,78,57,21,87
"2011","Bedford 009B","E01017483",1611,126,29,97,227,141,86,62,124,74,34,21,13,737
"2011","Bedford 009C","E01017484",899,106,16,90,194,76,65,48,76,49,69,45,24,216
"2011","Bedford 009D","E01017485",1068,183,36,147,289,115,77,47,106,92,52,32,20,107
"2011","Bedford 010A","E01017497",1117,98,19,79,234,119,59,54,140,121,49,37,12,243
"2011","Bedford 010B","E01017498",989,96,14,82,245,143,77,55,103,107,39,25,14,124
"2011","Bedford 010C","E01017499",1040,124,15,109,234,113,66,48,123,110,97,69,28,125
"2011","Bedford 010D","E01017500",922,101,14,87,195,96,72,53,114,84,57,21,36,150
"2011","Bedford 010E","E01017501",876,106,17,89,170,83,55,62,106,85,70,49,21,139
"2011","Bedford 010F","E01017502",1316,60,18,42,165,92,113,116,229,242,178,115,63,121
"2011","Bedford 011A","E01017524",1130,113,29,84,244,154,103,77,147,106,48,26,22,138
"2011","Bedford 011B","E01017525",870,68,16,52,175,118,70,71,122,113,44,22,22,89
"2011","Bedford 011C","E01017526",1080,175,40,135,293,177,84,66,113,68,18,12,6,86
"2011","Bedford 011D","E01017527",872,96,22,74,197,143,72,58,109,86,37,22,15,74
"2011","Bedford 012A","E01017466",1489,102,17,85,190,89,74,104,247,278,196,139,57,209
"2011","Bedford 012B","E01017467",964,175,37,138,288,107,82,46,78,71,27,14,13,90
"2011","Bedford 012C","E01017468",1015,158,33,125,318,120,86,41,97,68,30,21,9,97
"2011","Bedford 012D","E01017469",1337,222,43,179,306,158,128,58,108,112,47,33,14,198
"2011","Bedford 012E","E01017470",932,147,37,110,248,133,90,42,74,67,21,11,10,110
"2011","Bedford 012F","E01017471",1223,81,12,69,161,97,61,97,198,240,165,108,57,123
"2011","Bedford 013A","E01017535",980,109,26,83,180,86,101,60,137,110,88,72,16,109
"2011","Bedford 013B","E01017536",1716,95,17,78,175,173,141,119,268,316,239,192,47,190
"2011","Bedford 013C","E01017537",900,30,5,25,89,87,77,66,152,147,145,122,23,107
"2011","Bedford 013D","E01017538",1210,60,8,52,119,88,123,66,158,185,238,211,27,173
"2011","Bedford 013E","E01017539",1026,59,13,46,132,82,95,49,154,170,154,133,21,131
"2011","Bedford 014A","E01017518",1062,72,22,50,186,136,89,88,173,184,63,32,31,71
"2011","Bedford 014B","E01017519",1081,34,9,25,138,126,48,90,214,201,121,87,34,109
"2011","Bedford 014C","E01017520",1115,73,18,55,198,153,97,102,178,160,61,37,24,93
"2011","Bedford 014D","E01017521",1110,66,11,55,189,166,93,96,173,192,81,57,24,54
"2011","Bedford 014E","E01017522",1286,116,23,93,197,115,88,120,227,219,117,80,37,87
"2011","Bedford 014F","E01017523",1006,33,7,26,118,90,63,82,199,205,122,81,41,94
"2011","Bedford 015A","E01017472",997,39,10,29,105,111,74,66,173,205,124,87,37,100
"2011","Bedford 015B","E01017473",1767,196,25,171,288,173,114,136,239,283,138,104,34,200
"2011","Bedford 015C","E01017474",1224,69,12,57,167,105,85,91,190,251,145,105,40,121
"2011","Bedford 015D","E01017475",1089,62,17,45,187,117,91,93,190,222,70,47,23,57
"2011","Bedford 015E","E01017476",1032,70,8,62,154,129,66,77,189,199,65,46,19,83
"2011","Bedford 015F","E01017477",817,23,4,19,77,67,51,63,158,191,119,72,47,68
"2011","Bedford 016A","E01017509",839,42,12,30,134,98,61,55,179,136,65,35,30,69
"2011","Bedford 016B","E01017510",1131,110,35,75,248,178,96,90,183,117,37,24,13,72
"2011","Bedford 016C","E01017511",971,106,19,87,227,148,65,70,133,103,40,21,19,79
"2011","Bedford 016D","E01017512",1073,86,22,64,175,154,78,77,179,162,66,45,21,96
"2011","Bedford 017A","E01017505",1160,77,26,51,188,179,116,86,200,182,64,49,15,68
"2011","Bedford 017B","E01017506",1120,73,15,58,202,177,73,96,197,164,66,33,33,72
"2011","Bedford 017C","E01017507",984,74,12,62,173,154,86,78,155,138,52,29,23,74
"2011","Bedford 017D","E01017508",1191,82,18,64,245,187,112,96,161,161,57,41,16,90
"2011","Bedford 018A","E01017513",1102,53,9,44,212,185,92,79,203,161,33,26,7,84
"2011","Bedford 018B","E01017514",1158,61,11,50,150,114,107,96,225,206,104,70,34,95
"2011","Bedford 018C","E01017515",1110,65,15,50,157,125,99,113,179,173,103,73,30,96
"2011","Bedford 018D","E01017516",1063,86,23,63,219,146,118,79,160,158,20,9,11,77
"2011","Bedford 018E","E01017517",1184,88,20,68,235,191,82,100,192,165,39,22,17,92
"2011","Bedford 019A","E01017486",1224,118,40,78,286,190,137,85,159,154,31,17,14,64
"2011","Bedford 019B","E01017487",1281,97,29,68,289,183,105,96,181,160,77,50,27,93
"2011","Bedford 019C","E01017548",1349,158,42,116,343,236,140,104,134,123,44,28,16,67
"2011","Bedford 019D","E01017549",1043,133,38,95,224,181,111,75,133,115,23,12,11,48
"2011","Bedford 019E","E01017550",1969,232,48,184,495,269,204,139,235,189,81,44,37,125
"2011","Bedford 020A","E01017551",1060,137,40,97,269,166,127,50,119,65,36,22,14,91
"2011","Bedford 020B","E01017552",812,67,19,48,158,131,66,84,104,123,27,14,13,52
"2011","Bedford 020C","E01017553",942,98,19,79,227,160,96,78,119,83,16,7,9,65
"2011","Bedford 020D","E01017554",1016,99,26,73,208,154,121,79,162,110,23,12,11,60
"2011","Central Bedfordshire 001A","E01017433",1100,57,13,44,155,133,72,99,199,209,90,42,48,86
"2011","Central Bedfordshire 001B","E01017434",1269,147,28,119,289,166,101,114,187,140,44,25,19,81
"2011","Central Bedfordshire 001C","E01017436",1720,256,82,174,434,304,136,136,189,134,30,14,16,101
"2011","Central Bedfordshire 002A","E01017430",1035,91,31,60,207,154,97,91,153,158,43,24,19,41
"2011","Central Bedfordshire 002B","E01017431",1152,137,48,89,285,151,124,99,144,104,47,26,21,61
"2011","Central Bedfordshire 002C","E01017432",1120,149,35,114,255,167,125,93,150,90,20,14,6,71
"2011","Central Bedfordshire 002D","E01017435",1185,133,29,104,252,164,107,97,172,147,43,19,24,70
"2011","Central Bedfordshire 003A","E01017425",825,114,35,79,214,106,120,49,98,63,18,8,10,43
"2011","Central Bedfordshire 003B","E01017426",1026,171,49,122,258,155,133,41,98,88,26,11,15,56
"2011","Central Bedfordshire 003C","E01017427",1274,159,40,119,295,165,148,99,173,121,40,23,17,74
"2011","Central Bedfordshire 003D","E01017428",1166,176,46,130,270,177,149,68,132,91,32,16,16,71
"2011","Central Bedfordshire 003E","E01017429",1067,157,39,118,307,157,122,65,103,83,15,5,10,58
"2011","Central Bedfordshire 004A","E01017412",1141,161,51,110,253,131,161,86,137,68,27,16,11,117
"2011","Central Bedfordshire 004B","E01017422",1113,159,33,126,280,164,137,78,125,83,32,16,16,55
"2011","Central Bedfordshire 004C","E01017423",1115,178,53,125,258,133,203,73,103,99,21,10,11,47
"2011","Central Bedfordshire 004D","E01017424",1042,174,50,124,244,134,171,55,103,68,28,13,15,65
"2011","Central Bedfordshire 005A","E01017383",1452,213,42,171,341,219,120,101,202,133,40,23,17,83
"2011","Central Bedfordshire 005B","E01017384",1112,86,21,65,211,144,102,118,166,176,37,14,23,72
"2011","Central Bedfordshire 005C","E01017385",1216,154,40,114,270,187,141,102,156,121,41,32,9,44
"2011","Central Bedfordshire 005D","E01017386",1323,169,40,129,308,190,95,108,202,147,36,16,20,68
"2011","Central Bedfordshire 005E","E01017387",1006,84,17,67,235,163,87,77,154,117,28,17,11,61
"2011","Central Bedfordshire 005F","E01017388",1035,78,22,56,187,159,105,81,142,164,40,22,18,79
"2011","Central Bedfordshire 006A","E01017381",1082,117,27,90,243,170,117,85,155,121,23,14,9,51
"2011","Central Bedfordshire 006B","E01017382",963,80,18,62,181,135,109,69,170,119,30,16,14,70
"2011","Central Bedfordshire 006C","E01017389",1424,228,51,177,365,227,109,102,170,95,40,20,20,88
"2011","Central Bedfordshire 006D","E01017390",1436,119,24,95,251,212,136,123,219,192,85,46,39,99
"2011","Central Bedfordshire 007A","E01017379",857,137,31,106,199,94,118,75,93,79,16,4,12,46
"2011","Central Bedfordshire 007B","E01017380",931,185,53,132,288,124,110,38,67,37,17,12,5,65
"2011","Central Bedfordshire 007C","E01017394",1139,122,32,90,219,155,109,83,139,124,28,10,18,160
"2011","Central Bedfordshire 007F","E01017397",1248,171,44,127,262,170,125,76,134,91,32,17,15,187
"2011","Central Bedfordshire 007G","E01033194",2092,200,38,162,334,167,176,74,144,108,62,52,10,827
"2011","Central Bedfordshire 008A","E01017410",908,161,40,121,242,122,118,50,83,65,19,10,9,48
"2011","Central Bedfordshire 008B","E01017411",1131,148,44,104,267,151,159,75,131,89,27,14,13,84
"2011","Central Bedfordshire 008C","E01017419",1135,196,69,127,318,145,184,35,101,58,10,4,6,88
"2011","Central Bedfordshire 008D","E01017420",1112,145,28,117,294,138,119,78,126,116,25,13,12,71
"2011","Central Bedfordshire 008E","E01017421",1259,187,52,135,346,167,167,79,113,98,34,19,15,68
"2011","Central Bedfordshire 009A","E01017416",1476,169,46,123,377,207,177,122,154,127,40,24,16,103
"2011","Central Bedfordshire 009B","E01017417",1743,253,59,194,442,267,181,114,171,133,23,11,12,159
"2011","Central Bedfordshire 009C","E01017418",1136,85,28,57,215,162,129,93,175,147,53,38,15,77
"2011","Central Bedfordshire 009D","E01017451",1038,173,52,121,259,108,149,74,106,93,28,11,17,48
"2011","Central Bedfordshire 009E","E01017452",844,171,44,127,219,96,137,38,69,46,17,9,8,51
"2011","Central Bedfordshire 010A","E01017376",1421,152,38,114,364,210,158,104,190,133,47,29,18,63
"2011","Central Bedfordshire 010B","E01017377",1479,164,35,129,356,234,161,119,170,122,43,20,23,110
"2011","Central Bedfordshire 010C","E01017378",1313,102,25,77,260,167,120,132,218,173,54,38,16,87
"2011","Central Bedfordshire 010D","E01017413",1301,189,49,140,354,192,179,93,127,90,21,10,11,56
"2011","Central Bedfordshire 010E","E01017414",1284,177,50,127,329,193,147,79,145,102,38,20,18,74
"2011","Central Bedfordshire 010F","E01017415",1322,189,51,138,368,172,148,93,154,104,25,13,12,69
"2011","Central Bedfordshire 011A","E01017437",1147,97,20,77,242,155,133,109,155,138,38,23,15,80
"2011","Central Bedfordshire 011B","E01017438",1215,171,48,123,315,223,106,87,126,96,19,8,11,72
"2011","Central Bedfordshire 011C","E01017439",1167,205,73,132,346,151,88,74,129,79,18,12,6,77
"2011","Central Bedfordshire 011D","E01017440",973,89,26,63,214,143,92,71,147,121,55,33,22,41
"2011","Central Bedfordshire 011E","E01017441",1402,191,60,131,448,262,118,90,94,85,18,12,6,96
"2011","Central Bedfordshire 011F","E01017444",1347,192,39,153,371,171,178,93,133,106,26,14,12,77
"2011","Central Bedfordshire 012A","E01017371",895,129,32,97,278,121,104,55,81,51,13,7,6,63
"2011","Central Bedfordshire 012B","E01017372",1037,102,26,76,263,153,133,72,126,105,26,16,10,57
"2011","Central Bedfordshire 012C","E01017373",1055,183,46,137,294,155,112,62,80,56,23,7,16,90
"2011","Central Bedfordshire 012D","E01017374",1090,210,48,162,342,153,110,40,92,47,22,17,5,74
"2011","Central Bedfordshire 012E","E01017375",1011,177,31,146,284,138,107,38,101,63,29,22,7,74
"2011","Central Bedfordshire 013A","E01017391",984,93,31,62,214,132,108,80,139,115,44,26,18,59
"2011","Central Bedfordshire 013B","E01017392",1091,193,45,148,315,176,123,55,91,56,11,7,4,71
"2011","Central Bedfordshire 013C","E01017393",1248,180,45,135,364,180,146,79,103,91,25,14,11,80
"2011","Central Bedfordshire 013D","E01017442",1536,229,73,156,414,219,185,121,140,120,26,12,14,82
"2011","Central Bedfordshire 013E","E01017443",1334,184,110,74,420,230,93,85,138,96,31,17,14,57
"2011","Central Bedfordshire 014A","E01017446",1245,133,29,104,251,186,160,88,183,141,34,16,18,69
"2011","Central Bedfordshire 014B","E01017447",1531,207,55,152,397,254,174,112,160,104,22,11,11,101
"2011","Central Bedfordshire 014D","E01017449",1104,109,36,73,288,190,144,95,123,95,20,12,8,40
"2011","Central Bedfordshire 014E","E01033188",1051,128,24,104,283,176,130,70,110,77,23,12,11,54
"2011","Central Bedfordshire 014F","E01033189",1133,265,66,199,362,140,109,49,93,48,19,7,12,48
"2011","Central Bedfordshire 014G","E01033190",1038,231,46,185,364,135,80,59,77,54,8,2,6,30
"2011","Central Bedfordshire 015A","E01017399",1092,150,25,125,303,167,99,68,129,74,18,8,10,84
"2011","Central Bedfordshire 015B","E01017400",1040,58,20,38,149,97,126,108,205,171,55,31,24,71
"2011","Central Bedfordshire 015C","E01017401",959,138,31,107,217,170,116,59,112,58,19,14,5,70
"2011","Central Bedfordshire 015D","E01017402",1154,146,37,109,284,188,167,71,127,91,14,9,5,66
"2011","Central Bedfordshire 016A","E01017403",1040,105,31,74,242,166,94,92,137,102,25,16,9,77
"2011","Central Bedfordshire 016B","E01017404",1064,145,27,118,327,185,98,50,118,52,13,6,7,76
"2011","Central Bedfordshire 016C","E01017405",1130,108,18,90,273,194,104,96,160,101,20,9,11,74
"2011","Central Bedfordshire 016D","E01017406",1175,167,42,125,321,173,143,79,134,68,8,3,5,82
"2011","Central Bedfordshire 016E","E01017407",1286,153,34,119,312,197,116,107,180,105,27,15,12,89
"2011","Central Bedfordshire 017A","E01017398",1783,315,93,222,495,253,242,101,136,95,36,18,18,110
"2011","Central Bedfordshire 017B","E01017408",790,126,30,96,225,127,72,49,71,47,7,5,2,66
"2011","Central Bedfordshire 017C","E01017409",903,141,32,109,233,128,85,49,96,79,18,8,10,74
"2011","Central Bedfordshire 017D","E01017445",1340,236,64,172,383,185,137,68,85,77,27,18,9,142
"2011","Central Bedfordshire 017E","E01017450",1735,214,71,143,434,252,209,117,193,145,48,36,12,123
"2011","Central Bedfordshire 018A","E01017558",1329,202,49,153,373,230,146,73,122,68,28,18,10,87
"2011","Central Bedfordshire 018B","E01017559",1186,157,45,112,291,202,147,78,113,80,22,15,7,96
"2011","Central Bedfordshire 018C","E01017560",1093,106,31,75,269,179,121,103,125,88,19,9,10,83
"2011","Central Bedfordshire 018D","E01017616",1708,216,49,167,435,256,205,113,179,145,46,25,21,113
"2011","Central Bedfordshire 019A","E01017577",1636,228,60,168,404,229,192,132,190,141,51,28,23,69
"2011","Central Bedfordshire 019B","E01017615",1573,209,72,137,402,212,244,97,159,118,30,14,16,102
"2011","Central Bedfordshire 019C","E01017620",1355,198,49,149,370,193,182,86,127,79,22,9,13,98
"2011","Central Bedfordshire 019D","E01017621",1146,158,43,115,347,189,112,77,94,81,19,10,9,69
"2011","Central Bedfordshire 019E","E01017622",1191,117,33,84,236,159,142,92,148,162,43,21,22,92
"2011","Central Bedfordshire 020A","E01017603",1134,94,30,64,239,170,100,104,180,160,29,16,13,58
"2011","Central Bedfordshire 020B","E01017604",1287,130,38,92,279,201,115,99,203,141,33,15,18,86
"2011","Central Bedfordshire 020C","E01017605",994,46,8,38,158,107,76,76,211,185,67,40,27,68
"2011","Central Bedfordshire 020D","E01017606",1116,187,43,144,306,197,109,66,102,74,14,9,5,61
"2011","Central Bedfordshire 020E","E01017607",1011,188,54,134,325,143,110,50,69,41,27,15,12,58
"2011","Central Bedfordshire 021A","E01017555",1419,140,32,108,320,226,116,104,177,172,70,46,24,94
"2011","Central Bedfordshire 021B","E01017556",1199,124,33,91,345,165,116,84,146,119,27,14,13,73
"2011","Central Bedfordshire 021C","E01017557",1240,129,29,100,297,174,125,95,176,131,49,26,23,64
"2011","Central Bedfordshire 021D","E01017608",1241,127,28,99,287,173,109,98,192,146,45,22,23,64
"2011","Central Bedfordshire 021E","E01017609",1155,52,8,44,177,142,79,86,225,235,76,48,28,83
"2011","Central Bedfordshire 022A","E01017589",1286,147,24,123,342,185,130,86,155,124,45,23,22,72
"2011","Central Bedfordshire 022B","E01017590",1094,195,40,155,314,159,119,62,102,67,23,9,14,53
"2011","Central Bedfordshire 022C","E01017591",1301,173,36,137,326,187,109,81,197,117,27,13,14,84
"2011","Central Bedfordshire 022D","E01017610",885,137,32,105,219,151,87,51,110,59,22,15,7,49
"2011","Central Bedfordshire 023A","E01017611",997,163,35,128,299,177,68,59,98,56,15,7,8,62
"2011","Central Bedfordshire 023B","E01017612",1000,130,27,103,288,179,82,62,119,70,18,8,10,52
"2011","Central Bedfordshire 023C","E01017613",1040,178,40,138,291,189,97,52,96,67,20,12,8,50
"2011","Central Bedfordshire 023D","E01017614",1141,147,31,116,300,188,89,86,156,92,21,5,16,62
"2011","Central Bedfordshire 025A","E01017600",1484,90,25,65,287,211,111,160,248,215,70,39,31,92
"2011","Central Bedfordshire 025B","E01017601",982,43,17,26,137,117,68,82,179,179,73,46,27,104
"2011","Central Bedfordshire 025C","E01017602",1114,32,6,26,176,140,86,96,204,216,87,57,30,77
"2011","Central Bedfordshire 025D","E01017618",1068,40,10,30,133,125,80,89,197,195,95,53,42,114
"2011","Central Bedfordshire 025E","E01017619",1449,60,10,50,207,185,107,114,275,272,108,70,38,121
"2011","Central Bedfordshire 024A","E01017573",1043,86,25,61,189,167,103,106,178,127,25,16,9,62
"2011","Central Bedfordshire 024C","E01017575",1847,217,55,162,488,295,156,125,241,189,51,30,21,85
"2011","Central Bedfordshire 024D","E01017576",1048,110,30,80,246,176,111,74,128,115,33,21,12,55
"2011","Central Bedfordshire 024E","E01033191",1015,137,38,99,293,158,81,72,125,78,20,10,10,51
"2011","Central Bedfordshire 024F","E01033192",1086,173,46,127,335,192,78,74,89,71,29,18,11,45
"2011","Central Bedfordshire 024G","E01033193",1153,155,33,122,307,203,96,84,119,97,23,13,10,69
"2011","Central Bedfordshire 026A","E01017578",1295,122,39,83,266,230,136,110,180,126,57,35,22,68
"2011","Central Bedfordshire 026B","E01017579",1085,57,15,42,191,167,95,95,176,155,61,31,30,88
"2011","Central Bedfordshire 026C","E01017580",1533,115,27,88,292,223,115,129,238,189,110,68,42,122
"2011","Central Bedfordshire 026D","E01017581",1291,70,19,51,242,208,129,105,194,201,69,47,22,73
"2011","Central Bedfordshire 026E","E01017617",935,60,22,38,196,136,87,100,136,123,28,12,16,69
"2011","Central Bedfordshire 027A","E01017582",1106,87,17,70,231,185,104,103,163,136,28,20,8,69
"2011","Central Bedfordshire 027B","E01017583",1336,129,36,93,278,219,127,89,182,147,44,28,16,121
"2011","Central Bedfordshire 027C","E01017584",1335,103,34,69,284,231,127,98,204,134,60,42,18,94
"2011","Central Bedfordshire 027D","E01017585",1052,91,23,68,197,199,120,101,127,99,24,14,10,94
"2011","Central Bedfordshire 028A","E01017566",1128,161,48,113,287,197,173,52,100,69,16,7,9,73
"2011","Central Bedfordshire 028B","E01017595",854,58,20,38,130,119,67,82,147,134,49,26,23,68
"2011","Central Bedfordshire 028C","E01017596",1024,61,15,46,152,159,77,96,195,153,68,43,25,63
"2011","Central Bedfordshire 028D","E01017597",1021,88,31,57,181,149,95,79,163,171,38,19,19,57
"2011","Central Bedfordshire 028E","E01017598",811,67,20,47,169,147,77,73,102,105,22,14,8,49
"2011","Central Bedfordshire 028F","E01017599",1532,108,22,86,291,223,155,125,220,194,100,59,41,116
"2011","Central Bedfordshire 029A","E01017565",1081,153,34,119,246,200,122,69,109,78,12,5,7,92
"2011","Central Bedfordshire 029B","E01017567",1186,95,23,72,254,184,116,84,158,140,61,37,24,94
"2011","Central Bedfordshire 029C","E01017568",1327,93,24,69,287,179,149,110,177,166,86,50,36,80
"2011","Central Bedfordshire 029D","E01017569",1169,124,32,92,252,182,128,94,146,130,41,24,17,72
"2011","Central Bedfordshire 029E","E01017570",1480,160,35,125,374,205,148,117,175,159,58,36,22,84
"2011","Central Bedfordshire 030A","E01017592",1124,105,26,79,258,182,101,92,156,117,41,22,19,72
"2011","Central Bedfordshire 030B","E01017593",1091,84,30,54,259,180,107,86,144,109,44,20,24,78
"2011","Central Bedfordshire 030C","E01017594",1400,52,15,37,193,162,115,110,237,269,154,83,71,108
"2011","Central Bedfordshire 031A","E01017623",1270,127,31,96,256,201,130,77,196,139,61,30,31,83
"2011","Central Bedfordshire 031B","E01017624",1425,145,32,113,339,230,159,102,165,133,60,38,22,92
"2011","Central Bedfordshire 031C","E01017625",1199,139,42,97,317,226,111,92,140,83,17,9,8,74
"2011","Central Bedfordshire 031D","E01017626",1352,168,39,129,361,257,113,98,132,88,23,10,13,112
"2011","Central Bedfordshire 032A","E01017571",899,118,27,91,213,146,123,34,98,74,39,28,11,54
"2011","Central Bedfordshire 032B","E01017572",1010,152,43,109,290,142,143,64,76,53,23,7,16,67
"2011","Central Bedfordshire 032C","E01017586",1066,146,31,115,265,124,135,76,117,105,38,23,15,60
"2011","Central Bedfordshire 032D","E01017587",1170,200,55,145,331,151,194,61,101,62,24,15,9,46
"2011","Central Bedfordshire 032E","E01017588",878,100,21,79,205,116,135,54,95,114,20,12,8,39
"2011","Central Bedfordshire 033A","E01017561",1165,157,49,108,294,206,133,94,104,89,23,17,6,65
"2011","Central Bedfordshire 033B","E01017562",1058,106,28,78,199,152,122,90,149,151,37,20,17,52
"2011","Central Bedfordshire 033C","E01017563",1149,150,30,120,272,191,132,96,136,106,16,11,5,50
"2011","Central Bedfordshire 033D","E01017564",1082,144,37,107,269,158,126,93,108,112,20,10,10,52
"2011","Luton 001A","E01015706",1023,143,36,107,255,208,85,61,116,63,34,22,12,58
"2011","Luton 001B","E01015707",1110,146,29,117,258,198,112,78,137,79,30,20,10,72
"2011","Luton 001C","E01015708",1056,155,29,126,266,189,88,65,109,59,44,25,19,81
"2011","Luton 001D","E01015709",1125,136,36,100,264,194,115,92,125,78,42,26,16,79
"2011","Luton 001E","E01015710",1136,127,25,102,278,197,111,91,147,76,47,29,18,62
"2011","Luton 001F","E01015770",1010,94,23,71,215,172,92,83,159,103,32,19,13,60
"2011","Luton 002A","E01015801",1243,66,11,55,205,173,80,105,198,194,107,65,42,115
"2011","Luton 002B","E01015803",1144,62,21,41,213,193,109,119,189,154,36,20,16,69
"2011","Luton 002C","E01015804",1254,58,13,45,201,175,99,119,208,197,84,58,26,113
"2011","Luton 002D","E01015805",986,66,15,51,180,175,84,88,169,99,41,21,20,84
"2011","Luton 003A","E01015769",871,28,6,22,138,111,77,85,149,150,61,37,24,72
"2011","Luton 003B","E01015771",997,45,17,28,114,96,61,63,188,179,152,110,42,99
"2011","Luton 003C","E01015772",1018,38,9,29,120,101,69,66,189,165,121,81,40,149
"2011","Luton 003D","E01015773",900,26,5,21,98,121,71,76,158,166,96,68,28,88
"2011","Luton 003E","E01015774",988,29,9,20,130,88,68,76,179,167,127,86,41,124
"2011","Luton 003F","E01015802",1050,41,11,30,157,119,86,85,169,174,113,81,32,106
"2011","Luton 004A","E01015744",1023,57,13,44,180,155,85,85,161,138,83,53,30,79
"2011","Luton 004B","E01015746",1044,90,17,73,215,143,112,94,156,120,55,35,20,59
"2011","Luton 004C","E01015747",1067,161,22,139,261,182,115,51,102,51,42,35,7,102
"2011","Luton 004D","E01015748",1129,89,26,63,221,157,117,104,167,130,68,46,22,76
"2011","Luton 005A","E01015749",1283,44,10,34,153,112,114,98,221,234,170,121,49,137
"2011","Luton 005B","E01015751",1145,70,18,52,191,154,92,90,186,147,105,78,27,110
"2011","Luton 005C","E01015752",972,61,15,46,138,138,93,81,162,142,68,51,17,89
"2011","Luton 005D","E01015753",1091,70,20,50,224,201,88,88,160,142,58,31,27,60
"2011","Luton 005E","E01015754",1222,50,18,32,167,162,93,117,197,196,136,96,40,104
"2011","Luton 005F","E01015755",1142,91,15,76,232,179,107,78,171,130,69,48,21,85
"2011","Luton 006A","E01015764",1081,67,19,48,188,197,110,94,155,147,45,30,15,78
"2011","Luton 006B","E01015765",1178,66,12,54,207,170,93,91,187,162,94,64,30,108
"2011","Luton 006C","E01015766",1127,77,15,62,194,150,113,95,139,131,93,73,20,135
"2011","Luton 006D","E01015767",1165,76,14,62,209,163,122,81,162,164,92,63,29,96
"2011","Luton 006E","E01015768",1015,73,19,54,226,155,100,79,162,101,45,31,14,74
"2011","Luton 006F","E01015783",1166,37,9,28,144,119,119,101,187,168,150,116,34,141
"2011","Luton 006G","E01015785",1499,90,9,81,263,191,124,113,230,201,141,111,30,146
"2011","Luton 007A","E01015693",1111,180,29,151,309,146,117,55,93,58,52,44,8,101
"2011","Luton 007B","E01015694",977,105,20,85,202,147,113,54,122,89,66,58,8,79
"2011","Luton 007C","E01015695",1100,122,28,94,258,137,129,63,109,68,94,82,12,120
"2011","Luton 007D","E01015696",966,121,22,99,265,154,78,76,100,62,28,15,13,82
"2011","Luton 007E","E01015697",1221,182,32,150,348,175,95,73,111,83,44,34,10,110
"2011","Luton 007F","E01015745",1124,147,30,117,267,174,107,62,110,78,48,36,12,131
"2011","Luton 008A","E01015797",969,99,25,74,234,183,76,98,116,65,20,12,8,78
"2011","Luton 008B","E01015798",971,74,14,60,188,160,99,72,134,113,62,45,17,69
"2011","Luton 008C","E01015799",1038,110,31,79,214,216,101,96,139,83,18,9,9,61
"2011","Luton 008D","E01015800",1110,84,21,63,202,186,113,100,184,121,30,16,14,90
"2011","Luton 008E","E01015812",1047,83,20,63,239,216,72,103,144,100,21,9,12,69
"2011","Luton 008F","E01015813",1012,66,16,50,169,141,73,102,179,145,40,29,11,97
"2011","Luton 009A","E01015756",1144,64,15,49,208,170,84,99,189,175,60,39,21,95
"2011","Luton 009B","E01015757",1057,28,6,22,128,123,78,85,206,208,109,81,28,92
"2011","Luton 009C","E01015758",1068,53,11,42,185,134,82,76,159,133,102,62,40,144
"2011","Luton 009D","E01015759",1034,33,7,26,128,105,84,78,184,195,116,81,35,111
"2011","Luton 009E","E01015760",1023,35,15,20,148,121,77,82,170,178,111,72,39,101
"2011","Luton 009F","E01015761",1061,44,10,34,141,123,102,81,188,180,100,71,29,102
"2011","Luton 010A","E01015700",1654,163,18,145,297,173,175,104,163,158,245,220,25,176
"2011","Luton 010B","E01015701",1469,51,9,42,114,109,153,89,212,168,355,320,35,218
"2011","Luton 010C","E01015704",1329,43,7,36,95,104,107,78,198,195,296,262,34,213
"2011","Luton 010D","E01015782",1351,88,12,76,199,142,151,78,194,147,176,151,25,176
"2011","Luton 010E","E01015784",1412,89,13,76,152,113,189,88,162,162,274,251,23,183
"2011","Luton 010F","E01015786",1481,51,4,47,137,110,190,91,176,181,250,228,22,295
"2011","Luton 011A","E01015711",1149,51,10,41,170,125,141,58,155,123,173,151,22,153
"2011","Luton 011B","E01015712",1180,95,12,83,182,154,129,67,163,139,135,114,21,116
"2011","Luton 011C","E01015715",1201,36,9,27,120,112,128,58,197,158,246,216,30,146
"2011","Luton 011D","E01015716",1227,72,11,61,211,178,84,84,159,155,141,110,31,143
"2011","Luton 011E","E01015717",1027,53,9,44,159,117,82,74,160,147,131,106,25,104
"2011","Luton 011F","E01015750",1504,115,15,100,254,207,128,92,194,179,175,143,32,160
"2011","Luton 012A","E01015740",1166,138,24,114,249,154,97,70,137,133,73,56,17,115
"2011","Luton 012B","E01015775",1196,106,36,70,280,192,112,87,147,111,33,19,14,128
"2011","Luton 012C","E01015776",1311,73,18,55,237,178,136,95,184,172,88,67,21,148
"2011","Luton 012D","E01015777",1285,103,23,80,234,196,114,106,158,129,79,48,31,166
"2011","Luton 012E","E01015778",1278,104,14,90,269,193,124,100,171,151,51,31,20,115
"2011","Luton 012F","E01015796",1066,81,31,50,197,177,131,95,148,124,40,21,19,73
"2011","Luton 013A","E01015713",952,53,18,35,142,123,111,60,132,128,116,90,26,87
"2011","Luton 013B","E01015714",1205,89,19,70,258,149,108,72,192,134,90,75,15,113
"2011","Luton 013C","E01015718",1181,114,18,96,305,146,85,53,171,123,61,45,16,123
"2011","Luton 013D","E01015762",1205,85,18,67,244,186,91,93,178,164,62,41,21,102
"2011","Luton 013E","E01015763",1078,54,11,43,199,147,91,84,210,150,70,52,18,73
"2011","Luton 014A","E01015721",1081,81,22,59,172,178,104,139,157,148,42,27,15,60
"2011","Luton 014B","E01015722",942,58,11,47,151,147,85,84,137,146,55,27,28,79
"2011","Luton 014C","E01015806",1023,124,34,90,246,190,90,92,107,76,28,21,7,70
"2011","Luton 014D","E01015808",1101,107,23,84,242,202,87,118,129,115,29,14,15,72
"2011","Luton 014E","E01015809",1125,116,34,82,279,213,96,100,137,74,22,11,11,88
"2011","Luton 014F","E01015810",1027,118,26,92,234,167,65,80,135,88,41,24,17,99
"2011","Luton 014G","E01015811",1129,124,37,87,270,229,99,101,156,74,22,15,7,54
"2011","Luton 015A","E01015703",1418,42,6,36,95,88,142,71,189,186,420,388,32,185
"2011","Luton 015B","E01015726",1576,51,6,45,119,105,143,81,246,221,373,325,48,237
"2011","Luton 015C","E01015731",1321,51,7,44,115,113,128,75,187,211,250,210,40,191
"2011","Luton 015D","E01015787",1352,56,10,46,140,122,136,67,178,192,293,265,28,168
"2011","Luton 015E","E01015788",1362,48,10,38,106,101,145,72,178,169,342,313,29,201
"2011","Luton 016A","E01015719",1062,98,26,72,184,158,109,97,171,131,44,31,13,70
"2011","Luton 016B","E01015720",1114,57,10,47,131,100,73,78,168,188,139,106,33,180
"2011","Luton 016C","E01015723",966,78,19,59,167,129,82,80,149,133,71,45,26,77
"2011","Luton 016D","E01015779",1026,35,7,28,112,88,123,81,186,178,118,99,19,105
"2011","Luton 016E","E01015780",1222,77,17,60,262,165,129,103,167,131,62,44,18,126
"2011","Luton 016F","E01015781",1090,52,12,40,156,143,105,101,200,140,89,67,22,104
"2011","Luton 016G","E01015807",953,33,6,27,159,126,78,86,177,135,84,51,33,75
"2011","Luton 017A","E01015698",1290,70,9,61,105,100,107,74,158,164,235,208,27,277
"2011","Luton 017B","E01015699",1312,29,5,24,103,89,108,79,178,192,244,192,52,290
"2011","Luton 017C","E01015702",1183,50,7,43,102,96,127,56,160,161,258,224,34,173
"2011","Luton 017D","E01015705",1259,43,5,38,123,96,80,76,158,210,221,198,23,252
"2011","Luton 017E","E01015725",1073,31,4,27,70,80,60,57,151,156,289,252,37,179
"2011","Luton 017F","E01015727",1292,40,9,31,87,75,82,75,174,204,288,256,32,267
"2011","Luton 018A","E01015739",1537,135,17,118,293,165,118,101,180,250,90,59,31,205
"2011","Luton 018B","E01015741",1796,89,8,81,237,177,123,109,238,261,210,148,62,352
"2011","Luton 018C","E01015742",1416,100,22,78,265,170,110,90,193,188,81,57,24,219
"2011","Luton 018D","E01015743",1227,84,14,70,173,114,84,70,171,163,129,77,52,239
"2011","Luton 018E","E01015789",1301,41,6,35,96,82,99,87,194,215,156,110,46,331
"2011","Luton 018F","E01015794",2285,67,13,54,206,130,85,88,233,260,144,102,42,1072
"2011","Luton 019A","E01015724",1574,54,8,46,159,120,149,88,222,307,260,216,44,215
"2011","Luton 019B","E01015728",1154,50,6,44,103,99,119,72,183,187,162,138,24,179
"2011","Luton 019C","E01015729",1442,43,3,40,112,75,105,89,184,264,281,231,50,289
"2011","Luton 019D","E01015730",1660,49,6,43,186,109,121,94,222,307,259,210,49,313
"2011","Luton 020A","E01015732",1038,31,8,23,129,130,84,72,166,187,116,95,21,123
"2011","Luton 020B","E01015733",1135,42,8,34,143,92,106,102,200,201,137,107,30,112
"2011","Luton 020C","E01015734",1351,86,17,69,257,158,125,108,187,194,74,57,17,162
"2011","Luton 020D","E01015735",1357,62,14,48,180,136,76,83,189,215,150,98,52,266
"2011","Luton 020E","E01015736",1146,27,5,22,145,110,86,79,199,242,148,106,42,110
"2011","Luton 020F","E01015737",1061,45,13,32,138,124,101,93,151,164,118,86,32,127
"2011","Luton 021A","E01015738",1462,110,17,93,223,154,125,91,175,182,94,65,29,308
"2011","Luton 021B","E01015790",1212,74,15,59,190,142,109,89,155,154,70,43,27,229
"2011","Luton 021C","E01015791",2011,77,9,68,196,158,122,123,252,267,144,101,43,672
"2011","Luton 021D","E01015792",1382,76,11,65,204,153,91,91,195,201,77,48,29,294
"2011","Luton 021E","E01015793",1342,132,28,104,274,167,136,80,183,129,82,57,25,159
"2011","Luton 021F","E01015795",1820,64,9,55,190,151,120,92,217,318,165,96,69,503
"2011","Peterborough 001A","E01015629",1243,143,41,102,311,205,123,87,156,103,32,19,13,83
"2011","Peterborough 001B","E01015635",1131,154,37,117,282,206,131,70,139,69,23,15,8,57
"2011","Peterborough 001C","E01015636",842,111,47,64,198,139,134,46,89,66,13,6,7,46
"2011","Peterborough 001D","E01015679",1355,131,35,96,313,260,101,100,187,140,40,22,18,83
"2011","Peterborough 002A","E01015678",1079,87,23,64,229,194,76,98,187,114,23,15,8,71
"2011","Peterborough 002B","E01015680",1081,49,16,33,163,152,86,102,196,158,97,60,37,78
"2011","Peterborough 002C","E01015681",1164,138,36,102,273,216,71,92,178,81,24,16,8,91
"2011","Peterborough 002D","E01015682",1096,121,29,92,249,227,72,78,150,100,32,20,12,67
"2011","Peterborough 003A","E01015630",1164,110,39,71,259,165,168,80,150,131,34,23,11,67
"2011","Peterborough 003B","E01015631",978,107,31,76,210,163,107,85,143,92,19,13,6,52
"2011","Peterborough 003C","E01015659",1489,119,24,95,277,253,118,132,282,191,39,21,18,78
"2011","Peterborough 003D","E01015684",1074,136,35,101,283,201,90,63,143,81,23,20,3,54
"2011","Peterborough 003E","E01015685",1220,125,36,89,273,253,102,89,194,110,20,13,7,54
"2011","Peterborough 004A","E01015589",1186,217,70,147,336,181,130,64,103,68,20,9,11,67
"2011","Peterborough 004B","E01015590",860,163,55,108,240,82,94,60,91,62,18,9,9,50
"2011","Peterborough 004C","E01015626",1039,72,41,31,318,187,47,106,134,105,24,9,15,46
"2011","Peterborough 004D","E01015628",1861,277,147,130,575,364,123,180,138,99,40,21,19,65
"2011","Peterborough 005A","E01015617",984,108,32,76,228,163,115,67,117,114,29,15,14,43
"2011","Peterborough 005B","E01015618",786,56,15,41,143,123,95,68,141,93,19,14,5,48
"2011","Peterborough 005C","E01015619",1455,107,18,89,279,218,122,119,252,189,70,44,26,99
"2011","Peterborough 005D","E01015620",1246,143,38,105,288,197,130,79,173,133,28,18,10,75
"2011","Peterborough 006A","E01015674",1053,54,19,35,168,135,78,102,200,185,61,30,31,70
"2011","Peterborough 006B","E01015675",1128,81,23,58,238,158,100,105,188,152,48,30,18,58
"2011","Peterborough 006C","E01015676",1146,63,14,49,200,184,88,106,239,162,45,31,14,59
"2011","Peterborough 006D","E01015683",1329,125,48,77,298,232,125,106,227,116,37,22,15,63
"2011","Peterborough 006E","E01015686",1122,97,20,77,233,204,96,103,187,125,18,15,3,59
"2011","Peterborough 007A","E01015607",975,25,9,16,101,106,69,73,215,234,99,72,27,53
"2011","Peterborough 007B","E01015609",1211,16,4,12,92,80,57,108,254,317,181,137,44,106
"2011","Peterborough 007C","E01015656",1109,45,17,28,156,139,89,103,209,222,83,48,35,63
"2011","Peterborough 007D","E01015657",1321,59,15,44,173,148,87,113,223,282,145,103,42,91
"2011","Peterborough 007E","E01015658",1045,29,6,23,102,127,51,83,221,248,110,80,30,74
"2011","Peterborough 007F","E01015660",1102,39,11,28,168,160,69,101,231,204,83,48,35,47
"2011","Peterborough 008A","E01015605",1088,43,7,36,125,115,100,107,203,216,93,67,26,86
"2011","Peterborough 008B","E01015608",1105,41,6,35,124,143,90,99,203,216,122,85,37,67
"2011","Peterborough 008C","E01015610",1082,33,10,23,114,121,74,99,218,249,110,74,36,64
"2011","Peterborough 008D","E01015633",1557,64,16,48,222,208,104,133,314,284,145,101,44,83
"2011","Peterborough 008E","E01015634",1240,56,10,46,125,140,67,102,252,306,121,89,32,71
"2011","Peterborough 009A","E01015593",1022,23,7,16,111,140,58,104,202,216,86,54,32,82
"2011","Peterborough 009B","E01015596",1147,40,13,27,124,143,53,110,244,235,110,72,38,88
"2011","Peterborough 009C","E01015662",1019,32,13,19,127,132,46,89,198,195,105,81,24,95
"2011","Peterborough 009D","E01015663",1041,37,6,31,113,86,53,84,237,248,109,65,44,74
"2011","Peterborough 009E","E01015664",1191,34,10,24,124,132,56,100,242,274,139,92,47,90
"2011","Peterborough 010A","E01015603",1601,37,8,29,107,146,153,102,274,370,253,213,40,159
"2011","Peterborough 010B","E01015604",1309,27,7,20,57,87,112,58,231,280,306,278,28,151
"2011","Peterborough 010C","E01015632",1438,37,9,28,148,116,116,104,287,363,173,135,38,94
"2011","Peterborough 010D","E01015661",1315,44,10,34,149,133,77,112,247,311,178,146,32,64
"2011","Peterborough 010E","E01015677",801,39,8,31,135,109,64,85,168,131,42,27,15,28
"2011","Peterborough 011A","E01015591",1115,99,25,74,207,214,76,86,184,122,44,22,22,83
"2011","Peterborough 011B","E01015592",1104,45,7,38,181,172,49,109,236,195,67,51,16,50
"2011","Peterborough 011C","E01015594",1356,78,17,61,202,209,67,116,275,237,93,46,47,79
"2011","Peterborough 011D","E01015595",1065,41,7,34,178,153,66,83,208,193,81,50,31,62
"2011","Peterborough 011E","E01015597",1102,42,11,31,173,158,63,70,214,188,100,60,40,94
"2011","Peterborough 012A","E01015601",1375,50,7,43,94,124,137,70,187,232,294,274,20,187
"2011","Peterborough 012B","E01015651",1418,93,18,75,219,178,155,117,202,240,119,102,17,95
"2011","Peterborough 012C","E01015652",1386,49,12,37,139,141,116,88,204,362,152,133,19,135
"2011","Peterborough 012D","E01015653",1339,114,20,94,234,192,112,86,204,170,81,69,12,146
"2011","Peterborough 012E","E01015654",1526,86,16,70,213,154,125,102,278,310,146,115,31,112
"2011","Peterborough 013A","E01015606",1277,84,22,62,211,187,94,97,242,200,74,56,18,88
"2011","Peterborough 013B","E01015611",1497,50,8,42,184,151,91,107,309,363,168,127,41,74
"2011","Peterborough 013C","E01015613",1099,64,15,49,160,131,57,99,204,238,93,67,26,53
"2011","Peterborough 013D","E01015614",1337,84,17,67,214,186,104,116,243,247,77,50,27,66
"2011","Peterborough 013E","E01015615",1079,63,13,50,177,148,91,72,171,189,83,66,17,85
"2011","Peterborough 013F","E01015616",1208,28,4,24,85,92,88,71,243,306,196,149,47,99
"2011","Peterborough 014A","E01015599",1374,105,6,99,151,105,109,93,185,309,192,169,23,125
"2011","Peterborough 014B","E01015600",1256,32,4,28,85,88,95,81,199,307,256,230,26,113
"2011","Peterborough 014C","E01015602",1531,116,17,99,211,145,111,107,249,337,157,110,47,98
"2011","Peterborough 014D","E01015612",1584,73,6,67,159,152,85,153,285,417,176,136,40,84
"2011","Peterborough 014E","E01015655",1599,161,27,134,323,170,114,120,213,253,112,90,22,133
"2011","Peterborough 015A","E01015598",1163,181,41,140,287,213,90,61,135,80,37,27,10,79
"2011","Peterborough 015B","E01015687",1143,187,36,151,294,214,84,57,110,67,44,36,8,86
"2011","Peterborough 015C","E01015689",1057,236,64,172,278,191,89,31,86,47,32,19,13,67
"2011","Peterborough 015D","E01015690",899,163,43,120,243,121,100,26,77,53,47,34,13,69
"2011","Peterborough 015E","E01015691",889,89,19,70,166,143,65,59,133,104,56,45,11,74
"2011","Peterborough 016A","E01015622",1845,196,41,155,437,263,110,147,229,256,119,79,40,88
"2011","Peterborough 016C","E01015665",1149,72,13,59,153,120,100,78,178,204,143,131,12,101
"2011","Peterborough 016D","E01015688",1069,180,22,158,254,141,65,47,122,118,79,59,20,63
"2011","Peterborough 016E","E01015692",965,87,8,79,152,117,72,56,137,144,116,100,16,84
"2011","Peterborough 016F","E01033173",1396,262,60,202,359,238,93,92,153,98,25,12,13,76
"2011","Peterborough 016G","E01033182",1086,59,10,49,157,123,72,107,214,228,73,39,34,53
"2011","Peterborough 017A","E01015621",1499,140,28,112,359,209,98,117,220,217,72,54,18,67
"2011","Peterborough 017B","E01015623",1276,65,18,47,206,195,103,111,214,252,55,30,25,75
"2011","Peterborough 017C","E01015624",1233,111,26,85,285,174,101,97,191,163,54,27,27,57
"2011","Peterborough 017D","E01015666",956,53,18,35,146,125,77,89,171,163,83,58,25,49
"2011","Peterborough 017E","E01015668",1344,78,15,63,246,189,98,110,233,232,89,61,28,69
"2011","Peterborough 018A","E01015627",1240,221,54,167,337,169,164,73,119,71,20,14,6,66
"2011","Peterborough 018B","E01015644",1471,187,50,137,353,286,115,98,173,128,58,33,25,73
"2011","Peterborough 018C","E01015645",1272,138,26,112,327,269,65,82,165,119,32,23,9,75
"2011","Peterborough 018D","E01015646",1429,204,52,152,378,303,124,77,158,92,27,11,16,66
"2011","Peterborough 018E","E01015648",1076,208,65,143,307,204,89,52,93,48,29,17,12,46
"2011","Peterborough 019A","E01015667",992,78,18,60,147,156,61,93,188,172,31,20,11,66
"2011","Peterborough 019B","E01015669",1067,62,20,42,143,169,80,111,217,186,45,27,18,54
"2011","Peterborough 019C","E01015670",1040,55,17,38,149,185,83,115,178,177,35,20,15,63
"2011","Peterborough 019D","E01015671",1127,90,17,73,201,207,93,108,186,145,42,26,16,55
"2011","Peterborough 019E","E01015672",1139,110,38,72,237,220,75,85,188,134,34,24,10,56
"2011","Peterborough 019F","E01015673",1054,56,9,47,164,146,92,74,178,199,87,48,39,58
"2011","Peterborough 021A","E01015637",1028,26,8,18,138,142,54,83,211,218,96,64,32,60
"2011","Peterborough 021B","E01015639",1124,31,10,21,120,160,66,111,197,261,102,64,38,76
"2011","Peterborough 021C","E01015640",1096,52,9,43,188,166,57,101,208,213,57,38,19,54
"2011","Peterborough 021D","E01015641",886,50,17,33,134,112,48,79,181,158,50,33,17,74
"2011","Peterborough 021E","E01015642",1033,40,14,26,142,113,54,89,221,211,94,56,38,69
"2011","Peterborough 021F","E01015647",940,28,7,21,128,109,56,75,171,195,91,57,34,87
"2011","Peterborough 022A","E01015638",1110,136,44,92,265,185,84,68,125,128,66,54,12,53
"2011","Peterborough 022B","E01015650",1512,236,53,183,383,216,131,124,174,140,36,21,15,72
"2011","Peterborough 022C","E01033174",817,105,23,82,170,118,47,48,118,111,53,34,19,47
"2011","Peterborough 022D","E01033179",1089,116,20,96,262,173,74,62,164,132,42,23,19,64
"2011","Peterborough 022E","E01033181",1113,169,30,139,302,188,71,73,107,95,37,25,12,71
"2011","Peterborough 023A","E01015643",1024,57,9,48,176,157,72,97,209,148,53,30,23,55
"2011","Peterborough 023B","E01033175",1011,178,43,135,292,162,61,51,113,58,25,16,9,71
"2011","Peterborough 023C","E01033176",1090,169,32,137,292,197,70,52,109,85,44,33,11,72
"2011","Peterborough 023D","E01033177",1000,160,33,127,298,144,61,68,108,77,42,21,21,42
"2011","Peterborough 023E","E01033178",1018,116,17,99,234,164,67,72,134,88,71,49,22,72
"2011","Peterborough 023F","E01033180",1094,143,28,115,270,176,73,77,118,105,58,34,24,74
"2011","Southend-on-Sea 001A","E01015833",1111,91,20,71,249,235,125,73,151,98,29,7,22,60
"2011","Southend-on-Sea 001B","E01015834",1094,95,25,70,220,219,136,82,168,101,28,14,14,45
"2011","Southend-on-Sea 001C","E01015835",1158,68,17,51,209,213,149,77,184,137,56,29,27,65
"2011","Southend-on-Sea 001D","E01015836",1108,93,20,73,195,204,148,93,177,122,21,14,7,55
"2011","Southend-on-Sea 001E","E01015837",1187,68,18,50,242,224,142,106,188,133,27,19,8,57
"2011","Southend-on-Sea 001F","E01015838",1058,106,21,85,207,212,134,80,164,76,19,11,8,60
"2011","Southend-on-Sea 002A","E01015863",1755,137,35,102,369,365,205,118,256,163,52,36,16,90
"2011","Southend-on-Sea 002B","E01015864",936,74,20,54,190,178,95,86,134,87,38,22,16,54
"2011","Southend-on-Sea 002C","E01015865",1061,54,19,35,185,179,143,87,194,131,36,26,10,52
"2011","Southend-on-Sea 002D","E01015866",1098,93,26,67,214,205,126,111,170,104,29,17,12,46
"2011","Southend-on-Sea 002E","E01015867",1032,49,18,31,171,140,127,82,174,158,71,49,22,60
"2011","Southend-on-Sea 002F","E01015868",1134,63,11,52,198,166,144,98,188,140,69,47,22,68
"2011","Southend-on-Sea 003A","E01015814",1000,92,18,74,247,183,100,63,125,86,54,37,17,50
"2011","Southend-on-Sea 003B","E01015815",1141,148,44,104,285,219,123,58,127,70,35,20,15,76
"2011","Southend-on-Sea 003C","E01015816",1012,83,23,60,211,195,135,71,152,116,22,15,7,27
"2011","Southend-on-Sea 003D","E01015817",1095,97,32,65,226,232,162,74,144,96,26,20,6,38
"2011","Southend-on-Sea 003E","E01015818",1195,92,25,67,236,233,148,82,162,124,52,32,20,66
"2011","Southend-on-Sea 003F","E01015819",1012,77,15,62,178,161,117,64,180,105,61,31,30,69
"2011","Southend-on-Sea 004A","E01015857",1076,116,26,90,267,194,139,58,133,75,22,15,7,72
"2011","Southend-on-Sea 004B","E01015858",1231,144,25,119,322,226,134,71,136,100,35,25,10,63
"2011","Southend-on-Sea 004C","E01015859",1329,122,26,96,299,211,138,87,200,127,54,31,23,91
"2011","Southend-on-Sea 004D","E01015860",1117,122,20,102,262,203,128,81,144,74,31,13,18,72
"2011","Southend-on-Sea 004E","E01015861",1158,92,22,70,219,167,114,72,198,146,77,49,28,73
"2011","Southend-on-Sea 004F","E01015862",1107,88,24,64,216,185,114,77,184,119,57,33,24,67
"2011","Southend-on-Sea 005A","E01015820",1035,57,13,44,169,131,93,90,187,139,87,62,25,82
"2011","Southend-on-Sea 005B","E01015821",1119,101,26,75,286,169,146,62,144,100,46,32,14,65
"2011","Southend-on-Sea 005C","E01015822",890,108,27,81,230,158,101,50,105,62,22,11,11,54
"2011","Southend-on-Sea 005D","E01015823",1178,132,30,102,314,192,145,74,121,73,40,22,18,87
"2011","Southend-on-Sea 005E","E01015824",1090,50,13,37,168,144,107,104,188,165,88,58,30,76
"2011","Southend-on-Sea 005F","E01015825",1132,72,13,59,222,170,121,87,188,146,57,43,14,69
"2011","Southend-on-Sea 005G","E01015826",981,103,26,77,232,159,127,69,136,70,29,21,8,56
"2011","Southend-on-Sea 006A","E01015869",1138,61,15,46,191,194,133,75,207,135,62,32,30,80
"2011","Southend-on-Sea 006B","E01015870",1185,67,12,55,220,239,127,94,186,99,71,38,33,82
"2011","Southend-on-Sea 006C","E01015871",1133,68,16,52,190,196,122,85,201,128,48,31,17,95
"2011","Southend-on-Sea 006D","E01015872",1210,92,27,65,223,201,147,76,198,135,75,33,42,63
"2011","Southend-on-Sea 006E","E01015873",955,73,16,57,203,181,74,71,159,103,46,25,21,45
"2011","Southend-on-Sea 006F","E01015874",1229,81,23,58,264,194,112,101,193,135,65,34,31,84
"2011","Southend-on-Sea 006G","E01015875",1169,46,15,31,172,160,128,96,202,181,115,72,43,69
"2011","Southend-on-Sea 007A","E01015901",1076,75,17,58,246,167,85,72,183,103,72,52,20,73
"2011","Southend-on-Sea 007B","E01015902",1227,78,16,62,256,183,107,98,197,123,96,72,24,89
"2011","Southend-on-Sea 007C","E01015903",1183,76,12,64,289,176,97,108,169,119,65,39,26,84
"2011","Southend-on-Sea 007D","E01015904",1216,84,23,61,291,189,110,85,168,132,79,57,22,78
"2011","Southend-on-Sea 007E","E01015905",1023,74,22,52,241,162,107,75,125,104,72,44,28,63
"2011","Southend-on-Sea 007F","E01015906",1141,80,12,68,260,155,116,88,179,113,85,47,38,65
"2011","Southend-on-Sea 007G","E01015907",1059,72,16,56,238,173,89,81,148,112,63,33,30,83
"2011","Southend-on-Sea 008A","E01015908",1118,232,49,183,348,214,101,45,73,23,15,8,7,67
"2011","Southend-on-Sea 008B","E01015909",1092,174,28,146,355,177,117,38,93,53,24,10,14,61
"2011","Southend-on-Sea 008C","E01015910",1082,221,39,182,316,165,122,37,94,38,23,12,11,66
"2011","Southend-on-Sea 008D","E01015911",929,158,38,120,285,166,115,36,61,29,21,13,8,58
"2011","Southend-on-Sea 008E","E01015912",1046,143,30,113,290,184,133,44,115,54,18,11,7,65
"2011","Southend-on-Sea 008F","E01015913",1223,171,35,136,345,204,171,55,102,74,34,14,20,67
"2011","Southend-on-Sea 009A","E01015883",968,163,28,135,278,180,116,39,68,37,28,16,12,59
"2011","Southend-on-Sea 009B","E01015884",1470,132,24,108,318,245,132,110,216,150,89,57,32,78
"2011","Southend-on-Sea 009C","E01015885",1115,209,38,171,309,219,133,39,101,40,15,10,5,50
"2011","Southend-on-Sea 009D","E01015886",1017,33,12,21,129,126,104,63,182,157,144,95,49,79
"2011","Southend-on-Sea 009E","E01015887",1074,51,13,38,173,154,112,75,158,138,103,69,34,110
"2011","Southend-on-Sea 009F","E01015888",1017,75,13,62,205,162,130,74,155,84,49,33,16,83
"2011","Southend-on-Sea 010A","E01015895",1482,54,7,47,190,161,102,128,290,252,200,110,90,105
"2011","Southend-on-Sea 010B","E01015896",1304,128,18,110,208,150,121,82,213,175,127,82,45,100
"2011","Southend-on-Sea 010C","E01015897",1518,82,20,62,245,179,108,127,278,226,178,135,43,95
"2011","Southend-on-Sea 010D","E01015898",1142,60,11,49,166,171,100,87,221,188,90,57,33,59
"2011","Southend-on-Sea 010E","E01015899",1414,82,21,61,275,230,145,94,245,140,76,46,30,127
"2011","Southend-on-Sea 010F","E01015900",1087,68,17,51,212,164,74,71,198,134,82,45,37,84
"2011","Southend-on-Sea 011A","E01015845",1210,156,35,121,376,211,130,47,128,63,31,12,19,68
"2011","Southend-on-Sea 011B","E01015846",1235,224,40,184,377,198,142,57,90,59,36,23,13,52
"2011","Southend-on-Sea 011C","E01015847",1280,176,33,143,387,200,155,76,127,81,30,13,17,48
"2011","Southend-on-Sea 011D","E01015848",1238,233,56,177,337,217,172,54,109,54,24,14,10,38
"2011","Southend-on-Sea 011E","E01015849",1254,182,41,141,345,192,149,68,126,85,48,30,18,59
"2011","Southend-on-Sea 011F","E01015850",1181,171,32,139,353,198,128,62,114,61,30,19,11,64
"2011","Southend-on-Sea 012A","E01015827",1169,194,55,139,335,167,143,37,105,62,58,45,13,68
"2011","Southend-on-Sea 012B","E01015828",1344,135,25,110,319,175,137,97,170,107,148,112,36,56
"2011","Southend-on-Sea 012C","E01015829",1091,163,34,129,340,192,109,51,98,58,29,17,12,51
"2011","Southend-on-Sea 012D","E01015830",1099,268,50,218,313,178,124,23,68,28,25,15,10,72
"2011","Southend-on-Sea 012E","E01015831",1619,154,46,108,333,228,154,121,211,196,96,58,38,126
"2011","Southend-on-Sea 012F","E01015832",1047,145,28,117,281,176,121,39,118,52,64,52,12,51
"2011","Southend-on-Sea 013A","E01015876",1616,170,38,132,376,281,163,116,229,145,46,31,15,90
"2011","Southend-on-Sea 013B","E01015877",1337,87,19,68,289,209,132,74,244,155,89,65,24,58
"2011","Southend-on-Sea 013C","E01015878",1063,106,23,83,240,190,118,67,139,88,43,22,21,72
"2011","Southend-on-Sea 013D","E01015879",987,68,18,50,160,151,71,75,205,127,65,42,23,65
"2011","Southend-on-Sea 013E","E01015880",1049,39,11,28,115,127,89,103,229,176,98,65,33,73
"2011","Southend-on-Sea 013F","E01015881",1013,69,18,51,202,182,104,73,157,109,37,21,16,80
"2011","Southend-on-Sea 013G","E01015882",1166,35,5,30,181,178,101,86,246,170,92,58,34,77
"2011","Southend-on-Sea 014A","E01015839",1235,94,19,75,230,181,108,86,175,130,112,66,46,119
"2011","Southend-on-Sea 014B","E01015840",1245,72,21,51,246,166,121,96,191,156,108,56,52,89
"2011","Southend-on-Sea 014C","E01015841",1814,117,23,94,327,219,184,141,312,242,150,81,69,122
"2011","Southend-on-Sea 014D","E01015842",1367,35,14,21,161,126,111,126,304,240,190,97,93,74
"2011","Southend-on-Sea 014E","E01015843",1238,85,10,75,229,186,91,94,209,161,97,58,39,86
"2011","Southend-on-Sea 014F","E01015844",1346,77,11,66,253,227,130,96,209,166,85,46,39,103
"2011","Southend-on-Sea 015A","E01015851",1259,125,30,95,313,167,137,88,187,100,110,67,43,32
"2011","Southend-on-Sea 015B","E01015852",1351,92,18,74,248,154,114,106,204,175,135,73,62,123
"2011","Southend-on-Sea 015C","E01015853",1342,188,39,149,359,177,129,91,171,86,71,37,34,70
"2011","Southend-on-Sea 015D","E01015854",1627,84,20,64,302,171,92,129,228,185,139,92,47,297
"2011","Southend-on-Sea 015E","E01015855",1511,118,27,91,279,198,162,102,245,177,117,67,50,113
"2011","Southend-on-Sea 015F","E01015856",1341,144,27,117,311,188,127,84,164,120,104,61,43,99
"2011","Southend-on-Sea 016A","E01015889",976,161,47,114,240,178,160,28,89,39,28,20,8,53
"2011","Southend-on-Sea 016B","E01015890",1072,202,42,160,302,162,109,57,89,43,25,16,9,83
"2011","Southend-on-Sea 016C","E01015891",1093,99,26,73,248,166,147,77,160,92,54,36,18,50
"2011","Southend-on-Sea 016D","E01015892",1228,142,33,109,316,207,145,78,140,80,28,11,17,92
"2011","Southend-on-Sea 016E","E01015893",1020,177,46,131,276,209,119,34,102,35,22,15,7,46
"2011","Southend-on-Sea 016F","E01015894",1096,122,38,84,266,219,112,76,138,54,35,22,13,74
"2011","Southend-on-Sea 017A","E01015914",1011,192,40,152,262,194,114,44,70,33,25,18,7,77
"2011","Southend-on-Sea 017B","E01015915",1062,109,33,76,275,189,99,66,154,80,28,17,11,62
"2011","Southend-on-Sea 017C","E01015916",980,41,9,32,121,120,76,76,180,165,118,88,30,83
"2011","Southend-on-Sea 017D","E01015917",1149,54,14,40,156,152,103,84,224,186,98,60,38,92
"2011","Southend-on-Sea 017E","E01015918",984,70,11,59,175,156,106,83,155,96,61,44,17,82
"2011","Southend-on-Sea 017F","E01015919",921,79,20,59,201,165,88,60,129,78,48,29,19,73
"2011","Southend-on-Sea 017G","E01015920",1069,112,27,85,272,213,139,63,114,50,42,28,14,64
"2011","Thurrock 001A","E01015943",1137,105,24,81,227,214,144,97,146,121,26,12,14,57
"2011","Thurrock 001B","E01015944",855,54,17,37,177,148,89,83,141,98,23,14,9,42
"2011","Thurrock 001C","E01015946",1150,103,30,73,259,196,140,105,159,100,24,13,11,64
"2011","Thurrock 001D","E01015997",1121,85,20,65,206,202,124,119,158,125,26,10,16,76
"2011","Thurrock 001E","E01015999",1040,83,24,59,208,193,99,115,170,101,23,12,11,48
"2011","Thurrock 002A","E01015945",877,61,17,44,170,149,119,83,123,98,26,16,10,48
"2011","Thurrock 002B","E01015983",1091,60,14,46,173,215,106,112,182,144,38,19,19,61
"2011","Thurrock 002C","E01015987",1076,47,16,31,153,158,120,97,208,140,54,30,24,99
"2011","Thurrock 002D","E01015988",963,35,13,22,132,119,94,79,201,153,69,33,36,81
"2011","Thurrock 002E","E01015998",1199,77,25,52,222,246,104,119,199,128,30,15,15,74
"2011","Thurrock 003A","E01015984",979,54,12,42,185,199,76,103,156,121,39,23,16,46
"2011","Thurrock 003B","E01015985",986,45,18,27,168,179,99,123,157,132,41,29,12,42
"2011","Thurrock 003C","E01015986",1056,49,8,41,160,117,109,100,200,172,76,50,26,73
"2011","Thurrock 003D","E01015990",1101,51,11,40,169,174,133,100,202,150,51,33,18,71
"2011","Thurrock 003E","E01016001",1000,62,19,43,215,204,88,105,164,96,24,13,11,42
"2011","Thurrock 004A","E01015977",1314,152,39,113,338,239,182,77,133,87,45,26,19,61
"2011","Thurrock 004B","E01015978",985,129,44,85,215,172,188,43,89,75,23,16,7,51
"2011","Thurrock 004C","E01015979",1052,110,23,87,264,177,125,91,124,82,14,9,5,65
"2011","Thurrock 004D","E01015980",1175,137,44,93,270,177,154,81,148,104,40,27,13,64
"2011","Thurrock 005A","E01015989",1159,62,15,47,254,186,115,103,196,112,64,38,26,67
"2011","Thurrock 005B","E01015991",1052,74,25,49,218,208,110,103,162,104,24,13,11,49
"2011","Thurrock 005C","E01015992",1391,92,31,61,262,252,159,136,202,154,55,30,25,79
"2011","Thurrock 005D","E01016000",1102,61,16,45,251,201,118,109,165,109,32,13,19,56
"2011","Thurrock 005E","E01016002",1090,77,23,54,226,249,93,91,154,123,23,16,7,54
"2011","Thurrock 006A","E01015932",1130,49,17,32,193,146,126,95,206,155,88,57,31,72
"2011","Thurrock 006B","E01015971",1083,58,19,39,190,161,105,115,170,161,67,31,36,56
"2011","Thurrock 006C","E01015972",1190,69,20,49,220,163,108,102,203,175,70,42,28,80
"2011","Thurrock 006D","E01015973",1194,46,9,37,171,181,83,129,248,169,90,49,41,77
"2011","Thurrock 006E","E01015974",1083,125,33,92,276,213,112,76,121,73,42,25,17,45
"2011","Thurrock 006F","E01015975",1159,80,20,60,243,194,93,93,205,132,59,39,20,60
"2011","Thurrock 007A","E01015927",1239,68,13,55,198,147,104,91,263,187,82,46,36,99
"2011","Thurrock 007B","E01015928",1241,58,13,45,193,164,132,125,234,172,82,51,31,81
"2011","Thurrock 007C","E01015929",1057,38,10,28,155,112,78,96,220,200,97,69,28,61
"2011","Thurrock 007D","E01015930",1246,60,20,40,206,188,110,91,246,187,73,45,28,85
"2011","Thurrock 007E","E01015931",977,47,11,36,140,140,81,94,161,162,102,55,47,50
"2011","Thurrock 007F","E01015976",1299,55,13,42,166,169,101,114,294,218,120,65,55,62
"2011","Thurrock 008A","E01015922",1078,49,18,31,154,122,85,100,212,198,81,54,27,77
"2011","Thurrock 008B","E01015923",1155,70,15,55,207,149,92,97,217,193,48,34,14,82
"2011","Thurrock 008C","E01015924",1073,48,10,38,153,159,119,109,203,164,67,38,29,51
"2011","Thurrock 008D","E01015925",1128,81,20,61,218,195,127,122,161,124,35,18,17,65
"2011","Thurrock 008E","E01015926",1086,54,13,41,211,167,135,106,170,143,50,33,17,50
"2011","Thurrock 009A","E01015957",1064,45,10,35,193,123,124,84,223,145,58,35,23,69
"2011","Thurrock 009B","E01015958",973,49,17,32,155,119,72,93,182,166,69,51,18,68
"2011","Thurrock 009C","E01015993",1072,75,16,59,193,168,87,86,183,149,45,26,19,86
"2011","Thurrock 009D","E01015994",1028,71,21,50,193,173,104,80,186,113,45,32,13,63
"2011","Thurrock 009E","E01015995",1270,134,41,93,288,226,124,100,154,122,26,12,14,96
"2011","Thurrock 009F","E01015996",1108,62,18,44,193,142,90,92,215,169,63,44,19,82
"2011","Thurrock 010A","E01015963",822,26,14,12,125,115,63,78,159,147,61,31,30,48
"2011","Thurrock 010B","E01015964",1145,103,25,78,237,204,117,94,159,109,52,33,19,70
"2011","Thurrock 010C","E01015965",1076,78,31,47,224,212,94,121,147,123,29,16,13,48
"2011","Thurrock 010D","E01015966",1134,89,33,56,217,212,114,108,171,128,38,24,14,57
"2011","Thurrock 012A","E01015933",1049,50,14,36,165,166,78,97,194,176,79,52,27,44
"2011","Thurrock 012B","E01015934",1031,40,9,31,130,111,92,86,223,171,88,50,38,90
"2011","Thurrock 012C","E01015935",1126,38,13,25,176,141,109,102,201,208,76,45,31,75
"2011","Thurrock 012D","E01015936",1157,39,9,30,156,159,94,120,246,218,65,39,26,60
"2011","Thurrock 012E","E01015937",1238,70,22,48,212,186,112,124,200,214,56,34,22,64
"2011","Thurrock 012F","E01015938",1276,46,12,34,171,150,112,92,269,241,127,76,51,68
"2011","Thurrock 013A","E01015947",1056,51,13,38,189,170,85,94,191,159,47,27,20,70
"2011","Thurrock 013B","E01015948",1130,50,12,38,214,197,82,111,179,181,44,25,19,72
"2011","Thurrock 013C","E01015949",1261,65,22,43,244,193,124,131,222,158,40,20,20,84
"2011","Thurrock 013D","E01015950",1330,85,22,63,262,235,120,130,208,190,38,23,15,62
"2011","Thurrock 014A","E01015960",1058,91,22,69,229,187,115,88,152,94,30,21,9,72
"2011","Thurrock 014B","E01015967",1154,76,28,48,237,196,111,88,187,139,45,21,24,75
"2011","Thurrock 014C","E01015968",1038,89,27,62,241,191,87,76,158,106,31,19,12,59
"2011","Thurrock 014D","E01015969",1277,93,30,63,292,218,112,101,180,180,47,32,15,54
"2011","Thurrock 014E","E01015970",960,81,20,61,241,164,85,89,142,85,16,8,8,57
"2011","Thurrock 015A","E01015921",894,52,12,40,169,143,103,79,125,135,54,38,16,34
"2011","Thurrock 015B","E01016011",1163,55,20,35,199,150,86,128,186,223,89,37,52,47
"2011","Thurrock 015C","E01016012",1801,116,24,92,298,212,165,131,283,343,136,77,59,117
"2011","Thurrock 015D","E01016013",1698,121,21,100,356,270,135,137,203,266,111,56,55,99
"2011","Thurrock 015E","E01016014",1756,127,20,107,339,256,132,141,248,195,179,102,77,139
"2011","Thurrock 015F","E01016015",1268,62,19,43,213,172,77,114,244,221,71,40,31,94
"2011","Thurrock 016A","E01015955",1190,97,26,71,272,175,126,97,158,153,68,51,17,44
"2011","Thurrock 016B","E01015956",1544,101,21,80,254,224,121,95,254,235,159,118,41,101
"2011","Thurrock 016C","E01015959",1222,78,25,53,217,163,100,90,191,199,88,53,35,96
"2011","Thurrock 016D","E01015961",1104,81,16,65,248,157,90,83,173,144,50,28,22,78
"2011","Thurrock 016E","E01015962",1176,52,6,46,206,159,77,95,177,225,104,66,38,81
"2011","Thurrock 017A","E01015951",1224,79,20,59,183,164,99,100,189,241,91,65,26,78
"2011","Thurrock 017B","E01015952",1487,64,9,55,249,171,103,112,257,294,143,95,48,94
"2011","Thurrock 017C","E01015953",1638,145,33,112,346,234,122,138,208,273,101,62,39,71
"2011","Thurrock 017D","E01015954",1640,88,19,69,233,170,120,127,273,357,165,107,58,107
"2011","Thurrock 018A","E01016003",1444,57,13,44,210,188,137,137,280,211,135,84,51,89
"2011","Thurrock 018B","E01016004",1099,34,7,27,135,124,59,101,241,227,109,67,42,69
"2011","Thurrock 018C","E01016005",1112,40,9,31,136,143,87,110,210,201,102,50,52,83
"2011","Thurrock 018D","E01016006",1075,31,5,26,118,122,82,69,222,204,161,81,80,66
"2011","Thurrock 018E","E01016007",1062,27,8,19,115,108,81,103,202,218,129,89,40,79
"2011","Thurrock 018F","E01016008",1132,60,13,47,171,178,74,114,207,186,62,31,31,80
"2011","Thurrock 018G","E01016009",1211,54,19,35,156,136,87,103,231,243,124,76,48,77
"2011","Thurrock 018H","E01016010",995,31,10,21,125,90,61,77,196,213,130,93,37,72
"2011","Thurrock 019A","E01015982",1794,268,43,225,484,321,157,124,168,102,53,29,24,117
"2011","Thurrock 019B","E01033610",1120,172,37,135,307,192,61,76,107,96,35,21,14,74
"2011","Thurrock 019C","E01033611",1204,165,31,134,338,207,88,80,122,78,60,36,24,66
"2011","Thurrock 019D","E01033613",1114,170,41,129,328,197,91,69,104,62,27,14,13,66
"2011","Thurrock 020A","E01015939",1137,129,24,105,280,215,98,70,138,91,41,27,14,75
"2011","Thurrock 020B","E01015941",1027,148,32,116,255,173,104,50,108,91,27,15,12,71
"2011","Thurrock 020C","E01015942",1132,122,30,92,265,219,146,76,124,76,36,16,20,68
"2011","Thurrock 020D","E01033612",1176,146,29,117,311,207,107,64,117,98,40,19,21,86
"2011","Thurrock 020E","E01033614",1283,164,41,123,342,243,126,81,119,80,41,26,15,87
"2011","Cambridge 001A","E01017975",1157,103,10,93,181,114,74,98,210,200,86,52,34,91
"2011","Cambridge 001B","E01017976",1319,229,29,200,283,134,116,91,158,126,43,33,10,139
"2011","Cambridge 001C","E01017977",1270,194,18,176,224,153,64,95,178,152,82,48,34,128
"2011","Cambridge 001D","E01017978",1128,100,13,87,166,103,74,92,193,202,87,51,36,111
"2011","Cambridge 001E","E01017979",1186,104,8,96,180,122,83,103,214,195,75,44,31,110
"2011","Cambridge 001F","E01017980",868,133,15,118,160,131,61,61,132,100,30,18,12,60
"2011","Cambridge 002A","E01017949",1378,269,17,252,275,107,70,69,129,117,54,32,22,288
"2011","Cambridge 002B","E01017950",1108,313,25,288,275,71,65,27,64,39,22,16,6,232
"2011","Cambridge 002C","E01017951",1128,208,21,187,198,99,76,79,157,150,46,30,16,115
"2011","Cambridge 002D","E01017952",1065,91,11,80,167,94,87,102,191,161,70,43,27,102
"2011","Cambridge 002E","E01017953",1203,197,14,183,201,123,78,77,169,126,82,58,24,150
"2011","Cambridge 002F","E01017954",1013,107,8,99,179,88,78,86,151,158,63,39,24,103
"2011","Cambridge 003B","E01017971",1236,149,13,136,224,125,92,85,205,146,70,52,18,140
"2011","Cambridge 003C","E01017972",1208,206,17,189,260,128,95,82,159,118,70,44,26,90
"2011","Cambridge 003D","E01017973",1242,187,22,165,251,137,101,78,165,148,49,30,19,126
"2011","Cambridge 003E","E01017974",1349,216,18,198,281,109,72,85,211,166,66,50,16,143
"2011","Cambridge 003F","E01032792",1020,347,50,297,277,85,61,35,59,37,28,12,16,91
"2011","Cambridge 003G","E01032802",1033,250,14,236,233,85,58,46,112,85,27,13,14,137
"2011","Cambridge 004A","E01018006",1324,330,23,307,322,126,103,57,94,74,33,19,14,185
"2011","Cambridge 004B","E01018007",1175,339,34,305,361,119,80,25,61,37,19,8,11,134
"2011","Cambridge 004C","E01018008",1264,363,32,331,282,102,95,48,85,70,35,22,13,184
"2011","Cambridge 004D","E01018009",1548,336,45,291,320,125,103,66,139,90,91,62,29,278
"2011","Cambridge 004E","E01018010",1477,516,52,464,341,109,62,36,80,37,43,35,8,253
"2011","Cambridge 005A","E01017955",1127,300,31,269,272,128,66,47,80,66,18,11,7,150
"2011","Cambridge 005B","E01017956",1339,309,29,280,236,66,49,23,48,13,17,10,7,578
"2011","Cambridge 005C","E01017957",1311,291,24,267,235,55,43,24,40,31,14,9,5,578
"2011","Cambridge 005D","E01017958",4972,251,9,242,128,46,36,29,61,56,35,27,8,4330
"2011","Cambridge 006A","E01017943",1439,375,38,337,336,101,79,61,124,88,45,22,23,230
"2011","Cambridge 006B","E01017944",1048,102,11,91,168,102,88,86,200,148,50,34,16,104
"2011","Cambridge 006C","E01017945",1377,310,25,285,278,132,93,92,149,105,51,37,14,167
"2011","Cambridge 006D","E01017946",1168,133,9,124,203,115,81,74,183,183,71,48,23,125
"2011","Cambridge 006E","E01017947",1236,135,7,128,210,140,97,81,173,195,62,45,17,143
"2011","Cambridge 006F","E01017948",1222,109,11,98,175,122,91,127,228,179,91,68,23,100
"2011","Cambridge 007C","E01017983",1517,466,42,424,412,96,89,47,73,51,28,16,12,255
"2011","Cambridge 007D","E01017984",1190,434,46,388,236,61,78,16,38,18,22,16,6,287
"2011","Cambridge 007E","E01017985",2108,440,33,407,290,82,74,19,40,26,26,17,9,1111
"2011","Cambridge 007F","E01017986",3388,228,14,214,106,39,23,17,27,18,20,17,3,2910
"2011","Cambridge 007G","E01032797",4971,377,28,349,236,99,75,40,92,39,53,32,21,3960
"2011","Cambridge 008A","E01017987",1437,407,35,372,290,96,43,42,85,47,32,22,10,395
"2011","Cambridge 008B","E01017988",1472,354,25,329,251,66,54,21,41,33,21,16,5,631
"2011","Cambridge 008C","E01017989",1867,471,29,442,402,133,101,57,102,68,55,40,15,478
"2011","Cambridge 008D","E01017990",1036,335,17,318,287,78,51,39,63,24,13,7,6,146
"2011","Cambridge 008E","E01017991",1217,201,23,178,194,64,71,46,71,59,50,36,14,461
"2011","Cambridge 009A","E01017997",1844,383,28,355,399,170,116,121,182,158,65,51,14,250
"2011","Cambridge 009B","E01017998",1473,408,27,381,322,114,43,54,82,65,26,19,7,359
"2011","Cambridge 009C","E01017999",1396,236,27,209,274,102,91,61,164,146,53,34,19,269
"2011","Cambridge 009D","E01018000",1491,330,21,309,351,114,79,62,91,54,26,19,7,384
"2011","Cambridge 009E","E01018001",1427,367,31,336,354,122,73,48,74,53,20,9,11,316
"2011","Cambridge 010A","E01017965",1320,230,25,205,286,130,75,76,125,78,42,26,16,278
"2011","Cambridge 010B","E01017966",2257,561,54,507,417,165,131,84,154,103,65,37,28,577
"2011","Cambridge 010C","E01017967",1339,180,16,164,206,102,96,62,195,125,56,40,16,317
"2011","Cambridge 010D","E01017968",1188,231,9,222,221,120,91,61,120,93,29,16,13,222
"2011","Cambridge 010E","E01017969",1143,211,20,191,266,120,76,69,127,90,44,36,8,140
"2011","Cambridge 011A","E01017959",1282,321,34,287,288,148,83,69,132,88,40,25,15,113
"2011","Cambridge 011B","E01017960",931,114,13,101,182,110,70,48,145,135,54,35,19,73
"2011","Cambridge 011C","E01017961",889,168,16,152,202,109,55,54,119,78,27,13,14,77
"2011","Cambridge 011D","E01017962",1177,185,25,160,260,144,99,83,156,112,60,43,17,78
"2011","Cambridge 011E","E01017963",1169,147,16,131,264,154,81,83,176,136,39,17,22,89
"2011","Cambridge 011F","E01017964",990,169,24,145,204,159,82,62,124,67,27,18,9,96
"2011","Cambridge 012A","E01018002",1183,291,25,266,314,126,71,58,90,91,26,9,17,116
"2011","Cambridge 012B","E01018003",1156,275,30,245,303,122,82,56,117,80,24,16,8,97
"2011","Cambridge 012D","E01018005",1575,330,28,302,294,115,64,48,92,79,66,49,17,487
"2011","Cambridge 012E","E01032794",928,330,49,281,218,71,50,21,52,26,20,16,4,140
"2011","Cambridge 012F","E01032795",1183,392,55,337,226,78,75,41,75,61,46,32,14,189
"2011","Cambridge 013A","E01017992",1317,291,25,266,320,115,85,66,135,95,42,30,12,168
"2011","Cambridge 013B","E01017993",1649,515,51,464,453,142,75,27,47,43,22,14,8,325
"2011","Cambridge 013C","E01017994",1149,216,17,199,236,118,89,46,149,125,48,32,16,122
"2011","Cambridge 013D","E01017995",1031,335,34,301,261,123,72,19,52,36,19,17,2,114
"2011","Cambridge 013E","E01017996",1655,336,39,297,264,84,55,23,58,23,23,16,7,789
"2011","East Cambridgeshire 001A","E01018042",1008,84,17,67,169,123,109,95,195,162,33,21,12,38
"2011","East Cambridgeshire 001B","E01018043",1482,125,33,92,285,212,162,140,245,178,53,39,14,82
"2011","East Cambridgeshire 001C","E01018044",1308,106,22,84,240,156,184,97,258,171,52,34,18,44
"2011","East Cambridgeshire 001D","E01018045",1022,85,24,61,203,108,132,100,171,125,48,31,17,50
"2011","East Cambridgeshire 001E","E01018046",1438,98,26,72,250,137,119,148,292,220,92,54,38,82
"2011","East Cambridgeshire 002A","E01018020",1148,139,29,110,255,140,196,73,145,105,26,13,13,69
"2011","East Cambridgeshire 002B","E01018021",1096,102,28,74,244,159,159,92,153,102,23,7,16,62
"2011","East Cambridgeshire 002C","E01018022",1031,123,33,90,204,150,132,72,172,108,27,17,10,43
"2011","East Cambridgeshire 002D","E01018055",1571,233,64,169,389,234,171,135,188,137,23,15,8,61
"2011","East Cambridgeshire 002E","E01018056",1364,146,41,105,278,182,146,107,225,165,48,22,26,67
"2011","East Cambridgeshire 003A","E01018027",1192,188,56,132,327,173,109,99,165,68,25,17,8,38
"2011","East Cambridgeshire 003C","E01018029",1923,320,66,254,523,253,132,159,232,170,50,31,19,84
"2011","East Cambridgeshire 003D","E01018032",1826,288,65,223,501,271,152,96,236,115,57,44,13,110
"2011","East Cambridgeshire 003E","E01018033",1375,150,32,118,309,151,124,117,219,170,62,42,20,73
"2011","East Cambridgeshire 003F","E01033426",1022,217,51,166,300,144,64,62,90,52,43,31,12,50
"2011","East Cambridgeshire 003G","E01033430",1014,84,18,66,168,103,91,68,205,166,57,27,30,72
"2011","East Cambridgeshire 004A","E01018024",810,97,20,77,191,93,112,44,134,98,16,12,4,25
"2011","East Cambridgeshire 004B","E01018025",1101,170,29,141,278,118,99,64,121,73,27,16,11,151
"2011","East Cambridgeshire 004C","E01018026",1067,199,42,157,326,122,102,52,121,74,25,17,8,46
"2011","East Cambridgeshire 004D","E01018030",762,93,16,77,164,105,68,52,122,83,32,22,10,43
"2011","East Cambridgeshire 004F","E01033425",1341,287,62,225,386,200,98,71,140,65,27,11,16,67
"2011","East Cambridgeshire 004G","E01033428",1084,194,44,150,319,155,76,71,114,70,21,11,10,64
"2011","East Cambridgeshire 005A","E01018036",1187,127,38,89,251,154,162,111,183,122,28,17,11,49
"2011","East Cambridgeshire 005B","E01018037",1048,150,43,107,279,124,146,63,137,79,17,10,7,53
"2011","East Cambridgeshire 005C","E01018038",1134,169,43,126,239,176,140,68,148,96,25,13,12,73
"2011","East Cambridgeshire 005D","E01018039",932,78,18,60,198,126,121,80,133,117,21,13,8,58
"2011","East Cambridgeshire 005E","E01018053",1263,163,46,117,299,143,194,75,163,137,37,26,11,52
"2011","East Cambridgeshire 005F","E01018054",1680,217,58,159,446,257,190,117,193,139,33,14,19,88
"2011","East Cambridgeshire 006A","E01018047",1376,114,19,95,267,164,196,114,234,192,35,18,17,60
"2011","East Cambridgeshire 006C","E01018049",1205,138,34,104,263,138,183,81,181,111,32,21,11,78
"2011","East Cambridgeshire 006D","E01018050",1040,85,25,60,176,122,124,98,228,143,15,7,8,49
"2011","East Cambridgeshire 006E","E01018051",1238,69,13,56,206,157,152,116,220,227,44,31,13,47
"2011","East Cambridgeshire 006F","E01018052",1358,105,32,73,244,150,132,148,250,242,46,21,25,41
"2011","East Cambridgeshire 006G","E01033427",933,115,30,85,225,135,81,86,125,91,19,10,9,56
"2011","East Cambridgeshire 006H","E01033429",1503,146,38,108,272,213,168,160,234,221,28,17,11,61
"2011","East Cambridgeshire 007A","E01018034",1150,164,38,126,276,160,156,91,119,93,27,20,7,64
"2011","East Cambridgeshire 007B","E01018035",1615,202,60,142,384,191,225,110,210,170,44,29,15,79
"2011","East Cambridgeshire 007C","E01018040",926,137,44,93,239,124,116,58,110,79,20,14,6,43
"2011","East Cambridgeshire 007D","E01018041",787,64,18,46,165,87,125,74,110,98,23,13,10,41
"2011","East Cambridgeshire 008A","E01018013",1227,177,41,136,347,201,169,55,124,55,20,11,9,79
"2011","East Cambridgeshire 008B","E01018014",1264,228,46,182,352,191,137,64,113,80,26,14,12,73
"2011","East Cambridgeshire 008C","E01018015",977,170,33,137,248,147,130,55,82,70,17,9,8,58
"2011","East Cambridgeshire 008D","E01018016",966,98,23,75,203,120,101,86,145,129,35,22,13,49
"2011","East Cambridgeshire 009A","E01018011",1868,311,59,252,450,247,261,93,208,147,47,35,12,104
"2011","East Cambridgeshire 009B","E01018012",934,147,32,115,215,136,89,77,132,74,17,9,8,47
"2011","East Cambridgeshire 009C","E01018057",1453,266,37,229,354,179,178,91,162,115,36,15,21,72
"2011","East Cambridgeshire 011A","E01018017",917,126,32,94,214,98,109,66,128,112,23,12,11,41
"2011","East Cambridgeshire 011B","E01018019",750,98,29,69,182,103,100,48,101,78,11,8,3,29
"2011","East Cambridgeshire 011C","E01018023",1653,257,69,188,400,186,235,94,167,185,31,17,14,98
"2011","East Cambridgeshire 011D","E01032611",1345,220,62,158,335,194,151,110,111,125,34,19,15,65
"2011","Fenland 001A","E01018094",1258,62,22,40,201,119,145,107,263,233,78,52,26,50
"2011","Fenland 001B","E01018095",1166,75,29,46,214,150,196,84,192,159,45,29,16,51
"2011","Fenland 001C","E01018096",1156,84,28,56,193,144,148,104,217,180,34,19,15,52
"2011","Fenland 001D","E01018097",1089,68,24,44,228,130,164,79,199,133,42,27,15,46
"2011","Fenland 002A","E01018063",1691,66,17,49,203,155,145,126,438,352,117,73,44,89
"2011","Fenland 002B","E01018073",1681,79,33,46,213,165,161,156,383,306,110,90,20,108
"2011","Fenland 002C","E01018107",1192,21,10,11,87,81,73,128,297,307,116,74,42,82
"2011","Fenland 002D","E01018108",1416,25,9,16,91,88,86,119,402,379,147,100,47,79
"2011","Fenland 002E","E01018109",1307,45,23,22,137,120,83,157,361,272,77,53,24,55
"2011","Fenland 003A","E01018069",1291,54,22,32,215,180,111,121,280,236,35,18,17,59
"2011","Fenland 003B","E01018070",1286,38,14,24,132,107,81,142,344,277,106,67,39,59
"2011","Fenland 003C","E01018071",1208,61,22,39,183,106,102,115,273,229,76,53,23,63
"2011","Fenland 003E","E01018093",1745,129,42,87,290,192,205,141,325,245,117,82,35,101
"2011","Fenland 003F","E01018103",862,16,4,12,64,42,59,79,237,206,99,53,46,60
"2011","Fenland 003G","E01018104",927,47,18,29,119,136,99,80,195,149,40,27,13,62
"2011","Fenland 003H","E01033111",1030,54,13,41,121,106,98,78,225,208,79,47,32,61
"2011","Fenland 003I","E01033112",884,37,13,24,109,72,70,108,195,191,60,32,28,42
"2011","Fenland 004A","E01018066",1025,68,25,43,171,105,110,97,227,147,55,37,18,45
"2011","Fenland 004B","E01018067",1311,82,29,53,248,160,155,110,241,198,57,35,22,60
"2011","Fenland 004C","E01018068",1159,68,20,48,193,125,193,91,205,140,83,51,32,61
"2011","Fenland 004D","E01018090",1260,96,38,58,225,148,186,100,213,171,62,47,15,59
"2011","Fenland 004E","E01018091",1074,63,22,41,182,130,156,90,189,147,60,37,23,57
"2011","Fenland 004F","E01018092",1239,78,25,53,194,162,162,106,236,178,64,37,27,59
"2011","Fenland 005A","E01018081",1513,54,16,38,202,168,155,119,283,340,97,68,29,95
"2011","Fenland 005B","E01018082",1402,103,34,69,237,185,140,146,261,188,59,29,30,83
"2011","Fenland 005C","E01018083",1363,69,19,50,200,166,117,162,271,221,61,36,25,96
"2011","Fenland 005D","E01018084",1493,87,15,72,247,226,130,132,275,250,74,55,19,72
"2011","Fenland 006A","E01018064",1445,122,32,90,316,236,142,117,218,152,51,26,25,91
"2011","Fenland 006B","E01018072",1197,41,9,32,186,138,106,113,242,245,62,36,26,64
"2011","Fenland 006C","E01018074",886,84,18,66,165,156,90,70,150,102,28,20,8,41
"2011","Fenland 006D","E01018075",837,42,16,26,111,101,65,82,186,142,57,39,18,51
"2011","Fenland 006E","E01018098",917,55,12,43,173,153,94,79,157,146,21,14,7,39
"2011","Fenland 006F","E01018099",959,61,19,42,159,160,105,107,169,123,17,7,10,58
"2011","Fenland 006G","E01018100",856,58,20,38,130,138,119,84,128,121,38,23,15,40
"2011","Fenland 006H","E01018101",994,78,23,55,190,141,122,76,177,131,35,20,15,44
"2011","Fenland 007A","E01018077",1302,76,21,55,225,163,136,122,262,177,83,54,29,58
"2011","Fenland 007B","E01018078",1078,28,10,18,131,124,98,97,247,225,84,58,26,44
"2011","Fenland 007C","E01018079",1225,79,17,62,222,165,111,102,247,194,43,28,15,62
"2011","Fenland 007D","E01018080",1685,85,29,56,279,254,165,193,332,251,60,37,23,66
"2011","Fenland 008A","E01018058",1161,76,17,59,232,203,85,115,192,173,28,18,10,57
"2011","Fenland 008B","E01018059",1011,79,27,52,202,155,164,81,142,132,23,12,11,33
"2011","Fenland 008C","E01018060",1418,123,39,84,298,176,203,116,192,171,54,21,33,85
"2011","Fenland 008D","E01018061",928,54,16,38,185,142,96,80,158,135,23,12,11,55
"2011","Fenland 009A","E01018085",1177,92,30,62,271,159,127,100,207,128,38,27,11,55
"2011","Fenland 009B","E01018086",1223,51,18,33,183,186,148,130,245,159,54,31,23,67
"2011","Fenland 009C","E01018087",1455,103,31,72,238,184,164,137,281,177,105,76,29,66
"2011","Fenland 009D","E01018088",1099,80,16,64,213,160,131,85,200,138,38,21,17,54
"2011","Fenland 010A","E01018065",1645,146,42,104,339,237,234,149,225,193,41,27,14,81
"2011","Fenland 010B","E01018076",1522,104,28,76,291,196,224,122,277,185,58,33,25,65
"2011","Fenland 010C","E01018111",1615,118,37,81,315,221,243,142,247,201,47,25,22,81
"2011","Fenland 011A","E01018062",1794,116,26,90,326,228,201,157,314,301,61,40,21,90
"2011","Fenland 011B","E01018102",1905,132,41,91,376,236,149,162,389,280,76,48,28,105
"2011","Fenland 011C","E01018105",803,59,15,44,132,119,77,71,156,109,26,15,11,54
"2011","Fenland 011D","E01018106",1174,76,22,54,222,167,128,116,213,164,32,20,12,56
"2011","Fenland 011E","E01018110",1919,171,50,121,354,251,237,159,324,243,76,46,30,104
"2011","Huntingdonshire 001A","E01018212",1199,105,34,71,227,165,135,104,198,160,49,34,15,56
"2011","Huntingdonshire 001B","E01018213",1414,111,33,78,277,237,141,141,203,175,53,38,15,76
"2011","Huntingdonshire 001C","E01018214",1445,129,29,100,278,208,132,131,232,179,69,41,28,87
"2011","Huntingdonshire 001D","E01018215",1039,90,17,73,218,155,87,114,159,145,25,14,11,46
"2011","Huntingdonshire 001E","E01018216",1805,204,59,145,448,327,160,129,232,167,36,17,19,102
"2011","Huntingdonshire 001F","E01018217",1218,128,31,97,270,199,109,117,201,123,33,20,13,38
"2011","Huntingdonshire 002A","E01018127",1162,198,49,149,264,193,160,76,94,69,31,21,10,77
"2011","Huntingdonshire 002B","E01018128",859,136,35,101,237,104,121,49,85,66,22,11,11,39
"2011","Huntingdonshire 002C","E01018200",1233,183,56,127,323,183,143,68,139,73,20,13,7,101
"2011","Huntingdonshire 002D","E01018201",1059,106,26,80,275,168,97,86,146,97,16,9,7,68
"2011","Huntingdonshire 003A","E01018156",1272,122,46,76,291,196,145,88,206,116,29,24,5,79
"2011","Huntingdonshire 003B","E01018157",1530,161,54,107,321,198,226,114,222,167,45,29,16,76
"2011","Huntingdonshire 003C","E01018158",1233,93,27,66,266,156,119,115,206,155,59,33,26,64
"2011","Huntingdonshire 003D","E01018159",1064,167,56,111,268,150,96,71,147,89,18,11,7,58
"2011","Huntingdonshire 003E","E01018160",1186,51,10,41,178,123,124,126,233,223,52,27,25,76
"2011","Huntingdonshire 004A","E01018191",849,74,14,60,216,152,69,74,113,96,7,4,3,48
"2011","Huntingdonshire 004B","E01018192",1101,130,30,100,270,148,155,75,142,88,20,9,11,73
"2011","Huntingdonshire 004C","E01018193",914,122,34,88,248,159,86,61,100,69,15,10,5,54
"2011","Huntingdonshire 004D","E01018194",1036,124,30,94,287,174,124,78,100,76,24,16,8,49
"2011","Huntingdonshire 004E","E01018195",911,94,29,65,215,130,64,76,152,96,34,18,16,50
"2011","Huntingdonshire 005A","E01018208",1203,157,48,109,269,176,146,101,178,105,25,15,10,46
"2011","Huntingdonshire 005B","E01018209",1130,154,44,110,280,186,129,52,141,112,18,9,9,58
"2011","Huntingdonshire 005C","E01018210",1034,99,30,69,209,166,85,91,182,114,27,16,11,61
"2011","Huntingdonshire 005D","E01018211",1327,190,56,134,342,215,113,92,157,101,26,20,6,91
"2011","Huntingdonshire 006A","E01018196",941,141,39,102,220,147,152,60,85,71,23,14,9,42
"2011","Huntingdonshire 006B","E01018197",1097,103,32,71,238,142,119,93,172,124,28,20,8,78
"2011","Huntingdonshire 006C","E01018198",1231,175,47,128,345,192,140,79,136,77,25,17,8,62
"2011","Huntingdonshire 006D","E01018199",1157,149,46,103,274,170,164,102,120,95,21,13,8,62
"2011","Huntingdonshire 006E","E01018206",1354,177,74,103,383,177,107,100,173,113,42,24,18,82
"2011","Huntingdonshire 006F","E01018207",1147,139,25,114,285,175,143,78,149,97,29,20,9,52
"2011","Huntingdonshire 007A","E01018121",1035,181,47,134,333,141,116,45,89,47,14,5,9,69
"2011","Huntingdonshire 007B","E01018122",840,105,31,74,217,126,80,70,111,70,13,9,4,48
"2011","Huntingdonshire 007C","E01018123",1220,168,48,120,312,184,129,87,144,111,14,6,8,71
"2011","Huntingdonshire 007D","E01018124",1479,236,58,178,427,216,155,73,145,123,16,11,5,88
"2011","Huntingdonshire 008A","E01018143",1150,78,23,55,157,113,61,111,265,215,93,58,35,57
"2011","Huntingdonshire 008B","E01018144",1021,39,13,26,118,92,53,106,248,234,75,43,32,56
"2011","Huntingdonshire 008C","E01018145",942,45,8,37,120,84,44,92,210,199,76,52,24,72
"2011","Huntingdonshire 008D","E01018146",1574,104,31,73,245,179,90,125,304,305,109,78,31,113
"2011","Huntingdonshire 008E","E01018147",1230,43,11,32,153,117,72,96,281,289,95,51,44,84
"2011","Huntingdonshire 009A","E01018139",1140,120,33,87,246,178,71,82,184,129,56,39,17,74
"2011","Huntingdonshire 009B","E01018140",988,66,17,49,184,144,78,96,188,148,25,20,5,59
"2011","Huntingdonshire 009C","E01018141",1221,260,85,175,352,189,77,75,122,70,12,8,4,64
"2011","Huntingdonshire 009D","E01018142",1007,95,27,68,195,145,91,74,188,131,37,17,20,51
"2011","Huntingdonshire 010B","E01018113",1091,146,40,106,292,177,115,75,125,79,22,15,7,60
"2011","Huntingdonshire 010D","E01018116",890,168,84,84,277,142,70,41,78,33,19,13,6,62
"2011","Huntingdonshire 010E","E01018117",1140,164,56,108,288,183,88,76,164,97,20,8,12,60
"2011","Huntingdonshire 010F","E01018118",1452,245,87,158,403,271,94,98,149,82,26,12,14,84
"2011","Huntingdonshire 010G","E01033433",1697,212,68,144,470,296,147,117,193,130,53,37,16,79
"2011","Huntingdonshire 011A","E01018161",1085,102,25,77,258,190,92,85,144,123,18,8,10,73
"2011","Huntingdonshire 011B","E01018162",1251,172,49,123,324,197,93,92,168,104,24,17,7,77
"2011","Huntingdonshire 011C","E01018163",1066,97,18,79,230,151,75,113,152,158,35,17,18,55
"2011","Huntingdonshire 011D","E01018164",967,119,30,89,206,150,73,81,149,115,32,20,12,42
"2011","Huntingdonshire 011E","E01018165",968,111,28,83,198,155,59,89,177,108,29,18,11,42
"2011","Huntingdonshire 011F","E01018170",1009,83,19,64,211,159,74,79,161,136,40,29,11,66
"2011","Huntingdonshire 011G","E01018171",1132,167,53,114,299,209,94,65,129,77,28,20,8,64
"2011","Huntingdonshire 012A","E01018138",1519,191,48,143,334,205,88,121,235,175,85,60,25,85
"2011","Huntingdonshire 012B","E01018148",1781,336,81,255,474,288,96,99,174,132,42,28,14,140
"2011","Huntingdonshire 012C","E01018149",1088,156,37,119,319,186,55,63,124,83,21,16,5,81
"2011","Huntingdonshire 012D","E01018150",1268,166,41,125,281,184,63,81,213,163,48,27,21,69
"2011","Huntingdonshire 012E","E01018151",1362,202,29,173,320,194,73,109,198,167,47,28,19,52
"2011","Huntingdonshire 013A","E01018166",1084,150,37,113,239,148,99,98,158,97,40,28,12,55
"2011","Huntingdonshire 013B","E01018167",1092,173,38,135,263,175,100,83,117,72,29,20,9,80
"2011","Huntingdonshire 013C","E01018168",1399,200,43,157,360,170,125,116,173,131,60,39,21,64
"2011","Huntingdonshire 013D","E01018169",1142,129,26,103,244,155,96,85,161,158,43,27,16,71
"2011","Huntingdonshire 014A","E01018131",1093,111,28,83,220,149,93,93,164,174,40,20,20,49
"2011","Huntingdonshire 014B","E01018132",1233,205,53,152,372,143,124,76,140,90,26,12,14,57
"2011","Huntingdonshire 014C","E01018133",1220,187,39,148,331,183,94,78,148,83,39,18,21,77
"2011","Huntingdonshire 014D","E01018134",1383,256,61,195,385,216,94,73,146,98,30,17,13,85
"2011","Huntingdonshire 015A","E01018125",1143,189,57,132,347,143,130,61,100,82,17,11,6,74
"2011","Huntingdonshire 015B","E01018126",1194,205,59,146,353,150,183,41,83,77,22,14,8,80
"2011","Huntingdonshire 015C","E01018152",1095,168,39,129,286,151,143,79,102,76,34,17,17,56
"2011","Huntingdonshire 015D","E01018153",1319,228,66,162,407,149,154,61,99,73,21,12,9,127
"2011","Huntingdonshire 016A","E01018129",1158,176,48,128,314,162,113,76,135,90,19,15,4,73
"2011","Huntingdonshire 016B","E01018130",1271,185,50,135,329,200,118,90,176,86,20,12,8,67
"2011","Huntingdonshire 016C","E01018202",1013,208,67,141,319,144,123,31,72,45,14,8,6,57
"2011","Huntingdonshire 016D","E01018203",1006,174,45,129,325,118,99,53,107,66,16,10,6,48
"2011","Huntingdonshire 016E","E01018204",984,230,62,168,303,132,111,34,66,25,21,9,12,62
"2011","Huntingdonshire 016F","E01018205",1401,262,74,188,405,215,155,77,118,81,30,19,11,58
"2011","Huntingdonshire 017A","E01018115",2118,203,52,151,371,212,201,183,273,311,258,228,30,106
"2011","Huntingdonshire 017B","E01018119",1152,204,63,141,306,168,136,65,109,84,17,5,12,63
"2011","Huntingdonshire 017C","E01018120",1196,195,48,147,283,185,126,66,122,108,33,17,16,78
"2011","Huntingdonshire 017D","E01018137",1262,184,46,138,352,201,143,73,128,104,20,6,14,57
"2011","Huntingdonshire 018A","E01018135",2129,321,90,231,570,300,167,142,243,182,85,54,31,119
"2011","Huntingdonshire 018B","E01018136",1287,298,75,223,387,150,144,55,103,62,25,15,10,63
"2011","Huntingdonshire 018C","E01018154",1313,171,44,127,313,220,113,83,211,106,32,17,15,64
"2011","Huntingdonshire 018D","E01018155",1123,148,38,110,250,185,98,105,170,94,16,12,4,57
"2011","Huntingdonshire 019A","E01018187",1391,155,45,110,272,167,154,109,209,192,60,34,26,73
"2011","Huntingdonshire 019B","E01018188",1063,106,25,81,227,149,79,89,184,115,39,26,13,75
"2011","Huntingdonshire 019C","E01018189",959,162,52,110,271,174,79,50,103,54,15,6,9,51
"2011","Huntingdonshire 019D","E01018190",1098,97,29,68,208,125,95,100,197,156,43,25,18,77
"2011","Huntingdonshire 020A","E01018172",985,132,39,93,232,175,105,64,145,74,13,9,4,45
"2011","Huntingdonshire 020B","E01018173",927,115,25,90,211,152,69,83,139,87,23,11,12,48
"2011","Huntingdonshire 020C","E01018174",1184,126,33,93,247,182,103,113,196,136,26,12,14,55
"2011","Huntingdonshire 020D","E01018175",1037,169,46,123,285,174,97,51,113,72,16,11,5,60
"2011","Huntingdonshire 020E","E01018176",964,160,47,113,280,177,87,55,94,49,11,8,3,51
"2011","Huntingdonshire 021A","E01018181",2104,315,84,231,530,308,131,169,301,190,47,23,24,113
"2011","Huntingdonshire 021B","E01018182",1144,83,23,60,220,145,87,128,216,153,43,16,27,69
"2011","Huntingdonshire 021C","E01018183",1143,69,16,53,174,139,82,125,215,192,71,34,37,76
"2011","Huntingdonshire 021D","E01018184",956,53,16,37,122,103,63,106,207,169,44,26,18,89
"2011","Huntingdonshire 021E","E01018185",1255,123,33,90,270,171,101,118,190,143,65,56,9,74
"2011","Huntingdonshire 021F","E01018186",1332,87,22,65,219,182,128,120,246,233,38,25,13,79
"2011","Huntingdonshire 022A","E01018177",1129,120,23,97,280,185,128,98,140,115,17,6,11,46
"2011","Huntingdonshire 022B","E01018178",1078,132,28,104,254,186,85,98,134,103,29,19,10,57
"2011","Huntingdonshire 022C","E01018179",1030,77,22,55,180,136,83,104,187,165,46,29,17,52
"2011","Huntingdonshire 022D","E01018180",994,53,13,40,139,106,66,112,225,186,53,30,23,54
"2011","South Cambridgeshire 001A","E01018304",1340,208,34,174,364,165,146,80,145,141,28,16,12,63
"2011","South Cambridgeshire 001B","E01018305",962,147,31,116,227,131,113,66,125,71,15,6,9,67
"2011","South Cambridgeshire 001C","E01018306",1096,203,56,147,313,150,129,42,110,66,12,8,4,71
"2011","South Cambridgeshire 001D","E01018307",1638,284,60,224,367,238,191,119,197,107,32,17,15,103
"2011","South Cambridgeshire 002A","E01018233",1183,217,43,174,325,157,137,73,118,74,20,15,5,62
"2011","South Cambridgeshire 002B","E01018234",1209,227,43,184,356,128,147,64,120,67,15,9,6,85
"2011","South Cambridgeshire 002C","E01018235",1167,225,46,179,327,148,109,57,134,84,16,12,4,67
"2011","South Cambridgeshire 002D","E01018236",1098,172,37,135,262,152,94,64,158,104,20,10,10,72
"2011","South Cambridgeshire 003A","E01018237",1097,187,40,147,320,153,114,73,91,79,22,12,10,58
"2011","South Cambridgeshire 003B","E01018266",1966,382,84,298,547,273,183,119,193,146,41,27,14,82
"2011","South Cambridgeshire 003C","E01018284",932,184,35,149,254,118,103,55,103,59,10,5,5,46
"2011","South Cambridgeshire 003D","E01018285",893,140,36,104,239,133,87,57,111,61,11,4,7,54
"2011","South Cambridgeshire 004A","E01018298",1395,156,71,85,399,379,54,100,149,82,26,14,12,50
"2011","South Cambridgeshire 004B","E01018299",1217,184,34,150,315,147,115,95,161,119,25,13,12,56
"2011","South Cambridgeshire 004C","E01018300",885,153,31,122,194,107,103,62,119,76,28,18,10,43
"2011","South Cambridgeshire 004D","E01018301",1021,200,43,157,262,133,94,65,125,81,19,11,8,42
"2011","South Cambridgeshire 005A","E01018221",1284,166,19,147,286,215,119,111,175,106,20,8,12,86
"2011","South Cambridgeshire 005B","E01018222",1176,177,30,147,307,189,104,80,132,83,21,12,9,83
"2011","South Cambridgeshire 005C","E01018223",1401,239,44,195,319,210,120,102,193,121,20,9,11,77
"2011","South Cambridgeshire 006A","E01018257",965,180,31,149,183,124,74,74,146,94,33,20,13,57
"2011","South Cambridgeshire 006B","E01018258",1121,245,47,198,300,137,104,51,121,65,22,15,7,76
"2011","South Cambridgeshire 006C","E01018259",981,213,29,184,269,127,90,46,95,47,16,7,9,78
"2011","South Cambridgeshire 006D","E01018260",1213,275,43,232,319,151,115,68,110,76,22,15,7,77
"2011","South Cambridgeshire 006F","E01018262",1020,171,33,138,269,170,85,67,110,74,10,4,6,64
"2011","South Cambridgeshire 006G","E01033120",1112,169,14,155,226,105,100,59,141,111,58,39,19,143
"2011","South Cambridgeshire 006H","E01033121",1174,240,23,217,270,116,52,83,141,117,40,34,6,115
"2011","South Cambridgeshire 007A","E01018272",964,262,42,220,232,103,89,50,94,57,19,10,9,58
"2011","South Cambridgeshire 007B","E01018273",1178,161,20,141,252,129,154,65,142,99,108,91,17,68
"2011","South Cambridgeshire 007C","E01018274",1365,313,35,278,327,171,105,107,111,96,55,43,12,80
"2011","South Cambridgeshire 007D","E01018297",1257,228,38,190,315,168,161,81,125,94,23,10,13,62
"2011","South Cambridgeshire 009A","E01018224",985,256,24,232,247,121,100,48,76,51,21,16,5,65
"2011","South Cambridgeshire 009B","E01018225",754,192,18,174,198,70,74,41,66,43,13,8,5,57
"2011","South Cambridgeshire 009C","E01018248",1813,409,47,362,396,135,79,41,84,40,23,11,12,606
"2011","South Cambridgeshire 009D","E01018249",700,171,29,142,192,99,58,37,57,33,14,10,4,39
"2011","South Cambridgeshire 009E","E01018250",846,209,28,181,208,100,62,49,85,60,19,13,6,54
"2011","South Cambridgeshire 010A","E01018231",1772,447,88,359,410,210,194,86,175,85,36,21,15,129
"2011","South Cambridgeshire 010B","E01018232",1647,357,62,295,427,195,149,93,163,121,23,6,17,119
"2011","South Cambridgeshire 010C","E01018251",935,163,20,143,218,134,83,90,107,71,14,8,6,55
"2011","South Cambridgeshire 010D","E01018252",1073,186,40,146,257,140,101,77,112,88,24,16,8,88
"2011","South Cambridgeshire 010E","E01018255",811,194,41,153,203,106,104,41,59,32,14,6,8,58
"2011","South Cambridgeshire 011A","E01018242",928,116,22,94,222,136,92,70,135,83,17,12,5,57
"2011","South Cambridgeshire 011B","E01018243",1306,247,27,220,306,165,90,65,155,99,60,49,11,119
"2011","South Cambridgeshire 011C","E01018244",1131,244,38,206,301,139,130,55,106,64,19,15,4,73
"2011","South Cambridgeshire 011D","E01018286",1180,200,29,171,274,157,96,75,144,117,40,27,13,77
"2011","South Cambridgeshire 011E","E01018287",1036,234,24,210,282,130,66,52,115,55,27,18,9,75
"2011","South Cambridgeshire 011F","E01018296",786,154,32,122,199,95,98,40,83,49,12,7,5,56
"2011","South Cambridgeshire 012A","E01018292",988,294,45,249,262,119,92,24,60,46,18,12,6,73
"2011","South Cambridgeshire 012B","E01018293",960,297,41,256,255,129,91,34,43,27,24,16,8,60
"2011","South Cambridgeshire 012C","E01018294",1205,235,25,210,288,152,103,66,144,128,32,18,14,57
"2011","South Cambridgeshire 012D","E01018295",1089,271,50,221,297,135,120,36,84,51,23,14,9,72
"2011","South Cambridgeshire 013A","E01018245",1250,164,35,129,311,184,149,88,134,128,24,14,10,68
"2011","South Cambridgeshire 013B","E01018246",1186,140,29,111,262,159,134,86,164,135,35,17,18,71
"2011","South Cambridgeshire 013C","E01018247",1198,187,56,131,272,167,200,63,110,98,21,16,5,80
"2011","South Cambridgeshire 013D","E01018275",1685,307,65,242,418,216,223,105,155,135,33,18,15,93
"2011","South Cambridgeshire 014A","E01018240",866,167,31,136,223,119,99,50,85,52,17,8,9,54
"2011","South Cambridgeshire 014B","E01018253",799,200,33,167,245,87,87,29,59,30,8,4,4,54
"2011","South Cambridgeshire 014C","E01018254",949,184,33,151,249,119,104,48,111,58,25,17,8,51
"2011","South Cambridgeshire 014D","E01018256",1078,255,44,211,308,142,97,57,86,50,18,10,8,65
"2011","South Cambridgeshire 014E","E01018291",853,227,48,179,238,84,94,36,59,37,26,14,12,52
"2011","South Cambridgeshire 015A","E01018279",1036,137,16,121,219,135,95,84,138,143,26,21,5,59
"2011","South Cambridgeshire 015B","E01018280",1150,164,34,130,237,137,103,98,163,143,42,31,11,63
"2011","South Cambridgeshire 015C","E01018281",1137,111,18,93,232,150,107,116,184,158,28,20,8,51
"2011","South Cambridgeshire 015D","E01018282",979,151,23,128,238,152,98,82,100,79,17,11,6,62
"2011","South Cambridgeshire 015E","E01018283",974,145,25,120,209,136,82,86,118,125,24,15,9,49
"2011","South Cambridgeshire 016A","E01018218",1300,314,54,260,347,149,167,51,104,62,37,30,7,69
"2011","South Cambridgeshire 016B","E01018219",996,177,45,132,238,127,136,54,115,77,13,7,6,59
"2011","South Cambridgeshire 016C","E01018220",1132,183,40,143,281,126,197,50,105,87,33,24,9,70
"2011","South Cambridgeshire 016D","E01018263",1101,231,45,186,293,147,104,65,101,70,21,12,9,69
"2011","South Cambridgeshire 016E","E01018264",1086,131,27,104,202,120,112,90,160,152,42,24,18,77
"2011","South Cambridgeshire 016F","E01018265",1258,287,49,238,358,190,119,66,93,59,11,5,6,75
"2011","South Cambridgeshire 017A","E01018238",1031,168,35,133,251,117,111,83,110,119,20,7,13,52
"2011","South Cambridgeshire 017B","E01018239",982,222,45,177,278,98,96,57,102,57,17,6,11,55
"2011","South Cambridgeshire 017C","E01018288",817,170,26,144,205,98,90,54,74,54,7,3,4,65
"2011","South Cambridgeshire 017D","E01018289",853,221,41,180,219,86,108,36,74,45,15,9,6,49
"2011","South Cambridgeshire 017E","E01018302",1133,247,58,189,290,144,114,77,112,72,13,5,8,64
"2011","South Cambridgeshire 017F","E01018303",845,187,42,145,219,95,80,50,81,52,21,11,10,60
"2011","South Cambridgeshire 018A","E01018241",874,174,30,144,244,87,115,68,72,68,10,6,4,36
"2011","South Cambridgeshire 018B","E01018267",1642,340,74,266,436,244,167,88,155,106,21,10,11,85
"2011","South Cambridgeshire 018C","E01018268",1391,246,78,168,350,183,192,90,128,102,19,10,9,81
"2011","South Cambridgeshire 018D","E01018269",979,111,25,86,184,121,110,92,162,125,26,16,10,48
"2011","South Cambridgeshire 018E","E01018270",829,154,46,108,209,99,98,51,85,69,10,8,2,54
"2011","South Cambridgeshire 018F","E01018271",1034,141,29,112,220,120,113,64,146,91,62,54,8,77
"2011","South Cambridgeshire 019A","E01018226",1129,181,85,96,325,129,104,65,109,91,78,67,11,47
"2011","South Cambridgeshire 019B","E01018227",1384,141,35,106,314,172,157,111,203,156,45,27,18,85
"2011","South Cambridgeshire 019C","E01018228",1222,212,61,151,309,155,165,71,131,83,16,9,7,80
"2011","South Cambridgeshire 019D","E01018290",1775,323,92,231,497,243,235,86,155,106,44,32,12,86
"2011","South Cambridgeshire 020A","E01033113",718,150,22,128,209,89,49,49,75,41,22,9,13,34
"2011","South Cambridgeshire 020B","E01033114",1059,245,44,201,305,140,75,47,99,51,28,16,12,69
"2011","South Cambridgeshire 020C","E01033115",924,247,38,209,257,118,78,41,68,33,19,8,11,63
"2011","South Cambridgeshire 020D","E01033117",875,177,32,145,266,120,54,43,76,49,26,18,8,64
"2011","South Cambridgeshire 020E","E01033119",1250,332,44,288,330,155,65,75,119,79,24,14,10,71
"2011","South Cambridgeshire 021A","E01018276",1024,134,25,109,291,143,59,74,132,96,40,21,19,55
"2011","South Cambridgeshire 021B","E01018277",1270,250,54,196,359,156,173,47,123,74,23,18,5,65
"2011","South Cambridgeshire 021C","E01018278",1254,249,64,185,391,155,112,48,115,71,39,29,10,74
"2011","South Cambridgeshire 021D","E01033116",1161,264,47,217,310,137,124,57,105,69,34,23,11,61
"2011","South Cambridgeshire 021E","E01033118",1056,265,57,208,286,140,101,61,82,54,11,9,2,56
"2011","Basildon 001A","E01021237",1007,215,40,175,293,200,95,24,79,27,13,7,6,61
"2011","Basildon 001B","E01021238",1027,175,42,133,297,188,95,39,92,55,14,8,6,72
"2011","Basildon 001C","E01021242",958,171,38,133,246,176,88,53,101,48,16,8,8,59
"2011","Basildon 001D","E01021250",1141,202,45,157,320,236,91,56,96,56,30,18,12,54
"2011","Basildon 001E","E01021251",1160,201,53,148,324,236,92,55,106,51,21,13,8,74
"2011","Basildon 002A","E01021245",1009,85,20,65,188,158,121,59,157,127,61,34,27,53
"2011","Basildon 002B","E01021246",1051,165,42,123,284,231,77,66,82,65,25,22,3,56
"2011","Basildon 002C","E01021248",1054,159,26,133,280,223,84,63,87,68,31,15,16,59
"2011","Basildon 002D","E01021249",1138,217,53,164,302,234,93,63,97,63,18,6,12,51
"2011","Basildon 002E","E01021252",1059,197,47,150,319,200,76,52,86,49,26,12,14,54
"2011","Basildon 003A","E01021239",1031,231,58,173,309,191,88,29,73,31,14,9,5,65
"2011","Basildon 003B","E01021240",1189,233,48,185,297,183,105,72,133,86,24,10,14,56
"2011","Basildon 003C","E01021241",1088,134,34,100,247,173,91,74,146,104,48,26,22,71
"2011","Basildon 003D","E01021243",1252,194,40,154,335,245,118,60,128,68,25,15,10,79
"2011","Basildon 003E","E01021247",1014,185,43,142,292,233,78,43,71,37,19,11,8,56
"2011","Basildon 004A","E01021244",996,187,48,139,284,213,90,42,81,35,19,13,6,45
"2011","Basildon 004B","E01021253",1216,243,66,177,350,258,103,39,101,34,26,13,13,62
"2011","Basildon 004C","E01021255",970,142,29,113,242,218,85,50,110,55,19,8,11,49
"2011","Basildon 004D","E01021256",1047,170,37,133,282,206,112,41,99,57,23,14,9,57
"2011","Basildon 004E","E01021258",1136,105,25,80,263,226,131,74,139,114,33,22,11,51
"2011","Basildon 005A","E01021334",1155,102,24,78,241,218,136,85,170,108,39,22,17,56
"2011","Basildon 005B","E01021336",1153,107,31,76,276,239,114,80,160,97,24,15,9,56
"2011","Basildon 005C","E01021338",1047,82,23,59,215,164,126,80,160,129,42,19,23,49
"2011","Basildon 005D","E01021339",993,85,25,60,196,169,104,80,158,127,38,22,16,36
"2011","Basildon 006A","E01021264",1078,138,38,100,257,183,201,61,86,52,39,26,13,61
"2011","Basildon 006B","E01021329",1033,78,11,67,188,203,138,92,160,103,30,16,14,41
"2011","Basildon 006C","E01021330",1165,93,25,68,218,244,129,106,165,107,37,24,13,66
"2011","Basildon 006D","E01021332",1035,97,33,64,228,199,112,73,158,86,25,16,9,57
"2011","Basildon 006E","E01021333",1155,132,40,92,249,227,156,77,148,95,19,10,9,52
"2011","Basildon 007A","E01021335",1081,132,35,97,228,214,130,70,126,79,23,15,8,79
"2011","Basildon 007B","E01021337",1043,113,28,85,207,199,111,93,149,98,24,13,11,49
"2011","Basildon 007C","E01021340",1212,83,20,63,288,209,143,94,181,110,41,24,17,63
"2011","Basildon 007D","E01021341",1163,98,22,76,246,229,137,98,139,127,28,20,8,61
"2011","Basildon 007E","E01021345",1414,200,53,147,381,328,130,84,127,92,18,5,13,54
"2011","Basildon 008A","E01021331",1163,97,32,65,251,216,123,86,176,127,22,15,7,65
"2011","Basildon 008B","E01021342",1143,73,17,56,226,198,116,92,178,148,57,32,25,55
"2011","Basildon 008C","E01021343",1282,131,31,100,288,290,99,105,155,116,48,26,22,50
"2011","Basildon 008D","E01021344",1630,191,44,147,400,313,204,108,175,126,40,27,13,73
"2011","Basildon 008E","E01021346",1469,152,33,119,374,323,156,90,185,93,31,14,17,65
"2011","Basildon 009A","E01021254",1074,155,42,113,233,191,212,54,86,67,24,15,9,52
"2011","Basildon 009B","E01021257",1090,116,29,87,249,219,146,55,138,81,21,9,12,65
"2011","Basildon 009C","E01021259",1107,144,32,112,270,200,120,76,129,80,31,17,14,57
"2011","Basildon 009D","E01021260",1706,188,53,135,360,257,295,104,198,157,98,85,13,49
"2011","Basildon 010A","E01021261",1252,120,38,82,228,236,176,99,163,116,48,33,15,66
"2011","Basildon 010B","E01021262",1179,124,31,93,277,206,134,81,151,110,54,40,14,42
"2011","Basildon 010C","E01021263",1387,155,31,124,365,260,134,93,145,88,74,41,33,73
"2011","Basildon 010D","E01021274",1296,115,26,89,236,205,130,108,200,172,64,36,28,66
"2011","Basildon 010E","E01021279",1186,72,16,56,213,188,115,80,180,160,98,57,41,80
"2011","Basildon 011A","E01021301",1090,26,7,19,163,150,91,98,227,185,89,50,39,61
"2011","Basildon 011B","E01021303",994,49,13,36,167,153,99,91,186,159,50,26,24,40
"2011","Basildon 011C","E01021307",1023,61,17,44,183,154,97,104,167,150,61,37,24,46
"2011","Basildon 011D","E01021308",1004,74,19,55,201,173,111,88,160,108,24,16,8,65
"2011","Basildon 011E","E01021309",1036,54,5,49,225,162,111,103,172,116,42,26,16,51
"2011","Basildon 011F","E01021312",1207,69,22,47,218,193,212,94,165,115,78,66,12,63
"2011","Basildon 012A","E01021265",1066,49,9,40,167,151,98,96,221,164,60,33,27,60
"2011","Basildon 012B","E01021267",1182,56,13,43,162,152,120,100,236,223,72,36,36,61
"2011","Basildon 012C","E01021269",1159,47,10,37,179,166,130,94,227,179,51,36,15,86
"2011","Basildon 012D","E01021270",1063,51,9,42,162,143,117,79,222,155,63,41,22,71
"2011","Basildon 012E","E01021272",1077,54,8,46,170,172,92,90,210,180,56,29,27,53
"2011","Basildon 013A","E01021271",1225,42,10,32,148,133,92,105,245,247,124,82,42,89
"2011","Basildon 013B","E01021302",1033,29,6,23,113,113,88,75,225,197,127,77,50,66
"2011","Basildon 013C","E01021304",1051,30,10,20,135,135,113,84,195,208,98,62,36,53
"2011","Basildon 013D","E01021305",1065,28,6,22,132,131,90,95,246,196,72,50,22,75
"2011","Basildon 013E","E01021306",1095,41,10,31,158,148,102,114,203,176,82,57,25,71
"2011","Basildon 014A","E01021273",1201,68,15,53,195,195,147,84,201,181,82,47,35,48
"2011","Basildon 014B","E01021275",1252,115,25,90,268,234,135,75,185,102,62,43,19,76
"2011","Basildon 014C","E01021276",1103,73,10,63,216,173,114,81,186,153,49,25,24,58
"2011","Basildon 014D","E01021277",1053,76,11,65,181,160,100,72,183,183,51,25,26,47
"2011","Basildon 014E","E01021278",1202,78,19,59,201,165,109,89,229,182,84,61,23,65
"2011","Basildon 015A","E01021266",1120,64,11,53,180,183,104,96,220,140,71,45,26,62
"2011","Basildon 015B","E01021268",935,42,8,34,133,122,95,82,169,149,91,53,38,52
"2011","Basildon 015C","E01021318",1460,87,15,72,267,214,123,115,246,201,111,66,45,96
"2011","Basildon 015D","E01021320",1190,45,12,33,174,173,103,108,226,202,80,41,39,79
"2011","Basildon 015E","E01021321",1107,53,10,43,182,171,97,103,204,165,62,40,22,70
"2011","Basildon 016A","E01021286",1272,60,14,46,217,163,89,122,213,226,92,52,40,90
"2011","Basildon 016B","E01021288",1066,28,6,22,129,111,87,71,207,192,135,63,72,106
"2011","Basildon 016C","E01021289",1268,80,22,58,224,165,120,87,209,209,108,67,41,66
"2011","Basildon 016D","E01021290",1195,36,10,26,138,122,104,95,211,232,149,100,49,108
"2011","Basildon 016E","E01021291",1202,48,11,37,218,171,106,95,229,187,80,42,38,68
"2011","Basildon 017A","E01021287",1094,68,13,55,218,185,106,77,193,137,55,33,22,55
"2011","Basildon 017B","E01021292",1092,59,23,36,179,166,94,94,194,181,66,33,33,59
"2011","Basildon 017C","E01021293",1197,54,9,45,206,191,114,80,218,193,57,25,32,84
"2011","Basildon 017D","E01021298",1114,60,13,47,192,206,101,74,201,154,52,36,16,74
"2011","Basildon 017E","E01021319",1141,49,11,38,188,163,101,82,212,193,85,50,35,68
"2011","Basildon 018A","E01021313",1164,86,24,62,224,193,158,86,180,131,50,29,21,56
"2011","Basildon 018B","E01021314",980,36,5,31,114,110,114,93,194,175,79,46,33,65
"2011","Basildon 018C","E01021315",1090,51,12,39,144,137,105,102,217,190,81,52,29,63
"2011","Basildon 018D","E01021316",1072,48,14,34,166,140,100,83,221,187,71,42,29,56
"2011","Basildon 018E","E01021317",1141,45,9,36,160,129,100,96,223,222,82,50,32,84
"2011","Basildon 019A","E01021322",1098,50,9,41,144,154,109,105,185,199,83,49,34,69
"2011","Basildon 019B","E01021323",1175,41,7,34,167,146,96,88,233,187,130,83,47,87
"2011","Basildon 019C","E01021324",1134,39,10,29,154,149,108,85,223,168,120,77,43,88
"2011","Basildon 019D","E01021325",1049,38,7,31,140,112,88,78,216,184,110,66,44,83
"2011","Basildon 019E","E01021327",1176,41,13,28,156,144,101,93,262,204,91,53,38,84
"2011","Basildon 020A","E01021294",1175,106,30,76,234,221,127,81,175,118,36,18,18,77
"2011","Basildon 020B","E01021295",1183,89,21,68,224,181,114,87,200,160,58,32,26,70
"2011","Basildon 020C","E01021296",1232,94,22,72,253,189,108,85,213,158,49,35,14,83
"2011","Basildon 020D","E01021297",1226,110,11,99,300,183,91,86,185,133,64,42,22,74
"2011","Basildon 020E","E01021299",1141,133,19,114,247,233,137,90,126,81,27,18,9,67
"2011","Basildon 021A","E01021280",1147,148,35,113,341,240,102,53,104,70,26,14,12,63
"2011","Basildon 021B","E01021281",1129,171,28,143,258,242,109,57,123,83,28,17,11,58
"2011","Basildon 021C","E01021282",1165,189,42,147,265,220,145,73,101,75,31,21,10,66
"2011","Basildon 021D","E01021283",1201,81,24,57,249,178,124,81,195,158,61,35,26,74
"2011","Basildon 021E","E01021284",1141,191,42,149,304,230,105,61,88,66,19,13,6,77
"2011","Basildon 021F","E01021285",1021,148,27,121,255,194,110,82,95,46,26,17,9,65
"2011","Basildon 022A","E01021300",1520,86,13,73,246,214,148,123,264,223,129,82,47,87
"2011","Basildon 022B","E01021310",1077,93,15,78,223,190,107,84,150,155,44,13,31,31
"2011","Basildon 022C","E01021311",1041,55,12,43,134,142,114,76,211,159,88,53,35,62
"2011","Basildon 022D","E01021326",1317,60,12,48,242,207,121,109,254,160,81,48,33,83
"2011","Basildon 022E","E01021328",1132,44,13,31,174,158,101,83,230,176,76,42,34,90
"2011","Braintree 001A","E01021375",844,120,30,90,211,104,123,67,104,56,21,10,11,38
"2011","Braintree 001B","E01021376",1043,136,40,96,273,151,128,86,106,76,24,14,10,63
"2011","Braintree 001C","E01021414",1633,189,55,134,384,206,249,111,189,151,48,25,23,106
"2011","Braintree 001D","E01021430",1573,149,43,106,316,190,261,127,207,186,60,36,24,77
"2011","Braintree 002A","E01021398",1121,145,47,98,260,147,226,51,110,96,15,8,7,71
"2011","Braintree 002B","E01021406",1651,233,60,173,422,201,303,86,176,121,36,22,14,73
"2011","Braintree 002C","E01021407",1571,224,49,175,438,204,281,76,166,85,32,18,14,65
"2011","Braintree 003A","E01021382",914,109,32,77,227,127,141,52,122,64,11,4,7,61
"2011","Braintree 003B","E01021397",1297,136,34,102,279,171,208,93,185,119,33,20,13,73
"2011","Braintree 003C","E01021399",1178,80,29,51,180,148,182,103,193,186,32,25,7,74
"2011","Braintree 003D","E01021400",1225,130,35,95,272,166,223,68,149,124,31,18,13,62
"2011","Braintree 004A","E01021387",1485,115,38,77,289,193,198,116,247,196,61,32,29,70
"2011","Braintree 004B","E01021388",1167,87,30,57,249,136,133,97,198,163,37,24,13,67
"2011","Braintree 004C","E01021391",1148,49,20,29,155,123,129,94,244,195,82,39,43,77
"2011","Braintree 004D","E01021392",1227,81,20,61,224,163,147,111,214,161,69,55,14,57
"2011","Braintree 004E","E01021393",1105,82,26,56,214,128,114,122,204,144,44,27,17,53
"2011","Braintree 005A","E01021404",1574,231,67,164,353,211,253,103,176,123,36,22,14,88
"2011","Braintree 005B","E01021411",886,129,36,93,233,112,150,52,91,58,20,11,9,41
"2011","Braintree 005C","E01021412",1090,128,38,90,306,151,190,57,100,77,26,14,12,55
"2011","Braintree 005D","E01021413",957,123,48,75,236,116,189,47,112,72,21,15,6,41
"2011","Braintree 006A","E01021389",1247,114,38,76,291,206,137,91,189,106,50,29,21,63
"2011","Braintree 006B","E01021390",1114,104,32,72,286,163,129,95,164,101,31,15,16,41
"2011","Braintree 006C","E01021408",1259,173,50,123,314,158,200,67,150,72,59,52,7,66
"2011","Braintree 006D","E01021409",1320,160,38,122,344,178,194,82,164,87,20,9,11,91
"2011","Braintree 006E","E01021410",1138,97,36,61,253,121,138,94,206,110,62,43,19,57
"2011","Braintree 007A","E01021349",1087,83,18,65,214,180,98,112,175,109,29,12,17,87
"2011","Braintree 007B","E01021351",1169,131,32,99,312,196,137,63,132,94,25,12,13,79
"2011","Braintree 007C","E01021352",1163,91,29,62,232,171,120,122,195,131,25,13,12,76
"2011","Braintree 007D","E01021355",1407,129,26,103,327,207,174,117,191,140,61,44,17,61
"2011","Braintree 007E","E01021356",1021,111,20,91,217,155,121,96,137,101,36,27,9,47
"2011","Braintree 007F","E01021381",875,102,23,79,190,115,135,60,130,86,17,10,7,40
"2011","Braintree 008A","E01021354",954,36,13,23,117,103,84,103,227,193,55,34,21,36
"2011","Braintree 008B","E01021357",1138,101,36,65,228,153,152,77,207,136,35,21,14,49
"2011","Braintree 008C","E01021358",1472,88,24,64,275,186,138,126,266,233,80,50,30,80
"2011","Braintree 008D","E01021359",1434,47,15,32,211,164,125,143,317,260,95,57,38,72
"2011","Braintree 009A","E01021350",1256,143,40,103,294,190,133,102,195,102,36,25,11,61
"2011","Braintree 009B","E01021353",1309,55,14,41,260,179,145,131,255,159,57,23,34,68
"2011","Braintree 009D","E01021365",1759,129,33,96,365,247,190,149,284,230,91,46,45,74
"2011","Braintree 009E","E01033458",1044,94,20,74,225,175,69,97,176,122,55,32,23,31
"2011","Braintree 009F","E01033459",1335,105,21,84,278,205,119,125,217,176,46,27,19,64
"2011","Braintree 010A","E01021364",1217,113,28,85,247,203,155,91,177,137,27,14,13,67
"2011","Braintree 010B","E01021366",1152,126,28,98,305,208,121,73,151,85,25,17,8,58
"2011","Braintree 010C","E01021383",1438,215,73,142,411,220,157,78,138,95,22,13,9,102
"2011","Braintree 010D","E01021405",1719,191,47,144,434,251,204,114,216,161,51,33,18,97
"2011","Braintree 011A","E01021368",1126,71,19,52,174,147,97,124,229,172,64,33,31,48
"2011","Braintree 011B","E01021370",1119,64,16,48,156,113,100,99,270,185,81,37,44,51
"2011","Braintree 011C","E01021372",1381,82,34,48,261,185,142,158,258,183,39,15,24,73
"2011","Braintree 011D","E01021373",1823,149,37,112,409,291,153,171,287,218,64,24,40,81
"2011","Braintree 011E","E01021374",1086,54,12,42,160,130,95,84,222,212,65,37,28,64
"2011","Braintree 012A","E01021360",1357,72,18,54,233,176,125,123,269,220,61,25,36,78
"2011","Braintree 012B","E01021361",1204,123,41,82,252,206,139,120,169,118,27,10,17,50
"2011","Braintree 012C","E01021367",1084,62,26,36,170,149,106,96,214,119,65,35,30,103
"2011","Braintree 012D","E01021369",1998,160,42,118,456,266,215,180,323,198,84,48,36,116
"2011","Braintree 012E","E01021380",1675,171,48,123,365,220,241,123,238,169,64,40,24,84
"2011","Braintree 013A","E01021347",1696,235,55,180,442,254,191,97,187,119,61,36,25,110
"2011","Braintree 013B","E01021371",1251,133,44,89,281,206,128,119,189,121,28,16,12,46
"2011","Braintree 013C","E01021384",1635,220,65,155,464,288,147,87,199,92,28,15,13,110
"2011","Braintree 013D","E01021385",932,100,27,73,235,165,93,59,127,72,29,11,18,52
"2011","Braintree 013E","E01021386",1159,176,57,119,333,192,121,46,108,63,25,15,10,95
"2011","Braintree 014A","E01021377",1257,181,42,139,347,159,152,70,143,83,57,47,10,65
"2011","Braintree 014B","E01021378",1096,158,42,116,247,146,138,60,149,121,33,20,13,44
"2011","Braintree 014C","E01021379",1328,189,35,154,347,232,169,84,133,90,23,17,6,61
"2011","Braintree 014D","E01021401",1048,110,25,85,217,130,129,78,149,144,35,17,18,56
"2011","Braintree 014E","E01021402",1497,255,69,186,410,242,121,69,167,101,40,25,15,92
"2011","Braintree 014F","E01021403",1167,191,48,143,300,209,133,66,118,72,17,8,9,61
"2011","Braintree 015A","E01021362",1116,104,30,74,215,174,133,86,169,118,50,29,21,67
"2011","Braintree 015B","E01021417",1126,114,29,85,231,165,93,83,202,142,45,23,22,51
"2011","Braintree 015C","E01021418",1054,50,9,41,137,140,83,82,247,180,70,32,38,65
"2011","Braintree 015D","E01021419",1255,85,19,66,220,197,127,100,210,192,57,35,22,67
"2011","Braintree 015E","E01021426",1005,96,23,73,216,150,83,68,156,98,71,33,38,67
"2011","Braintree 015F","E01021428",1094,121,27,94,212,185,112,97,185,121,13,6,7,48
"2011","Braintree 016A","E01021423",1092,46,11,35,184,148,80,99,208,180,68,36,32,79
"2011","Braintree 016B","E01021425",1097,44,15,29,166,163,98,99,215,197,57,32,25,58
"2011","Braintree 016C","E01021427",1019,50,17,33,167,136,74,80,214,167,67,24,43,64
"2011","Braintree 016D","E01021429",981,51,13,38,167,144,85,74,188,167,52,28,24,53
"2011","Braintree 017A","E01021415",955,87,33,54,212,161,80,60,165,105,38,19,19,47
"2011","Braintree 017B","E01021416",1202,173,44,129,294,224,80,86,143,100,59,43,16,43
"2011","Braintree 017C","E01021420",1306,92,29,63,258,199,122,112,233,170,47,22,25,73
"2011","Braintree 017E","E01021422",1164,76,21,55,214,188,100,95,211,183,38,20,18,59
"2011","Braintree 017F","E01033460",947,116,31,85,240,158,75,65,137,86,23,10,13,47
"2011","Braintree 017G","E01033461",1109,152,40,112,335,206,110,58,108,67,26,14,12,47
"2011","Braintree 017H","E01033462",796,81,17,64,180,129,51,57,125,90,50,35,15,33
"2011","Braintree 018A","E01021348",1162,143,44,99,296,157,141,70,172,98,22,10,12,63
"2011","Braintree 018B","E01021394",1043,121,22,99,235,151,105,84,142,104,53,27,26,48
"2011","Braintree 018C","E01021395",1016,126,26,100,245,186,114,59,132,85,20,7,13,49
"2011","Braintree 018D","E01021396",1046,147,43,104,255,174,123,60,128,63,40,26,14,56
"2011","Braintree 018E","E01021424",1498,155,39,116,338,245,134,121,236,148,39,22,17,82
"2011","Brentwood 001A","E01021441",1119,115,35,80,269,220,158,55,114,66,28,21,7,94
"2011","Brentwood 001B","E01021442",1008,146,48,98,257,188,134,52,87,47,20,11,9,77
"2011","Brentwood 001C","E01021443",1068,114,35,79,256,180,182,58,102,67,46,35,11,63
"2011","Brentwood 001D","E01021444",1204,122,34,88,285,195,178,80,142,86,38,24,14,78
"2011","Brentwood 001E","E01021469",856,124,34,90,185,119,146,39,104,45,25,19,6,69
"2011","Brentwood 001F","E01021470",798,87,33,54,204,126,121,41,82,61,22,13,9,54
"2011","Brentwood 001G","E01021471",1144,162,42,120,290,206,170,53,107,62,22,14,8,72
"2011","Brentwood 002A","E01021457",1043,138,35,103,241,162,144,48,118,90,33,22,11,69
"2011","Brentwood 002B","E01021458",1123,225,46,179,310,201,118,41,80,53,27,19,8,68
"2011","Brentwood 002C","E01021459",940,175,43,132,261,185,93,32,71,25,16,5,11,82
"2011","Brentwood 002D","E01021460",1161,157,35,122,233,189,144,67,151,93,42,27,15,85
"2011","Brentwood 003A","E01021448",986,118,32,86,202,158,86,66,137,120,38,24,14,61
"2011","Brentwood 003B","E01021449",1085,121,22,99,251,155,137,51,137,113,44,22,22,76
"2011","Brentwood 003C","E01021450",1455,223,51,172,401,279,128,84,123,63,40,20,20,114
"2011","Brentwood 003D","E01021451",1059,80,14,66,216,153,91,77,160,132,68,36,32,82
"2011","Brentwood 003E","E01021452",1000,143,35,108,254,201,104,67,108,56,16,9,7,51
"2011","Brentwood 004A","E01021431",1111,145,38,107,344,184,117,63,105,46,41,27,14,66
"2011","Brentwood 004B","E01021432",1225,105,32,73,247,199,113,73,217,133,58,27,31,80
"2011","Brentwood 004C","E01021434",890,132,20,112,247,135,86,51,91,51,35,25,10,62
"2011","Brentwood 004D","E01021461",1070,77,19,58,181,155,105,80,197,158,57,34,23,60
"2011","Brentwood 004E","E01021464",1108,101,24,77,254,170,109,83,173,111,47,26,21,60
"2011","Brentwood 005A","E01021447",1712,363,88,275,478,338,149,56,114,46,27,20,7,141
"2011","Brentwood 005B","E01021453",849,181,32,149,226,164,67,31,76,29,15,6,9,60
"2011","Brentwood 005C","E01021455",942,248,60,188,267,195,57,15,43,18,22,12,10,77
"2011","Brentwood 005D","E01021465",1288,328,78,250,387,218,89,48,89,32,33,19,14,64
"2011","Brentwood 005E","E01021466",1265,355,77,278,344,206,106,26,65,23,32,19,13,108
"2011","Brentwood 005F","E01021467",1175,239,53,186,350,216,116,43,70,29,18,15,3,94
"2011","Brentwood 006A","E01021438",1475,276,57,219,434,247,175,66,117,53,24,13,11,83
"2011","Brentwood 006B","E01021462",1040,111,22,89,262,179,136,72,120,88,14,7,7,58
"2011","Brentwood 006C","E01021463",1128,121,27,94,257,176,160,63,135,96,45,29,16,75
"2011","Brentwood 006D","E01021468",1347,191,47,144,362,213,197,72,114,74,29,16,13,95
"2011","Brentwood 007A","E01021433",1420,214,53,161,423,206,133,88,151,74,44,24,20,87
"2011","Brentwood 007B","E01021436",1650,304,61,243,535,261,130,76,104,78,51,30,21,111
"2011","Brentwood 007C","E01021439",1822,279,46,233,570,319,171,87,160,111,59,24,35,66
"2011","Brentwood 007E","E01021475",1129,202,36,166,323,189,92,69,95,63,34,20,14,62
"2011","Brentwood 007F","E01033063",997,186,43,143,287,163,109,46,79,45,36,21,15,46
"2011","Brentwood 007G","E01033064",1010,153,25,128,254,156,97,68,116,86,23,17,6,57
"2011","Brentwood 008A","E01021435",1304,164,37,127,335,197,127,59,167,111,51,26,25,93
"2011","Brentwood 008B","E01021437",1161,80,14,66,229,174,135,81,194,120,74,44,30,74
"2011","Brentwood 008C","E01021472",1130,149,32,117,292,179,102,59,150,89,42,28,14,68
"2011","Brentwood 008D","E01021473",1002,153,30,123,250,124,147,57,92,66,49,42,7,64
"2011","Brentwood 008E","E01021474",1119,224,51,173,355,190,90,39,91,37,22,16,6,71
"2011","Brentwood 009A","E01021445",1547,259,74,185,434,260,193,84,125,79,25,10,15,88
"2011","Brentwood 009B","E01021446",1094,125,31,94,255,223,152,88,104,72,26,18,8,49
"2011","Brentwood 009C","E01021454",946,131,36,95,272,193,99,40,95,47,18,7,11,51
"2011","Brentwood 009D","E01021456",954,194,41,153,264,188,83,42,66,33,18,8,10,66
"2011","Castle Point 001A","E01021513",1235,92,23,69,218,233,134,124,201,144,36,20,16,53
"2011","Castle Point 001B","E01021514",1110,94,20,74,235,221,117,84,166,119,34,20,14,40
"2011","Castle Point 001C","E01021515",995,69,16,53,195,170,108,90,170,103,27,9,18,63
"2011","Castle Point 001D","E01021525",1123,80,20,60,236,192,139,102,177,123,32,19,13,42
"2011","Castle Point 001E","E01021527",1243,89,33,56,256,243,152,97,176,129,33,19,14,68
"2011","Castle Point 002A","E01021509",990,82,19,63,212,182,120,65,162,83,30,19,11,54
"2011","Castle Point 002B","E01021510",1031,89,23,66,209,204,109,90,152,105,27,17,10,46
"2011","Castle Point 002C","E01021511",982,125,36,89,203,196,116,65,120,67,32,24,8,58
"2011","Castle Point 002D","E01021528",1159,112,29,83,272,194,157,69,141,116,37,27,10,61
"2011","Castle Point 002E","E01021531",1034,102,32,70,226,184,125,68,143,81,36,24,12,69
"2011","Castle Point 003A","E01021476",1423,124,34,90,287,259,172,124,209,119,43,31,12,86
"2011","Castle Point 003B","E01021477",1128,113,36,77,234,216,126,86,164,105,22,17,5,62
"2011","Castle Point 003C","E01021478",1284,122,32,90,275,233,125,105,185,108,42,28,14,89
"2011","Castle Point 003D","E01021516",1030,100,22,78,206,185,132,81,143,94,29,16,13,60
"2011","Castle Point 004A","E01021479",1089,101,29,72,231,232,137,67,145,85,21,9,12,70
"2011","Castle Point 004B","E01021481",1110,129,28,101,297,216,160,54,115,60,19,13,6,60
"2011","Castle Point 004C","E01021483",1257,201,54,147,290,234,166,66,132,58,28,11,17,82
"2011","Castle Point 004D","E01021512",1153,95,28,67,284,207,137,81,157,113,22,9,13,57
"2011","Castle Point 004E","E01021526",1234,122,30,92,271,233,161,86,158,107,23,18,5,73
"2011","Castle Point 005A","E01021517",1147,129,25,104,262,226,157,59,140,76,30,23,7,68
"2011","Castle Point 005B","E01021519",1066,137,33,104,240,201,126,63,138,74,21,10,11,66
"2011","Castle Point 005C","E01021530",1018,106,27,79,226,183,108,72,155,85,30,18,12,53
"2011","Castle Point 005D","E01021532",1073,129,39,90,227,206,175,82,119,75,20,11,9,40
"2011","Castle Point 006A","E01021482",1118,108,18,90,254,226,137,74,127,81,40,28,12,71
"2011","Castle Point 006B","E01021518",1373,100,17,83,315,233,138,107,225,137,50,35,15,68
"2011","Castle Point 006C","E01021520",1104,121,29,92,254,207,129,76,141,70,31,23,8,75
"2011","Castle Point 006D","E01021529",1069,85,12,73,220,157,128,65,159,123,53,28,25,79
"2011","Castle Point 007A","E01021480",1348,189,45,144,318,258,158,86,144,75,32,18,14,88
"2011","Castle Point 007B","E01021521",1047,64,17,47,205,207,135,86,161,106,35,22,13,48
"2011","Castle Point 007C","E01021522",1253,104,32,72,260,203,158,96,185,131,52,29,23,64
"2011","Castle Point 007D","E01021523",1009,84,21,63,218,215,117,78,153,71,25,19,6,48
"2011","Castle Point 007E","E01021524",1143,118,37,81,210,245,139,75,161,105,34,25,9,56
"2011","Castle Point 008A","E01021487",1039,50,11,39,175,166,126,96,191,155,36,24,12,44
"2011","Castle Point 008B","E01021494",1142,64,18,46,183,191,134,100,206,157,54,34,20,53
"2011","Castle Point 008C","E01021504",1161,82,22,60,238,225,140,86,135,126,46,38,8,83
"2011","Castle Point 008D","E01021505",1102,96,31,65,196,208,159,86,154,107,32,13,19,64
"2011","Castle Point 008E","E01021506",999,56,19,37,152,161,107,83,175,153,51,29,22,61
"2011","Castle Point 009A","E01021492",1275,85,21,64,202,245,157,95,216,183,49,33,16,43
"2011","Castle Point 009B","E01021493",1143,53,9,44,215,202,143,98,196,144,46,25,21,46
"2011","Castle Point 009C","E01021495",1440,71,23,48,180,221,176,133,321,262,47,28,19,29
"2011","Castle Point 009D","E01021496",1031,48,14,34,161,152,143,85,191,157,41,27,14,53
"2011","Castle Point 010A","E01021485",893,27,4,23,108,104,112,79,194,158,65,39,26,46
"2011","Castle Point 010B","E01021486",848,32,9,23,94,99,88,89,189,145,60,39,21,52
"2011","Castle Point 010C","E01021488",1031,28,8,20,138,148,129,99,204,169,58,35,23,58
"2011","Castle Point 010D","E01021503",1048,61,22,39,148,146,139,82,211,149,54,39,15,58
"2011","Castle Point 010E","E01021507",1146,49,13,36,154,159,117,95,236,151,107,64,43,78
"2011","Castle Point 010F","E01021508",979,41,13,28,140,167,100,86,183,135,55,29,26,72
"2011","Castle Point 011A","E01021484",1032,62,20,42,192,181,116,98,161,128,49,35,14,45
"2011","Castle Point 011B","E01021498",1155,78,22,56,197,161,164,104,214,139,48,32,16,50
"2011","Castle Point 011C","E01021499",1300,61,18,43,218,236,183,113,230,162,42,27,15,55
"2011","Castle Point 011D","E01021501",1034,70,19,51,148,162,161,109,170,139,44,29,15,31
"2011","Castle Point 011E","E01021502",1675,106,27,79,301,268,237,136,243,241,90,44,46,53
"2011","Castle Point 012A","E01021489",1085,48,11,37,179,180,148,111,189,146,43,28,15,41
"2011","Castle Point 012B","E01021490",1142,53,15,38,189,166,109,119,231,158,64,36,28,53
"2011","Castle Point 012C","E01021491",1233,75,28,47,211,187,173,92,216,162,55,39,16,62
"2011","Castle Point 012D","E01021497",1093,60,16,44,161,176,150,97,193,147,48,33,15,61
"2011","Castle Point 012E","E01021500",1222,73,22,51,188,208,153,111,225,154,54,32,22,56
"2011","Chelmsford 001A","E01021538",1953,294,59,235,523,271,220,130,197,137,46,19,27,135
"2011","Chelmsford 001B","E01021539",917,144,44,100,229,122,140,45,81,81,32,13,19,43
"2011","Chelmsford 001C","E01021540",1180,197,49,148,322,183,150,61,108,90,23,12,11,46
"2011","Chelmsford 001D","E01021541",1031,115,32,83,251,159,119,51,137,96,38,22,16,65
"2011","Chelmsford 002A","E01021542",1481,225,47,178,397,219,120,71,165,122,57,43,14,105
"2011","Chelmsford 002B","E01021543",1170,169,44,125,323,206,111,81,123,77,19,12,7,61
"2011","Chelmsford 002C","E01021587",1044,155,31,124,271,183,98,56,123,73,22,12,10,63
"2011","Chelmsford 002D","E01021590",1097,203,44,159,303,201,85,65,98,48,15,5,10,79
"2011","Chelmsford 002E","E01021591",1137,154,25,129,336,201,95,61,129,73,32,23,9,56
"2011","Chelmsford 003A","E01021550",1060,172,42,130,289,151,144,58,103,73,24,14,10,46
"2011","Chelmsford 003B","E01021597",1001,84,16,68,195,138,83,93,169,105,56,23,33,78
"2011","Chelmsford 003C","E01021598",1008,88,21,67,225,150,97,65,151,126,46,24,22,60
"2011","Chelmsford 003D","E01021600",912,138,37,101,235,158,64,46,126,59,18,11,7,68
"2011","Chelmsford 003E","E01021601",1062,85,19,66,202,130,84,85,185,148,72,44,28,71
"2011","Chelmsford 004A","E01021616",1132,159,34,125,300,226,72,77,139,66,21,11,10,72
"2011","Chelmsford 004B","E01021617",1030,84,19,65,235,156,89,80,177,115,40,25,15,54
"2011","Chelmsford 004C","E01021619",1130,118,26,92,269,233,89,87,145,89,19,6,13,81
"2011","Chelmsford 004D","E01021620",1097,140,26,114,266,231,78,83,130,86,27,8,19,56
"2011","Chelmsford 004E","E01021623",954,93,18,75,269,174,65,66,149,65,16,7,9,57
"2011","Chelmsford 004F","E01021624",841,108,26,82,188,194,62,48,125,55,7,5,2,54
"2011","Chelmsford 005A","E01021536",1171,107,30,77,258,171,138,96,169,140,30,12,18,62
"2011","Chelmsford 005B","E01021537",1502,192,45,147,373,260,155,86,161,90,34,13,21,151
"2011","Chelmsford 005D","E01021568",1128,216,59,157,311,204,142,26,89,42,29,20,9,69
"2011","Chelmsford 005E","E01033142",1501,274,69,205,438,217,120,75,163,78,36,19,17,100
"2011","Chelmsford 005F","E01033144",1272,267,60,207,340,179,108,50,125,58,46,27,19,99
"2011","Chelmsford 006A","E01021576",1101,56,15,41,152,119,80,110,191,198,98,65,33,97
"2011","Chelmsford 006B","E01021588",960,50,17,33,166,137,80,76,196,130,61,33,28,64
"2011","Chelmsford 006C","E01021589",1109,116,24,92,283,168,87,69,160,102,39,19,20,85
"2011","Chelmsford 006D","E01021592",1077,75,13,62,175,129,99,61,204,162,90,55,35,82
"2011","Chelmsford 006E","E01021596",1067,60,18,42,183,108,100,88,210,185,74,42,32,59
"2011","Chelmsford 007A","E01021618",1123,165,38,127,288,174,84,75,147,85,24,9,15,81
"2011","Chelmsford 007B","E01021621",1167,127,22,105,281,195,115,105,168,104,20,11,9,52
"2011","Chelmsford 007C","E01021622",1026,194,39,155,261,172,76,42,127,57,16,11,5,81
"2011","Chelmsford 007D","E01021625",1026,103,21,82,232,235,66,74,147,80,18,10,8,71
"2011","Chelmsford 007E","E01021626",1042,171,48,123,300,181,92,45,99,59,28,18,10,67
"2011","Chelmsford 008A","E01021544",1024,130,24,106,282,181,94,60,122,71,33,15,18,51
"2011","Chelmsford 008B","E01021545",1134,197,39,158,318,218,94,57,114,55,14,5,9,67
"2011","Chelmsford 008C","E01021546",1090,174,34,140,273,172,87,74,126,66,44,18,26,74
"2011","Chelmsford 008D","E01021547",1256,190,38,152,347,234,98,67,126,91,26,11,15,77
"2011","Chelmsford 008E","E01021628",1253,167,32,135,320,181,113,76,145,115,37,19,18,99
"2011","Chelmsford 008F","E01021629",1211,134,26,108,303,193,86,87,170,117,40,20,20,81
"2011","Chelmsford 009A","E01021573",1256,205,39,166,331,171,102,62,140,86,52,25,27,107
"2011","Chelmsford 009B","E01021575",1250,201,37,164,324,166,76,74,130,99,69,38,31,111
"2011","Chelmsford 009C","E01021599",1343,270,45,225,415,234,89,53,111,68,28,17,11,75
"2011","Chelmsford 009E","E01021631",1290,72,17,55,186,150,87,117,229,249,93,50,43,107
"2011","Chelmsford 009F","E01033138",1147,170,32,138,293,165,116,69,123,106,39,20,19,66
"2011","Chelmsford 009G","E01033139",1145,156,17,139,288,164,90,69,132,106,52,33,19,88
"2011","Chelmsford 010A","E01021574",2060,278,35,243,498,252,89,78,148,89,52,27,25,576
"2011","Chelmsford 010B","E01021578",1360,210,43,167,411,210,89,86,140,90,56,22,34,68
"2011","Chelmsford 010D","E01021582",1510,285,49,236,430,216,124,94,153,94,42,25,17,72
"2011","Chelmsford 010E","E01021627",1241,162,26,136,297,173,103,83,143,126,95,77,18,59
"2011","Chelmsford 010F","E01033140",902,173,30,143,275,124,56,35,94,56,23,12,11,66
"2011","Chelmsford 010G","E01033141",783,135,20,115,245,116,56,37,71,44,35,19,16,44
"2011","Chelmsford 011A","E01021551",1005,145,41,104,242,131,156,66,108,74,26,18,8,57
"2011","Chelmsford 011B","E01021632",1007,130,24,106,244,219,73,63,140,71,24,11,13,43
"2011","Chelmsford 011C","E01021633",1075,131,22,109,235,123,87,40,70,44,13,7,6,332
"2011","Chelmsford 011D","E01021634",1134,174,35,139,280,187,116,66,126,72,25,19,6,88
"2011","Chelmsford 011E","E01021635",997,148,28,120,262,157,113,43,125,77,23,18,5,49
"2011","Chelmsford 011F","E01021636",785,72,16,56,162,107,61,59,113,108,45,26,19,58
"2011","Chelmsford 012A","E01021556",1192,162,30,132,307,183,119,95,118,95,37,20,17,76
"2011","Chelmsford 012B","E01021577",1055,177,30,147,296,157,87,59,104,68,36,23,13,71
"2011","Chelmsford 012C","E01021579",1100,215,44,171,320,157,113,54,97,57,32,23,9,55
"2011","Chelmsford 012D","E01021580",1019,203,38,165,304,144,102,36,92,38,15,11,4,85
"2011","Chelmsford 012E","E01021584",859,127,35,92,212,161,64,58,111,66,6,4,2,54
"2011","Chelmsford 013A","E01021548",1025,150,36,114,273,186,88,53,125,66,17,12,5,67
"2011","Chelmsford 013B","E01021560",1146,184,34,150,310,198,105,52,147,75,20,9,11,55
"2011","Chelmsford 013C","E01021561",1297,163,29,134,342,226,112,93,163,95,20,9,11,83
"2011","Chelmsford 013D","E01021564",1066,137,26,111,279,180,115,58,129,77,30,20,10,61
"2011","Chelmsford 013E","E01021571",1116,183,47,136,279,173,133,54,113,72,27,12,15,82
"2011","Chelmsford 014A","E01021562",1282,156,28,128,305,203,126,82,170,129,34,18,16,77
"2011","Chelmsford 014B","E01021563",1233,118,34,84,263,160,111,87,218,114,85,41,44,77
"2011","Chelmsford 014C","E01021565",1141,80,15,65,209,153,107,90,219,163,57,29,28,63
"2011","Chelmsford 014D","E01021566",1253,162,37,125,315,198,126,73,160,110,29,22,7,80
"2011","Chelmsford 014F","E01033137",1140,186,36,150,300,194,107,73,134,68,21,16,5,57
"2011","Chelmsford 014G","E01033145",988,123,31,92,210,160,76,62,144,107,37,21,16,69
"2011","Chelmsford 015A","E01021557",983,100,29,71,228,183,75,76,162,86,15,8,7,58
"2011","Chelmsford 015B","E01021558",978,85,8,77,242,183,80,65,164,83,19,11,8,57
"2011","Chelmsford 015C","E01021583",1122,151,35,116,275,167,73,74,167,95,29,18,11,91
"2011","Chelmsford 015D","E01021585",945,77,23,54,206,185,69,76,149,99,22,9,13,62
"2011","Chelmsford 015E","E01021586",1157,97,27,70,263,232,85,107,177,106,25,14,11,65
"2011","Chelmsford 016A","E01021533",1729,239,52,187,455,285,215,101,191,111,49,37,12,83
"2011","Chelmsford 016B","E01021535",1291,165,40,125,319,179,205,67,148,86,38,24,14,84
"2011","Chelmsford 016C","E01021569",1164,265,64,201,347,175,126,43,85,33,25,13,12,65
"2011","Chelmsford 016D","E01021570",1359,270,60,210,369,224,147,51,145,51,25,17,8,77
"2011","Chelmsford 016E","E01021572",1077,118,41,77,229,144,117,77,184,102,38,22,16,68
"2011","Chelmsford 017A","E01021552",1085,126,37,89,241,187,114,64,140,116,31,17,14,66
"2011","Chelmsford 017B","E01021553",1038,100,25,75,238,185,76,68,155,120,39,16,23,57
"2011","Chelmsford 017C","E01021554",1078,129,23,106,251,171,96,65,138,114,67,43,24,47
"2011","Chelmsford 017D","E01021555",992,115,28,87,223,184,102,78,129,73,24,13,11,64
"2011","Chelmsford 017E","E01021559",1127,164,33,131,313,178,129,66,105,69,31,23,8,72
"2011","Chelmsford 018B","E01021602",1196,164,41,123,282,162,198,72,132,86,41,31,10,59
"2011","Chelmsford 018D","E01021604",1649,254,62,192,439,274,250,74,133,90,35,21,14,100
"2011","Chelmsford 018E","E01033143",1908,317,95,222,500,279,284,80,205,122,43,27,16,78
"2011","Chelmsford 019A","E01021611",1121,127,32,95,243,199,117,94,151,78,21,11,10,91
"2011","Chelmsford 019B","E01021612",1132,127,33,94,244,227,108,80,155,106,20,6,14,65
"2011","Chelmsford 019C","E01021613",1359,136,33,103,317,264,136,94,179,120,37,19,18,76
"2011","Chelmsford 019D","E01021614",1343,157,38,119,304,269,155,83,145,115,31,15,16,84
"2011","Chelmsford 019E","E01021615",1089,123,33,90,236,210,133,74,157,81,28,10,18,47
"2011","Chelmsford 020A","E01021605",992,148,42,106,248,193,105,55,104,51,16,10,6,72
"2011","Chelmsford 020B","E01021606",1290,202,45,157,316,231,129,53,133,87,41,26,15,98
"2011","Chelmsford 020C","E01021607",1139,139,29,110,292,199,121,91,143,65,23,10,13,66
"2011","Chelmsford 020D","E01021608",865,80,27,53,192,194,92,64,105,80,24,11,13,34
"2011","Chelmsford 020E","E01021609",1057,156,47,109,290,200,113,61,112,42,20,8,12,63
"2011","Chelmsford 020F","E01021610",1016,114,23,91,256,175,99,73,120,81,30,16,14,68
"2011","Chelmsford 021A","E01021593",1221,111,22,89,248,194,158,78,169,129,72,59,13,62
"2011","Chelmsford 021B","E01021594",1269,135,37,98,253,175,220,79,165,137,50,32,18,55
"2011","Chelmsford 021C","E01021595",1243,106,22,84,257,218,183,99,155,115,47,29,18,63
"2011","Colchester 001A","E01021655",1018,163,39,124,288,125,162,48,104,51,18,12,6,59
"2011","Colchester 001B","E01021656",1105,169,42,127,283,132,157,48,140,79,29,13,16,68
"2011","Colchester 001C","E01021659",1532,231,55,176,405,223,194,91,162,112,29,16,13,85
"2011","Colchester 001D","E01021661",1268,175,39,136,301,189,141,89,163,100,31,21,10,79
"2011","Colchester 002A","E01021668",1271,126,28,98,308,200,70,85,219,115,64,33,31,84
"2011","Colchester 002B","E01021669",1113,77,13,64,217,151,70,83,225,141,72,47,25,77
"2011","Colchester 002C","E01021670",1087,124,22,102,211,180,75,74,150,111,70,41,29,92
"2011","Colchester 002D","E01021671",1092,192,46,146,289,156,89,49,113,64,56,38,18,84
"2011","Colchester 002F","E01033720",1458,178,40,138,408,209,104,96,192,104,55,41,14,112
"2011","Colchester 002G","E01033721",1219,195,43,152,351,241,82,70,126,58,33,26,7,63
"2011","Colchester 003A","E01021660",1117,177,52,125,257,147,170,56,136,75,40,31,9,59
"2011","Colchester 003B","E01021728",1175,194,34,160,363,204,130,46,101,51,15,4,11,71
"2011","Colchester 003C","E01021729",1217,158,34,124,304,177,111,81,166,120,24,16,8,76
"2011","Colchester 003D","E01021730",1265,145,34,111,294,167,178,79,182,97,56,40,16,67
"2011","Colchester 004A","E01021679",1778,324,40,284,512,273,118,87,191,108,70,41,29,95
"2011","Colchester 004B","E01021680",2040,291,49,242,589,311,137,123,244,126,97,71,26,122
"2011","Colchester 004C","E01021681",2030,353,66,287,629,334,151,110,210,91,45,23,22,107
"2011","Colchester 004D","E01021682",2021,311,48,263,544,297,145,135,241,120,83,63,20,145
"2011","Colchester 007A","E01021646",1516,273,48,225,468,199,108,75,160,71,29,14,15,133
"2011","Colchester 007B","E01021647",1367,171,25,146,337,211,110,88,195,91,56,38,18,108
"2011","Colchester 007C","E01021648",1851,230,40,190,443,232,156,96,242,136,94,58,36,222
"2011","Colchester 007D","E01021649",1503,150,30,120,321,184,101,106,225,151,102,63,39,163
"2011","Colchester 007E","E01021650",1566,246,31,215,392,207,104,90,200,117,60,31,29,150
"2011","Colchester 008A","E01021696",1126,37,9,28,106,76,78,82,269,198,89,53,36,191
"2011","Colchester 008B","E01021697",1217,45,8,37,121,98,86,96,272,206,95,64,31,198
"2011","Colchester 008C","E01021698",1228,35,11,24,100,97,57,63,174,128,72,46,26,502
"2011","Colchester 008D","E01021699",1143,30,7,23,89,109,73,80,241,167,67,36,31,287
"2011","Colchester 008E","E01021700",1116,25,4,21,103,82,66,64,220,143,97,54,43,316
"2011","Colchester 008G","E01033719",1538,59,8,51,84,41,29,31,58,30,53,43,10,1153
"2011","Colchester 008H","E01033722",1306,40,8,32,115,103,51,66,173,127,85,55,30,546
"2011","Colchester 009A","E01021673",938,179,33,146,262,144,83,32,90,53,16,12,4,79
"2011","Colchester 009B","E01021674",976,63,20,43,191,111,105,70,181,120,53,34,19,82
"2011","Colchester 009C","E01021675",946,151,40,111,248,157,91,45,103,69,24,10,14,58
"2011","Colchester 009D","E01021676",950,176,31,145,276,132,99,30,86,47,27,22,5,77
"2011","Colchester 010A","E01021654",1331,217,44,173,358,195,186,70,131,87,24,19,5,63
"2011","Colchester 010B","E01021662",1185,188,50,138,284,196,169,58,113,64,38,31,7,75
"2011","Colchester 010C","E01021663",816,110,28,82,237,111,114,47,90,46,19,15,4,42
"2011","Colchester 010D","E01021677",938,109,37,72,220,187,93,84,112,68,11,10,1,54
"2011","Colchester 010E","E01021678",1016,98,17,81,235,156,121,87,136,91,36,25,11,56
"2011","Colchester 011A","E01021683",2148,457,389,68,768,395,65,77,136,101,55,29,26,94
"2011","Colchester 011B","E01021684",1118,93,16,77,260,155,93,99,199,118,37,23,14,64
"2011","Colchester 011C","E01021685",1496,104,21,83,259,142,83,92,241,145,94,50,44,336
"2011","Colchester 011D","E01021686",1477,90,16,74,294,163,118,103,235,179,119,68,51,176
"2011","Colchester 011E","E01021687",1267,89,19,70,305,164,96,109,213,114,52,26,26,125
"2011","Colchester 011F","E01021688",1046,87,21,66,238,139,83,76,155,115,42,24,18,111
"2011","Colchester 012A","E01021718",1167,114,26,88,309,183,109,99,166,90,28,13,15,69
"2011","Colchester 012B","E01021719",1099,96,24,72,240,196,113,84,173,100,38,25,13,59
"2011","Colchester 012C","E01021720",1047,91,20,71,218,166,108,74,185,114,40,25,15,51
"2011","Colchester 012D","E01021721",1442,143,41,102,389,240,128,99,220,95,22,14,8,106
"2011","Colchester 012E","E01021722",1200,122,29,93,257,182,122,81,200,105,40,30,10,91
"2011","Colchester 013A","E01021651",1177,156,29,127,348,138,89,66,151,93,37,22,15,99
"2011","Colchester 013B","E01021652",1119,239,37,202,357,134,88,27,87,40,35,18,17,112
"2011","Colchester 013C","E01021653",965,146,42,104,315,139,76,29,97,38,18,8,10,107
"2011","Colchester 013D","E01021717",1279,158,45,113,388,198,83,73,172,80,24,12,12,103
"2011","Colchester 014A","E01021689",989,76,15,61,210,155,90,60,159,86,48,32,16,105
"2011","Colchester 014B","E01021690",998,77,21,56,235,174,96,63,165,89,29,18,11,70
"2011","Colchester 014C","E01021691",1055,118,19,99,274,164,86,65,168,69,45,36,9,66
"2011","Colchester 014D","E01021692",1087,117,30,87,273,179,97,79,142,63,43,36,7,94
"2011","Colchester 014E","E01021693",1096,120,24,96,248,220,93,69,161,82,24,18,6,79
"2011","Colchester 015A","E01021711",894,29,8,21,141,88,71,84,235,149,47,28,19,50
"2011","Colchester 015C","E01021713",850,45,18,27,178,79,56,73,171,133,51,40,11,64
"2011","Colchester 015D","E01021714",1272,82,25,57,340,177,90,100,214,123,60,38,22,86
"2011","Colchester 015E","E01021715",1057,93,27,66,231,140,93,62,200,113,50,32,18,75
"2011","Colchester 015G","E01033723",1646,134,94,40,538,258,57,117,246,141,71,48,23,84
"2011","Colchester 016A","E01021657",1203,104,32,72,310,159,147,90,171,101,46,27,19,75
"2011","Colchester 016B","E01021658",776,53,20,33,170,92,76,71,135,85,30,17,13,64
"2011","Colchester 016C","E01021664",1515,121,27,94,295,202,110,126,236,153,70,47,23,202
"2011","Colchester 016D","E01021665",999,39,9,30,153,107,103,78,203,169,73,39,34,74
"2011","Colchester 016E","E01021666",1011,86,23,63,191,160,101,70,180,97,42,17,25,84
"2011","Colchester 016F","E01021667",1027,54,16,38,171,117,108,105,176,135,84,55,29,77
"2011","Colchester 017A","E01021736",3115,99,24,75,152,138,67,49,98,62,54,45,9,2396
"2011","Colchester 017B","E01021737",913,69,11,58,167,144,84,70,132,93,20,10,10,134
"2011","Colchester 017C","E01021738",1600,373,54,319,480,175,153,50,105,67,31,19,12,166
"2011","Colchester 017D","E01021739",1180,194,39,155,318,142,129,55,130,68,22,13,9,122
"2011","Colchester 017E","E01021740",1286,160,17,143,256,167,111,79,173,123,36,27,9,181
"2011","Colchester 018A","E01021637",896,46,15,31,140,108,95,86,207,128,40,31,9,46
"2011","Colchester 018B","E01021638",915,37,12,25,140,88,74,85,231,135,48,30,18,77
"2011","Colchester 018C","E01021639",1523,96,54,42,435,240,108,116,214,160,70,46,24,84
"2011","Colchester 018D","E01021640",898,44,9,35,178,110,73,82,185,130,37,22,15,59
"2011","Colchester 018E","E01021641",989,48,25,23,165,126,89,99,218,124,45,26,19,75
"2011","Colchester 018F","E01021642",1454,80,25,55,288,183,122,112,294,200,73,52,21,102
"2011","Colchester 019A","E01021643",1808,251,73,178,444,287,235,110,224,120,35,26,9,102
"2011","Colchester 019B","E01021644",1271,145,41,104,302,159,192,96,153,96,48,37,11,80
"2011","Colchester 019C","E01021645",1128,145,34,111,284,179,149,68,141,77,23,8,15,62
"2011","Colchester 019D","E01021694",1095,163,46,117,280,140,182,56,114,62,36,29,7,62
"2011","Colchester 019E","E01021695",822,94,29,65,227,121,129,39,88,59,25,19,6,40
"2011","Colchester 020A","E01021723",1222,107,24,83,240,185,155,102,198,135,44,37,7,56
"2011","Colchester 020B","E01021724",1179,112,26,86,233,177,131,96,179,158,27,13,14,66
"2011","Colchester 020C","E01021725",983,108,29,79,197,145,129,59,147,106,27,15,12,65
"2011","Colchester 020D","E01021726",1124,79,23,56,174,140,136,94,208,166,61,44,17,66
"2011","Colchester 020E","E01021727",1111,95,25,70,232,179,138,99,175,107,22,14,8,64
"2011","Colchester 021A","E01021731",1013,126,35,91,258,159,155,52,119,73,24,21,3,47
"2011","Colchester 021B","E01021732",1060,79,18,61,221,122,179,77,185,106,31,17,14,60
"2011","Colchester 021C","E01021733",1073,131,37,94,265,141,157,75,158,87,27,18,9,32
"2011","Colchester 021D","E01021734",964,115,30,85,233,133,154,65,123,68,24,16,8,49
"2011","Colchester 021E","E01021735",917,134,49,85,224,122,168,43,109,71,17,10,7,29
"2011","Colchester 022D","E01021702",994,63,17,46,183,157,81,89,199,106,26,11,15,90
"2011","Colchester 022E","E01021703",856,23,5,18,94,66,68,75,207,157,85,60,25,81
"2011","Colchester 022F","E01021704",1103,61,13,48,191,148,87,77,233,151,54,34,20,101
"2011","Colchester 022G","E01021705",1583,151,38,113,379,224,140,95,253,132,53,24,29,156
"2011","Colchester 022H","E01021706",1027,84,13,71,153,117,95,74,187,94,53,36,17,170
"2011","Colchester 022I","E01021707",981,47,13,34,195,132,91,84,190,121,41,28,13,80
"2011","Colchester 022A","E01021708",1075,143,37,106,264,177,108,62,160,72,37,31,6,52
"2011","Colchester 022B","E01021709",1022,101,25,76,217,179,103,78,172,95,13,6,7,64
"2011","Colchester 022C","E01021710",1481,160,42,118,349,259,125,96,204,130,44,33,11,114
"2011","Epping Forest 001A","E01021768",1555,203,68,135,350,220,268,98,161,117,56,28,28,82
"2011","Epping Forest 001B","E01021795",1573,217,62,155,437,264,198,98,128,123,26,14,12,82
"2011","Epping Forest 001C","E01021797",1008,99,25,74,216,149,174,75,110,114,19,11,8,52
"2011","Epping Forest 001D","E01021798",1104,116,44,72,267,201,147,72,124,84,32,21,11,61
"2011","Epping Forest 001E","E01021799",1142,83,16,67,275,199,128,96,165,104,36,23,13,56
"2011","Epping Forest 002A","E01021741",1479,175,64,111,316,211,312,79,138,122,40,24,16,86
"2011","Epping Forest 002B","E01021792",919,127,47,80,190,153,162,45,91,58,21,9,12,72
"2011","Epping Forest 002C","E01021793",1126,121,43,78,250,196,212,61,110,76,32,25,7,68
"2011","Epping Forest 002D","E01021794",831,87,29,58,155,123,131,51,105,86,32,19,13,61
"2011","Epping Forest 002E","E01021801",1669,224,62,162,373,257,272,90,161,137,48,32,16,107
"2011","Epping Forest 003A","E01021769",1628,201,54,147,378,225,300,103,150,121,42,31,11,108
"2011","Epping Forest 003B","E01021796",1562,183,46,137,398,228,299,92,140,106,38,29,9,78
"2011","Epping Forest 003C","E01021800",1696,185,54,131,383,236,381,89,149,115,51,34,17,107
"2011","Epping Forest 004A","E01021753",1018,95,26,69,207,153,159,69,139,97,35,17,18,64
"2011","Epping Forest 004B","E01021754",1089,139,33,106,299,200,141,63,86,56,31,20,11,74
"2011","Epping Forest 004C","E01021755",785,85,22,63,207,149,106,44,85,43,16,8,8,50
"2011","Epping Forest 004D","E01021802",1515,119,41,78,280,222,195,142,214,191,70,48,22,82
"2011","Epping Forest 005A","E01021760",1080,152,41,111,278,161,146,63,106,76,33,18,15,65
"2011","Epping Forest 005B","E01021761",1306,176,49,127,328,209,189,75,135,72,50,32,18,72
"2011","Epping Forest 005C","E01021762",936,107,26,81,215,139,105,59,128,95,38,27,11,50
"2011","Epping Forest 005D","E01021763",1081,170,39,131,306,167,132,46,125,54,37,17,20,44
"2011","Epping Forest 006A","E01021756",1120,172,42,130,282,193,152,50,106,57,42,23,19,66
"2011","Epping Forest 006B","E01021757",1184,229,66,163,374,188,140,46,91,44,24,14,10,48
"2011","Epping Forest 006C","E01021758",1140,145,27,118,253,184,140,63,134,106,57,35,22,58
"2011","Epping Forest 006D","E01021759",1051,131,37,94,300,176,114,60,102,72,31,11,20,65
"2011","Epping Forest 007A","E01021811",992,37,12,25,164,159,118,79,171,155,56,27,29,53
"2011","Epping Forest 007B","E01021813",1055,99,30,69,202,192,138,78,158,112,23,12,11,53
"2011","Epping Forest 007C","E01021814",1055,67,22,45,214,173,162,80,127,115,47,28,19,70
"2011","Epping Forest 007D","E01021815",1139,55,11,44,165,186,130,107,189,169,55,36,19,83
"2011","Epping Forest 007E","E01021816",925,40,8,32,123,116,103,65,162,202,59,39,20,55
"2011","Epping Forest 008A","E01021807",1091,88,31,57,243,192,149,84,119,99,45,27,18,72
"2011","Epping Forest 008B","E01021808",1074,56,17,39,152,177,134,85,173,164,66,34,32,67
"2011","Epping Forest 008C","E01021809",1073,74,20,54,178,168,126,94,171,141,62,49,13,59
"2011","Epping Forest 008D","E01021810",1370,116,37,79,351,253,174,80,172,122,47,24,23,55
"2011","Epping Forest 008E","E01021817",1806,174,50,124,373,279,229,135,229,188,88,53,35,111
"2011","Epping Forest 009A","E01021806",1639,163,50,113,360,201,290,93,225,173,60,47,13,74
"2011","Epping Forest 009B","E01021812",954,65,27,38,180,154,155,60,136,130,34,16,18,40
"2011","Epping Forest 009C","E01021818",1325,121,33,88,294,229,149,90,167,159,55,35,20,61
"2011","Epping Forest 010A","E01021770",1439,143,49,94,329,209,251,99,160,125,55,40,15,68
"2011","Epping Forest 010B","E01021803",949,147,36,111,251,155,110,49,86,38,35,21,14,78
"2011","Epping Forest 010C","E01021804",1027,180,43,137,283,161,159,34,70,48,25,17,8,67
"2011","Epping Forest 010D","E01021805",867,138,42,96,260,170,100,28,63,31,13,9,4,64
"2011","Epping Forest 011A","E01021774",1021,52,15,37,181,148,128,87,162,114,72,41,31,77
"2011","Epping Forest 011B","E01021775",1023,56,16,40,189,159,102,100,154,125,56,40,16,82
"2011","Epping Forest 011C","E01021776",994,71,11,60,171,146,123,90,138,121,52,35,17,82
"2011","Epping Forest 011D","E01021777",998,54,23,31,181,167,107,77,158,95,54,26,28,105
"2011","Epping Forest 011E","E01021778",1070,71,8,63,217,155,107,81,151,112,56,27,29,120
"2011","Epping Forest 011F","E01021779",1107,73,18,55,231,167,129,77,161,112,67,30,37,90
"2011","Epping Forest 012A","E01021786",917,143,42,101,229,178,109,42,89,47,25,13,12,55
"2011","Epping Forest 012B","E01021787",1186,222,48,174,334,193,179,29,79,24,19,11,8,107
"2011","Epping Forest 012C","E01021788",1141,157,33,124,276,187,178,47,106,63,36,25,11,91
"2011","Epping Forest 012D","E01021789",1119,227,59,168,301,188,166,23,78,22,40,32,8,74
"2011","Epping Forest 012E","E01021790",1014,112,24,88,203,147,119,73,122,87,54,29,25,97
"2011","Epping Forest 012F","E01021791",1162,186,36,150,322,193,138,49,79,54,26,18,8,115
"2011","Epping Forest 013A","E01021771",1080,67,21,46,203,169,110,87,170,127,74,38,36,73
"2011","Epping Forest 013B","E01021772",1078,108,21,87,242,174,119,59,132,99,37,21,16,108
"2011","Epping Forest 013C","E01021773",1105,93,17,76,205,166,134,75,150,115,54,24,30,113
"2011","Epping Forest 013D","E01021783",1141,135,42,93,261,196,159,70,127,69,43,23,20,81
"2011","Epping Forest 013E","E01021784",1115,154,36,118,287,206,134,61,100,66,35,22,13,72
"2011","Epping Forest 014A","E01021780",1042,239,59,180,283,155,143,21,55,37,20,15,5,89
"2011","Epping Forest 014B","E01021781",1107,207,57,150,354,171,145,42,77,33,23,18,5,55
"2011","Epping Forest 014C","E01021782",1015,233,55,178,295,139,134,39,66,27,23,18,5,59
"2011","Epping Forest 014D","E01021785",1160,125,37,88,226,202,121,66,147,124,74,44,30,75
"2011","Epping Forest 015A","E01021742",977,120,30,90,249,151,111,49,123,65,43,26,17,66
"2011","Epping Forest 015B","E01021743",1163,192,46,146,327,193,123,59,99,64,38,25,13,68
"2011","Epping Forest 015C","E01021744",1158,140,31,109,284,227,148,62,119,70,36,17,19,72
"2011","Epping Forest 015D","E01021745",1126,225,54,171,340,163,148,42,71,25,31,22,9,81
"2011","Epping Forest 015E","E01021746",1271,252,51,201,352,209,154,44,116,43,27,14,13,74
"2011","Epping Forest 015F","E01021747",1216,264,58,206,361,184,156,33,80,21,31,19,12,86
"2011","Epping Forest 015G","E01021748",1266,268,47,221,387,185,157,45,73,55,30,22,8,66
"2011","Epping Forest 016A","E01021749",1666,214,47,167,434,282,259,69,155,86,70,58,12,97
"2011","Epping Forest 016B","E01021750",945,171,44,127,227,123,147,22,69,36,40,32,8,110
"2011","Epping Forest 016C","E01021751",1014,197,43,154,268,159,156,30,55,25,30,22,8,94
"2011","Epping Forest 016D","E01021752",1142,172,41,131,258,180,180,50,103,57,53,35,18,89
"2011","Epping Forest 017A","E01021764",1208,63,14,49,198,147,143,73,226,160,121,75,46,77
"2011","Epping Forest 017B","E01021765",1201,161,34,127,297,195,179,40,125,49,48,26,22,107
"2011","Epping Forest 017C","E01021766",1074,168,37,131,188,156,208,40,87,53,66,53,13,108
"2011","Epping Forest 017D","E01021767",1223,190,41,149,278,195,179,50,107,52,60,48,12,112
"2011","Harlow 001A","E01021854",1219,126,38,88,274,206,142,67,166,128,31,15,16,79
"2011","Harlow 001B","E01021855",957,102,27,75,211,142,111,73,133,104,31,17,14,50
"2011","Harlow 001C","E01021856",1054,92,30,62,222,191,103,67,167,105,32,14,18,75
"2011","Harlow 001D","E01021857",1818,242,56,186,507,294,231,81,189,128,38,22,16,108
"2011","Harlow 002A","E01021844",991,47,10,37,158,132,103,79,185,139,68,42,26,80
"2011","Harlow 002B","E01021845",995,49,15,34,162,149,99,83,175,143,68,39,29,67
"2011","Harlow 002C","E01021846",962,40,7,33,151,114,81,75,164,178,66,32,34,93
"2011","Harlow 002D","E01021847",954,50,9,41,167,147,80,79,169,156,43,30,13,63
"2011","Harlow 002E","E01021848",1114,79,18,61,194,169,88,99,194,153,68,36,32,70
"2011","Harlow 003A","E01021849",1145,70,20,50,207,171,102,110,193,141,59,37,22,92
"2011","Harlow 003B","E01021850",998,43,15,28,160,119,86,79,183,200,63,37,26,65
"2011","Harlow 003C","E01021851",1089,49,14,35,212,147,61,85,185,182,84,34,50,84
"2011","Harlow 003D","E01021852",1031,53,12,41,179,154,93,90,183,148,68,40,28,63
"2011","Harlow 003E","E01021853",956,77,18,59,187,135,78,76,155,144,52,29,23,52
"2011","Harlow 004A","E01021839",1091,109,16,93,232,148,82,86,177,126,62,31,31,69
"2011","Harlow 004B","E01021840",1041,54,11,43,197,158,70,87,202,151,50,27,23,72
"2011","Harlow 004C","E01021841",965,54,19,35,186,155,89,83,168,134,45,27,18,51
"2011","Harlow 004D","E01021842",1079,58,10,48,190,154,70,76,190,174,81,48,33,86
"2011","Harlow 004E","E01021843",1539,146,17,129,361,227,96,110,236,210,74,42,32,79
"2011","Harlow 005A","E01021824",1182,152,46,106,331,207,133,75,115,87,21,11,10,61
"2011","Harlow 005B","E01021825",1151,136,28,108,302,218,101,72,137,82,33,13,20,70
"2011","Harlow 005C","E01021826",1166,149,38,111,281,221,103,105,135,85,34,18,16,53
"2011","Harlow 005D","E01021827",1227,145,46,99,302,235,113,78,129,107,46,21,25,72
"2011","Harlow 005E","E01021828",1608,224,65,159,429,315,165,77,184,107,27,15,12,80
"2011","Harlow 006A","E01021819",1079,66,26,40,161,177,99,87,193,174,53,22,31,69
"2011","Harlow 006B","E01021820",1048,59,11,48,187,154,88,100,191,134,57,38,19,78
"2011","Harlow 006C","E01021822",1100,70,22,48,177,165,98,100,199,168,49,31,18,74
"2011","Harlow 006D","E01021823",1179,54,12,42,194,158,93,97,235,194,86,51,35,68
"2011","Harlow 006E","E01021870",915,36,12,24,159,132,77,72,173,167,43,23,20,56
"2011","Harlow 007A","E01021831",992,60,18,42,159,154,88,89,160,171,52,36,16,59
"2011","Harlow 007B","E01021868",1154,70,25,45,207,179,91,97,206,174,54,24,30,76
"2011","Harlow 007C","E01021869",954,57,12,45,186,130,83,76,160,145,48,29,19,69
"2011","Harlow 007D","E01021871",1002,50,15,35,185,144,78,74,191,140,78,46,32,62
"2011","Harlow 007E","E01021872",1317,68,8,60,243,143,100,75,210,215,90,51,39,173
"2011","Harlow 008A","E01021821",927,45,14,31,150,123,95,80,166,156,65,37,28,47
"2011","Harlow 008B","E01021834",1037,44,11,33,150,153,116,101,175,186,54,26,28,58
"2011","Harlow 008C","E01021835",1036,71,26,45,176,158,106,74,190,131,48,26,22,82
"2011","Harlow 008D","E01021836",1016,49,14,35,178,126,91,87,181,153,76,51,25,75
"2011","Harlow 008E","E01021837",1048,58,17,41,192,142,106,93,197,150,53,32,21,57
"2011","Harlow 009A","E01021829",1115,65,22,43,217,173,117,81,173,177,56,28,28,56
"2011","Harlow 009B","E01021830",882,78,20,58,210,150,103,58,107,86,40,24,16,50
"2011","Harlow 009C","E01021832",967,66,14,52,230,187,84,70,132,117,26,13,13,55
"2011","Harlow 009D","E01021833",899,66,23,43,179,157,85,55,149,112,49,34,15,47
"2011","Harlow 009E","E01021865",1012,48,16,32,183,162,88,112,188,143,41,18,23,47
"2011","Harlow 010A","E01021838",1083,67,16,51,192,180,107,96,190,128,42,19,23,81
"2011","Harlow 010B","E01021858",1108,69,23,46,217,144,90,117,190,168,58,26,32,55
"2011","Harlow 010C","E01021859",1053,55,18,37,182,125,67,99,214,179,61,35,26,71
"2011","Harlow 010D","E01021860",1091,58,13,45,187,144,86,80,211,179,78,42,36,68
"2011","Harlow 010E","E01021861",906,48,17,31,154,117,68,93,159,124,62,37,25,81
"2011","Harlow 011A","E01021862",1059,43,14,29,161,138,80,98,180,190,83,48,35,86
"2011","Harlow 011B","E01021863",1175,50,7,43,197,169,107,114,193,186,76,39,37,83
"2011","Harlow 011C","E01021864",1062,53,15,38,187,119,70,71,197,181,100,55,45,84
"2011","Harlow 011D","E01021866",1013,93,22,71,204,155,105,85,159,116,48,25,23,48
"2011","Harlow 011E","E01021867",1108,97,31,66,242,218,123,79,166,103,29,21,8,51
"2011","Maldon 001A","E01021908",1515,151,44,107,359,192,236,112,198,154,28,16,12,85
"2011","Maldon 001B","E01021909",1011,110,31,79,245,141,176,66,113,88,28,21,7,44
"2011","Maldon 001C","E01021910",1098,135,31,104,230,154,174,75,146,92,32,13,19,60
"2011","Maldon 001D","E01021911",982,130,26,104,213,158,152,57,109,73,37,31,6,53
"2011","Maldon 002A","E01021882",1508,225,61,164,393,231,239,75,138,105,34,18,16,68
"2011","Maldon 002B","E01021883",1203,187,41,146,311,196,127,80,143,87,15,9,6,57
"2011","Maldon 002C","E01021912",1443,272,75,197,393,247,166,52,132,68,26,12,14,87
"2011","Maldon 002D","E01021913",1124,186,56,130,296,160,203,47,105,43,14,9,5,70
"2011","Maldon 003A","E01021884",1094,82,27,55,225,179,107,86,209,134,29,17,12,43
"2011","Maldon 003B","E01021885",862,121,34,87,223,140,114,45,88,59,21,14,7,51
"2011","Maldon 003C","E01021886",1137,141,37,104,221,195,130,89,161,113,24,11,13,63
"2011","Maldon 003D","E01021887",1566,191,41,150,427,240,174,84,236,106,27,13,14,81
"2011","Maldon 003E","E01021888",1341,69,20,49,231,144,144,139,287,213,64,39,25,50
"2011","Maldon 004A","E01021889",1541,117,42,75,282,169,182,123,293,207,76,52,24,92
"2011","Maldon 004B","E01021890",1258,153,39,114,319,132,159,74,188,134,43,22,21,56
"2011","Maldon 004C","E01021891",989,131,37,94,259,142,115,74,116,87,25,15,10,40
"2011","Maldon 004D","E01021892",705,54,12,42,111,80,85,60,145,96,34,22,12,40
"2011","Maldon 005A","E01021893",1111,139,46,93,299,190,122,75,134,64,30,18,12,58
"2011","Maldon 005B","E01021894",864,73,14,59,195,107,88,62,152,95,45,29,16,47
"2011","Maldon 005C","E01021895",912,60,15,45,182,147,86,83,170,111,23,14,9,50
"2011","Maldon 005D","E01021896",1004,139,34,105,271,160,84,65,140,61,14,9,5,70
"2011","Maldon 005E","E01021897",914,90,24,66,213,139,89,72,142,85,26,17,9,58
"2011","Maldon 005F","E01021898",898,89,25,64,229,124,91,78,141,96,15,11,4,35
"2011","Maldon 006A","E01021901",1383,119,36,83,305,192,260,99,189,124,38,20,18,57
"2011","Maldon 006B","E01021904",1080,108,35,73,203,145,151,89,177,119,45,32,13,43
"2011","Maldon 006C","E01021905",918,49,8,41,152,119,141,73,173,127,40,26,14,44
"2011","Maldon 006D","E01021906",1097,82,27,55,245,146,159,72,175,113,53,23,30,52
"2011","Maldon 006E","E01021907",1636,171,39,132,387,191,295,106,222,140,60,37,23,64
"2011","Maldon 007A","E01021873",1061,109,37,72,228,167,171,80,125,96,32,13,19,53
"2011","Maldon 007B","E01021874",1025,85,30,55,198,142,168,66,158,118,35,21,14,55
"2011","Maldon 007C","E01021875",1028,88,22,66,216,174,172,68,137,102,32,21,11,39
"2011","Maldon 007D","E01021899",1037,110,32,78,215,140,162,93,141,102,21,10,11,53
"2011","Maldon 007E","E01021900",799,94,31,63,147,126,123,68,103,71,16,6,10,51
"2011","Maldon 007F","E01021902",1373,194,48,146,364,208,220,69,116,80,33,26,7,89
"2011","Maldon 007G","E01021903",1209,143,41,102,286,180,198,80,165,84,30,18,12,43
"2011","Maldon 008C","E01021878",1003,91,25,66,208,152,103,105,156,127,29,17,12,32
"2011","Maldon 008D","E01021879",1010,103,24,79,244,141,143,65,127,101,39,14,25,47
"2011","Maldon 008E","E01021880",1068,145,33,112,228,136,180,62,127,108,42,26,16,40
"2011","Maldon 008F","E01021881",867,81,15,66,184,138,124,69,116,81,32,15,17,42
"2011","Maldon 008G","E01033057",1732,220,54,166,363,279,236,124,208,149,64,29,35,89
"2011","Rochford 001A","E01021942",1196,69,22,47,189,207,189,81,225,166,39,17,22,31
"2011","Rochford 001B","E01021943",1343,130,38,92,296,237,171,100,192,104,34,17,17,79
"2011","Rochford 001C","E01021944",1255,106,29,77,265,253,175,98,178,108,22,14,8,50
"2011","Rochford 001D","E01021945",1193,100,24,76,233,248,143,80,181,110,29,15,14,69
"2011","Rochford 002A","E01021914",1546,146,34,112,356,272,240,104,180,117,37,18,19,94
"2011","Rochford 002B","E01021927",1040,100,34,66,249,198,124,90,140,66,13,10,3,60
"2011","Rochford 002C","E01021928",1158,78,22,56,264,282,113,83,151,97,28,18,10,62
"2011","Rochford 002D","E01021929",1200,154,57,97,301,249,125,73,139,67,13,6,7,79
"2011","Rochford 002E","E01021931",940,64,26,38,209,175,107,79,143,94,30,18,12,39
"2011","Rochford 003A","E01021933",1001,110,33,77,243,203,134,52,113,67,19,8,11,60
"2011","Rochford 003B","E01021934",1024,117,32,85,222,200,131,81,132,73,20,9,11,48
"2011","Rochford 003C","E01021935",1011,118,26,92,229,231,140,51,99,59,27,15,12,57
"2011","Rochford 003D","E01021936",1161,161,33,128,288,225,117,55,128,80,29,14,15,78
"2011","Rochford 003E","E01021937",1192,148,36,112,300,271,115,65,131,79,24,13,11,59
"2011","Rochford 003F","E01021938",1048,100,25,75,259,251,105,67,123,85,18,10,8,40
"2011","Rochford 003G","E01021939",1229,117,28,89,302,248,139,88,150,90,21,9,12,74
"2011","Rochford 003H","E01021940",1541,199,51,148,359,330,175,102,145,112,39,27,12,80
"2011","Rochford 003I","E01021941",1557,239,64,175,389,320,188,68,167,73,27,15,12,86
"2011","Rochford 004A","E01021915",970,107,29,78,220,127,162,62,142,69,31,17,14,50
"2011","Rochford 004B","E01021916",740,62,9,53,185,122,107,36,105,69,20,14,6,34
"2011","Rochford 004C","E01021953",1014,36,11,25,126,121,104,95,211,153,75,39,36,93
"2011","Rochford 004D","E01021955",1276,101,23,78,279,209,168,76,193,121,71,40,31,58
"2011","Rochford 005A","E01021918",1109,144,37,107,341,224,104,63,105,52,14,5,9,62
"2011","Rochford 005B","E01021919",947,112,23,89,212,174,97,79,115,86,13,4,9,59
"2011","Rochford 005C","E01021925",1194,122,27,95,253,242,125,73,176,107,25,12,13,71
"2011","Rochford 005D","E01021960",1590,201,48,153,356,289,190,110,163,107,73,59,14,101
"2011","Rochford 005E","E01021961",1050,115,25,90,241,238,120,64,118,80,15,7,8,59
"2011","Rochford 006A","E01021920",1516,192,51,141,375,309,195,82,155,103,42,32,10,63
"2011","Rochford 006B","E01021926",1450,171,34,137,362,309,112,107,168,134,44,22,22,43
"2011","Rochford 006C","E01021957",1094,91,15,76,168,198,103,94,177,147,68,47,21,48
"2011","Rochford 006D","E01021958",940,107,20,87,250,211,84,56,113,64,20,12,8,35
"2011","Rochford 006E","E01021959",1200,133,28,105,304,221,123,87,127,100,36,17,19,69
"2011","Rochford 007A","E01021930",1039,76,19,57,224,204,110,102,145,99,34,18,16,45
"2011","Rochford 007B","E01021932",1079,86,22,64,215,204,125,96,166,103,32,12,20,52
"2011","Rochford 007C","E01021952",1017,112,26,86,248,192,114,59,132,87,25,16,9,48
"2011","Rochford 007D","E01021954",1101,97,21,76,259,152,143,75,154,108,42,27,15,71
"2011","Rochford 007E","E01021956",1069,57,21,36,172,185,139,83,210,127,42,24,18,54
"2011","Rochford 008A","E01021950",1073,93,19,74,241,219,99,76,159,88,36,17,19,62
"2011","Rochford 008B","E01021951",903,102,22,80,211,179,91,65,114,69,11,5,6,61
"2011","Rochford 008C","E01021962",859,81,18,63,176,176,100,68,124,73,26,13,13,35
"2011","Rochford 008D","E01021963",968,142,36,106,253,197,104,45,94,49,22,13,9,62
"2011","Rochford 008E","E01021964",1115,143,28,115,286,243,100,69,114,82,18,8,10,60
"2011","Rochford 008F","E01021966",1175,120,31,89,262,208,134,82,164,102,32,18,14,71
"2011","Rochford 009A","E01021946",1210,142,46,96,286,245,147,77,168,65,23,16,7,57
"2011","Rochford 009B","E01021947",862,96,26,70,208,188,100,64,96,54,16,9,7,40
"2011","Rochford 009C","E01021948",964,93,22,71,223,193,95,61,140,74,21,11,10,64
"2011","Rochford 009D","E01021949",1094,121,32,89,248,235,123,61,156,80,20,10,10,50
"2011","Rochford 009E","E01021965",1613,173,44,129,365,361,176,124,193,101,34,16,18,86
"2011","Rochford 010A","E01021917",1366,114,24,90,292,225,202,99,200,116,41,26,15,77
"2011","Rochford 010B","E01021921",1145,80,27,53,214,203,147,87,185,129,39,19,20,61
"2011","Rochford 010C","E01021922",1060,59,17,42,191,156,127,96,194,136,36,19,17,65
"2011","Rochford 010D","E01021923",1021,97,28,69,247,175,117,82,145,82,17,8,9,59
"2011","Rochford 010E","E01021924",967,93,33,60,234,171,123,76,113,73,19,10,9,65
"2011","Tendring 001A","E01021997",1004,36,3,33,121,108,105,89,210,177,101,41,60,57
"2011","Tendring 001B","E01021998",999,45,12,33,147,91,94,119,203,175,70,40,30,55
"2011","Tendring 001C","E01021999",1180,55,16,39,224,178,95,98,212,169,71,41,30,78
"2011","Tendring 001D","E01022001",1205,43,8,35,167,128,122,108,244,199,131,59,72,63
"2011","Tendring 002A","E01022000",1117,59,19,40,205,182,44,134,233,150,50,32,18,60
"2011","Tendring 002C","E01022006",1119,32,14,18,129,137,75,123,272,203,71,40,31,77
"2011","Tendring 002D","E01022007",1205,39,10,29,161,142,86,117,262,241,86,51,35,71
"2011","Tendring 002F","E01033051",1651,61,20,41,243,219,125,159,376,284,95,56,39,89
"2011","Tendring 003A","E01021978",1652,174,44,130,398,224,245,120,234,124,48,32,16,85
"2011","Tendring 003B","E01022013",1149,123,26,97,270,158,137,104,169,99,17,8,9,72
"2011","Tendring 003C","E01022014",993,70,16,54,198,110,102,78,201,141,38,28,10,55
"2011","Tendring 003D","E01022015",1053,105,26,79,291,165,76,78,171,73,27,15,12,67
"2011","Tendring 003E","E01022019",1131,123,37,86,261,141,183,55,111,65,131,114,17,61
"2011","Tendring 003F","E01022020",1262,196,37,159,342,173,158,74,139,93,33,16,17,54
"2011","Tendring 003G","E01022021",986,58,12,46,183,126,113,82,192,135,38,21,17,59
"2011","Tendring 004A","E01021991",748,72,22,50,188,106,92,62,121,52,14,9,5,41
"2011","Tendring 004B","E01021992",853,54,18,36,160,127,102,73,135,113,42,19,23,47
"2011","Tendring 004C","E01022002",1336,89,27,62,254,210,119,133,240,176,42,31,11,73
"2011","Tendring 004D","E01022004",1178,60,20,40,225,203,102,124,226,160,41,23,18,37
"2011","Tendring 004E","E01022005",1193,114,44,70,314,196,106,76,182,125,28,14,14,52
"2011","Tendring 004F","E01022028",969,68,24,44,197,144,136,66,163,82,70,49,21,43
"2011","Tendring 005A","E01021971",800,99,33,66,177,92,146,51,87,71,24,19,5,53
"2011","Tendring 005B","E01021972",946,118,31,87,220,116,156,60,107,84,32,20,12,53
"2011","Tendring 005C","E01022051",1054,108,31,77,227,152,175,69,119,81,61,48,13,62
"2011","Tendring 005D","E01022052",1037,99,16,83,195,174,122,79,157,114,29,21,8,68
"2011","Tendring 006A","E01021985",873,84,21,63,229,135,117,48,125,74,24,16,8,37
"2011","Tendring 006B","E01021986",935,117,33,84,244,125,135,46,117,57,46,29,17,48
"2011","Tendring 006C","E01022054",969,48,13,35,174,124,131,66,200,107,63,34,29,56
"2011","Tendring 006D","E01022055",821,26,2,24,144,118,109,58,174,115,45,31,14,32
"2011","Tendring 006E","E01022056",1151,56,17,39,189,119,181,95,219,140,90,51,39,62
"2011","Tendring 007A","E01021973",823,81,27,54,204,145,122,48,95,60,17,13,4,51
"2011","Tendring 007B","E01021974",889,74,14,60,204,96,165,62,112,78,41,32,9,57
"2011","Tendring 007C","E01022016",1243,65,17,48,209,173,166,94,238,196,48,35,13,54
"2011","Tendring 007D","E01022017",1051,68,13,55,177,149,194,79,156,116,48,43,5,64
"2011","Tendring 007E","E01022018",1006,68,25,43,176,134,120,81,183,156,48,37,11,40
"2011","Tendring 008A","E01021987",812,85,20,65,207,136,112,40,126,42,18,12,6,46
"2011","Tendring 008B","E01021994",748,39,7,32,134,124,83,62,157,95,31,21,10,23
"2011","Tendring 008C","E01021995",865,72,19,53,176,135,81,62,172,90,26,11,15,51
"2011","Tendring 008D","E01021996",824,62,19,43,173,135,87,67,134,70,44,21,23,52
"2011","Tendring 008E","E01022009",1020,73,19,54,222,160,148,59,165,108,36,30,6,49
"2011","Tendring 008F","E01022010",1056,71,24,47,217,151,164,70,172,104,42,22,20,65
"2011","Tendring 008G","E01022011",1264,92,24,68,264,162,194,73,225,143,48,30,18,63
"2011","Tendring 008H","E01022012",1153,57,15,42,186,185,136,88,247,163,49,30,19,42
"2011","Tendring 009A","E01021967",1474,132,36,96,301,229,185,128,223,144,51,32,19,81
"2011","Tendring 009B","E01021983",1007,79,23,56,223,170,156,90,129,93,22,13,9,45
"2011","Tendring 009C","E01021993",1599,167,53,114,336,247,221,133,222,152,32,22,10,89
"2011","Tendring 009D","E01022053",1316,123,30,93,307,188,200,86,181,129,46,34,12,56
"2011","Tendring 010A","E01021984",1453,63,21,42,207,185,191,123,343,247,60,40,20,34
"2011","Tendring 010B","E01022039",1035,26,8,18,160,134,107,110,210,137,76,38,38,75
"2011","Tendring 010C","E01022040",1227,43,16,27,196,159,136,112,289,188,49,34,15,55
"2011","Tendring 010D","E01022041",1025,38,10,28,165,139,108,93,264,143,34,22,12,41
"2011","Tendring 011A","E01021979",1049,70,18,52,179,129,124,88,213,128,29,19,10,89
"2011","Tendring 011B","E01021980",1246,83,28,55,268,174,170,118,203,129,36,22,14,65
"2011","Tendring 011C","E01021981",1199,107,27,80,269,149,148,100,199,131,35,23,12,61
"2011","Tendring 011D","E01021982",1321,119,37,82,265,137,184,102,225,156,58,26,32,75
"2011","Tendring 011E","E01022046",1150,67,20,47,192,143,226,96,171,148,47,29,18,60
"2011","Tendring 012A","E01022008",1362,71,21,50,229,198,165,112,295,185,54,35,19,53
"2011","Tendring 012B","E01022033",963,36,8,28,151,146,115,94,208,136,41,27,14,36
"2011","Tendring 012C","E01022034",1064,53,15,38,191,174,131,86,189,137,45,25,20,58
"2011","Tendring 012D","E01022035",1010,59,22,37,187,168,134,80,167,123,41,30,11,51
"2011","Tendring 013A","E01021975",1032,40,11,29,148,153,120,73,242,132,55,31,24,69
"2011","Tendring 013B","E01021976",1004,47,16,31,181,155,124,81,177,116,61,41,20,62
"2011","Tendring 013C","E01021977",1144,50,15,35,194,147,152,97,234,135,65,39,26,70
"2011","Tendring 013D","E01022022",1052,41,13,28,175,125,125,90,217,152,65,31,34,62
"2011","Tendring 013E","E01022044",1133,56,29,27,162,174,120,115,233,163,51,28,23,59
"2011","Tendring 014A","E01022042",1001,28,9,19,132,115,108,92,232,159,77,47,30,58
"2011","Tendring 014B","E01022043",1328,42,13,29,161,122,141,118,324,221,117,73,44,82
"2011","Tendring 014C","E01022048",1035,77,23,54,217,146,140,73,177,105,48,30,18,52
"2011","Tendring 014D","E01022049",1014,52,11,41,188,161,127,82,158,100,71,51,20,75
"2011","Tendring 014E","E01022050",1113,76,22,54,242,177,127,84,193,116,45,32,13,53
"2011","Tendring 015A","E01022023",1073,44,14,30,152,134,117,95,240,164,51,38,13,76
"2011","Tendring 015B","E01022024",1020,44,20,24,166,144,103,89,213,152,47,30,17,62
"2011","Tendring 015C","E01022030",1104,30,13,17,139,122,84,93,251,203,114,85,29,68
"2011","Tendring 015D","E01022031",920,18,3,15,92,73,71,81,239,162,123,73,50,61
"2011","Tendring 015E","E01022032",1184,26,10,16,151,144,121,109,258,201,93,57,36,81
"2011","Tendring 016A","E01021970",1131,34,11,23,147,109,98,96,257,236,115,75,40,39
"2011","Tendring 016B","E01022025",1122,33,13,20,131,91,108,78,196,198,241,169,72,46
"2011","Tendring 016C","E01022026",1125,38,8,30,120,96,126,95,235,171,160,111,49,84
"2011","Tendring 016D","E01022027",1158,62,18,44,193,119,136,94,216,152,120,74,46,66
"2011","Tendring 017A","E01021968",1245,36,10,26,181,142,130,91,277,205,99,68,31,84
"2011","Tendring 017B","E01021969",1008,28,8,20,150,118,118,83,242,152,58,35,23,59
"2011","Tendring 017C","E01022036",898,52,18,34,168,154,112,63,174,94,43,27,16,38
"2011","Tendring 017D","E01022037",920,53,15,38,161,142,138,66,169,91,40,30,10,60
"2011","Tendring 017E","E01022038",1016,38,9,29,151,138,120,81,219,150,53,28,25,66
"2011","Tendring 018A","E01021988",1370,24,6,18,133,81,152,118,331,260,233,147,86,38
"2011","Tendring 018B","E01021989",1040,18,12,6,148,122,133,129,244,165,47,29,18,34
"2011","Tendring 018C","E01021990",1136,29,12,17,138,108,173,101,247,203,105,60,45,32
"2011","Tendring 018D","E01022045",993,51,19,32,159,104,156,80,190,135,75,51,24,43
"2011","Tendring 018E","E01022047",908,60,19,41,165,113,170,56,147,118,35,22,13,44
"2011","Uttlesford 001A","E01022057",1247,224,58,166,363,121,193,52,132,61,17,10,7,84
"2011","Uttlesford 001B","E01022075",1226,256,54,202,393,156,115,61,102,28,12,9,3,103
"2011","Uttlesford 001C","E01022077",1156,188,45,143,275,176,118,84,144,86,23,7,16,62
"2011","Uttlesford 001D","E01022094",1197,273,58,215,326,150,128,53,101,69,26,13,13,71
"2011","Uttlesford 002A","E01022074",1062,102,26,76,226,125,108,86,166,123,47,28,19,79
"2011","Uttlesford 002B","E01022076",1100,211,52,159,312,130,120,56,126,60,36,17,19,49
"2011","Uttlesford 002C","E01022078",1098,111,25,86,234,121,135,73,133,171,54,32,22,66
"2011","Uttlesford 002D","E01022079",1209,167,39,128,284,151,108,112,170,110,40,29,11,67
"2011","Uttlesford 002E","E01022080",1249,126,20,106,254,146,96,133,200,174,39,21,18,81
"2011","Uttlesford 002F","E01022081",1548,234,53,181,378,212,168,80,197,148,45,25,20,86
"2011","Uttlesford 002G","E01022082",1345,169,44,125,264,179,137,110,213,138,27,14,13,108
"2011","Uttlesford 003A","E01022061",1042,199,57,142,271,128,171,51,92,55,17,9,8,58
"2011","Uttlesford 003B","E01022071",1224,247,54,193,345,137,165,53,101,60,20,10,10,96
"2011","Uttlesford 003C","E01022072",1329,227,62,165,384,162,215,55,96,77,22,12,10,91
"2011","Uttlesford 003D","E01022073",1158,145,45,100,272,163,142,75,150,101,23,12,11,87
"2011","Uttlesford 003E","E01022098",1128,235,58,177,293,130,184,38,83,67,22,14,8,76
"2011","Uttlesford 004A","E01022092",1281,198,61,137,362,152,235,62,126,62,21,16,5,63
"2011","Uttlesford 004B","E01022093",1193,120,30,90,247,171,168,74,179,129,36,22,14,69
"2011","Uttlesford 004C","E01022097",1344,218,54,164,382,159,211,51,120,79,21,10,11,103
"2011","Uttlesford 004D","E01022099",1765,274,105,169,496,294,197,123,150,107,27,12,15,97
"2011","Uttlesford 005A","E01022062",1534,231,47,184,436,237,213,72,121,91,35,18,17,98
"2011","Uttlesford 005B","E01022063",1184,125,32,93,277,179,151,107,153,90,17,7,10,85
"2011","Uttlesford 005C","E01022083",1243,203,53,150,334,177,157,66,123,82,32,24,8,69
"2011","Uttlesford 005D","E01022084",1176,191,40,151,320,168,137,63,138,59,14,8,6,86
"2011","Uttlesford 005E","E01022085",1221,203,40,163,316,185,161,69,137,71,24,17,7,55
"2011","Uttlesford 005F","E01022087",1351,208,43,165,346,206,145,109,123,117,29,17,12,68
"2011","Uttlesford 005G","E01022089",1148,202,52,150,349,134,157,45,105,57,29,10,19,70
"2011","Uttlesford 006A","E01022086",999,104,25,79,224,109,100,85,151,128,41,22,19,57
"2011","Uttlesford 006B","E01022090",1735,204,57,147,420,227,250,129,208,166,48,17,31,83
"2011","Uttlesford 006C","E01022091",1732,213,66,147,441,257,240,96,188,171,46,28,18,80
"2011","Uttlesford 006D","E01022095",1150,162,45,117,290,167,186,69,105,93,21,11,10,57
"2011","Uttlesford 007B","E01022067",1317,147,41,106,306,206,148,86,211,118,39,22,17,56
"2011","Uttlesford 007C","E01022068",1132,167,46,121,289,156,145,69,128,81,20,15,5,77
"2011","Uttlesford 007D","E01033054",759,58,15,43,186,112,82,56,126,80,29,11,18,30
"2011","Uttlesford 007E","E01033055",1019,148,40,108,303,172,104,47,105,55,18,10,8,67
"2011","Uttlesford 007F","E01033056",940,110,36,74,205,119,125,61,135,95,32,18,14,58
"2011","Uttlesford 008A","E01022058",1255,178,39,139,316,161,208,77,115,79,36,17,19,85
"2011","Uttlesford 008B","E01022064",1257,225,58,167,346,170,194,61,118,50,17,9,8,76
"2011","Uttlesford 008D","E01022069",1071,128,34,94,254,173,161,73,144,72,16,8,8,50
"2011","Uttlesford 008E","E01022088",1168,191,48,143,320,152,177,56,114,64,19,12,7,75
"2011","Uttlesford 008F","E01033052",1292,190,41,149,291,128,144,73,127,82,27,16,11,230
"2011","Uttlesford 008G","E01033053",1228,230,53,177,373,185,113,52,104,72,25,11,14,74
"2011","Uttlesford 009A","E01022059",1158,160,44,116,287,154,196,60,122,79,26,11,15,74
"2011","Uttlesford 009B","E01022060",1415,211,63,148,394,169,216,65,146,77,29,19,10,108
"2011","Uttlesford 009C","E01022070",1341,212,60,152,333,194,211,64,126,86,29,17,12,86
"2011","Uttlesford 009D","E01022096",1360,158,41,117,366,176,239,74,133,103,36,22,14,75
"2011","Broxbourne 001A","E01023316",1106,97,25,72,223,228,125,81,156,102,22,14,8,72
"2011","Broxbourne 001B","E01023317",1768,165,50,115,385,282,223,122,221,182,66,36,30,122
"2011","Broxbourne 001C","E01023318",1227,98,27,71,246,236,136,106,192,98,26,15,11,89
"2011","Broxbourne 001D","E01023319",1143,148,38,110,278,222,157,77,106,69,21,14,7,65
"2011","Broxbourne 002A","E01023327",988,78,16,62,167,157,139,79,139,134,47,29,18,48
"2011","Broxbourne 002B","E01023328",996,75,15,60,198,137,120,68,144,128,38,20,18,88
"2011","Broxbourne 002C","E01023329",924,69,15,54,172,145,113,84,153,127,20,12,8,41
"2011","Broxbourne 002D","E01023330",1069,61,15,46,184,155,131,76,167,173,66,42,24,56
"2011","Broxbourne 002E","E01023331",1106,89,25,64,176,163,126,88,179,166,47,27,20,72
"2011","Broxbourne 003A","E01023320",1392,119,33,86,315,213,168,107,199,179,37,24,13,55
"2011","Broxbourne 003B","E01023321",1421,199,74,125,363,253,183,81,152,84,32,24,8,74
"2011","Broxbourne 003C","E01023322",1300,98,23,75,268,193,144,115,202,154,46,20,26,80
"2011","Broxbourne 003D","E01023323",1172,64,18,46,197,148,143,102,201,175,71,49,22,71
"2011","Broxbourne 004A","E01023289",1094,189,56,133,300,194,131,42,89,45,19,9,10,85
"2011","Broxbourne 004B","E01023290",1157,164,46,118,288,226,136,64,103,66,28,14,14,82
"2011","Broxbourne 004C","E01023291",1128,198,50,148,322,198,143,45,79,51,22,13,9,70
"2011","Broxbourne 004D","E01023292",1120,139,33,106,260,223,137,57,113,87,26,14,12,78
"2011","Broxbourne 005A","E01023340",1287,93,31,62,242,218,145,110,207,133,58,34,24,81
"2011","Broxbourne 005B","E01023341",1352,115,41,74,290,232,177,100,180,124,37,23,14,97
"2011","Broxbourne 005C","E01023342",1903,184,35,149,384,274,228,144,249,207,137,84,53,96
"2011","Broxbourne 005D","E01023343",1278,73,19,54,178,167,160,109,220,193,91,42,49,87
"2011","Broxbourne 005E","E01023344",1296,98,36,62,240,237,167,107,197,122,39,20,19,89
"2011","Broxbourne 006A","E01023307",1149,119,28,91,265,180,187,80,125,75,28,23,5,90
"2011","Broxbourne 006B","E01023308",1285,124,32,92,300,259,177,71,144,90,18,9,9,102
"2011","Broxbourne 006C","E01023309",1318,129,32,97,286,288,141,79,155,101,30,19,11,109
"2011","Broxbourne 006D","E01023310",1474,98,27,71,249,196,161,122,234,198,110,67,43,106
"2011","Broxbourne 007A","E01023311",1246,123,25,98,293,216,200,64,120,100,47,28,19,83
"2011","Broxbourne 007B","E01023312",1293,171,42,129,282,198,198,68,120,90,45,23,22,121
"2011","Broxbourne 007C","E01023313",1157,133,35,98,290,219,180,59,96,64,22,14,8,94
"2011","Broxbourne 007D","E01023315",1340,184,39,145,371,200,197,65,107,59,45,20,25,112
"2011","Broxbourne 008A","E01023302",1054,60,15,45,159,192,110,70,184,139,61,35,26,79
"2011","Broxbourne 008B","E01023303",1161,84,31,53,211,195,136,91,171,121,63,40,23,89
"2011","Broxbourne 008C","E01023304",1102,80,18,62,208,182,116,86,180,119,52,30,22,79
"2011","Broxbourne 008D","E01023305",986,77,19,58,186,162,129,66,144,103,43,26,17,76
"2011","Broxbourne 008E","E01023306",1128,70,18,52,203,204,143,89,190,112,45,32,13,72
"2011","Broxbourne 009A","E01023314",1012,93,24,69,196,191,131,77,130,86,42,23,19,66
"2011","Broxbourne 009B","E01023324",1019,61,20,41,185,187,99,82,156,149,39,23,16,61
"2011","Broxbourne 009C","E01023325",1052,64,19,45,185,181,134,79,182,132,38,21,17,57
"2011","Broxbourne 009D","E01023326",1174,53,13,40,184,174,155,100,195,145,83,49,34,85
"2011","Broxbourne 010A","E01023297",987,78,28,50,211,185,137,62,135,89,31,19,12,59
"2011","Broxbourne 010B","E01023298",1064,84,24,60,206,223,120,66,169,97,38,20,18,61
"2011","Broxbourne 010C","E01023299",1211,119,35,84,266,201,135,96,161,112,45,30,15,76
"2011","Broxbourne 010D","E01023300",952,72,15,57,167,149,97,59,133,140,66,40,26,69
"2011","Broxbourne 010E","E01023301",1166,86,17,69,213,182,139,91,173,140,60,38,22,82
"2011","Broxbourne 011A","E01023293",1229,94,24,70,238,215,173,82,176,133,51,33,18,67
"2011","Broxbourne 011B","E01023294",1032,53,15,38,179,160,114,88,171,136,63,35,28,68
"2011","Broxbourne 011C","E01023295",1068,64,15,49,207,158,137,57,178,126,54,28,26,87
"2011","Broxbourne 011D","E01023296",1188,68,27,41,201,187,161,84,179,140,68,41,27,100
"2011","Broxbourne 012A","E01023332",1378,110,27,83,273,208,139,110,206,192,53,33,20,87
"2011","Broxbourne 012B","E01023333",1343,99,23,76,220,202,143,103,215,175,82,47,35,104
"2011","Broxbourne 012C","E01023334",1179,132,27,105,247,188,163,76,131,119,36,24,12,87
"2011","Broxbourne 012D","E01023335",1228,89,24,65,244,182,135,95,183,144,51,35,16,105
"2011","Broxbourne 013A","E01023336",1509,85,21,64,255,194,128,112,252,244,110,66,44,129
"2011","Broxbourne 013B","E01023337",1237,67,11,56,177,168,133,107,203,186,83,61,22,113
"2011","Broxbourne 013C","E01023338",1555,83,25,58,220,205,154,130,242,291,143,87,56,87
"2011","Broxbourne 013D","E01023339",1096,36,10,26,166,151,108,89,192,169,93,63,30,92
"2011","Dacorum 001A","E01023430",850,173,42,131,236,114,138,39,53,42,15,11,4,40
"2011","Dacorum 001B","E01023431",980,127,31,96,281,90,196,53,88,71,24,21,3,50
"2011","Dacorum 001C","E01023432",1039,143,24,119,312,131,130,72,102,73,25,17,8,51
"2011","Dacorum 001D","E01023433",1099,156,38,118,295,158,118,69,119,94,36,18,18,54
"2011","Dacorum 002A","E01023423",939,156,40,116,258,145,114,48,92,55,11,7,4,60
"2011","Dacorum 002B","E01023424",1027,178,67,111,279,130,137,54,81,84,21,11,10,63
"2011","Dacorum 002C","E01023425",970,173,46,127,285,132,96,32,97,66,20,15,5,69
"2011","Dacorum 002D","E01023426",1128,182,57,125,342,135,116,51,73,49,31,16,15,149
"2011","Dacorum 003A","E01023418",997,89,29,60,199,120,104,90,154,145,42,26,16,54
"2011","Dacorum 003B","E01023419",1561,235,61,174,419,228,138,98,171,139,37,21,16,96
"2011","Dacorum 003C","E01023420",1085,174,41,133,298,174,115,60,88,66,28,17,11,82
"2011","Dacorum 004A","E01023352",1777,323,78,245,510,225,246,84,152,103,27,13,14,107
"2011","Dacorum 004B","E01023421",1085,188,40,148,354,164,96,58,81,64,11,4,7,69
"2011","Dacorum 004C","E01023422",907,204,53,151,284,127,91,24,66,40,16,6,10,55
"2011","Dacorum 005A","E01023434",1192,128,25,103,285,215,101,78,141,137,42,22,20,65
"2011","Dacorum 005B","E01023435",1209,131,23,108,298,221,88,67,158,127,45,24,21,74
"2011","Dacorum 005C","E01023436",945,135,34,101,257,165,69,49,100,72,27,17,10,71
"2011","Dacorum 005D","E01023437",1137,73,14,59,212,182,101,99,159,154,89,52,37,68
"2011","Dacorum 006A","E01023355",1107,255,82,173,331,126,140,41,76,49,17,13,4,72
"2011","Dacorum 006B","E01023356",761,180,52,128,233,79,104,29,39,38,6,5,1,53
"2011","Dacorum 006C","E01023416",1015,178,56,122,311,146,119,51,97,52,14,3,11,47
"2011","Dacorum 006D","E01023417",888,155,38,117,267,116,85,48,103,62,16,5,11,36
"2011","Dacorum 007A","E01023393",1267,78,21,57,221,175,107,98,227,216,80,39,41,65
"2011","Dacorum 007B","E01023394",1040,76,25,51,228,160,92,82,163,120,52,33,19,67
"2011","Dacorum 007C","E01023395",1202,81,28,53,198,180,105,103,199,178,76,50,26,82
"2011","Dacorum 007D","E01023396",1207,77,19,58,204,201,121,95,227,144,50,30,20,88
"2011","Dacorum 007E","E01023397",979,44,11,33,170,133,79,95,172,163,56,28,28,67
"2011","Dacorum 008A","E01023401",1289,88,20,68,239,175,107,109,215,195,70,40,30,91
"2011","Dacorum 008B","E01023402",1166,74,18,56,205,148,110,96,216,164,69,43,26,84
"2011","Dacorum 008C","E01023403",1008,71,15,56,219,159,73,66,161,137,59,33,26,63
"2011","Dacorum 008D","E01023404",918,39,11,28,145,109,80,85,169,144,87,52,35,60
"2011","Dacorum 008E","E01023405",1023,50,12,38,156,139,95,84,203,140,71,42,29,85
"2011","Dacorum 009A","E01023361",1319,293,55,238,499,130,134,54,92,39,14,6,8,64
"2011","Dacorum 009B","E01023362",1167,347,97,250,414,116,116,18,44,30,10,5,5,72
"2011","Dacorum 009C","E01023363",1126,236,49,187,361,197,82,40,96,41,12,6,6,61
"2011","Dacorum 009D","E01023364",925,211,55,156,313,135,75,31,60,34,15,6,9,51
"2011","Dacorum 010A","E01023390",1450,108,24,84,291,241,131,121,231,178,56,34,22,93
"2011","Dacorum 010B","E01023391",1201,135,31,104,309,215,106,68,150,102,29,17,12,87
"2011","Dacorum 010C","E01023399",1206,154,29,125,343,174,120,75,147,98,51,37,14,44
"2011","Dacorum 011A","E01023392",1114,98,25,73,210,168,109,83,183,138,42,22,20,83
"2011","Dacorum 011B","E01023427",1171,92,20,72,220,184,88,84,204,153,48,28,20,98
"2011","Dacorum 011C","E01023428",1150,168,43,125,321,196,136,74,91,74,20,7,13,70
"2011","Dacorum 011D","E01023429",1212,91,20,71,248,181,93,87,222,160,43,18,25,87
"2011","Dacorum 012A","E01023369",960,61,12,49,204,134,110,73,152,125,44,20,24,57
"2011","Dacorum 012B","E01023370",1183,234,43,191,390,149,132,52,82,53,31,23,8,60
"2011","Dacorum 012C","E01023371",1051,223,62,161,305,123,104,34,96,70,26,18,8,70
"2011","Dacorum 012D","E01023372",975,304,72,232,329,96,79,23,41,19,14,9,5,70
"2011","Dacorum 013A","E01023345",1154,117,28,89,277,202,112,86,145,104,43,26,17,68
"2011","Dacorum 013B","E01023346",891,84,14,70,183,155,89,65,124,104,47,27,20,40
"2011","Dacorum 013C","E01023347",901,95,21,74,210,158,96,52,117,80,39,29,10,54
"2011","Dacorum 013D","E01023348",1051,53,10,43,177,139,105,84,189,159,79,50,29,66
"2011","Dacorum 014A","E01023365",965,173,34,139,300,117,77,65,95,69,29,17,12,40
"2011","Dacorum 014B","E01023366",1115,134,37,97,269,117,119,67,155,143,39,17,22,72
"2011","Dacorum 014C","E01023367",741,204,53,151,249,86,64,26,39,15,11,8,3,47
"2011","Dacorum 014D","E01023368",1196,315,60,255,423,118,125,34,51,26,16,8,8,88
"2011","Dacorum 015A","E01023349",1355,100,27,73,274,194,124,109,210,175,65,41,24,104
"2011","Dacorum 015B","E01023350",1117,76,27,49,196,160,91,87,207,150,58,36,22,92
"2011","Dacorum 015C","E01023351",1136,127,36,91,248,194,114,74,153,117,48,31,17,61
"2011","Dacorum 015D","E01023398",1865,291,50,241,493,343,141,111,201,107,68,40,28,110
"2011","Dacorum 015E","E01023400",1269,157,26,131,340,184,129,77,141,107,72,45,27,62
"2011","Dacorum 016A","E01023383",1069,119,24,95,268,171,113,68,141,84,41,25,16,64
"2011","Dacorum 016B","E01023384",1355,108,28,80,287,211,128,124,204,151,57,32,25,85
"2011","Dacorum 016C","E01023385",1216,136,31,105,280,193,116,79,167,110,32,23,9,103
"2011","Dacorum 017A","E01023409",1054,116,25,91,243,173,93,68,164,87,57,34,23,53
"2011","Dacorum 017B","E01023410",984,145,44,101,274,198,98,48,92,43,17,10,7,69
"2011","Dacorum 017C","E01023411",1022,117,25,92,203,149,98,79,154,93,54,36,18,75
"2011","Dacorum 017D","E01023412",931,162,41,121,254,167,104,44,76,31,12,7,5,81
"2011","Dacorum 017E","E01023413",987,81,16,65,204,165,91,67,156,129,44,24,20,50
"2011","Dacorum 018B","E01023354",1255,183,36,147,397,214,125,72,104,60,16,7,9,84
"2011","Dacorum 018C","E01023379",1179,222,50,172,376,169,116,54,98,57,22,14,8,65
"2011","Dacorum 018D","E01023380",862,151,33,118,240,152,106,46,61,47,15,8,7,44
"2011","Dacorum 018E","E01023381",965,173,40,133,339,163,89,34,70,21,9,3,6,67
"2011","Dacorum 018F","E01023382",1049,161,46,115,287,170,107,54,110,72,31,22,9,57
"2011","Dacorum 018G","E01033022",1097,240,49,191,369,140,82,51,89,59,24,10,14,43
"2011","Dacorum 018H","E01033023",1192,144,28,116,354,159,143,75,127,88,61,42,19,41
"2011","Dacorum 019A","E01023386",1122,86,23,63,201,170,107,88,183,148,50,35,15,89
"2011","Dacorum 019B","E01023387",952,90,15,75,179,120,73,59,170,135,55,36,19,71
"2011","Dacorum 019C","E01023388",1174,118,28,90,250,194,105,85,167,114,59,36,23,82
"2011","Dacorum 019D","E01023389",1244,150,40,110,310,186,134,78,157,102,33,19,14,94
"2011","Dacorum 020A","E01023357",1131,51,9,42,193,136,110,125,200,154,76,56,20,86
"2011","Dacorum 020B","E01023358",1007,54,11,43,162,140,107,60,163,148,68,46,22,105
"2011","Dacorum 020C","E01023359",1245,85,20,65,222,170,122,105,193,159,60,46,14,129
"2011","Dacorum 020D","E01023360",1050,96,18,78,238,163,126,71,142,91,42,28,14,81
"2011","Dacorum 020E","E01023414",1064,140,31,109,235,158,93,71,134,109,53,30,23,71
"2011","Dacorum 020F","E01023415",977,136,36,100,245,138,125,67,108,59,24,16,8,75
"2011","Dacorum 021A","E01023373",1572,135,32,103,261,144,215,118,181,265,167,144,23,86
"2011","Dacorum 021B","E01023374",1028,150,47,103,317,149,161,42,77,53,13,7,6,66
"2011","Dacorum 021C","E01023375",1089,168,51,117,304,129,178,63,90,61,28,22,6,68
"2011","Dacorum 021D","E01023376",941,96,20,76,253,156,113,63,111,81,19,9,10,49
"2011","Dacorum 021E","E01023377",852,173,46,127,263,119,136,25,51,38,10,9,1,37
"2011","Dacorum 021F","E01023378",1242,257,82,175,384,176,149,49,67,36,39,34,5,85
"2011","Dacorum 022A","E01023406",1363,191,43,148,322,187,185,83,184,97,29,16,13,85
"2011","Dacorum 022B","E01023407",1224,183,40,143,343,159,165,67,109,90,28,13,15,80
"2011","Dacorum 022C","E01023408",1153,205,56,149,378,176,146,28,75,42,25,21,4,78
"2011","East Hertfordshire 001A","E01023462",979,162,48,114,230,109,181,48,101,79,18,7,11,51
"2011","East Hertfordshire 001B","E01023464",1581,223,73,150,395,291,188,91,167,99,27,17,10,100
"2011","East Hertfordshire 001C","E01023465",1068,129,38,91,257,146,155,61,117,95,28,11,17,80
"2011","East Hertfordshire 001D","E01023466",1212,123,35,88,268,154,147,92,161,168,28,20,8,71
"2011","East Hertfordshire 002A","E01023467",1760,311,88,223,500,238,221,76,153,113,48,29,19,100
"2011","East Hertfordshire 002B","E01023494",878,110,25,85,229,113,132,50,82,75,20,12,8,67
"2011","East Hertfordshire 002C","E01023495",936,138,43,95,217,120,150,53,99,75,34,25,9,50
"2011","East Hertfordshire 002D","E01023508",1095,187,43,144,269,152,170,54,89,62,30,16,14,82
"2011","East Hertfordshire 002E","E01023509",976,157,45,112,254,133,120,67,83,65,25,12,13,72
"2011","East Hertfordshire 003A","E01023452",992,188,49,139,284,149,65,40,118,39,16,4,12,93
"2011","East Hertfordshire 003B","E01023453",1027,191,60,131,327,140,88,32,64,47,19,10,9,119
"2011","East Hertfordshire 003C","E01023454",967,193,58,135,267,171,97,49,74,38,7,5,2,71
"2011","East Hertfordshire 003D","E01023455",939,154,28,126,273,142,92,52,86,43,21,12,9,76
"2011","East Hertfordshire 003E","E01023463",868,141,32,109,222,119,131,50,82,60,15,8,7,48
"2011","East Hertfordshire 003F","E01023493",1777,326,100,226,460,203,320,81,147,100,30,16,14,110
"2011","East Hertfordshire 004A","E01023449",1142,224,50,174,354,177,111,44,88,52,18,9,9,74
"2011","East Hertfordshire 004B","E01023450",1487,221,47,174,407,242,112,104,182,92,43,27,16,84
"2011","East Hertfordshire 004C","E01023451",1527,272,50,222,431,232,141,74,164,95,26,14,12,92
"2011","East Hertfordshire 005A","E01023438",1048,138,25,113,250,148,80,70,175,94,24,15,9,69
"2011","East Hertfordshire 005B","E01023439",988,107,21,86,183,138,75,101,161,120,35,27,8,68
"2011","East Hertfordshire 005C","E01023440",1181,190,44,146,317,217,90,57,122,75,18,7,11,95
"2011","East Hertfordshire 005D","E01023441",1020,181,32,149,258,115,69,46,96,53,26,18,8,176
"2011","East Hertfordshire 005E","E01023442",1527,289,72,217,414,213,116,86,164,123,37,31,6,85
"2011","East Hertfordshire 006A","E01023498",1924,242,56,186,462,281,288,136,199,182,35,21,14,99
"2011","East Hertfordshire 006B","E01023506",1019,153,36,117,261,118,147,72,89,102,28,17,11,49
"2011","East Hertfordshire 006C","E01023507",1218,185,52,133,299,168,172,66,96,92,20,13,7,120
"2011","East Hertfordshire 007A","E01023443",1122,141,30,111,284,183,82,98,136,87,28,20,8,83
"2011","East Hertfordshire 007B","E01023444",1194,227,45,182,314,182,110,86,126,78,25,19,6,46
"2011","East Hertfordshire 007C","E01023445",1217,108,22,86,237,170,104,106,194,168,43,19,24,87
"2011","East Hertfordshire 007D","E01023446",1700,277,42,235,482,245,144,113,196,107,64,37,27,72
"2011","East Hertfordshire 007E","E01023447",859,50,12,38,113,90,86,74,165,162,53,36,17,66
"2011","East Hertfordshire 007F","E01023448",1110,187,47,140,277,170,97,52,148,73,30,16,14,76
"2011","East Hertfordshire 008A","E01023456",1056,171,30,141,276,182,89,55,118,55,18,9,9,92
"2011","East Hertfordshire 008B","E01023457",1128,144,45,99,276,211,96,82,143,89,18,12,6,69
"2011","East Hertfordshire 008C","E01023458",994,138,21,117,259,152,97,61,121,65,27,14,13,74
"2011","East Hertfordshire 008D","E01023459",1038,150,38,112,286,187,92,57,114,58,19,13,6,75
"2011","East Hertfordshire 008E","E01023460",1059,179,44,135,296,162,118,47,102,63,13,5,8,79
"2011","East Hertfordshire 008F","E01023461",1086,257,59,198,315,165,97,31,72,25,20,14,6,104
"2011","East Hertfordshire 009A","E01023491",931,130,26,104,226,112,158,61,104,66,20,14,6,54
"2011","East Hertfordshire 009B","E01023492",1104,149,48,101,274,136,171,61,109,104,29,20,9,71
"2011","East Hertfordshire 009C","E01023496",946,127,37,90,219,99,130,44,77,53,113,104,9,84
"2011","East Hertfordshire 009D","E01023497",1081,189,57,132,296,139,163,55,79,61,27,18,9,72
"2011","East Hertfordshire 010A","E01023485",1672,273,94,179,477,230,245,81,126,117,37,20,17,86
"2011","East Hertfordshire 010B","E01023486",1862,313,96,217,538,244,275,86,140,100,44,21,23,122
"2011","East Hertfordshire 010E","E01033609",1704,266,66,200,425,270,197,109,179,122,42,17,25,94
"2011","East Hertfordshire 011A","E01023499",1248,100,22,78,269,151,144,98,204,148,42,23,19,92
"2011","East Hertfordshire 011B","E01023500",1268,234,58,176,323,203,147,54,115,59,62,55,7,71
"2011","East Hertfordshire 011C","E01023501",1120,177,43,134,286,201,116,67,113,81,24,15,9,55
"2011","East Hertfordshire 011D","E01023502",1283,191,46,145,388,231,145,67,111,77,18,14,4,55
"2011","East Hertfordshire 011E","E01023503",1286,197,41,156,374,234,125,75,120,65,26,10,16,70
"2011","East Hertfordshire 012A","E01023512",1425,243,64,179,395,207,148,88,142,85,31,13,18,86
"2011","East Hertfordshire 012B","E01023513",1040,101,26,75,213,150,110,87,144,135,32,17,15,68
"2011","East Hertfordshire 012C","E01023514",1285,200,50,150,363,180,104,101,130,101,49,33,16,57
"2011","East Hertfordshire 012D","E01023518",1376,118,29,89,255,170,140,125,221,205,60,41,19,82
"2011","East Hertfordshire 012E","E01023519",1228,142,30,112,268,163,109,84,175,158,42,21,21,87
"2011","East Hertfordshire 012F","E01023520",1144,152,38,114,304,188,102,73,119,99,31,15,16,76
"2011","East Hertfordshire 013A","E01023510",1069,188,35,153,340,143,100,55,90,52,18,8,10,83
"2011","East Hertfordshire 013B","E01023511",1185,193,37,156,314,180,106,83,130,96,39,26,13,44
"2011","East Hertfordshire 013C","E01023515",1222,167,32,135,347,207,119,91,130,82,19,11,8,60
"2011","East Hertfordshire 013D","E01023516",1599,227,55,172,419,282,146,116,175,119,26,15,11,89
"2011","East Hertfordshire 013E","E01023517",1173,156,45,111,260,165,123,84,144,134,31,17,14,76
"2011","East Hertfordshire 014A","E01023470",1336,286,68,218,469,180,137,56,85,65,19,12,7,39
"2011","East Hertfordshire 014B","E01023471",955,223,57,166,318,120,91,37,59,38,17,14,3,52
"2011","East Hertfordshire 014C","E01023472",935,90,23,67,213,120,106,66,144,117,27,10,17,52
"2011","East Hertfordshire 014D","E01023473",1004,183,41,142,291,170,91,55,80,49,17,7,10,68
"2011","East Hertfordshire 014E","E01023474",1117,258,64,194,425,122,108,42,61,28,18,6,12,55
"2011","East Hertfordshire 015A","E01023487",940,55,14,41,155,117,79,95,158,156,53,27,26,72
"2011","East Hertfordshire 015B","E01023488",1074,93,23,70,214,122,129,75,152,143,79,45,34,67
"2011","East Hertfordshire 015C","E01023489",968,176,32,144,285,144,97,42,104,57,21,9,12,42
"2011","East Hertfordshire 015D","E01023490",909,176,47,129,260,132,70,39,86,66,24,12,12,56
"2011","East Hertfordshire 016A","E01023482",1374,316,75,241,405,232,109,63,78,56,20,9,11,95
"2011","East Hertfordshire 016B","E01023483",1410,238,69,169,410,197,129,94,133,86,23,11,12,100
"2011","East Hertfordshire 016C","E01023484",1109,123,33,90,253,164,122,85,125,131,38,20,18,68
"2011","East Hertfordshire 017A","E01023475",1063,122,26,96,250,141,87,74,130,150,35,24,11,74
"2011","East Hertfordshire 017B","E01023476",1036,250,67,183,303,169,85,38,78,31,17,8,9,65
"2011","East Hertfordshire 017C","E01023477",1611,381,92,289,522,187,126,72,99,71,43,24,19,110
"2011","East Hertfordshire 017D","E01023478",1335,295,67,228,462,157,111,89,85,71,22,16,6,43
"2011","East Hertfordshire 017E","E01023479",1218,217,43,174,378,175,121,54,94,80,26,15,11,73
"2011","East Hertfordshire 018A","E01023468",1039,203,54,149,290,158,136,41,79,40,11,6,5,81
"2011","East Hertfordshire 018B","E01023469",1098,97,29,68,226,171,143,71,155,136,32,26,6,67
"2011","East Hertfordshire 018C","E01023480",1152,145,39,106,255,161,160,82,133,129,24,17,7,63
"2011","East Hertfordshire 018D","E01023481",1192,149,24,125,313,113,147,50,60,47,18,11,7,295
"2011","East Hertfordshire 018E","E01023504",980,108,22,86,222,137,146,60,112,89,39,24,15,67
"2011","East Hertfordshire 018F","E01023505",1288,197,49,148,386,218,135,78,97,76,23,9,14,78
"2011","Hertsmere 001A","E01023576",1019,143,32,111,250,181,129,43,95,49,29,25,4,100
"2011","Hertsmere 001B","E01023577",1223,163,33,130,286,217,153,49,132,46,27,15,12,150
"2011","Hertsmere 001C","E01023578",1140,214,43,171,333,176,145,23,72,42,26,19,7,109
"2011","Hertsmere 001D","E01023579",1019,112,21,91,197,144,96,48,109,55,41,28,13,217
"2011","Hertsmere 001E","E01023580",1167,205,44,161,308,168,128,37,97,47,37,20,17,140
"2011","Hertsmere 002A","E01023567",1486,182,42,140,408,256,168,72,131,79,34,22,12,156
"2011","Hertsmere 002B","E01023568",1065,162,33,129,274,204,110,45,112,57,21,14,7,80
"2011","Hertsmere 002C","E01023569",1133,119,32,87,254,178,136,76,124,93,49,30,19,104
"2011","Hertsmere 002D","E01023570",1090,95,12,83,182,164,110,69,153,106,43,27,16,168
"2011","Hertsmere 003A","E01023571",1005,128,27,101,250,174,130,43,93,44,52,39,13,91
"2011","Hertsmere 003B","E01023572",1091,126,31,95,247,207,140,51,120,70,31,17,14,99
"2011","Hertsmere 003C","E01023573",903,47,10,37,158,124,89,54,139,107,45,31,14,140
"2011","Hertsmere 003D","E01023574",1140,74,17,57,205,164,137,80,159,138,65,38,27,118
"2011","Hertsmere 003E","E01023575",1222,117,23,94,234,218,139,69,134,102,82,68,14,127
"2011","Hertsmere 004A","E01023581",943,214,46,168,311,137,119,26,60,20,8,4,4,48
"2011","Hertsmere 004B","E01023582",1170,165,41,124,326,164,143,48,142,66,46,29,17,70
"2011","Hertsmere 004C","E01023583",994,123,28,95,246,135,121,62,115,82,39,21,18,71
"2011","Hertsmere 004D","E01023584",762,77,27,50,175,90,126,43,94,72,24,15,9,61
"2011","Hertsmere 005A","E01023523",1209,328,61,267,355,158,137,19,43,24,20,15,5,125
"2011","Hertsmere 005B","E01023524",1011,251,46,205,306,109,127,12,44,26,25,16,9,111
"2011","Hertsmere 005C","E01023525",1204,267,56,211,363,153,159,37,83,43,29,17,12,70
"2011","Hertsmere 005D","E01023526",1256,333,84,249,355,155,173,18,64,24,19,10,9,115
"2011","Hertsmere 005E","E01023527",998,149,42,107,231,122,128,57,121,80,54,27,27,56
"2011","Hertsmere 006A","E01023534",1227,85,21,64,250,179,118,119,172,133,72,46,26,99
"2011","Hertsmere 006B","E01023535",1185,105,30,75,241,174,130,92,163,127,69,43,26,84
"2011","Hertsmere 006C","E01023536",1124,51,11,40,178,149,118,87,194,160,102,64,38,85
"2011","Hertsmere 006D","E01023537",1297,82,17,65,238,193,148,103,213,148,66,42,24,106
"2011","Hertsmere 006E","E01023538",1163,76,17,59,215,160,113,102,186,159,65,44,21,87
"2011","Hertsmere 007A","E01023529",1085,87,17,70,203,174,133,82,154,103,52,38,14,97
"2011","Hertsmere 007B","E01023530",873,60,19,41,153,104,75,90,164,107,65,41,24,55
"2011","Hertsmere 007C","E01023531",1379,181,34,147,342,209,143,79,160,114,59,36,23,92
"2011","Hertsmere 007D","E01023532",1184,183,45,138,307,192,138,52,111,71,54,31,23,76
"2011","Hertsmere 007E","E01023533",1101,89,16,73,205,142,119,100,162,128,60,37,23,96
"2011","Hertsmere 008A","E01023552",1224,131,32,99,288,205,134,77,147,95,43,25,18,104
"2011","Hertsmere 008B","E01023553",1251,233,54,179,350,140,114,46,83,45,57,47,10,183
"2011","Hertsmere 008C","E01023554",1269,126,18,108,311,180,149,94,171,84,57,43,14,97
"2011","Hertsmere 008D","E01023555",1223,99,25,74,218,179,179,76,153,142,85,69,16,92
"2011","Hertsmere 009A","E01023544",874,88,25,63,207,156,119,53,97,67,44,31,13,43
"2011","Hertsmere 009B","E01023545",976,101,23,78,258,159,115,74,110,78,27,13,14,54
"2011","Hertsmere 009C","E01023546",1297,107,18,89,267,219,156,90,177,138,64,32,32,79
"2011","Hertsmere 009D","E01023547",1237,82,18,64,179,205,138,85,204,156,83,41,42,105
"2011","Hertsmere 010A","E01023528",1245,213,60,153,371,152,146,60,93,48,33,22,11,129
"2011","Hertsmere 010B","E01023564",1215,149,40,109,262,158,160,74,144,111,59,47,12,98
"2011","Hertsmere 010C","E01023565",1206,248,42,206,333,144,171,30,99,33,26,12,14,122
"2011","Hertsmere 010D","E01023566",1142,294,54,240,288,157,149,18,75,25,29,21,8,107
"2011","Hertsmere 011A","E01023539",2184,333,51,282,554,306,246,100,210,161,95,68,27,179
"2011","Hertsmere 011B","E01023540",1175,145,27,118,261,161,147,62,145,96,63,48,15,95
"2011","Hertsmere 011C","E01023541",1376,159,41,118,349,213,148,99,144,117,38,19,19,109
"2011","Hertsmere 011D","E01023542",1302,110,29,81,252,199,160,99,155,123,73,42,31,131
"2011","Hertsmere 011E","E01023543",1055,54,13,41,207,164,109,64,195,123,62,29,33,77
"2011","Hertsmere 012A","E01023558",1210,171,47,124,368,197,150,53,93,59,22,11,11,97
"2011","Hertsmere 012B","E01023559",1129,193,43,150,323,163,158,37,83,36,41,33,8,95
"2011","Hertsmere 012C","E01023560",1007,97,13,84,224,166,78,67,140,115,57,39,18,63
"2011","Hertsmere 012D","E01023561",1142,132,34,98,282,165,116,79,151,98,45,24,21,74
"2011","Hertsmere 012E","E01023562",1075,144,31,113,278,180,111,63,119,63,27,21,6,90
"2011","Hertsmere 012F","E01023563",1055,146,35,111,367,143,118,41,74,39,37,25,12,90
"2011","Hertsmere 013A","E01023548",1244,187,52,135,328,206,178,48,104,60,52,44,8,81
"2011","Hertsmere 013B","E01023549",1108,164,41,123,285,193,170,42,105,44,26,13,13,79
"2011","Hertsmere 013C","E01023550",1182,296,157,139,305,158,155,38,74,36,31,19,12,89
"2011","Hertsmere 013D","E01023551",1061,182,40,142,292,197,164,29,64,29,32,18,14,72
"2011","Hertsmere 013E","E01023556",1117,130,35,95,290,170,155,60,119,78,39,21,18,76
"2011","Hertsmere 013F","E01023557",1062,150,38,112,310,155,142,46,99,47,36,23,13,77
"2011","North Hertfordshire 001A","E01023660",1590,258,37,221,399,211,160,112,220,133,34,25,9,63
"2011","North Hertfordshire 001B","E01023661",979,59,16,43,152,123,85,100,197,147,39,27,12,77
"2011","North Hertfordshire 001C","E01023662",1170,113,29,84,245,192,89,111,201,130,31,18,13,58
"2011","North Hertfordshire 002A","E01023654",1213,216,43,173,333,204,88,83,150,81,18,10,8,40
"2011","North Hertfordshire 002B","E01023655",1105,217,66,151,288,180,101,63,111,62,18,10,8,65
"2011","North Hertfordshire 002C","E01023656",1647,255,49,206,380,231,126,139,216,167,27,14,13,106
"2011","North Hertfordshire 002D","E01023657",1811,327,75,252,457,294,178,106,210,128,24,13,11,87
"2011","North Hertfordshire 002E","E01023658",1127,102,24,78,190,178,110,110,196,150,31,16,15,60
"2011","North Hertfordshire 002F","E01023659",1032,198,54,144,243,181,92,59,117,60,15,10,5,67
"2011","North Hertfordshire 003A","E01023635",978,65,8,57,197,132,82,106,181,132,32,13,19,51
"2011","North Hertfordshire 003B","E01023636",1244,145,35,110,269,201,97,102,166,146,41,24,17,77
"2011","North Hertfordshire 003C","E01023637",1141,61,14,47,187,175,98,114,217,188,63,32,31,38
"2011","North Hertfordshire 003D","E01023638",1116,118,27,91,200,146,85,99,194,132,76,60,16,66
"2011","North Hertfordshire 004A","E01023587",857,142,22,120,234,130,68,45,99,67,9,4,5,63
"2011","North Hertfordshire 004B","E01023588",984,164,40,124,281,164,83,49,100,51,17,13,4,75
"2011","North Hertfordshire 004C","E01023589",1178,180,42,138,295,150,129,70,117,101,61,42,19,75
"2011","North Hertfordshire 004D","E01023590",1230,178,41,137,343,162,117,68,151,104,39,15,24,68
"2011","North Hertfordshire 004E","E01023591",1056,154,33,121,292,147,96,61,139,63,20,6,14,84
"2011","North Hertfordshire 004F","E01023592",974,82,26,56,158,118,100,76,194,115,52,21,31,79
"2011","North Hertfordshire 004G","E01023593",969,112,29,83,211,134,94,74,161,90,31,10,21,62
"2011","North Hertfordshire 005A","E01023585",832,160,41,119,235,119,116,32,67,46,16,7,9,41
"2011","North Hertfordshire 005B","E01023586",1096,242,47,195,297,117,148,57,100,65,20,10,10,50
"2011","North Hertfordshire 005C","E01023597",880,172,40,132,259,90,148,39,79,40,11,5,6,42
"2011","North Hertfordshire 005D","E01023598",990,158,41,117,236,107,148,74,94,92,17,9,8,64
"2011","North Hertfordshire 005F","E01023600",975,132,30,102,243,130,123,70,107,88,31,19,12,51
"2011","North Hertfordshire 005G","E01023663",1541,288,82,206,440,179,248,58,112,78,21,11,10,117
"2011","North Hertfordshire 005H","E01033024",1140,240,57,183,331,179,118,49,78,62,14,7,7,69
"2011","North Hertfordshire 005I","E01033025",927,160,28,132,270,170,87,56,84,55,14,8,6,31
"2011","North Hertfordshire 005J","E01033026",1095,184,38,146,329,171,86,75,94,78,31,12,19,47
"2011","North Hertfordshire 005K","E01033027",1105,188,33,155,313,203,71,76,120,61,24,10,14,49
"2011","North Hertfordshire 006A","E01023630",1123,111,20,91,226,142,86,78,185,147,74,51,23,74
"2011","North Hertfordshire 006B","E01023631",1189,112,20,92,277,172,89,78,177,153,66,37,29,65
"2011","North Hertfordshire 006C","E01023632",1013,112,15,97,224,151,96,61,145,133,25,11,14,66
"2011","North Hertfordshire 006D","E01023633",979,116,22,94,241,108,92,74,131,123,40,17,23,54
"2011","North Hertfordshire 006E","E01023634",969,201,39,162,284,149,83,44,87,64,15,9,6,42
"2011","North Hertfordshire 007A","E01023649",967,168,32,136,266,156,56,63,125,75,19,8,11,39
"2011","North Hertfordshire 007B","E01023650",1054,67,19,48,166,136,88,89,195,156,83,43,40,74
"2011","North Hertfordshire 007C","E01023651",876,90,18,72,184,127,62,83,154,96,31,18,13,49
"2011","North Hertfordshire 007D","E01023652",979,86,25,61,184,145,59,81,165,140,49,29,20,70
"2011","North Hertfordshire 008A","E01023644",1154,242,63,179,332,124,128,52,82,65,21,13,8,108
"2011","North Hertfordshire 008B","E01023645",1096,190,42,148,246,144,86,57,133,103,43,20,23,94
"2011","North Hertfordshire 008C","E01023646",954,84,19,65,176,105,65,74,174,137,52,25,27,87
"2011","North Hertfordshire 008D","E01023647",1091,222,43,179,330,150,86,41,102,61,18,10,8,81
"2011","North Hertfordshire 008E","E01023648",889,197,55,142,262,122,90,26,55,23,17,14,3,97
"2011","North Hertfordshire 009A","E01023639",973,162,52,110,254,158,81,48,105,71,31,16,15,63
"2011","North Hertfordshire 009B","E01023640",863,47,9,38,152,96,73,68,191,126,47,31,16,63
"2011","North Hertfordshire 009C","E01023641",940,34,11,23,165,108,73,90,187,171,63,33,30,49
"2011","North Hertfordshire 009D","E01023642",984,202,42,160,309,134,60,41,86,59,23,15,8,70
"2011","North Hertfordshire 009E","E01023643",960,105,27,78,182,114,76,89,153,100,48,31,17,93
"2011","North Hertfordshire 010A","E01023601",1702,303,58,245,480,238,115,90,166,143,77,47,30,90
"2011","North Hertfordshire 010B","E01023602",1174,236,37,199,346,128,101,60,101,84,51,30,21,67
"2011","North Hertfordshire 010C","E01023603",1118,202,36,166,328,144,95,58,119,64,24,14,10,84
"2011","North Hertfordshire 010D","E01023604",995,163,33,130,254,132,97,55,110,71,30,16,14,83
"2011","North Hertfordshire 010E","E01023605",1152,166,30,136,312,154,68,76,143,104,50,31,19,79
"2011","North Hertfordshire 011A","E01023617",1044,178,44,134,271,181,83,44,107,68,25,15,10,87
"2011","North Hertfordshire 011B","E01023618",1087,141,23,118,235,134,100,80,148,123,43,21,22,83
"2011","North Hertfordshire 011C","E01023619",1312,230,34,196,382,168,112,73,159,86,35,19,16,67
"2011","North Hertfordshire 011D","E01023620",924,105,20,85,168,99,59,88,153,110,63,20,43,79
"2011","North Hertfordshire 011E","E01023621",1038,130,19,111,244,174,82,74,146,95,30,18,12,63
"2011","North Hertfordshire 012A","E01023611",1119,98,21,77,189,132,102,74,190,179,59,35,24,96
"2011","North Hertfordshire 012B","E01023612",1300,202,36,166,310,192,111,89,144,145,34,23,11,73
"2011","North Hertfordshire 012C","E01023613",1173,64,9,55,190,124,80,94,246,196,103,53,50,76
"2011","North Hertfordshire 012D","E01023614",1439,360,77,283,427,218,129,47,84,50,26,14,12,98
"2011","North Hertfordshire 012E","E01023615",1109,222,47,175,342,163,115,40,78,42,42,37,5,65
"2011","North Hertfordshire 012F","E01023616",1434,285,52,233,473,174,115,84,129,62,38,16,22,74
"2011","North Hertfordshire 013A","E01023606",1201,188,40,148,284,164,111,57,128,107,71,48,23,91
"2011","North Hertfordshire 013B","E01023607",1020,176,32,144,267,182,76,66,117,49,29,18,11,58
"2011","North Hertfordshire 013C","E01023608",1050,202,39,163,329,173,88,45,88,44,17,7,10,64
"2011","North Hertfordshire 013D","E01023609",1112,241,61,180,359,157,89,48,76,40,30,22,8,72
"2011","North Hertfordshire 013E","E01023610",967,244,53,191,278,137,75,42,65,29,14,8,6,83
"2011","North Hertfordshire 014A","E01023594",1610,231,49,182,405,217,191,98,178,132,59,25,34,99
"2011","North Hertfordshire 014B","E01023622",798,129,32,97,216,72,130,33,89,61,17,11,6,51
"2011","North Hertfordshire 014C","E01023623",1057,185,50,135,277,126,154,52,117,72,34,23,11,40
"2011","North Hertfordshire 014D","E01023624",955,130,39,91,242,106,140,77,103,84,31,19,12,42
"2011","North Hertfordshire 014E","E01023625",834,149,37,112,214,102,126,44,62,53,13,8,5,71
"2011","North Hertfordshire 014F","E01023653",1529,252,55,197,407,194,189,86,149,126,37,20,17,89
"2011","North Hertfordshire 015A","E01023595",1074,222,62,160,317,137,124,54,84,55,20,7,13,61
"2011","North Hertfordshire 015B","E01023596",774,102,25,77,195,117,89,49,90,62,20,9,11,50
"2011","North Hertfordshire 015C","E01023626",1582,323,72,251,446,190,218,74,116,96,30,21,9,89
"2011","North Hertfordshire 015D","E01023627",1244,230,62,168,341,155,176,65,101,66,26,20,6,84
"2011","North Hertfordshire 015E","E01023628",1248,275,52,223,373,147,125,60,115,63,16,12,4,74
"2011","North Hertfordshire 015F","E01023629",1300,205,38,167,340,183,137,79,144,101,36,22,14,75
"2011","St Albans 001A","E01023690",1028,335,56,279,311,106,84,31,50,27,10,5,5,74
"2011","St Albans 001B","E01023691",993,278,51,227,330,108,75,17,52,26,11,6,5,96
"2011","St Albans 001C","E01023692",975,203,38,165,292,94,65,44,96,61,34,19,15,86
"2011","St Albans 001D","E01023693",940,207,30,177,297,122,79,43,55,60,9,7,2,68
"2011","St Albans 001E","E01023694",1002,264,57,207,334,125,99,18,44,32,13,7,6,73
"2011","St Albans 002A","E01023685",1167,269,63,206,375,163,96,43,87,52,19,11,8,63
"2011","St Albans 002B","E01023686",1039,318,61,257,316,137,68,25,54,27,13,6,7,81
"2011","St Albans 002C","E01023687",1031,113,16,97,215,123,116,73,143,122,43,20,23,83
"2011","St Albans 002D","E01023688",1020,202,47,155,321,135,104,44,78,59,17,8,9,60
"2011","St Albans 002E","E01023689",921,271,56,215,263,101,59,18,49,23,12,5,7,125
"2011","St Albans 003A","E01023699",996,302,69,233,362,110,62,17,32,16,26,22,4,69
"2011","St Albans 003B","E01023700",887,292,65,227,271,92,73,12,33,13,33,25,8,68
"2011","St Albans 003C","E01023701",1218,314,71,243,377,113,121,46,81,60,19,7,12,87
"2011","St Albans 003D","E01023702",1094,356,73,283,386,114,79,30,35,26,16,6,10,52
"2011","St Albans 003E","E01023703",948,303,55,248,322,103,66,17,46,27,13,7,6,51
"2011","St Albans 004A","E01023746",1079,127,24,103,241,149,115,78,143,117,43,16,27,66
"2011","St Albans 004B","E01023747",1201,238,55,183,360,152,117,47,102,85,28,11,17,72
"2011","St Albans 004C","E01023748",981,239,63,176,312,128,104,29,54,29,15,10,5,71
"2011","St Albans 004D","E01023749",1177,250,59,191,344,144,146,50,83,47,20,14,6,93
"2011","St Albans 005A","E01023695",1097,278,66,212,337,155,78,31,84,45,11,11,0,78
"2011","St Albans 005B","E01023696",1157,351,98,253,352,150,119,18,39,20,11,8,3,97
"2011","St Albans 005C","E01023697",1291,293,55,238,401,145,138,42,111,57,27,11,16,77
"2011","St Albans 005D","E01023698",1184,275,63,212,339,197,104,42,80,47,9,5,4,91
"2011","St Albans 006A","E01023722",1007,199,49,150,318,113,142,49,63,49,13,9,4,61
"2011","St Albans 006B","E01023723",1217,116,37,79,253,174,154,84,154,147,52,36,16,83
"2011","St Albans 006C","E01023724",1069,230,46,184,348,139,120,42,80,47,19,11,8,44
"2011","St Albans 006D","E01023725",1075,237,69,168,370,145,119,23,70,25,18,9,9,68
"2011","St Albans 007A","E01023713",1296,245,48,197,360,154,117,59,131,74,51,32,19,105
"2011","St Albans 007B","E01023734",1231,271,56,215,375,192,100,46,97,43,22,8,14,85
"2011","St Albans 007C","E01023735",1318,231,40,191,384,208,129,50,132,72,21,8,13,91
"2011","St Albans 007D","E01023736",1107,175,40,135,285,167,130,62,131,80,20,13,7,57
"2011","St Albans 008A","E01023709",1187,198,38,160,307,162,121,68,121,88,29,18,11,93
"2011","St Albans 008B","E01023710",1098,231,48,183,356,160,96,37,63,43,17,10,7,95
"2011","St Albans 008C","E01023711",1056,166,29,137,295,161,112,42,106,54,25,12,13,95
"2011","St Albans 008D","E01023712",1247,217,50,167,352,158,99,78,109,96,38,22,16,100
"2011","St Albans 009A","E01023669",1186,157,25,132,280,140,87,83,179,99,63,45,18,98
"2011","St Albans 009B","E01023670",1475,431,95,336,504,126,102,48,94,54,26,14,12,90
"2011","St Albans 009C","E01023671",1279,139,26,113,285,173,125,77,180,112,70,54,16,118
"2011","St Albans 009D","E01023672",1325,238,43,195,388,149,136,58,117,65,59,44,15,115
"2011","St Albans 010A","E01023673",1044,278,45,233,314,144,80,28,66,31,18,11,7,85
"2011","St Albans 010B","E01023714",1252,380,95,285,377,166,97,24,57,24,20,12,8,107
"2011","St Albans 010C","E01023715",1069,259,47,212,323,123,93,29,75,35,28,17,11,104
"2011","St Albans 010D","E01023716",1473,453,90,363,521,157,102,38,79,40,21,10,11,62
"2011","St Albans 011A","E01023666",1365,297,47,250,377,146,77,61,129,72,107,86,21,99
"2011","St Albans 011B","E01023674",1371,374,79,295,433,117,107,46,80,59,58,43,15,97
"2011","St Albans 011C","E01023675",965,287,52,235,323,113,65,22,28,20,27,20,7,80
"2011","St Albans 011D","E01023676",1630,432,65,367,523,169,124,56,112,67,49,36,13,98
"2011","St Albans 012A","E01023726",1373,418,74,344,484,126,105,39,75,40,40,19,21,46
"2011","St Albans 012B","E01023727",1536,429,62,367,466,134,113,63,127,77,71,41,30,56
"2011","St Albans 012C","E01023728",1652,435,83,352,568,162,131,46,107,51,39,30,9,113
"2011","St Albans 012D","E01023729",1394,365,57,308,444,138,70,55,95,86,68,49,19,73
"2011","St Albans 013A","E01023664",1256,253,51,202,391,166,101,39,94,74,37,24,13,101
"2011","St Albans 013B","E01023665",1136,243,34,209,352,131,79,46,99,48,45,36,9,93
"2011","St Albans 013C","E01023667",1061,226,29,197,318,103,108,39,101,55,40,25,15,71
"2011","St Albans 013D","E01023668",962,197,28,169,276,124,80,40,76,40,29,20,9,100
"2011","St Albans 014A","E01023742",1036,228,34,194,348,167,83,28,81,28,14,8,6,59
"2011","St Albans 014B","E01023743",1242,367,77,290,413,131,134,37,54,23,20,13,7,63
"2011","St Albans 014C","E01023744",1036,247,59,188,344,144,84,26,72,20,10,4,6,89
"2011","St Albans 014D","E01023745",1265,343,72,271,465,134,126,28,56,39,15,6,9,59
"2011","St Albans 015A","E01023677",854,183,42,141,217,72,75,37,88,63,50,43,7,69
"2011","St Albans 015B","E01023678",1370,320,72,248,425,181,104,47,93,62,59,45,14,79
"2011","St Albans 015C","E01023679",1076,137,39,98,272,162,126,82,117,91,24,12,12,65
"2011","St Albans 015D","E01023680",950,156,36,120,236,111,100,45,104,72,22,14,8,104
"2011","St Albans 016A","E01023681",1208,128,27,101,265,141,105,90,136,165,84,60,24,94
"2011","St Albans 016B","E01023682",1232,246,53,193,323,134,107,53,119,93,54,35,19,103
"2011","St Albans 016C","E01023683",1103,147,32,115,270,132,91,66,159,104,44,27,17,90
"2011","St Albans 016D","E01023684",1211,256,54,202,385,155,113,41,105,34,34,21,13,88
"2011","St Albans 017A","E01023737",966,99,18,81,187,101,74,58,152,123,82,66,16,90
"2011","St Albans 017B","E01023738",1136,136,24,112,240,127,91,78,184,140,68,49,19,72
"2011","St Albans 017C","E01023739",963,127,19,108,258,110,90,50,134,74,52,42,10,68
"2011","St Albans 017D","E01023740",1016,268,49,219,302,100,84,38,80,56,38,22,16,50
"2011","St Albans 017E","E01023741",1175,314,64,250,357,130,101,42,79,55,39,27,12,58
"2011","St Albans 018A","E01023704",1283,165,24,141,334,186,132,78,143,84,44,25,19,117
"2011","St Albans 018B","E01023705",1219,94,26,68,232,151,104,91,201,146,85,71,14,115
"2011","St Albans 018C","E01023706",1196,138,28,110,318,176,110,77,154,78,39,24,15,106
"2011","St Albans 018E","E01023708",1095,116,33,83,268,162,107,82,133,115,33,22,11,79
"2011","St Albans 018F","E01033028",1084,126,23,103,294,128,97,64,144,86,42,28,14,103
"2011","St Albans 018G","E01033029",1129,235,54,181,355,124,101,32,103,56,39,29,10,84
"2011","St Albans 019A","E01023718",1212,232,43,189,349,187,111,74,103,47,22,15,7,87
"2011","St Albans 019B","E01023719",803,93,30,63,199,101,90,57,92,81,33,18,15,57
"2011","St Albans 019C","E01023720",1371,205,47,158,331,180,160,83,139,93,99,73,26,81
"2011","St Albans 019D","E01023721",996,157,36,121,278,168,114,46,88,57,17,11,6,71
"2011","St Albans 020A","E01023717",884,126,23,103,240,130,120,59,77,57,13,7,6,62
"2011","St Albans 020B","E01023730",1184,241,56,185,371,170,115,39,95,47,21,15,6,85
"2011","St Albans 020C","E01023731",1030,194,43,151,289,146,116,55,88,44,33,22,11,65
"2011","St Albans 020D","E01023732",1225,163,38,125,328,185,157,66,130,61,51,34,17,84
"2011","St Albans 020E","E01023733",1175,179,39,140,318,190,185,61,82,53,19,11,8,88
"2011","Stevenage 001A","E01023787",1062,79,15,64,225,150,96,95,147,145,41,26,15,84
"2011","Stevenage 001B","E01023788",1128,74,15,59,215,160,88,116,196,146,51,30,21,82
"2011","Stevenage 001C","E01023789",1422,114,19,95,272,233,101,119,213,177,80,51,29,113
"2011","Stevenage 001D","E01023790",1253,64,10,54,246,160,81,112,219,182,76,52,24,113
"2011","Stevenage 002A","E01023776",1885,294,65,229,453,300,202,142,201,116,67,43,24,110
"2011","Stevenage 002B","E01023777",1334,180,42,138,389,200,145,79,125,92,37,30,7,87
"2011","Stevenage 002C","E01023778",1182,91,20,71,205,152,105,91,212,184,60,37,23,82
"2011","Stevenage 002D","E01023799",1058,183,42,141,258,166,121,40,107,54,44,25,19,85
"2011","Stevenage 002E","E01023800",1483,266,45,221,407,188,121,87,145,103,69,51,18,97
"2011","Stevenage 002F","E01023801",1732,224,51,173,428,267,138,102,239,126,79,38,41,129
"2011","Stevenage 003A","E01023771",1229,125,33,92,282,217,106,94,176,110,32,20,12,87
"2011","Stevenage 003B","E01023772",1328,94,18,76,274,211,124,111,206,169,55,25,30,84
"2011","Stevenage 003C","E01023773",985,80,10,70,213,155,85,54,156,104,55,32,23,83
"2011","Stevenage 003D","E01023774",1141,91,23,68,182,156,108,114,195,123,73,49,24,99
"2011","Stevenage 004A","E01023767",1166,196,52,144,306,212,85,67,126,68,20,6,14,86
"2011","Stevenage 004B","E01023768",1300,207,36,171,326,226,108,83,150,69,18,12,6,113
"2011","Stevenage 004C","E01023769",1216,88,26,62,244,222,108,103,185,146,45,24,21,75
"2011","Stevenage 004D","E01023770",1170,161,33,128,286,218,104,70,142,88,21,10,11,80
"2011","Stevenage 005A","E01023795",1147,142,30,112,243,172,128,78,162,85,56,41,15,81
"2011","Stevenage 005B","E01023796",1085,92,21,71,191,160,86,81,183,180,62,38,24,50
"2011","Stevenage 005C","E01023797",965,73,16,57,218,144,101,76,153,105,35,20,15,60
"2011","Stevenage 005D","E01023798",1115,132,22,110,276,163,110,80,146,101,38,19,19,69
"2011","Stevenage 006A","E01023775",1388,152,28,124,331,191,135,88,197,125,83,51,32,86
"2011","Stevenage 006B","E01023779",1185,106,17,89,210,161,112,89,206,140,80,47,33,81
"2011","Stevenage 006C","E01023780",1085,79,18,61,216,166,94,83,168,149,40,23,17,90
"2011","Stevenage 006D","E01023781",1241,77,8,69,246,188,122,98,198,154,75,38,37,83
"2011","Stevenage 006E","E01023782",1043,95,17,78,240,168,81,87,148,116,51,25,26,57
"2011","Stevenage 007A","E01023759",1038,67,21,46,186,164,91,64,204,136,45,27,18,81
"2011","Stevenage 007B","E01023760",1142,117,22,95,255,186,92,93,178,111,28,16,12,82
"2011","Stevenage 007C","E01023761",1557,123,22,101,289,256,131,149,249,191,55,28,27,114
"2011","Stevenage 007D","E01023762",1098,79,16,63,236,173,87,93,194,143,31,18,13,62
"2011","Stevenage 008A","E01023755",1143,82,15,67,197,155,103,88,199,151,60,39,21,108
"2011","Stevenage 008B","E01023756",1113,60,10,50,179,135,99,88,236,142,82,42,40,92
"2011","Stevenage 008C","E01023757",1327,78,8,70,242,166,101,119,198,214,98,60,38,111
"2011","Stevenage 008D","E01023758",1294,87,5,82,217,162,82,108,262,193,96,43,53,87
"2011","Stevenage 009A","E01023750",876,58,17,41,155,119,60,82,148,139,56,31,25,59
"2011","Stevenage 009B","E01023751",836,56,11,45,180,135,85,64,127,107,35,20,15,47
"2011","Stevenage 009C","E01023752",924,89,13,76,166,137,81,84,143,109,39,23,16,76
"2011","Stevenage 009D","E01023753",1150,162,33,129,293,223,89,77,129,76,21,8,13,80
"2011","Stevenage 009E","E01023754",952,88,26,62,181,153,78,65,146,111,44,31,13,86
"2011","Stevenage 010A","E01023791",1126,88,20,68,231,170,83,109,205,130,33,25,8,77
"2011","Stevenage 010B","E01023792",1096,62,16,46,192,166,87,93,219,138,53,28,25,86
"2011","Stevenage 010C","E01023793",999,44,9,35,172,134,88,91,198,145,57,27,30,70
"2011","Stevenage 010D","E01023794",1112,67,13,54,201,153,114,97,194,143,54,32,22,89
"2011","Stevenage 011A","E01023783",1213,103,26,77,221,170,107,92,202,151,77,41,36,90
"2011","Stevenage 011B","E01023784",1172,137,36,101,272,149,102,76,166,128,60,31,29,82
"2011","Stevenage 011C","E01023785",1143,80,9,71,210,154,104,125,197,150,58,34,24,65
"2011","Stevenage 011D","E01023786",1055,99,23,76,204,156,92,93,150,119,55,28,27,87
"2011","Stevenage 012A","E01023763",1131,132,33,99,255,191,127,71,158,99,28,13,15,70
"2011","Stevenage 012B","E01023764",1107,134,36,98,268,169,105,84,152,103,37,21,16,55
"2011","Stevenage 012C","E01023765",988,79,20,59,221,131,83,96,168,100,42,25,17,68
"2011","Stevenage 012D","E01023766",1068,67,14,53,196,154,94,93,211,130,49,24,25,74
"2011","Three Rivers 001A","E01023802",1242,170,33,137,336,186,142,82,139,86,19,12,7,82
"2011","Three Rivers 001B","E01023803",1052,201,56,145,322,146,132,41,81,35,21,9,12,73
"2011","Three Rivers 001C","E01023804",1061,98,22,76,253,148,110,79,166,102,40,27,13,65
"2011","Three Rivers 001D","E01023807",1090,122,32,90,243,130,167,83,139,102,28,18,10,76
"2011","Three Rivers 001E","E01023808",1925,328,77,251,567,276,219,98,181,144,32,16,16,80
"2011","Three Rivers 002A","E01023829",1171,105,34,71,215,158,110,91,202,117,63,45,18,110
"2011","Three Rivers 002B","E01023830",1071,138,34,104,278,185,103,54,122,103,36,23,13,52
"2011","Three Rivers 002C","E01023832",1266,160,39,121,316,182,131,75,128,112,54,30,24,108
"2011","Three Rivers 002D","E01023833",1723,290,79,211,468,280,167,81,158,97,63,45,18,119
"2011","Three Rivers 002E","E01023834",1154,136,33,103,258,204,131,80,149,76,33,17,16,87
"2011","Three Rivers 003A","E01023823",971,133,29,104,258,146,101,57,117,61,22,14,8,76
"2011","Three Rivers 003B","E01023824",1359,188,38,150,366,270,133,82,124,70,17,11,6,109
"2011","Three Rivers 003C","E01023831",1436,210,48,162,432,212,176,64,121,76,29,13,16,116
"2011","Three Rivers 003D","E01023854",1347,234,68,166,383,165,249,51,122,63,17,12,5,63
"2011","Three Rivers 004A","E01023812",1068,278,80,198,306,129,152,10,55,13,28,22,6,97
"2011","Three Rivers 004B","E01023813",1047,238,74,164,290,129,163,20,54,30,32,20,12,91
"2011","Three Rivers 004C","E01023814",689,144,34,110,205,86,105,15,42,16,6,5,1,70
"2011","Three Rivers 004D","E01023851",1210,245,46,199,405,142,105,51,81,39,29,20,9,113
"2011","Three Rivers 005A","E01023815",1075,247,53,194,343,150,120,36,52,39,23,17,6,65
"2011","Three Rivers 005B","E01023816",841,182,50,132,264,113,95,24,49,30,14,12,2,70
"2011","Three Rivers 005C","E01023817",963,241,65,176,327,114,99,26,47,22,12,6,6,75
"2011","Three Rivers 005D","E01023818",933,267,67,200,302,119,82,18,27,16,16,7,9,86
"2011","Three Rivers 006A","E01023819",1135,161,43,118,345,154,117,63,121,73,27,13,14,74
"2011","Three Rivers 006B","E01023820",890,175,44,131,276,144,93,33,57,32,14,7,7,66
"2011","Three Rivers 006C","E01023821",923,136,29,107,232,189,92,54,94,47,11,9,2,68
"2011","Three Rivers 006D","E01023822",940,135,38,97,226,163,100,61,103,69,20,13,7,63
"2011","Three Rivers 006E","E01023825",1678,258,56,202,511,278,174,82,150,76,38,19,19,111
"2011","Three Rivers 006F","E01023826",1007,179,30,149,287,145,105,59,101,41,18,11,7,72
"2011","Three Rivers 007A","E01023847",1362,212,41,171,393,224,140,71,136,69,53,37,16,64
"2011","Three Rivers 007B","E01023848",1148,107,22,85,260,137,140,76,153,146,45,27,18,84
"2011","Three Rivers 007C","E01023850",1062,231,37,194,330,134,114,49,74,62,30,20,10,38
"2011","Three Rivers 007D","E01023852",1005,227,54,173,307,145,113,33,57,43,16,13,3,64
"2011","Three Rivers 007E","E01023853",1477,366,91,275,425,231,130,45,110,34,23,16,7,113
"2011","Three Rivers 008A","E01023827",1527,89,23,66,289,204,201,134,232,204,74,38,36,100
"2011","Three Rivers 008B","E01023828",1053,41,7,34,165,168,154,87,170,138,49,30,19,81
"2011","Three Rivers 008C","E01023845",1306,138,31,107,325,227,162,75,164,95,38,19,19,82
"2011","Three Rivers 008D","E01023846",1151,165,37,128,334,173,128,67,115,56,36,22,14,77
"2011","Three Rivers 009A","E01023835",993,118,26,92,216,140,103,84,116,115,39,28,11,62
"2011","Three Rivers 009B","E01023836",1028,102,24,78,256,144,114,72,130,114,41,19,22,55
"2011","Three Rivers 009C","E01023837",1156,159,46,113,304,183,143,92,119,78,19,10,9,59
"2011","Three Rivers 009D","E01023838",874,70,26,44,169,113,113,68,130,108,42,25,17,61
"2011","Three Rivers 010A","E01023805",1146,71,23,48,175,161,137,84,200,140,78,48,30,100
"2011","Three Rivers 010B","E01023809",1170,109,27,82,241,191,139,88,164,105,64,40,24,69
"2011","Three Rivers 010C","E01023810",1323,172,38,134,345,240,144,70,148,62,46,32,14,96
"2011","Three Rivers 010D","E01023811",1097,121,28,93,301,200,145,58,107,75,35,17,18,55
"2011","Three Rivers 011A","E01023839",1648,492,103,389,445,238,145,18,60,31,59,41,18,160
"2011","Three Rivers 011B","E01023840",1189,344,164,180,361,168,132,20,51,22,29,22,7,62
"2011","Three Rivers 011C","E01023841",1227,364,73,291,358,128,154,17,33,24,42,35,7,107
"2011","Three Rivers 011D","E01023849",1014,212,52,160,312,141,115,41,65,44,20,14,6,64
"2011","Three Rivers 012A","E01023806",1571,92,24,68,245,233,230,134,277,169,72,41,31,119
"2011","Three Rivers 012B","E01023842",1107,48,10,38,171,155,113,90,199,172,83,46,37,76
"2011","Three Rivers 012C","E01023843",1386,102,24,78,263,225,148,104,219,155,69,44,25,101
"2011","Three Rivers 012D","E01023844",1153,32,5,27,167,134,148,104,207,170,117,60,57,74
"2011","Watford 001A","E01023904",1438,113,19,94,289,214,149,122,223,152,72,54,18,104
"2011","Watford 001B","E01023905",1377,148,38,110,313,183,125,109,174,152,71,42,29,102
"2011","Watford 001C","E01023906",1074,74,11,63,200,146,118,99,175,134,58,38,20,70
"2011","Watford 001D","E01023907",1247,153,39,114,300,198,123,73,169,121,32,20,12,78
"2011","Watford 002A","E01023890",946,117,25,92,240,167,99,65,97,64,26,18,8,71
"2011","Watford 002B","E01023891",989,58,9,49,155,131,92,86,162,133,57,36,21,115
"2011","Watford 002C","E01023892",962,66,14,52,205,161,85,83,160,88,30,21,9,84
"2011","Watford 002D","E01023893",1245,143,34,109,307,200,128,87,141,110,31,18,13,98
"2011","Watford 002E","E01023894",1073,106,28,78,267,207,118,82,111,80,21,14,7,81
"2011","Watford 003A","E01023873",884,55,10,45,137,132,76,63,164,149,37,24,13,71
"2011","Watford 003B","E01023874",904,74,19,55,181,144,104,80,141,94,31,18,13,55
"2011","Watford 003C","E01023875",1368,130,22,108,335,250,152,102,169,110,41,21,20,79
"2011","Watford 003D","E01023876",1187,55,11,44,193,143,84,93,235,208,100,54,46,76
"2011","Watford 003E","E01023877",1155,108,24,84,218,199,120,88,175,118,46,32,14,83
"2011","Watford 004A","E01023868",1161,115,24,91,232,169,97,80,181,125,48,32,16,114
"2011","Watford 004B","E01023869",1024,91,21,70,194,133,89,67,135,132,92,73,19,91
"2011","Watford 004C","E01023870",1012,59,9,50,145,115,102,78,151,130,112,83,29,120
"2011","Watford 004D","E01023871",874,107,20,87,214,146,74,56,109,81,33,23,10,54
"2011","Watford 004E","E01023872",1268,103,18,85,269,202,152,95,178,109,60,43,17,100
"2011","Watford 005A","E01023895",1304,298,38,260,385,197,103,69,106,68,25,11,14,53
"2011","Watford 005B","E01023896",991,128,28,100,218,176,97,71,113,80,23,12,11,85
"2011","Watford 005C","E01023897",1135,106,14,92,255,213,130,61,146,101,51,38,13,72
"2011","Watford 005D","E01023898",1170,163,31,132,270,233,107,81,135,83,25,15,10,73
"2011","Watford 006A","E01023855",1445,160,36,124,371,210,137,121,161,126,55,39,16,104
"2011","Watford 006B","E01023856",1743,179,31,148,481,259,166,109,206,159,62,37,25,122
"2011","Watford 006C","E01023857",1207,75,16,59,217,148,116,84,211,129,76,66,10,151
"2011","Watford 006D","E01023858",1346,168,31,137,367,195,113,79,184,107,49,27,22,84
"2011","Watford 007A","E01023878",1396,290,71,219,416,218,129,67,103,36,32,23,9,105
"2011","Watford 007B","E01023879",1579,353,54,299,461,224,136,59,146,58,55,34,21,87
"2011","Watford 007C","E01023880",1371,253,44,209,401,199,118,73,111,82,57,43,14,77
"2011","Watford 007D","E01023881",1154,187,49,138,320,174,143,57,111,51,25,17,8,86
"2011","Watford 008A","E01023886",2038,421,84,337,535,289,152,94,186,115,81,58,23,165
"2011","Watford 008B","E01023887",1148,265,53,212,346,166,107,37,81,29,34,25,9,83
"2011","Watford 008C","E01023888",1146,225,49,176,315,162,104,40,93,51,48,38,10,108
"2011","Watford 008D","E01023889",1235,268,56,212,418,165,114,26,58,37,36,26,10,113
"2011","Watford 009A","E01023859",1695,261,42,219,471,196,126,104,213,135,96,55,41,93
"2011","Watford 009B","E01023860",1500,153,29,124,301,159,128,119,236,154,138,98,40,112
"2011","Watford 009C","E01023861",1821,218,23,195,452,199,161,111,206,203,118,86,32,153
"2011","Watford 009D","E01023862",1478,183,26,157,416,211,116,91,203,119,58,34,24,81
"2011","Watford 010A","E01023899",1106,98,21,77,196,118,101,81,144,134,123,93,30,111
"2011","Watford 010B","E01023900",1278,108,23,85,263,129,124,73,167,135,97,72,25,182
"2011","Watford 010C","E01023901",1380,122,17,105,382,168,127,104,183,123,70,50,20,101
"2011","Watford 010D","E01023902",1184,111,22,89,285,171,98,75,175,111,65,50,15,93
"2011","Watford 010E","E01023903",1130,77,17,60,228,132,127,69,171,119,79,64,15,128
"2011","Watford 011A","E01023863",1311,99,12,87,277,189,118,86,180,161,99,71,28,102
"2011","Watford 011B","E01023864",1078,113,26,87,229,145,72,78,153,115,86,64,22,87
"2011","Watford 011C","E01023865",1115,67,8,59,166,124,75,84,180,175,111,85,26,133
"2011","Watford 011D","E01023866",1026,52,10,42,187,142,78,59,213,139,84,57,27,72
"2011","Watford 011E","E01023867",1624,212,34,178,396,213,147,110,186,156,96,75,21,108
"2011","Watford 012A","E01023882",1187,197,34,163,392,153,126,61,82,55,37,20,17,84
"2011","Watford 012B","E01023883",1148,93,33,60,194,146,132,88,160,136,88,62,26,111
"2011","Watford 012C","E01023884",1302,211,51,160,420,190,143,56,97,61,40,21,19,84
"2011","Watford 012D","E01023885",1326,242,59,183,426,181,151,51,92,45,36,23,13,102
"2011","Welwyn Hatfield 001A","E01023965",1022,236,56,180,311,145,141,29,50,17,19,11,8,74
"2011","Welwyn Hatfield 001B","E01023966",1178,275,74,201,360,159,132,43,61,39,28,19,9,81
"2011","Welwyn Hatfield 001C","E01023967",972,151,27,124,235,132,128,61,97,81,21,11,10,66
"2011","Welwyn Hatfield 001D","E01023971",1144,297,80,217,387,133,101,31,70,29,11,10,1,85
"2011","Welwyn Hatfield 002B","E01023968",929,205,51,154,275,121,110,28,53,43,25,18,7,69
"2011","Welwyn Hatfield 002C","E01023969",969,185,51,134,282,137,113,47,70,59,24,14,10,52
"2011","Welwyn Hatfield 002D","E01023970",932,87,21,66,181,139,89,80,143,110,43,27,16,60
"2011","Welwyn Hatfield 002E","E01033310",1216,193,32,161,315,190,111,72,132,75,23,11,12,105
"2011","Welwyn Hatfield 002F","E01033313",1086,199,38,161,277,140,151,47,88,57,21,16,5,106
"2011","Welwyn Hatfield 003A","E01023959",985,266,51,215,306,152,70,16,61,31,13,8,5,70
"2011","Welwyn Hatfield 003B","E01023960",1093,141,22,119,253,187,90,86,125,105,35,24,11,71
"2011","Welwyn Hatfield 003C","E01023961",1004,111,18,93,229,167,86,67,130,89,40,17,23,85
"2011","Welwyn Hatfield 003D","E01023962",1007,160,35,125,265,157,87,54,112,65,26,9,17,81
"2011","Welwyn Hatfield 004A","E01023912",1059,127,26,101,275,180,94,65,133,86,27,16,11,72
"2011","Welwyn Hatfield 004B","E01023913",1015,124,29,95,205,151,93,74,161,106,39,13,26,62
"2011","Welwyn Hatfield 004C","E01023914",1147,93,13,80,250,152,96,93,187,136,47,19,28,93
"2011","Welwyn Hatfield 004D","E01023915",1085,136,39,97,242,148,86,66,184,114,47,24,23,62
"2011","Welwyn Hatfield 005A","E01023950",1233,226,59,167,320,208,103,63,109,65,41,31,10,98
"2011","Welwyn Hatfield 005B","E01023951",1203,105,20,85,227,178,89,89,187,149,96,51,45,83
"2011","Welwyn Hatfield 005C","E01023952",1290,143,33,110,311,205,102,121,186,116,39,19,20,67
"2011","Welwyn Hatfield 005D","E01023953",1080,157,36,121,303,182,86,89,117,78,21,11,10,47
"2011","Welwyn Hatfield 006A","E01023916",1193,176,34,142,313,170,103,71,130,85,43,21,22,102
"2011","Welwyn Hatfield 006B","E01023917",1218,246,49,197,345,195,103,58,109,56,35,22,13,71
"2011","Welwyn Hatfield 006C","E01023918",1121,208,37,171,292,181,78,66,115,80,37,19,18,64
"2011","Welwyn Hatfield 006D","E01023919",1101,278,55,223,363,131,97,26,56,40,15,10,5,95
"2011","Welwyn Hatfield 007A","E01023954",1264,87,23,64,224,167,92,103,220,188,102,48,54,81
"2011","Welwyn Hatfield 007B","E01023955",931,66,16,50,177,139,75,79,151,126,41,27,14,77
"2011","Welwyn Hatfield 007C","E01023956",990,80,14,66,192,139,54,97,160,139,39,23,16,90
"2011","Welwyn Hatfield 007D","E01023957",1094,83,8,75,209,145,79,99,182,159,48,26,22,90
"2011","Welwyn Hatfield 007E","E01023958",943,53,9,44,184,116,63,74,154,140,62,27,35,97
"2011","Welwyn Hatfield 008A","E01023943",1041,137,28,109,192,154,102,82,162,89,43,27,16,80
"2011","Welwyn Hatfield 008B","E01023944",1450,164,38,126,344,232,100,112,205,144,48,19,29,101
"2011","Welwyn Hatfield 008C","E01023945",1110,100,26,74,236,162,86,96,177,136,47,26,21,70
"2011","Welwyn Hatfield 008D","E01023946",1095,179,35,144,290,208,86,60,103,65,22,9,13,82
"2011","Welwyn Hatfield 009A","E01023939",808,94,24,70,152,145,58,60,112,95,42,28,14,50
"2011","Welwyn Hatfield 009B","E01023940",1216,132,19,113,259,170,93,83,203,136,42,19,23,98
"2011","Welwyn Hatfield 009C","E01023941",2051,337,57,280,570,282,158,124,213,163,68,33,35,136
"2011","Welwyn Hatfield 009D","E01023942",1142,93,21,72,231,173,81,72,193,131,59,39,20,109
"2011","Welwyn Hatfield 010A","E01023929",1177,79,16,63,207,161,116,86,200,161,48,30,18,119
"2011","Welwyn Hatfield 010B","E01023930",1211,95,24,71,201,157,91,98,193,155,61,34,27,160
"2011","Welwyn Hatfield 010D","E01023938",2458,178,38,140,272,166,114,54,121,63,35,24,11,1455
"2011","Welwyn Hatfield 010E","E01033308",2635,113,15,98,177,92,52,43,94,72,59,39,20,1933
"2011","Welwyn Hatfield 010F","E01033311",1152,89,14,75,206,156,104,100,187,138,40,24,16,132
"2011","Welwyn Hatfield 010G","E01033314",1690,150,19,131,243,122,57,55,119,93,47,36,11,804
"2011","Welwyn Hatfield 011A","E01023924",1357,67,13,54,158,98,66,79,260,180,77,63,14,372
"2011","Welwyn Hatfield 011B","E01023925",934,166,47,119,259,107,116,60,81,56,16,11,5,73
"2011","Welwyn Hatfield 011C","E01023926",1323,245,49,196,375,209,123,61,95,55,40,20,20,120
"2011","Welwyn Hatfield 011D","E01023927",1213,111,11,100,215,131,96,70,201,172,60,37,23,157
"2011","Welwyn Hatfield 012A","E01023920",1240,67,11,56,153,111,82,81,246,223,82,64,18,195
"2011","Welwyn Hatfield 012B","E01023921",1687,105,12,93,253,153,57,98,217,183,83,60,23,538
"2011","Welwyn Hatfield 012C","E01023922",1317,64,13,51,166,105,73,79,207,141,55,38,17,427
"2011","Welwyn Hatfield 012D","E01023923",1462,107,26,81,206,155,82,83,160,116,37,24,13,516
"2011","Welwyn Hatfield 013A","E01023932",1387,56,8,48,149,119,68,92,166,122,34,20,14,581
"2011","Welwyn Hatfield 013B","E01023934",1209,48,12,36,126,77,43,62,101,90,42,27,15,620
"2011","Welwyn Hatfield 013C","E01023935",1071,54,13,41,120,73,59,45,125,78,27,20,7,490
"2011","Welwyn Hatfield 013D","E01023936",1697,80,15,65,205,174,103,99,248,175,58,30,28,555
"2011","Welwyn Hatfield 013E","E01023937",1084,33,8,25,86,62,51,58,121,106,41,28,13,526
"2011","Welwyn Hatfield 014A","E01023933",1166,62,11,51,152,117,74,82,187,142,43,25,18,307
"2011","Welwyn Hatfield 014B","E01023963",1611,146,36,110,315,237,195,114,225,168,50,22,28,161
"2011","Welwyn Hatfield 014C","E01023964",1133,150,33,117,260,130,157,63,84,76,21,15,6,192
"2011","Welwyn Hatfield 015A","E01023908",1091,215,56,159,284,165,159,35,68,33,16,10,6,116
"2011","Welwyn Hatfield 015B","E01023909",964,181,43,138,267,134,98,25,49,15,19,17,2,176
"2011","Welwyn Hatfield 015C","E01023910",1045,189,47,142,276,123,200,40,63,48,19,13,6,87
"2011","Welwyn Hatfield 015D","E01023911",1106,143,32,111,302,197,159,45,98,50,18,8,10,94
"2011","Welwyn Hatfield 016A","E01023947",1150,175,41,134,294,178,162,59,109,57,35,17,18,81
"2011","Welwyn Hatfield 016B","E01023948",1171,200,48,152,294,229,175,42,90,40,26,18,8,75
"2011","Welwyn Hatfield 016C","E01023949",1356,271,84,187,391,226,183,40,95,32,13,7,6,105
"2011","Breckland 001A","E01026436",1662,169,56,113,358,228,251,137,256,151,34,22,12,78
"2011","Breckland 001C","E01026461",971,96,17,79,240,134,132,68,137,92,24,16,8,48
"2011","Breckland 001E","E01026483",818,75,23,52,157,85,129,61,119,112,45,35,10,35
"2011","Breckland 001F","E01033042",1790,173,82,91,405,289,222,161,214,212,48,32,16,66
"2011","Breckland 002A","E01026442",1575,172,53,119,314,207,258,104,243,174,35,24,11,68
"2011","Breckland 002B","E01026443",1518,132,35,97,344,157,237,117,234,151,46,29,17,100
"2011","Breckland 002C","E01026445",1658,111,32,79,346,214,193,119,301,245,55,39,16,74
"2011","Breckland 002D","E01026462",1605,171,57,114,335,220,264,116,250,156,35,23,12,58
"2011","Breckland 003A","E01026428",1962,148,52,96,372,242,168,160,390,251,107,76,31,124
"2011","Breckland 003B","E01026429",1075,69,19,50,202,145,119,76,221,142,40,22,18,61
"2011","Breckland 003C","E01026430",1178,119,38,81,269,153,131,87,194,100,60,42,18,65
"2011","Breckland 003D","E01026431",730,46,8,38,144,101,58,64,166,89,13,10,3,49
"2011","Breckland 004A","E01026446",1365,97,27,70,251,210,150,110,249,192,50,29,21,56
"2011","Breckland 004B","E01026452",1195,117,40,77,231,167,157,86,211,123,38,17,21,65
"2011","Breckland 004C","E01026453",1184,96,24,72,235,150,214,90,197,99,43,27,16,60
"2011","Breckland 004D","E01026454",1234,92,18,74,281,207,103,110,209,140,24,18,6,68
"2011","Breckland 005A","E01026425",1300,52,17,35,181,137,110,131,300,228,78,44,34,83
"2011","Breckland 005B","E01026426",1766,133,36,97,357,198,162,155,354,214,87,40,47,106
"2011","Breckland 005C","E01026427",1524,90,23,67,305,198,149,131,329,210,48,24,24,64
"2011","Breckland 005D","E01026432",1048,72,23,49,206,158,97,82,220,132,35,24,11,46
"2011","Breckland 005E","E01026433",1069,61,19,42,210,121,78,100,244,166,31,13,18,58
"2011","Breckland 005F","E01026434",1467,89,28,61,303,213,126,146,302,185,36,18,18,67
"2011","Breckland 006A","E01026479",1105,91,30,61,233,122,155,89,194,109,35,21,14,77
"2011","Breckland 006B","E01026480",1099,116,24,92,254,150,143,66,177,97,41,33,8,55
"2011","Breckland 006C","E01026481",865,81,21,60,161,100,146,80,124,94,30,18,12,49
"2011","Breckland 006D","E01026484",1003,123,30,93,230,128,174,73,134,87,18,11,7,36
"2011","Breckland 006E","E01026485",825,101,27,74,188,100,173,47,103,69,10,5,5,34
"2011","Breckland 007A","E01026455",1248,53,15,38,203,111,138,100,284,213,82,55,27,64
"2011","Breckland 007B","E01026456",824,77,31,46,169,127,91,67,133,87,31,24,7,42
"2011","Breckland 007C","E01026457",876,48,17,31,171,137,71,71,189,139,27,14,13,23
"2011","Breckland 007D","E01026458",1031,58,17,41,166,126,98,106,205,165,60,40,20,47
"2011","Breckland 007E","E01026459",942,55,19,36,156,107,95,82,193,158,57,33,24,39
"2011","Breckland 008A","E01026437",860,70,19,51,165,124,122,74,130,111,27,20,7,37
"2011","Breckland 008B","E01026438",750,56,18,38,151,100,112,62,113,96,25,8,17,35
"2011","Breckland 008C","E01026451",1475,109,33,76,312,160,198,132,253,188,36,24,12,87
"2011","Breckland 008D","E01026495",935,61,23,38,158,119,138,95,173,118,43,23,20,30
"2011","Breckland 008E","E01026496",742,67,17,50,156,125,97,63,103,89,16,13,3,26
"2011","Breckland 009A","E01026486",1069,70,17,53,189,131,124,90,218,163,46,33,13,38
"2011","Breckland 009B","E01026487",1132,42,14,28,204,163,80,136,236,173,40,21,19,58
"2011","Breckland 009C","E01026488",789,27,9,18,96,74,50,76,217,166,58,40,18,25
"2011","Breckland 009D","E01026489",920,36,16,20,161,132,92,89,205,150,18,13,5,37
"2011","Breckland 009E","E01026490",1069,81,32,49,198,166,105,106,193,144,28,19,9,48
"2011","Breckland 010A","E01026419",922,102,30,72,194,108,185,60,114,73,32,24,8,54
"2011","Breckland 010B","E01026420",845,81,22,59,166,125,140,69,130,73,26,11,15,35
"2011","Breckland 010D","E01026464",938,109,38,71,202,114,137,66,137,97,24,17,7,52
"2011","Breckland 010E","E01026491",1640,182,69,113,394,191,297,104,222,147,34,22,12,69
"2011","Breckland 010F","E01033040",1592,57,18,39,179,121,198,196,215,344,224,188,36,58
"2011","Breckland 010G","E01033041",774,43,17,26,134,77,79,72,163,128,34,17,17,44
"2011","Breckland 011A","E01026422",1363,97,34,63,238,203,175,128,253,198,14,6,8,57
"2011","Breckland 011B","E01026423",1300,90,28,62,219,142,117,138,242,238,41,25,16,73
"2011","Breckland 011C","E01026447",1068,69,19,50,162,96,85,128,209,184,70,55,15,65
"2011","Breckland 011D","E01026449",1399,111,36,75,271,192,147,147,230,188,35,17,18,78
"2011","Breckland 011E","E01026450",1263,107,28,79,261,186,129,108,205,166,34,23,11,67
"2011","Breckland 012A","E01026424",1489,125,47,78,344,183,182,143,225,191,30,18,12,66
"2011","Breckland 012B","E01026444",1545,122,44,78,342,143,222,132,258,199,61,42,19,66
"2011","Breckland 012C","E01026492",924,59,18,41,176,97,105,89,160,167,37,19,18,34
"2011","Breckland 012D","E01026493",882,54,16,38,201,133,102,87,128,120,15,6,9,42
"2011","Breckland 013A","E01026421",1239,151,37,114,288,172,183,89,125,129,21,12,9,81
"2011","Breckland 013B","E01026435",1631,137,36,101,363,175,252,137,214,203,48,31,17,102
"2011","Breckland 013C","E01026448",1627,165,59,106,370,214,163,143,227,188,46,31,15,111
"2011","Breckland 014A","E01026439",1169,108,29,79,236,159,154,119,172,138,29,9,20,54
"2011","Breckland 014B","E01026440",880,78,32,46,201,112,135,73,106,94,21,19,2,60
"2011","Breckland 014C","E01026441",1104,103,28,75,226,139,185,96,135,123,43,27,16,54
"2011","Breckland 014D","E01026494",1642,175,37,138,369,200,273,115,204,176,38,31,7,92
"2011","Breckland 015A","E01026465",1285,74,30,44,156,109,80,138,295,322,54,31,23,57
"2011","Breckland 015B","E01026466",1424,58,20,38,168,157,73,168,328,314,54,41,13,104
"2011","Breckland 015C","E01026467",1420,37,16,21,111,94,62,155,361,384,114,62,52,102
"2011","Breckland 016A","E01026468",1760,112,40,72,260,190,156,179,364,328,80,54,26,91
"2011","Breckland 016B","E01026469",1175,76,35,41,210,168,78,102,234,219,25,17,8,63
"2011","Breckland 016C","E01026470",2110,160,58,102,403,290,131,214,437,306,54,35,19,115
"2011","Breckland 016D","E01026471",960,65,20,45,177,129,74,99,189,165,22,13,9,40
"2011","Breckland 016E","E01026472",934,53,25,28,174,134,54,120,189,161,16,9,7,33
"2011","Breckland 016F","E01026473",1103,46,20,26,170,161,52,136,241,212,20,12,8,65
"2011","Breckland 017A","E01026474",1212,68,35,33,182,149,72,122,246,251,49,29,20,73
"2011","Breckland 017B","E01026475",1093,93,31,62,236,146,81,88,166,170,44,19,25,69
"2011","Breckland 017C","E01026476",1078,29,13,16,95,99,73,140,240,275,58,29,29,69
"2011","Breckland 017D","E01026477",992,26,7,19,115,81,47,99,235,264,65,45,20,60
"2011","Breckland 017E","E01026478",1141,25,10,15,127,76,61,134,263,298,71,41,30,86
"2011","Broadland 001A","E01026499",1021,71,23,48,204,124,97,85,220,139,41,22,19,40
"2011","Broadland 001B","E01026500",1200,120,44,76,302,200,101,96,201,105,24,14,10,51
"2011","Broadland 001C","E01026501",1205,110,24,86,231,162,169,87,192,131,71,53,18,52
"2011","Broadland 001D","E01026502",855,98,35,63,221,103,118,69,133,63,19,11,8,31
"2011","Broadland 001E","E01026503",1017,103,19,84,242,137,134,70,168,95,21,14,7,47
"2011","Broadland 002A","E01026522",1033,93,22,71,219,110,181,84,155,94,34,26,8,63
"2011","Broadland 002B","E01026523",1368,101,21,80,272,128,241,100,247,167,34,18,16,78
"2011","Broadland 002C","E01026524",1073,139,24,115,245,125,164,96,154,89,18,9,9,43
"2011","Broadland 002D","E01026525",846,104,26,78,204,114,154,50,93,74,20,12,8,33
"2011","Broadland 002E","E01026547",1016,94,23,71,234,115,156,69,158,102,21,13,8,67
"2011","Broadland 002F","E01026548",919,95,25,70,235,132,113,81,131,56,21,11,10,55
"2011","Broadland 003A","E01026514",1116,117,38,79,255,174,138,91,147,93,37,26,11,64
"2011","Broadland 003B","E01026515",787,83,20,63,170,119,137,51,108,64,15,10,5,40
"2011","Broadland 003C","E01026516",899,70,19,51,190,107,140,73,150,87,22,9,13,60
"2011","Broadland 003D","E01026517",1008,113,36,77,254,137,164,65,121,85,23,11,12,46
"2011","Broadland 004A","E01026533",939,70,23,47,177,135,164,69,156,100,22,15,7,46
"2011","Broadland 004B","E01026534",1192,97,27,70,244,139,240,93,178,120,34,25,9,47
"2011","Broadland 004C","E01026535",1262,102,28,74,232,181,186,102,214,133,45,34,11,67
"2011","Broadland 004D","E01026536",1260,114,28,86,244,200,188,102,171,113,47,38,9,81
"2011","Broadland 004E","E01026537",1096,105,22,83,269,183,98,86,153,109,34,17,17,59
"2011","Broadland 005A","E01026549",1287,96,29,67,252,196,163,108,209,171,25,10,15,67
"2011","Broadland 005B","E01026550",845,72,18,54,159,133,92,68,166,81,18,7,11,56
"2011","Broadland 005C","E01026551",891,72,19,53,169,156,95,86,149,101,23,15,8,40
"2011","Broadland 005D","E01026552",1057,78,30,48,188,191,132,92,202,117,16,12,4,41
"2011","Broadland 006A","E01026562",853,108,27,81,231,145,71,48,108,63,16,12,4,63
"2011","Broadland 006B","E01026563",1054,118,23,95,264,164,99,60,147,97,32,19,13,73
"2011","Broadland 006C","E01026564",1103,118,33,85,215,198,123,73,144,91,52,44,8,89
"2011","Broadland 006D","E01026565",875,68,11,57,214,149,80,70,134,85,20,9,11,55
"2011","Broadland 006E","E01026566",1097,116,34,82,240,192,115,67,188,93,23,16,7,63
"2011","Broadland 006F","E01026567",1189,113,29,84,287,198,118,116,183,117,17,11,6,40
"2011","Broadland 006G","E01026568",1189,141,35,106,292,220,122,79,163,74,18,11,7,80
"2011","Broadland 007A","E01026518",972,86,15,71,223,169,98,67,148,94,18,9,9,69
"2011","Broadland 007B","E01026519",1260,122,17,105,301,245,94,98,206,95,29,16,13,70
"2011","Broadland 007C","E01026520",816,82,27,55,171,119,90,60,137,82,32,31,1,43
"2011","Broadland 007D","E01026521",839,105,27,78,196,146,92,60,112,63,15,8,7,50
"2011","Broadland 008A","E01026545",1168,125,28,97,326,174,117,84,160,85,38,27,11,59
"2011","Broadland 008B","E01026546",1111,212,59,153,301,182,135,35,115,40,17,10,7,74
"2011","Broadland 008C","E01026578",1357,134,43,91,282,234,192,87,193,123,38,22,16,74
"2011","Broadland 008D","E01026579",1147,132,38,94,249,178,144,89,171,98,22,17,5,64
"2011","Broadland 008E","E01026580",1079,105,36,69,245,144,166,65,141,93,65,53,12,55
"2011","Broadland 009A","E01026540",1042,98,23,75,236,191,130,74,150,107,18,11,7,38
"2011","Broadland 009B","E01026541",1699,125,36,89,347,289,156,138,306,208,43,22,21,87
"2011","Broadland 009C","E01026542",1057,93,26,67,199,182,96,85,208,110,23,14,9,61
"2011","Broadland 009D","E01026543",1053,125,29,96,264,208,88,83,157,63,7,2,5,58
"2011","Broadland 009E","E01026544",1299,132,25,107,277,201,108,129,234,137,22,11,11,59
"2011","Broadland 010A","E01026526",1030,52,15,37,174,168,102,99,215,143,24,14,10,53
"2011","Broadland 010B","E01026527",1016,63,18,45,180,164,112,92,187,148,14,10,4,56
"2011","Broadland 010C","E01026528",936,54,21,33,124,146,111,85,204,140,19,13,6,53
"2011","Broadland 010D","E01026529",1161,87,25,62,245,161,115,102,220,152,33,21,12,46
"2011","Broadland 011A","E01026530",1275,117,31,86,254,199,135,120,182,162,29,22,7,77
"2011","Broadland 011B","E01026531",1219,70,22,48,225,203,143,107,223,162,37,26,11,49
"2011","Broadland 011C","E01026532",1278,79,20,59,219,222,136,121,234,163,27,13,14,77
"2011","Broadland 012A","E01026553",979,74,22,52,171,157,114,90,189,105,26,19,7,53
"2011","Broadland 012B","E01026554",887,84,26,58,169,170,85,71,155,74,20,8,12,59
"2011","Broadland 012C","E01026555",1091,80,26,54,181,180,100,81,205,156,41,29,12,67
"2011","Broadland 012D","E01026556",1063,64,16,48,212,164,133,94,204,125,27,17,10,40
"2011","Broadland 013A","E01026557",999,94,21,73,184,165,119,61,188,121,18,12,6,49
"2011","Broadland 013B","E01026558",931,65,11,54,190,137,109,93,173,113,19,11,8,32
"2011","Broadland 013C","E01026559",1075,78,24,54,209,167,124,106,181,121,25,14,11,64
"2011","Broadland 013D","E01026560",932,50,20,30,159,147,87,95,201,144,10,6,4,39
"2011","Broadland 013E","E01026561",1075,67,14,53,186,178,81,100,248,140,35,26,9,40
"2011","Broadland 014A","E01026504",1140,143,46,97,290,144,172,72,150,98,14,12,2,57
"2011","Broadland 014B","E01026505",940,126,37,89,231,126,112,54,135,77,28,18,10,51
"2011","Broadland 014C","E01026506",1017,126,37,89,266,167,135,71,101,82,26,17,9,43
"2011","Broadland 014D","E01026507",975,117,29,88,243,173,104,47,139,75,17,9,8,60
"2011","Broadland 014E","E01026512",967,81,15,66,198,142,138,96,164,88,25,16,9,35
"2011","Broadland 014F","E01026513",965,82,20,62,195,152,104,82,164,110,32,18,14,44
"2011","Broadland 015A","E01026569",995,87,23,64,218,149,85,82,187,113,25,20,5,49
"2011","Broadland 015B","E01026570",1069,99,39,60,228,171,113,94,191,108,10,5,5,55
"2011","Broadland 015C","E01026571",1027,99,31,68,235,171,90,88,174,101,15,10,5,54
"2011","Broadland 015D","E01026572",1062,112,28,84,251,194,101,91,143,87,30,14,16,53
"2011","Broadland 015E","E01026573",945,64,16,48,170,160,103,100,168,108,23,8,15,49
"2011","Broadland 016A","E01026574",1260,185,39,146,358,215,95,79,157,66,28,16,12,77
"2011","Broadland 016B","E01026575",1167,153,39,114,279,153,106,65,196,113,38,29,9,64
"2011","Broadland 016C","E01026576",1542,229,53,176,391,264,139,92,183,84,54,35,19,106
"2011","Broadland 016D","E01026577",1270,224,51,173,362,178,132,64,139,69,27,13,14,75
"2011","Broadland 017A","E01026508",1030,104,18,86,234,161,98,84,167,88,32,13,19,62
"2011","Broadland 017B","E01026509",1200,150,41,109,315,185,162,72,163,79,24,16,8,50
"2011","Broadland 017C","E01026510",1137,153,31,122,293,176,159,74,128,64,22,12,10,68
"2011","Broadland 017D","E01026511",869,59,15,44,208,103,115,80,135,96,28,17,11,45
"2011","Broadland 018A","E01026497",1048,96,24,72,226,183,114,87,165,109,15,9,6,53
"2011","Broadland 018B","E01026498",896,65,18,47,203,130,115,69,148,93,32,20,12,41
"2011","Broadland 018C","E01026538",1149,114,28,86,235,155,140,100,162,109,64,51,13,70
"2011","Broadland 018D","E01026539",1237,114,24,90,269,161,162,117,200,136,18,13,5,60
"2011","Great Yarmouth 001A","E01026605",1183,68,18,50,198,165,171,106,202,174,47,35,12,52
"2011","Great Yarmouth 001B","E01026606",1176,96,33,63,229,153,179,87,165,145,57,40,17,65
"2011","Great Yarmouth 001C","E01026607",1176,44,16,28,163,153,176,110,228,195,46,28,18,61
"2011","Great Yarmouth 001D","E01026627",1020,68,23,45,214,131,169,73,179,112,28,16,12,46
"2011","Great Yarmouth 001E","E01026628",1056,83,23,60,204,131,166,86,182,100,37,24,13,67
"2011","Great Yarmouth 001F","E01026629",1087,72,22,50,214,152,152,87,192,120,27,11,16,71
"2011","Great Yarmouth 002A","E01026608",967,94,31,63,213,139,160,60,151,88,29,20,9,33
"2011","Great Yarmouth 002B","E01026609",892,77,19,58,226,104,161,63,125,69,30,18,12,37
"2011","Great Yarmouth 002C","E01026636",1147,72,19,53,238,143,180,101,189,134,34,19,15,56
"2011","Great Yarmouth 002D","E01026637",1494,85,31,54,284,195,201,114,267,231,35,26,9,82
"2011","Great Yarmouth 002E","E01026638",1100,58,12,46,192,128,115,109,219,160,49,24,25,70
"2011","Great Yarmouth 003A","E01026589",1055,44,17,27,168,160,99,105,185,178,47,27,20,69
"2011","Great Yarmouth 003B","E01026590",1057,74,19,55,190,154,117,101,207,134,32,23,9,48
"2011","Great Yarmouth 003C","E01026591",1298,57,21,36,232,164,143,138,254,209,46,21,25,55
"2011","Great Yarmouth 003D","E01026592",1035,32,9,23,150,113,105,82,247,203,48,31,17,55
"2011","Great Yarmouth 003E","E01026593",957,59,15,44,179,138,135,80,170,124,22,15,7,50
"2011","Great Yarmouth 003F","E01026594",1203,55,14,41,218,141,135,101,237,174,57,35,22,85
"2011","Great Yarmouth 004A","E01026599",1063,34,11,23,124,124,107,84,233,199,72,40,32,86
"2011","Great Yarmouth 004B","E01026639",1167,43,12,31,173,130,155,98,216,184,85,53,32,83
"2011","Great Yarmouth 004C","E01026640",1035,42,14,28,176,120,118,102,221,158,49,32,17,49
"2011","Great Yarmouth 004D","E01026641",1028,21,5,16,88,76,66,114,247,232,102,67,35,82
"2011","Great Yarmouth 005A","E01026595",1206,28,12,16,154,110,101,133,279,258,88,43,45,55
"2011","Great Yarmouth 005B","E01026596",1189,41,10,31,155,135,114,131,255,223,51,32,19,84
"2011","Great Yarmouth 005C","E01026597",1366,31,7,24,110,89,114,108,332,314,169,85,84,99
"2011","Great Yarmouth 005D","E01026598",1242,28,9,19,123,81,143,111,329,222,129,76,53,76
"2011","Great Yarmouth 006A","E01026622",1061,13,7,6,85,71,59,94,244,278,140,96,44,77
"2011","Great Yarmouth 006B","E01026623",1191,33,5,28,126,74,154,124,265,207,144,74,70,64
"2011","Great Yarmouth 006C","E01026624",1325,40,5,35,137,84,124,108,306,257,171,113,58,98
"2011","Great Yarmouth 006D","E01026625",1228,19,6,13,100,56,80,105,269,307,210,140,70,82
"2011","Great Yarmouth 006E","E01026626",1412,43,15,28,158,93,119,113,358,281,162,95,67,85
"2011","Great Yarmouth 007A","E01026600",1040,38,11,27,120,117,81,93,240,203,80,53,27,68
"2011","Great Yarmouth 007B","E01026633",1364,29,10,19,164,127,116,148,331,242,102,47,55,105
"2011","Great Yarmouth 007C","E01026634",1083,26,7,19,151,82,62,122,248,225,101,59,42,66
"2011","Great Yarmouth 007D","E01026635",1644,41,10,31,195,161,119,158,378,331,159,89,70,102
"2011","Great Yarmouth 008A","E01026581",1246,88,29,59,249,207,114,103,250,132,24,14,10,79
"2011","Great Yarmouth 008B","E01026582",1410,109,39,70,302,218,122,151,247,157,38,28,10,66
"2011","Great Yarmouth 008C","E01026583",967,47,18,29,205,137,102,107,167,121,32,23,9,49
"2011","Great Yarmouth 008D","E01026584",1038,32,13,19,181,159,103,116,219,166,18,15,3,44
"2011","Great Yarmouth 009A","E01026601",1115,46,12,34,188,150,69,117,231,189,52,22,30,73
"2011","Great Yarmouth 009B","E01026602",1052,49,15,34,171,139,91,106,237,167,51,30,21,41
"2011","Great Yarmouth 009C","E01026603",1157,17,5,12,123,108,76,105,254,252,136,75,61,86
"2011","Great Yarmouth 009D","E01026604",1128,25,5,20,113,111,85,89,264,276,102,72,30,63
"2011","Great Yarmouth 009E","E01026632",1201,60,24,36,177,148,104,107,270,213,65,38,27,57
"2011","Great Yarmouth 010A","E01026610",1158,74,19,55,249,150,104,96,209,141,59,26,33,76
"2011","Great Yarmouth 010B","E01026611",1053,123,21,102,245,141,120,73,142,81,60,45,15,68
"2011","Great Yarmouth 010C","E01026612",1728,194,42,152,371,270,153,125,260,186,60,32,28,109
"2011","Great Yarmouth 010D","E01026630",1214,67,24,43,177,133,96,116,257,203,90,63,27,75
"2011","Great Yarmouth 010E","E01026631",1237,70,18,52,203,164,111,117,240,195,76,37,39,61
"2011","Great Yarmouth 011A","E01026617",890,39,8,31,143,112,65,72,188,156,57,29,28,58
"2011","Great Yarmouth 011B","E01026618",1181,115,17,98,221,158,96,92,207,149,67,40,27,76
"2011","Great Yarmouth 011C","E01026619",985,34,9,25,112,80,79,74,211,229,101,70,31,65
"2011","Great Yarmouth 011D","E01026620",881,23,4,19,103,57,58,91,229,199,66,42,24,55
"2011","Great Yarmouth 011E","E01026621",1005,49,14,35,156,114,83,92,198,176,47,23,24,90
"2011","Great Yarmouth 012A","E01026613",996,94,35,59,191,145,139,91,148,112,21,12,9,55
"2011","Great Yarmouth 012B","E01026614",1280,84,37,47,232,128,197,132,207,179,51,32,19,70
"2011","Great Yarmouth 012C","E01026615",1038,76,28,48,207,145,112,111,185,124,31,22,9,47
"2011","Great Yarmouth 012D","E01026616",929,53,16,37,159,123,102,106,165,140,19,13,6,62
"2011","Great Yarmouth 013A","E01026585",922,53,16,37,168,113,90,110,178,131,33,16,17,46
"2011","Great Yarmouth 013B","E01026586",718,40,7,33,111,94,69,80,136,123,31,16,15,34
"2011","Great Yarmouth 013C","E01026587",1287,84,26,58,269,200,120,122,226,168,27,12,15,71
"2011","Great Yarmouth 013D","E01026588",1871,114,41,73,425,276,186,168,320,244,60,37,23,78
"2011","King's Lynn and West Norfolk 001A","E01026680",866,40,12,28,143,106,101,78,193,120,44,28,16,41
"2011","King's Lynn and West Norfolk 001B","E01026681",1000,111,50,61,245,109,198,75,139,67,25,16,9,31
"2011","King's Lynn and West Norfolk 001C","E01026682",814,57,11,46,183,84,149,64,143,68,31,17,14,35
"2011","King's Lynn and West Norfolk 001D","E01026683",966,47,16,31,193,105,161,77,168,128,41,29,12,46
"2011","King's Lynn and West Norfolk 002A","E01026645",958,97,33,64,251,99,191,72,134,76,20,14,6,18
"2011","King's Lynn and West Norfolk 002B","E01026646",1179,106,30,76,246,107,249,83,180,120,44,31,13,44
"2011","King's Lynn and West Norfolk 002C","E01026656",1422,100,26,74,293,133,229,110,263,168,70,49,21,56
"2011","King's Lynn and West Norfolk 002D","E01026695",1603,147,33,114,346,174,281,129,243,188,48,32,16,47
"2011","King's Lynn and West Norfolk 003A","E01026676",1200,88,25,63,224,153,214,89,217,132,37,28,9,46
"2011","King's Lynn and West Norfolk 003B","E01026677",1035,43,9,34,166,109,158,81,239,143,36,19,17,60
"2011","King's Lynn and West Norfolk 003C","E01026678",1046,67,24,43,190,150,145,104,191,111,43,30,13,45
"2011","King's Lynn and West Norfolk 003D","E01026701",1148,70,18,52,242,156,157,82,216,161,18,11,7,46
"2011","King's Lynn and West Norfolk 003E","E01026702",900,58,15,43,173,100,129,95,157,122,31,22,9,35
"2011","King's Lynn and West Norfolk 003F","E01026703",859,92,27,65,213,92,142,67,132,68,27,15,12,26
"2011","King's Lynn and West Norfolk 004A","E01026653",1214,100,37,63,285,198,156,85,197,122,25,16,9,46
"2011","King's Lynn and West Norfolk 004B","E01026654",1063,61,17,44,188,150,119,100,205,138,39,19,20,63
"2011","King's Lynn and West Norfolk 004C","E01026655",957,92,19,73,202,139,104,80,169,100,27,16,11,44
"2011","King's Lynn and West Norfolk 004D","E01026718",1671,138,44,94,342,210,231,154,279,192,51,29,22,74
"2011","King's Lynn and West Norfolk 005A","E01026691",850,124,23,101,230,129,91,41,115,55,22,15,7,43
"2011","King's Lynn and West Norfolk 005B","E01026692",938,87,22,65,248,159,81,71,148,68,19,11,8,57
"2011","King's Lynn and West Norfolk 005C","E01026708",957,117,34,83,235,127,94,76,153,67,20,14,6,68
"2011","King's Lynn and West Norfolk 005D","E01026709",1320,162,40,122,377,215,106,97,170,84,24,11,13,85
"2011","King's Lynn and West Norfolk 005E","E01026710",880,92,23,69,239,122,104,76,130,53,15,12,3,49
"2011","King's Lynn and West Norfolk 006A","E01026669",1210,59,22,37,235,193,103,140,248,151,22,11,11,59
"2011","King's Lynn and West Norfolk 006B","E01026670",1140,38,15,23,172,109,73,111,279,202,83,66,17,73
"2011","King's Lynn and West Norfolk 006C","E01026671",1066,58,16,42,208,154,82,110,227,132,18,15,3,77
"2011","King's Lynn and West Norfolk 006D","E01026672",1112,64,15,49,218,169,100,108,209,136,29,21,8,79
"2011","King's Lynn and West Norfolk 006E","E01026673",1132,61,20,41,242,212,83,127,205,124,25,17,8,53
"2011","King's Lynn and West Norfolk 007A","E01026687",1076,12,6,6,79,72,66,111,297,235,130,93,37,74
"2011","King's Lynn and West Norfolk 007B","E01026688",1002,24,9,15,80,73,78,98,261,212,105,69,36,71
"2011","King's Lynn and West Norfolk 007C","E01026689",1179,34,11,23,141,95,71,114,346,231,80,42,38,67
"2011","King's Lynn and West Norfolk 007D","E01026690",1051,6,1,5,87,64,72,108,269,254,110,66,44,81
"2011","King's Lynn and West Norfolk 008A","E01026647",1636,95,25,70,232,252,191,150,346,223,60,48,12,87
"2011","King's Lynn and West Norfolk 008B","E01026711",1106,57,20,37,141,118,131,96,245,171,71,44,27,76
"2011","King's Lynn and West Norfolk 008C","E01026712",1192,98,31,67,217,165,133,111,219,166,31,19,12,52
"2011","King's Lynn and West Norfolk 008D","E01026713",1152,78,31,47,228,141,203,101,177,133,34,26,8,57
"2011","King's Lynn and West Norfolk 009A","E01026666",1309,36,9,27,130,108,91,115,341,270,112,71,41,106
"2011","King's Lynn and West Norfolk 009B","E01026667",1253,78,20,58,261,151,105,94,259,160,47,31,16,98
"2011","King's Lynn and West Norfolk 009C","E01026668",1176,69,17,52,196,117,99,111,265,174,58,41,17,87
"2011","King's Lynn and West Norfolk 009D","E01026693",1370,67,23,44,243,161,128,120,295,204,62,41,21,90
"2011","King's Lynn and West Norfolk 010A","E01026662",1724,68,15,53,205,151,113,167,432,312,175,117,58,101
"2011","King's Lynn and West Norfolk 010B","E01026663",1219,40,15,25,179,125,78,121,287,224,74,39,35,91
"2011","King's Lynn and West Norfolk 010C","E01026664",1683,93,21,72,372,184,105,183,365,245,59,30,29,77
"2011","King's Lynn and West Norfolk 010D","E01026714",1531,197,45,152,402,221,115,114,203,155,24,14,10,100
"2011","King's Lynn and West Norfolk 011A","E01026698",1433,85,20,65,250,135,115,140,296,231,105,69,36,76
"2011","King's Lynn and West Norfolk 011B","E01026699",1161,33,6,27,137,68,78,114,320,280,96,62,34,35
"2011","King's Lynn and West Norfolk 011C","E01026700",1154,66,16,50,182,99,90,79,275,215,91,50,41,57
"2011","King's Lynn and West Norfolk 011D","E01026704",1296,34,13,21,136,76,76,137,323,299,124,81,43,91
"2011","King's Lynn and West Norfolk 011E","E01026705",1112,53,23,30,178,151,112,122,232,167,47,31,16,50
"2011","King's Lynn and West Norfolk 011F","E01026706",1183,46,9,37,170,107,75,121,298,242,51,34,17,73
"2011","King's Lynn and West Norfolk 012A","E01026665",1666,165,49,116,346,222,188,119,273,212,56,44,12,85
"2011","King's Lynn and West Norfolk 012B","E01026674",849,72,20,52,183,110,100,84,129,101,23,14,9,47
"2011","King's Lynn and West Norfolk 012C","E01026675",907,76,24,52,186,113,124,89,163,85,23,14,9,48
"2011","King's Lynn and West Norfolk 012D","E01026694",1793,165,46,119,372,192,274,132,288,238,44,28,16,88
"2011","King's Lynn and West Norfolk 013A","E01026684",877,58,17,41,152,92,151,66,145,122,41,24,17,50
"2011","King's Lynn and West Norfolk 013B","E01026685",931,59,27,32,162,107,121,73,184,130,49,40,9,46
"2011","King's Lynn and West Norfolk 013C","E01026719",1717,94,43,51,312,212,245,145,320,229,80,41,39,80
"2011","King's Lynn and West Norfolk 013D","E01026720",999,72,24,48,174,120,170,95,168,118,33,22,11,49
"2011","King's Lynn and West Norfolk 013E","E01026721",950,60,22,38,165,97,166,86,161,111,47,37,10,57
"2011","King's Lynn and West Norfolk 014A","E01026642",975,80,30,50,209,142,108,95,160,98,33,23,10,50
"2011","King's Lynn and West Norfolk 014B","E01026643",1084,85,37,48,193,163,151,100,183,124,27,18,9,58
"2011","King's Lynn and West Norfolk 014C","E01026644",2119,220,145,75,645,666,48,188,154,113,35,16,19,50
"2011","King's Lynn and West Norfolk 014D","E01026723",1182,130,32,98,268,179,118,92,195,113,24,15,9,63
"2011","King's Lynn and West Norfolk 014E","E01026724",1114,102,20,82,232,156,149,92,176,113,44,29,15,50
"2011","King's Lynn and West Norfolk 014F","E01026725",1085,116,36,80,227,139,162,97,156,114,27,16,11,47
"2011","King's Lynn and West Norfolk 015A","E01026696",866,44,13,31,128,93,99,101,182,112,50,29,21,57
"2011","King's Lynn and West Norfolk 015B","E01026697",966,44,9,35,177,117,147,94,178,116,47,29,18,46
"2011","King's Lynn and West Norfolk 015C","E01026722",1795,145,48,97,366,255,197,173,302,201,66,38,28,90
"2011","King's Lynn and West Norfolk 015D","E01026726",1551,102,39,63,296,163,204,151,300,185,61,41,20,89
"2011","King's Lynn and West Norfolk 016A","E01026659",1139,61,19,42,168,126,159,113,220,186,54,31,23,52
"2011","King's Lynn and West Norfolk 016B","E01026660",1196,69,29,40,178,135,186,108,234,173,47,25,22,66
"2011","King's Lynn and West Norfolk 016C","E01026661",1087,62,23,39,183,128,171,108,194,129,53,34,19,59
"2011","King's Lynn and West Norfolk 016D","E01026715",1069,79,20,59,201,145,178,73,176,133,39,22,17,45
"2011","King's Lynn and West Norfolk 016E","E01026716",1357,115,26,89,215,162,185,118,218,205,59,30,29,80
"2011","King's Lynn and West Norfolk 016F","E01026717",1143,80,22,58,212,111,198,91,191,144,49,35,14,67
"2011","King's Lynn and West Norfolk 017C","E01026686",1308,103,48,55,294,209,97,131,248,162,29,14,15,35
"2011","King's Lynn and West Norfolk 017D","E01026707",1270,85,29,56,246,230,141,102,259,154,28,14,14,25
"2011","King's Lynn and West Norfolk 017E","E01033036",1105,106,32,74,239,163,112,95,159,119,39,21,18,73
"2011","King's Lynn and West Norfolk 017F","E01033037",1076,98,39,59,227,123,79,94,204,123,41,21,20,87
"2011","King's Lynn and West Norfolk 017G","E01033038",1171,83,25,58,215,145,123,113,225,145,60,28,32,62
"2011","King's Lynn and West Norfolk 017H","E01033039",678,58,20,38,156,90,83,55,102,73,25,16,9,36
"2011","King's Lynn and West Norfolk 018A","E01026679",1782,142,41,101,331,189,273,158,308,231,53,35,18,97
"2011","King's Lynn and West Norfolk 018B","E01026727",1858,159,58,101,402,227,286,150,288,227,49,36,13,70
"2011","King's Lynn and West Norfolk 018C","E01026728",1679,130,46,84,350,208,219,142,272,216,58,39,19,84
"2011","King's Lynn and West Norfolk 019A","E01026648",1122,75,37,38,227,137,153,118,189,133,39,29,10,51
"2011","King's Lynn and West Norfolk 019B","E01026649",1121,68,23,45,208,119,153,113,185,178,42,26,16,55
"2011","King's Lynn and West Norfolk 019C","E01026650",868,55,21,34,186,139,86,71,128,95,32,29,3,76
"2011","King's Lynn and West Norfolk 019D","E01026651",1666,148,52,96,330,206,271,134,230,211,51,28,23,85
"2011","King's Lynn and West Norfolk 019E","E01026652",966,52,15,37,160,107,139,100,198,145,26,15,11,39
"2011","North Norfolk 001A","E01026770",1314,93,10,83,299,145,231,118,217,112,55,45,10,44
"2011","North Norfolk 001B","E01026771",1107,72,18,54,250,117,194,94,172,128,38,27,11,42
"2011","North Norfolk 001C","E01026772",1166,106,30,76,317,160,152,67,187,107,15,11,4,55
"2011","North Norfolk 001D","E01026773",1388,106,32,74,281,182,220,102,236,167,40,20,20,54
"2011","North Norfolk 002A","E01026739",1430,155,34,121,363,120,303,91,184,109,47,39,8,58
"2011","North Norfolk 002B","E01026763",949,45,13,32,152,51,135,98,216,167,42,28,14,43
"2011","North Norfolk 002C","E01026764",879,68,19,49,214,74,169,87,118,90,24,15,9,35
"2011","North Norfolk 002D","E01026765",971,102,28,74,211,83,209,68,139,91,26,19,7,42
"2011","North Norfolk 003A","E01026734",952,39,12,27,185,65,131,93,208,119,89,62,27,23
"2011","North Norfolk 003B","E01026735",827,60,20,40,139,88,125,76,189,90,45,30,15,15
"2011","North Norfolk 003C","E01026736",889,42,12,30,177,102,120,84,187,116,36,26,10,25
"2011","North Norfolk 003D","E01026777",828,58,10,48,161,115,98,64,182,103,23,14,9,24
"2011","North Norfolk 003E","E01026778",874,79,18,61,199,108,128,47,170,92,23,17,6,28
"2011","North Norfolk 003F","E01026779",1039,36,12,24,158,104,105,91,258,155,80,56,24,52
"2011","North Norfolk 004A","E01026741",1269,138,34,104,322,133,227,85,180,115,31,22,9,38
"2011","North Norfolk 004B","E01026742",938,66,19,47,234,133,101,46,112,40,19,15,4,187
"2011","North Norfolk 004C","E01026743",1473,99,33,66,297,122,220,131,292,212,56,35,21,44
"2011","North Norfolk 005A","E01026762",1741,118,38,80,373,216,297,156,294,169,49,33,16,69
"2011","North Norfolk 005B","E01026766",1718,136,47,89,398,200,306,124,272,143,59,30,29,80
"2011","North Norfolk 005C","E01026781",1555,141,41,100,339,174,292,92,211,167,59,39,20,80
"2011","North Norfolk 006A","E01026731",679,48,11,37,169,78,101,47,116,81,15,9,6,24
"2011","North Norfolk 006B","E01026732",947,87,16,71,237,102,184,71,124,82,19,14,5,41
"2011","North Norfolk 006C","E01026733",1674,132,29,103,379,174,345,105,233,178,55,32,23,73
"2011","North Norfolk 006D","E01026737",1771,202,54,148,448,177,312,104,249,145,31,21,10,103
"2011","North Norfolk 007A","E01026738",1820,150,46,104,358,212,320,153,298,185,52,31,21,92
"2011","North Norfolk 007B","E01026750",942,53,22,31,181,107,145,79,176,107,57,43,14,37
"2011","North Norfolk 007C","E01026751",916,49,14,35,182,127,134,75,176,107,30,13,17,36
"2011","North Norfolk 007D","E01026752",1063,72,24,48,199,137,199,76,183,122,41,23,18,34
"2011","North Norfolk 008A","E01026729",1675,150,34,116,376,157,291,132,267,163,70,54,16,69
"2011","North Norfolk 008B","E01026730",1785,108,18,90,348,172,315,143,335,226,48,31,17,90
"2011","North Norfolk 008C","E01026788",919,84,26,58,204,109,164,64,154,75,18,11,7,47
"2011","North Norfolk 009A","E01026780",1864,122,30,92,366,161,260,208,369,257,50,22,28,71
"2011","North Norfolk 009B","E01026782",1601,115,25,90,295,132,251,164,288,246,57,29,28,53
"2011","North Norfolk 009C","E01026787",746,69,22,47,137,80,129,54,146,87,16,12,4,28
"2011","North Norfolk 010A","E01026753",1061,41,14,27,166,93,101,84,268,168,83,43,40,57
"2011","North Norfolk 010B","E01026754",1023,68,21,47,203,161,92,73,210,129,27,14,13,60
"2011","North Norfolk 010C","E01026755",811,63,20,43,163,126,112,61,138,76,33,22,11,39
"2011","North Norfolk 010D","E01026756",846,33,11,22,115,89,107,76,195,130,60,32,28,41
"2011","North Norfolk 010E","E01026757",1143,63,23,40,233,178,115,118,214,142,31,21,10,49
"2011","North Norfolk 010F","E01026758",1019,43,11,32,174,125,90,118,251,150,27,15,12,41
"2011","North Norfolk 010G","E01026759",855,44,13,31,135,100,114,91,171,118,27,17,10,55
"2011","North Norfolk 010H","E01026760",907,61,15,46,184,114,106,79,167,105,42,20,22,49
"2011","North Norfolk 010I","E01026761",1105,62,16,46,191,128,127,114,236,152,55,31,24,40
"2011","North Norfolk 011A","E01026745",1191,58,16,42,219,110,120,126,283,184,36,22,14,55
"2011","North Norfolk 011B","E01026746",1246,78,21,57,244,161,126,123,266,159,28,13,15,61
"2011","North Norfolk 011C","E01026747",941,41,13,28,180,84,102,102,202,166,33,24,9,31
"2011","North Norfolk 011D","E01026748",1013,56,20,36,166,153,146,101,194,132,24,18,6,41
"2011","North Norfolk 011E","E01026749",975,48,16,32,153,113,95,88,212,147,63,42,21,56
"2011","North Norfolk 012A","E01026740",1804,146,41,105,371,206,310,141,286,184,91,75,16,69
"2011","North Norfolk 012B","E01026767",960,76,13,63,195,119,156,78,174,105,24,13,11,33
"2011","North Norfolk 012C","E01026768",1387,72,21,51,241,139,179,168,261,227,61,46,15,39
"2011","North Norfolk 012D","E01026789",926,77,23,54,205,108,167,65,144,86,26,15,11,48
"2011","North Norfolk 012E","E01026790",870,89,22,67,190,98,134,58,126,83,48,36,12,44
"2011","North Norfolk 013A","E01026774",1077,77,21,56,211,135,121,99,220,147,25,19,6,42
"2011","North Norfolk 013B","E01026775",854,27,3,24,104,98,75,80,223,137,61,40,21,49
"2011","North Norfolk 013C","E01026776",1169,63,13,50,216,110,194,108,237,146,45,22,23,50
"2011","North Norfolk 013D","E01026786",1634,127,37,90,344,188,302,137,241,180,45,27,18,70
"2011","North Norfolk 014A","E01026744",1336,122,49,73,280,188,184,100,234,137,47,29,18,44
"2011","North Norfolk 014B","E01026769",1531,183,54,129,361,167,286,88,218,129,40,20,20,59
"2011","North Norfolk 014C","E01026783",1329,113,48,65,271,173,195,104,253,142,32,22,10,46
"2011","North Norfolk 014D","E01026784",723,57,11,46,134,86,101,53,133,94,36,24,12,29
"2011","North Norfolk 014E","E01026785",1008,89,23,66,214,125,159,65,169,106,46,32,14,35
"2011","Norwich 001A","E01026797",1846,135,30,105,373,252,148,190,327,261,71,36,35,89
"2011","Norwich 001B","E01026798",1120,38,7,31,128,88,92,105,255,261,85,54,31,68
"2011","Norwich 001C","E01026799",1084,41,6,35,145,128,67,96,253,235,71,37,34,48
"2011","Norwich 001D","E01026800",1464,82,14,68,218,123,116,117,283,292,137,79,58,96
"2011","Norwich 001E","E01026801",1189,111,24,87,256,181,106,88,203,144,37,21,16,63
"2011","Norwich 001F","E01026802",1247,71,13,58,215,168,96,96,234,178,66,34,32,123
"2011","Norwich 002A","E01026828",1182,38,8,30,119,124,74,99,238,309,101,65,36,80
"2011","Norwich 002B","E01026829",1522,88,11,77,225,190,97,123,303,259,124,77,47,113
"2011","Norwich 002C","E01026830",975,47,7,40,162,99,61,83,208,183,84,49,35,48
"2011","Norwich 002D","E01026831",1044,109,20,89,279,136,81,70,149,95,36,15,21,89
"2011","Norwich 002E","E01026832",936,24,8,16,82,102,68,85,208,195,98,63,35,74
"2011","Norwich 002F","E01026833",990,21,7,14,91,89,62,105,241,224,122,70,52,35
"2011","Norwich 002G","E01026834",1049,31,3,28,102,107,78,96,255,238,83,61,22,59
"2011","Norwich 003A","E01026841",1211,131,14,117,284,183,77,83,186,135,36,29,7,96
"2011","Norwich 003B","E01026842",1353,138,26,112,317,215,128,102,178,135,46,30,16,94
"2011","Norwich 003C","E01026843",1426,106,12,94,285,177,109,122,257,195,89,59,30,86
"2011","Norwich 003D","E01026844",1289,70,10,60,214,172,80,119,231,221,100,64,36,82
"2011","Norwich 003E","E01026845",1297,119,21,98,348,225,88,93,168,148,31,18,13,77
"2011","Norwich 003F","E01026846",1333,110,12,98,323,186,100,89,212,138,64,45,19,111
"2011","Norwich 004A","E01026803",930,32,6,26,105,100,69,80,219,194,77,50,27,54
"2011","Norwich 004B","E01026804",984,44,5,39,171,127,83,97,201,162,39,23,16,60
"2011","Norwich 004C","E01026805",907,22,10,12,80,104,82,90,238,192,45,27,18,54
"2011","Norwich 004D","E01026806",1246,62,17,45,201,161,132,114,241,209,82,67,15,44
"2011","Norwich 004E","E01026807",893,76,16,60,192,114,72,66,172,124,34,22,12,43
"2011","Norwich 004F","E01026808",887,32,3,29,113,72,62,75,197,173,89,58,31,74
"2011","Norwich 004G","E01026809",1054,28,6,22,107,127,79,98,263,231,81,49,32,40
"2011","Norwich 005A","E01026791",1118,52,9,43,142,105,69,81,227,185,93,55,38,164
"2011","Norwich 005B","E01026792",1052,56,11,45,176,125,69,83,207,191,55,34,21,90
"2011","Norwich 005C","E01026793",1203,44,5,39,114,110,71,81,236,263,109,76,33,175
"2011","Norwich 005D","E01026794",1565,123,18,105,306,201,113,139,283,191,82,57,25,127
"2011","Norwich 005F","E01026796",1208,38,9,29,133,81,70,65,176,201,74,47,27,370
"2011","Norwich 005G","E01033435",1394,220,17,203,267,129,60,59,150,89,50,40,10,370
"2011","Norwich 005H","E01033436",999,62,14,48,116,103,46,61,194,171,84,57,27,162
"2011","Norwich 006A","E01026863",1471,133,22,111,272,157,105,89,164,137,56,36,20,358
"2011","Norwich 006B","E01026864",1121,58,10,48,213,157,114,101,201,156,44,24,20,77
"2011","Norwich 006C","E01026865",1395,73,9,64,180,109,96,101,253,261,112,67,45,210
"2011","Norwich 006D","E01026866",1265,128,13,115,263,146,85,74,179,126,47,24,23,217
"2011","Norwich 006E","E01026867",1077,36,4,32,88,61,78,86,234,222,119,82,37,153
"2011","Norwich 006F","E01026868",1140,59,4,55,109,91,80,72,196,207,88,63,25,238
"2011","Norwich 006G","E01026869",1006,19,2,17,91,62,77,87,245,256,104,51,53,65
"2011","Norwich 007A","E01026822",1674,204,22,182,321,192,114,125,244,177,135,80,55,162
"2011","Norwich 007B","E01026823",1687,269,28,241,348,183,122,110,208,127,85,51,34,235
"2011","Norwich 007C","E01026824",1183,88,10,78,185,124,85,78,230,201,76,40,36,116
"2011","Norwich 007D","E01026825",1065,92,14,78,227,112,92,74,162,130,63,40,23,113
"2011","Norwich 007E","E01026826",1100,69,11,58,188,113,90,83,199,183,105,62,43,70
"2011","Norwich 007F","E01026827",1110,51,6,45,140,117,89,84,228,229,106,67,39,66
"2011","Norwich 009A","E01026835",1217,185,18,167,305,100,74,31,87,39,27,20,7,369
"2011","Norwich 009B","E01026836",1244,200,28,172,375,118,65,24,77,43,16,5,11,326
"2011","Norwich 009C","E01026837",1203,232,33,199,339,101,80,48,120,52,28,14,14,203
"2011","Norwich 009D","E01026838",1184,221,26,195,325,105,76,33,60,39,17,14,3,308
"2011","Norwich 009E","E01026839",1374,167,16,151,293,127,59,37,87,43,23,11,12,538
"2011","Norwich 009F","E01026840",1386,191,24,167,384,164,96,56,114,78,25,10,15,278
"2011","Norwich 010A","E01026858",1069,44,7,37,117,77,50,77,190,188,67,35,32,259
"2011","Norwich 010B","E01026859",1104,86,13,73,207,107,67,75,153,121,60,41,19,228
"2011","Norwich 010C","E01026860",4026,74,10,64,109,81,49,43,110,94,60,42,18,3406
"2011","Norwich 010D","E01026861",1143,39,11,28,96,85,65,71,187,167,74,44,30,359
"2011","Norwich 010E","E01026862",952,76,12,64,166,85,56,54,130,105,41,30,11,239
"2011","Norwich 011A","E01026852",924,196,41,155,292,132,71,38,78,37,14,10,4,66
"2011","Norwich 011B","E01026853",1342,159,22,137,254,157,99,103,227,192,82,49,33,69
"2011","Norwich 011D","E01026855",1286,191,21,170,332,130,104,51,125,74,34,20,14,245
"2011","Norwich 011E","E01026856",1566,208,15,193,382,137,68,42,102,85,50,27,23,492
"2011","Norwich 011F","E01026857",1122,204,34,170,316,101,79,38,69,60,19,12,7,236
"2011","Norwich 011G","E01033434",926,197,16,181,260,129,63,28,74,45,20,12,8,110
"2011","Norwich 011H","E01033437",1060,83,16,67,175,118,67,67,189,147,94,56,38,120
"2011","Norwich 012A","E01026810",963,189,35,154,234,134,81,37,99,61,25,14,11,103
"2011","Norwich 012B","E01026811",1051,257,43,214,334,145,83,37,72,37,13,7,6,73
"2011","Norwich 012C","E01026812",1044,199,28,171,315,165,80,51,108,50,17,10,7,59
"2011","Norwich 012D","E01026813",990,200,26,174,294,153,65,34,98,49,24,15,9,73
"2011","Norwich 012E","E01026814",1051,92,16,76,130,119,77,65,182,149,43,26,17,194
"2011","Norwich 012F","E01026815",1084,256,36,220,335,103,79,28,63,31,19,15,4,170
"2011","Norwich 013A","E01026816",1324,167,25,142,349,180,104,59,193,114,73,50,23,85
"2011","Norwich 013B","E01026817",1009,97,25,72,176,121,79,66,223,136,69,51,18,42
"2011","Norwich 013C","E01026818",1021,54,10,44,136,85,85,92,229,197,78,47,31,65
"2011","Norwich 013D","E01026819",1022,43,13,30,142,102,60,83,225,204,91,70,21,72
"2011","Norwich 013E","E01026820",1134,47,15,32,152,108,82,114,259,222,74,51,23,76
"2011","Norwich 013F","E01026821",1020,38,9,29,121,114,74,82,241,219,68,45,23,63
"2011","Norwich 014A","E01033438",1006,147,25,122,264,130,73,68,106,72,62,34,28,84
"2011","Norwich 014B","E01033439",1209,165,24,141,285,167,80,92,191,99,61,33,28,69
"2011","Norwich 014C","E01033440",950,141,14,127,197,106,53,67,135,117,58,30,28,76
"2011","Norwich 014D","E01033441",1106,285,39,246,299,116,63,68,89,52,48,27,21,86
"2011","Norwich 015A","E01026848",1366,85,14,71,184,170,95,110,285,258,107,71,36,72
"2011","Norwich 015B","E01026849",1463,247,31,216,448,210,115,84,147,68,68,45,23,76
"2011","Norwich 015C","E01026850",1470,183,24,159,383,227,139,97,195,141,48,22,26,57
"2011","South Norfolk 001A","E01026916",1484,124,30,94,278,257,174,133,243,186,33,21,12,56
"2011","South Norfolk 001B","E01026917",1025,77,14,63,193,148,124,87,191,129,24,17,7,52
"2011","South Norfolk 001C","E01026918",1260,77,16,61,190,179,148,126,259,194,34,19,15,53
"2011","South Norfolk 001E","E01026924",1096,131,23,108,241,159,126,77,151,102,46,31,15,63
"2011","South Norfolk 001F","E01026925",1539,124,28,96,253,208,135,125,287,219,92,59,33,96
"2011","South Norfolk 001G","E01033538",1592,223,33,190,437,254,118,126,221,114,40,28,12,59
"2011","South Norfolk 001H","E01033540",1124,136,35,101,234,156,125,74,189,128,45,31,14,37
"2011","South Norfolk 002A","E01026881",975,209,42,167,299,127,86,49,88,48,21,13,8,48
"2011","South Norfolk 002B","E01026882",1399,322,41,281,461,184,125,41,101,40,24,17,7,101
"2011","South Norfolk 002C","E01026883",1189,203,32,171,312,157,130,72,144,76,22,14,8,73
"2011","South Norfolk 002D","E01026895",1153,133,46,87,264,175,96,90,164,93,26,14,12,112
"2011","South Norfolk 002E","E01026896",900,139,33,106,232,107,138,47,110,66,19,12,7,42
"2011","South Norfolk 003A","E01026905",691,58,13,45,120,114,56,51,133,109,20,11,9,30
"2011","South Norfolk 003B","E01026906",1041,127,26,101,246,202,98,74,141,64,24,18,6,65
"2011","South Norfolk 003C","E01026907",1294,206,48,158,374,186,118,75,161,80,26,15,11,68
"2011","South Norfolk 003D","E01026908",1046,153,28,125,293,182,94,62,104,48,29,17,12,81
"2011","South Norfolk 004A","E01026909",1016,109,22,87,214,121,128,76,175,114,38,26,12,41
"2011","South Norfolk 004B","E01026910",1081,134,31,103,290,157,175,60,139,65,17,13,4,44
"2011","South Norfolk 004C","E01026947",925,136,28,108,228,114,141,75,105,66,11,6,5,49
"2011","South Norfolk 004D","E01026948",1227,157,41,116,245,139,144,50,104,58,22,10,12,308
"2011","South Norfolk 005A","E01026870",1100,137,25,112,248,151,107,79,180,108,42,29,13,48
"2011","South Norfolk 005B","E01026871",975,113,39,74,252,148,87,72,142,91,15,8,7,55
"2011","South Norfolk 005C","E01026921",1014,73,16,57,213,180,88,91,188,116,15,7,8,50
"2011","South Norfolk 005D","E01026922",982,81,17,64,202,132,93,71,174,141,38,17,21,50
"2011","South Norfolk 006A","E01026875",836,138,30,108,230,120,113,40,82,52,10,5,5,51
"2011","South Norfolk 006B","E01026876",1054,148,38,110,262,147,179,62,104,86,17,11,6,49
"2011","South Norfolk 006C","E01026926",1122,126,33,93,264,178,160,76,162,76,16,13,3,64
"2011","South Norfolk 006D","E01026927",1344,199,43,156,365,217,119,87,163,95,18,10,8,81
"2011","South Norfolk 006E","E01026928",986,109,20,89,234,155,91,84,158,89,21,15,6,45
"2011","South Norfolk 006F","E01026936",995,115,29,86,250,155,118,71,132,80,18,13,5,56
"2011","South Norfolk 006G","E01026937",1039,180,36,144,307,139,116,37,98,63,34,18,16,65
"2011","South Norfolk 007A","E01026884",838,78,24,54,176,105,86,59,135,114,37,19,18,48
"2011","South Norfolk 007B","E01026885",1061,132,23,109,256,137,143,66,116,122,21,14,7,68
"2011","South Norfolk 007C","E01026933",1953,216,46,170,476,303,150,138,331,186,47,27,20,106
"2011","South Norfolk 007D","E01026945",1567,220,49,171,416,250,164,109,193,100,27,21,6,88
"2011","South Norfolk 007E","E01026946",743,64,17,47,175,89,70,60,153,71,21,17,4,40
"2011","South Norfolk 008A","E01026879",885,74,16,58,183,110,123,44,128,80,28,11,17,115
"2011","South Norfolk 008B","E01026880",1051,128,29,99,268,151,164,50,141,65,30,24,6,54
"2011","South Norfolk 008C","E01026911",751,61,16,45,160,119,76,29,131,103,31,25,6,41
"2011","South Norfolk 008D","E01026912",1110,109,19,90,248,158,138,66,180,109,19,9,10,83
"2011","South Norfolk 008E","E01026929",942,148,37,111,248,117,134,59,124,54,16,8,8,42
"2011","South Norfolk 008F","E01026930",1098,177,42,135,290,149,149,43,122,85,19,9,10,64
"2011","South Norfolk 009A","E01026913",1217,131,36,95,299,177,133,85,188,117,31,18,13,56
"2011","South Norfolk 009B","E01026914",1111,154,39,115,288,150,162,73,112,77,30,19,11,65
"2011","South Norfolk 009C","E01026915",1442,207,58,149,411,216,125,84,198,114,14,11,3,73
"2011","South Norfolk 009D","E01026919",1068,122,27,95,246,152,127,78,163,105,23,12,11,52
"2011","South Norfolk 009E","E01026920",843,121,24,97,206,116,111,47,104,79,17,11,6,42
"2011","South Norfolk 009F","E01026941",905,168,40,128,230,106,149,44,89,50,11,9,2,58
"2011","South Norfolk 009G","E01026942",860,117,26,91,234,138,83,72,98,57,17,7,10,44
"2011","South Norfolk 010A","E01026898",1017,100,24,76,223,114,152,74,158,112,33,25,8,51
"2011","South Norfolk 010B","E01026899",1063,98,29,69,226,130,187,87,153,104,36,24,12,42
"2011","South Norfolk 010C","E01026943",1194,138,44,94,284,134,190,66,163,128,35,19,16,56
"2011","South Norfolk 010D","E01026944",847,86,24,62,188,104,127,51,129,90,26,18,8,46
"2011","South Norfolk 011A","E01026877",1120,126,39,87,251,155,225,75,145,82,15,12,3,46
"2011","South Norfolk 011B","E01026878",878,86,19,67,198,102,138,65,125,88,25,12,13,51
"2011","South Norfolk 011C","E01026897",2023,265,69,196,500,254,275,148,261,168,42,28,14,110
"2011","South Norfolk 011D","E01026938",1467,142,30,112,342,227,143,105,253,153,32,15,17,70
"2011","South Norfolk 011E","E01026939",1295,132,40,92,273,179,149,117,199,142,32,18,14,72
"2011","South Norfolk 011F","E01026940",1246,113,27,86,228,150,146,110,249,135,43,24,19,72
"2011","South Norfolk 012A","E01026892",922,85,26,59,158,105,133,91,154,114,29,19,10,53
"2011","South Norfolk 012B","E01026893",763,71,17,54,168,91,105,65,120,81,23,12,11,39
"2011","South Norfolk 012C","E01026894",1773,172,43,129,334,211,308,142,271,208,41,26,15,86
"2011","South Norfolk 012D","E01026903",897,94,15,79,207,119,150,46,125,73,20,12,8,63
"2011","South Norfolk 012E","E01026904",992,101,28,73,224,124,184,58,125,94,27,14,13,55
"2011","South Norfolk 013A","E01026872",1601,178,40,138,392,167,282,108,219,141,48,31,17,66
"2011","South Norfolk 013B","E01026900",980,50,6,44,218,102,125,98,182,141,26,15,11,38
"2011","South Norfolk 013C","E01026901",955,65,22,43,199,122,98,82,189,149,21,9,12,30
"2011","South Norfolk 013D","E01026902",1328,70,25,45,212,143,144,145,297,218,56,35,21,43
"2011","South Norfolk 014A","E01026873",942,100,26,74,191,120,169,54,135,102,36,27,9,35
"2011","South Norfolk 014B","E01026874",1158,141,25,116,264,106,223,71,140,90,58,41,17,65
"2011","South Norfolk 014C","E01026886",1061,103,38,65,234,146,182,78,153,96,26,15,11,43
"2011","South Norfolk 014D","E01026887",1052,90,27,63,191,123,190,97,161,131,17,8,9,52
"2011","South Norfolk 014E","E01026934",746,50,13,37,146,101,85,59,131,119,26,21,5,29
"2011","South Norfolk 014F","E01026935",967,92,13,79,243,114,171,68,123,97,28,24,4,31
"2011","South Norfolk 015A","E01026888",1031,78,18,60,152,109,121,92,214,166,49,25,24,50
"2011","South Norfolk 015B","E01026889",1098,87,21,66,211,157,141,86,202,145,21,11,10,48
"2011","South Norfolk 015D","E01026891",1160,80,18,62,239,116,116,84,209,192,66,44,22,58
"2011","South Norfolk 015E","E01026931",875,52,14,38,176,126,84,87,158,105,42,36,6,45
"2011","South Norfolk 015F","E01026932",897,60,16,44,169,127,104,77,172,117,21,12,9,50
"2011","South Norfolk 015G","E01033539",1017,77,15,62,206,142,86,97,175,147,41,22,19,46
"2011","South Norfolk 015H","E01033541",1023,65,16,49,177,129,99,83,193,175,46,35,11,56
"2011","Babergh 001A","E01029876",1505,188,66,122,330,154,242,115,204,143,47,28,19,82
"2011","Babergh 001B","E01029898",1205,145,38,107,272,133,220,80,163,122,26,13,13,44
"2011","Babergh 001C","E01029907",1585,216,64,152,418,194,274,82,162,118,45,24,21,76
"2011","Babergh 002A","E01029881",1425,192,59,133,337,188,250,99,154,101,23,14,9,81
"2011","Babergh 002B","E01029884",1151,68,24,44,186,123,178,97,229,160,52,27,25,58
"2011","Babergh 002C","E01029885",1624,153,43,110,336,204,277,125,228,189,45,30,15,67
"2011","Babergh 003A","E01029900",1144,91,32,59,242,138,147,86,193,152,39,27,12,56
"2011","Babergh 003B","E01029901",1605,179,67,112,384,209,249,101,223,163,48,27,21,49
"2011","Babergh 003C","E01029917",1330,119,39,80,302,185,168,96,231,144,28,13,15,57
"2011","Babergh 004A","E01029892",1265,64,19,45,231,111,144,116,282,190,67,39,28,60
"2011","Babergh 004B","E01029893",1837,217,66,151,510,236,172,140,241,167,48,31,17,106
"2011","Babergh 004C","E01029894",852,93,21,72,192,124,80,85,126,94,15,10,5,43
"2011","Babergh 004D","E01029895",873,88,32,56,250,130,85,54,132,66,18,8,10,50
"2011","Babergh 004E","E01029896",907,91,22,69,184,121,89,61,159,96,36,22,14,70
"2011","Babergh 004F","E01029911",1608,194,56,138,418,226,221,102,187,143,34,16,18,83
"2011","Babergh 005A","E01029877",939,129,47,82,256,130,152,53,87,63,15,9,6,54
"2011","Babergh 005B","E01029878",867,105,24,81,218,154,109,49,100,74,17,11,6,41
"2011","Babergh 005C","E01029879",1125,118,36,82,280,157,153,80,154,106,26,12,14,51
"2011","Babergh 005D","E01029908",1239,164,29,135,390,261,81,67,130,90,9,5,4,47
"2011","Babergh 005E","E01029909",1232,135,22,113,275,239,93,88,194,124,22,3,19,62
"2011","Babergh 005F","E01029910",855,62,12,50,159,115,62,64,163,136,42,17,25,52
"2011","Babergh 006A","E01029880",1230,143,32,111,306,151,225,88,124,95,31,19,12,67
"2011","Babergh 006B","E01029921",921,98,32,66,219,132,137,59,108,105,27,20,7,36
"2011","Babergh 006C","E01029922",956,93,33,60,197,121,164,61,144,107,23,13,10,46
"2011","Babergh 006D","E01029923",1052,99,36,63,219,139,149,80,182,111,23,12,11,50
"2011","Babergh 007A","E01029912",1133,64,22,42,180,115,111,127,224,194,56,21,35,62
"2011","Babergh 007B","E01029913",727,58,18,40,132,116,85,73,137,76,19,11,8,31
"2011","Babergh 007C","E01029914",1169,66,18,48,169,115,128,129,255,192,60,37,23,55
"2011","Babergh 007D","E01029915",879,70,20,50,188,92,93,73,131,132,38,29,9,62
"2011","Babergh 007E","E01029916",936,40,12,28,127,80,79,97,209,191,55,29,26,58
"2011","Babergh 007F","E01029918",802,43,9,34,138,86,79,85,175,122,47,21,26,27
"2011","Babergh 007G","E01029919",1088,96,33,63,255,148,126,82,171,119,40,24,16,51
"2011","Babergh 007H","E01029920",1170,90,19,71,265,125,133,84,214,166,54,29,25,39
"2011","Babergh 008A","E01029886",866,46,14,32,118,80,72,100,187,157,80,69,11,26
"2011","Babergh 008B","E01029887",1366,107,32,75,229,176,182,154,221,198,25,8,17,74
"2011","Babergh 008C","E01029888",888,43,18,25,113,102,69,102,199,164,40,21,19,56
"2011","Babergh 008D","E01029889",937,29,10,19,133,90,91,84,206,175,56,29,27,73
"2011","Babergh 008E","E01029890",1006,88,21,67,193,132,110,107,175,105,18,13,5,78
"2011","Babergh 008F","E01029891",1427,115,42,73,279,191,162,111,288,168,39,23,16,74
"2011","Babergh 009A","E01029875",1553,201,59,142,425,175,234,108,156,122,40,23,17,92
"2011","Babergh 009B","E01029899",1298,197,56,141,356,223,173,60,142,75,26,14,12,46
"2011","Babergh 009C","E01029902",1589,249,57,192,425,177,240,93,164,114,44,27,17,83
"2011","Babergh 009D","E01029906",1244,215,57,158,310,152,197,75,128,81,31,20,11,55
"2011","Babergh 010A","E01029870",831,70,22,48,193,108,78,71,125,116,29,14,15,41
"2011","Babergh 010B","E01029872",998,113,32,81,251,169,104,68,145,83,12,5,7,53
"2011","Babergh 010C","E01029882",1069,178,43,135,294,129,128,62,103,82,21,18,3,72
"2011","Babergh 010D","E01029883",1440,191,42,149,374,215,185,88,162,113,30,12,18,82
"2011","Babergh 010E","E01029903",1057,176,41,135,286,169,111,52,136,56,9,6,3,62
"2011","Babergh 010F","E01029904",1065,127,24,103,261,174,119,60,143,87,18,11,7,76
"2011","Babergh 010G","E01029905",793,129,27,102,231,114,100,32,74,60,14,8,6,39
"2011","Babergh 011A","E01029871",962,146,38,108,261,139,117,50,108,82,22,15,7,37
"2011","Babergh 011B","E01029873",1529,155,29,126,387,189,216,111,194,167,29,16,13,81
"2011","Babergh 011C","E01029874",1301,115,34,81,291,191,137,115,198,144,29,17,12,81
"2011","Babergh 011D","E01029897",1620,190,41,149,404,170,162,100,149,88,32,24,8,325
"2011","Forest Heath 001A","E01029926",1206,62,27,35,176,188,114,130,235,227,40,24,16,34
"2011","Forest Heath 001B","E01029927",1666,80,32,48,210,158,146,164,363,391,71,44,27,83
"2011","Forest Heath 001C","E01029928",1327,73,21,52,218,169,147,141,228,259,37,20,17,55
"2011","Forest Heath 001D","E01029929",1640,74,28,46,239,199,155,172,320,339,70,45,25,72
"2011","Forest Heath 001E","E01029930",1117,65,27,38,192,160,112,103,216,180,33,19,14,56
"2011","Forest Heath 002C","E01029942",1093,56,18,38,246,164,119,112,185,142,29,20,9,40
"2011","Forest Heath 002E","E01029944",1209,61,18,43,231,175,111,123,210,196,51,29,22,51
"2011","Forest Heath 002F","E01033453",2642,186,115,71,683,642,139,250,305,225,95,78,17,117
"2011","Forest Heath 003E","E01029945",1417,148,48,100,377,217,169,111,177,120,41,34,7,57
"2011","Forest Heath 003F","E01032523",963,96,62,34,242,198,59,97,96,62,40,33,7,73
"2011","Forest Heath 003G","E01032524",728,53,25,28,169,113,105,51,87,94,21,12,9,35
"2011","Forest Heath 003H","E01032525",1942,126,53,73,482,344,159,184,218,202,81,65,16,146
"2011","Forest Heath 003I","E01032526",1262,89,30,59,285,183,199,110,167,133,36,23,13,60
"2011","Forest Heath 004A","E01029938",1003,29,11,18,119,98,63,125,221,222,51,33,18,75
"2011","Forest Heath 004B","E01029939",1137,124,39,85,244,172,89,113,164,119,48,32,16,64
"2011","Forest Heath 004C","E01029940",1034,46,18,28,149,125,85,107,208,214,54,31,23,46
"2011","Forest Heath 004D","E01029946",1483,89,30,59,295,223,106,131,256,218,68,50,18,97
"2011","Forest Heath 004E","E01029947",1613,118,37,81,348,284,177,149,233,193,46,34,12,65
"2011","Forest Heath 005A","E01029941",1322,177,42,135,316,169,146,93,184,147,30,21,9,60
"2011","Forest Heath 005C","E01029957",1233,192,48,144,301,142,186,78,121,132,23,14,9,58
"2011","Forest Heath 005D","E01033451",1086,137,40,97,343,186,70,94,95,82,33,21,12,46
"2011","Forest Heath 005E","E01033452",1006,90,28,62,236,134,117,84,123,141,21,11,10,60
"2011","Forest Heath 005F","E01033454",949,81,32,49,228,144,99,106,128,100,24,13,11,39
"2011","Forest Heath 006A","E01029937",1476,170,32,138,330,166,174,121,185,199,59,49,10,72
"2011","Forest Heath 006B","E01029953",1056,52,11,41,149,139,96,116,222,199,30,15,15,53
"2011","Forest Heath 006C","E01029954",1765,153,50,103,346,159,158,162,272,369,73,38,35,73
"2011","Forest Heath 006D","E01029955",1415,132,24,108,315,164,131,128,229,202,41,20,21,73
"2011","Forest Heath 006E","E01029956",1044,66,13,53,177,124,96,109,183,205,29,22,7,55
"2011","Forest Heath 008A","E01029925",1326,157,40,117,358,159,151,103,147,189,27,16,11,35
"2011","Forest Heath 008B","E01029949",1037,88,33,55,213,120,95,88,167,158,43,25,18,65
"2011","Forest Heath 008C","E01029950",1339,64,11,53,231,112,110,129,258,295,59,35,24,81
"2011","Forest Heath 008D","E01029951",1046,69,18,51,216,145,102,106,168,171,22,14,8,47
"2011","Forest Heath 008E","E01029952",855,84,23,61,141,119,83,92,143,128,24,14,10,41
"2011","Forest Heath 008F","E01032612",1616,154,24,130,350,186,120,169,253,290,46,26,20,48
"2011","Ipswich 001A","E01030032",999,20,7,13,89,93,60,76,250,226,91,57,34,94
"2011","Ipswich 001B","E01030033",1156,75,14,61,206,223,81,103,227,149,24,12,12,68
"2011","Ipswich 001C","E01030034",1047,81,14,67,222,210,103,77,171,115,13,9,4,55
"2011","Ipswich 001D","E01030035",1248,28,7,21,133,113,103,106,262,278,113,65,48,112
"2011","Ipswich 001E","E01030036",1196,41,9,32,119,109,92,93,299,241,104,71,33,98
"2011","Ipswich 002A","E01029973",1073,133,32,101,265,202,84,71,155,71,27,20,7,65
"2011","Ipswich 002B","E01029974",1147,97,20,77,242,179,108,96,192,117,39,23,16,77
"2011","Ipswich 002C","E01029975",882,55,9,46,148,142,77,74,159,146,21,14,7,60
"2011","Ipswich 002D","E01029976",1113,74,21,53,189,220,89,94,186,157,45,31,14,59
"2011","Ipswich 002E","E01029977",1116,82,16,66,231,207,96,97,193,132,17,9,8,61
"2011","Ipswich 003A","E01030027",1611,89,16,73,319,204,129,150,318,255,60,40,20,87
"2011","Ipswich 003B","E01030028",1206,79,20,59,189,142,109,117,253,181,65,46,19,71
"2011","Ipswich 003C","E01030029",1161,43,14,29,141,141,103,90,271,222,74,49,25,76
"2011","Ipswich 003D","E01030030",1498,90,21,69,253,216,110,124,289,250,88,44,44,78
"2011","Ipswich 003E","E01030031",1024,28,7,21,122,104,85,111,208,193,98,78,20,75
"2011","Ipswich 004A","E01029997",1072,93,18,75,270,178,90,75,137,108,43,25,18,78
"2011","Ipswich 004B","E01029998",1227,71,12,59,195,171,77,100,230,196,85,55,30,102
"2011","Ipswich 004C","E01029999",1177,137,29,108,284,194,106,67,165,82,42,33,9,100
"2011","Ipswich 004D","E01030000",1151,121,28,93,259,197,103,74,174,108,29,15,14,86
"2011","Ipswich 004E","E01030001",1093,86,23,63,214,160,93,83,194,136,45,32,13,82
"2011","Ipswich 005A","E01030007",1153,223,35,188,336,139,91,46,133,73,36,20,16,76
"2011","Ipswich 005B","E01030008",898,199,38,161,272,101,84,32,68,38,21,13,8,83
"2011","Ipswich 005C","E01030009",944,203,29,174,262,118,85,52,77,39,22,18,4,86
"2011","Ipswich 005D","E01030010",1371,165,23,142,322,165,87,88,210,175,88,53,35,71
"2011","Ipswich 005E","E01030011",1092,193,50,143,343,177,92,46,114,38,18,10,8,71
"2011","Ipswich 006A","E01030022",1670,119,28,91,326,208,119,147,322,254,86,50,36,89
"2011","Ipswich 006B","E01030023",1429,70,11,59,227,152,80,138,281,310,92,54,38,79
"2011","Ipswich 006C","E01030024",1940,120,15,105,217,137,120,138,346,349,325,201,124,188
"2011","Ipswich 006D","E01030025",1396,164,19,145,319,166,95,74,190,174,117,85,32,97
"2011","Ipswich 006E","E01030026",1241,64,14,50,229,141,98,90,270,205,72,52,20,72
"2011","Ipswich 007A","E01029958",1067,114,27,87,275,129,98,56,183,114,49,29,20,49
"2011","Ipswich 007C","E01029960",1385,136,22,114,351,193,96,93,207,118,46,21,25,145
"2011","Ipswich 007D","E01029961",1077,98,23,75,266,140,57,86,182,127,52,31,21,69
"2011","Ipswich 007E","E01029962",1239,127,17,110,277,158,99,73,205,160,62,42,20,78
"2011","Ipswich 007F","E01033124",1039,91,9,82,179,85,47,32,76,53,42,22,20,434
"2011","Ipswich 007G","E01033125",870,115,12,103,196,95,47,74,135,93,69,46,23,46
"2011","Ipswich 007H","E01033129",1030,88,18,70,127,96,62,78,185,144,134,80,54,116
"2011","Ipswich 008A","E01030002",1349,160,32,128,320,230,94,78,212,133,57,31,26,65
"2011","Ipswich 008B","E01030003",1237,113,19,94,272,185,107,113,181,149,42,25,17,75
"2011","Ipswich 008C","E01030004",978,101,13,88,216,157,75,75,162,95,20,13,7,77
"2011","Ipswich 008D","E01030005",1647,122,26,96,381,233,104,150,306,180,66,38,28,105
"2011","Ipswich 008E","E01030006",1255,86,10,76,275,207,84,108,213,170,34,16,18,78
"2011","Ipswich 009A","E01029963",1063,140,29,111,295,182,113,67,103,68,22,15,7,73
"2011","Ipswich 009B","E01029964",962,107,25,82,204,153,88,89,143,96,32,17,15,50
"2011","Ipswich 009C","E01029965",1005,132,33,99,230,190,75,76,137,90,27,18,9,48
"2011","Ipswich 009D","E01029966",1003,153,33,120,193,157,91,63,136,108,41,27,14,61
"2011","Ipswich 009E","E01029967",834,94,24,70,192,150,78,64,124,69,18,11,7,45
"2011","Ipswich 010A","E01029984",1114,54,6,48,187,122,74,99,219,194,78,52,26,87
"2011","Ipswich 010B","E01029985",1863,200,32,168,347,271,133,164,310,236,105,56,49,97
"2011","Ipswich 010C","E01029986",1032,28,9,19,143,108,72,91,215,206,88,50,38,81
"2011","Ipswich 010D","E01029987",1048,28,5,23,106,109,74,98,237,226,84,51,33,86
"2011","Ipswich 010E","E01029988",1459,109,20,89,218,132,97,127,322,257,123,72,51,74
"2011","Ipswich 011B","E01029990",1211,89,21,68,246,205,91,95,209,160,31,16,15,85
"2011","Ipswich 011C","E01029991",1253,115,20,95,249,216,128,97,208,143,26,9,17,71
"2011","Ipswich 011D","E01029992",969,79,19,60,207,172,74,83,165,104,31,18,13,54
"2011","Ipswich 011E","E01033123",1411,112,17,95,273,184,80,123,279,201,68,41,27,91
"2011","Ipswich 011F","E01033126",1219,262,28,234,295,154,77,79,134,93,67,44,23,58
"2011","Ipswich 012A","E01029968",1135,68,17,51,203,155,99,84,215,161,77,33,44,73
"2011","Ipswich 012B","E01029969",1016,46,8,38,156,148,81,94,194,161,76,60,16,60
"2011","Ipswich 012C","E01029970",1342,102,28,74,248,215,113,100,256,195,48,33,15,65
"2011","Ipswich 012D","E01029971",1020,40,9,31,125,122,91,88,243,184,65,37,28,62
"2011","Ipswich 012F","E01033122",1053,61,10,51,144,112,74,117,208,164,102,59,43,71
"2011","Ipswich 012G","E01033130",868,54,8,46,133,91,67,75,169,160,85,38,47,34
"2011","Ipswich 013A","E01030012",813,19,5,14,74,80,58,72,202,188,80,50,30,40
"2011","Ipswich 013B","E01030013",918,29,3,26,110,81,75,79,233,209,53,32,21,49
"2011","Ipswich 013C","E01030014",916,23,7,16,107,92,81,84,221,197,48,32,16,63
"2011","Ipswich 013D","E01030015",1006,82,19,63,194,194,103,87,159,111,31,17,14,45
"2011","Ipswich 013E","E01030016",1127,52,16,36,186,177,95,92,251,158,48,22,26,68
"2011","Ipswich 014B","E01029994",1067,23,3,20,110,86,66,87,245,229,133,90,43,88
"2011","Ipswich 014C","E01029995",1235,123,33,90,270,187,110,98,202,155,36,25,11,54
"2011","Ipswich 014D","E01029996",1206,48,12,36,139,151,78,118,264,217,104,70,34,87
"2011","Ipswich 014E","E01033127",1099,131,32,99,247,162,64,92,168,116,62,41,21,57
"2011","Ipswich 014F","E01033128",849,95,32,63,186,137,81,60,110,90,39,25,14,51
"2011","Ipswich 014G","E01033131",1006,49,12,37,121,100,61,77,212,195,101,66,35,90
"2011","Ipswich 015A","E01030017",1016,44,12,32,162,124,81,90,226,163,77,44,33,49
"2011","Ipswich 015B","E01030018",1077,29,6,23,122,136,69,93,246,198,119,64,55,65
"2011","Ipswich 015C","E01030019",1119,80,14,66,197,184,87,97,230,132,23,13,10,89
"2011","Ipswich 015D","E01030020",1135,77,23,54,206,191,82,95,224,150,42,22,20,68
"2011","Ipswich 015E","E01030021",1021,40,15,25,128,130,66,86,233,182,123,57,66,33
"2011","Ipswich 016A","E01029978",972,28,9,19,132,135,68,99,208,195,53,30,23,54
"2011","Ipswich 016B","E01029979",1067,26,6,20,95,100,58,89,256,264,97,58,39,82
"2011","Ipswich 016C","E01029980",1114,38,11,27,109,90,80,101,274,235,120,70,50,67
"2011","Ipswich 016D","E01029981",870,51,12,39,125,158,69,89,168,148,23,13,10,39
"2011","Ipswich 016E","E01029982",990,20,9,11,90,84,56,83,284,226,79,50,29,68
"2011","Ipswich 016F","E01029983",1160,75,10,65,186,173,96,104,246,177,52,32,20,51
"2011","Mid Suffolk 001A","E01030052",1542,149,35,114,368,137,216,109,237,185,46,21,25,95
"2011","Mid Suffolk 001B","E01030058",1501,193,52,141,336,164,289,86,200,125,31,21,10,77
"2011","Mid Suffolk 001C","E01030064",1693,204,66,138,397,225,306,94,198,137,73,59,14,59
"2011","Mid Suffolk 001D","E01030088",880,125,43,82,207,106,143,54,105,65,15,7,8,60
"2011","Mid Suffolk 002A","E01030039",1070,130,34,96,249,137,164,55,144,99,27,19,8,65
"2011","Mid Suffolk 002B","E01030054",939,123,27,96,244,113,185,43,97,63,13,10,3,58
"2011","Mid Suffolk 002C","E01030055",1043,127,31,96,249,121,159,71,136,106,29,14,15,45
"2011","Mid Suffolk 002D","E01030066",1116,138,41,97,268,124,189,61,137,97,37,29,8,65
"2011","Mid Suffolk 002E","E01030067",911,118,36,82,244,119,144,46,106,74,12,8,4,48
"2011","Mid Suffolk 002F","E01030068",1254,119,31,88,307,147,185,67,169,159,19,11,8,82
"2011","Mid Suffolk 003A","E01030053",1696,190,56,134,370,175,349,120,216,167,40,21,19,69
"2011","Mid Suffolk 003B","E01030082",1789,141,41,100,390,195,344,134,257,191,37,27,10,100
"2011","Mid Suffolk 003C","E01030090",1815,219,58,161,407,201,333,96,247,167,32,26,6,113
"2011","Mid Suffolk 004A","E01030040",896,104,31,73,189,111,145,52,125,94,19,12,7,57
"2011","Mid Suffolk 004B","E01030049",1207,189,67,122,288,126,164,88,136,104,37,29,8,75
"2011","Mid Suffolk 004C","E01030050",1495,188,55,133,405,195,141,109,214,139,19,9,10,85
"2011","Mid Suffolk 004D","E01030084",1159,155,29,126,278,208,134,83,128,95,18,11,7,60
"2011","Mid Suffolk 004E","E01030085",1143,134,43,91,301,161,111,97,151,106,18,9,9,64
"2011","Mid Suffolk 005A","E01030037",884,80,21,59,215,124,106,83,113,103,19,14,5,41
"2011","Mid Suffolk 005B","E01030038",895,78,16,62,178,104,112,85,144,123,10,6,4,61
"2011","Mid Suffolk 005C","E01030059",1690,182,54,128,375,219,259,125,204,199,37,20,17,90
"2011","Mid Suffolk 005D","E01030081",1650,132,40,92,323,218,192,159,302,202,36,31,5,86
"2011","Mid Suffolk 006A","E01030051",1216,109,31,78,266,159,122,92,191,187,28,14,14,62
"2011","Mid Suffolk 006B","E01030056",1554,161,51,110,381,195,194,105,225,172,41,30,11,80
"2011","Mid Suffolk 006C","E01030065",1514,191,61,130,405,172,262,94,172,109,37,18,19,72
"2011","Mid Suffolk 006D","E01030086",846,138,43,95,230,98,107,53,95,63,10,4,6,52
"2011","Mid Suffolk 006E","E01030089",1448,172,57,115,361,192,170,97,202,132,34,19,15,88
"2011","Mid Suffolk 007A","E01030048",1619,193,45,148,398,211,256,100,210,146,33,19,14,72
"2011","Mid Suffolk 007B","E01030057",1684,225,51,174,454,215,277,98,159,126,41,22,19,89
"2011","Mid Suffolk 007C","E01030083",1718,240,77,163,437,224,280,89,178,145,23,14,9,102
"2011","Mid Suffolk 007D","E01030087",967,138,43,95,214,116,161,45,107,90,25,11,14,71
"2011","Mid Suffolk 008A","E01030073",961,86,26,60,177,136,84,76,198,143,33,22,11,28
"2011","Mid Suffolk 008B","E01030077",934,35,16,19,160,91,79,92,209,159,60,38,22,49
"2011","Mid Suffolk 008C","E01030079",1105,40,13,27,121,104,75,104,230,243,116,92,24,72
"2011","Mid Suffolk 008D","E01030080",1161,75,24,51,179,121,94,129,242,222,42,27,15,57
"2011","Mid Suffolk 009A","E01030063",1591,175,41,134,423,219,210,89,214,139,31,18,13,91
"2011","Mid Suffolk 009B","E01030069",1015,161,55,106,287,113,144,60,124,59,13,6,7,54
"2011","Mid Suffolk 009C","E01030072",1138,101,33,68,211,159,90,125,229,145,25,14,11,53
"2011","Mid Suffolk 009D","E01030075",1213,117,31,86,310,213,88,107,172,116,22,10,12,68
"2011","Mid Suffolk 010A","E01030060",1183,112,23,89,273,197,115,93,185,117,28,15,13,63
"2011","Mid Suffolk 010B","E01030071",1069,91,21,70,237,140,99,93,172,154,29,17,12,54
"2011","Mid Suffolk 010D","E01030076",1108,58,18,40,238,111,79,120,216,177,45,32,13,64
"2011","Mid Suffolk 010E","E01030078",1309,107,34,73,252,208,96,139,240,175,22,7,15,70
"2011","Mid Suffolk 010F","E01033316",1150,130,32,98,327,177,87,81,152,118,19,11,8,59
"2011","Mid Suffolk 010G","E01033317",1137,99,22,77,283,150,94,82,188,143,36,20,16,62
"2011","Mid Suffolk 010H","E01033319",1380,180,49,131,375,224,126,82,165,134,20,13,7,74
"2011","Mid Suffolk 011A","E01030041",1630,179,47,132,390,239,235,103,206,173,34,21,13,71
"2011","Mid Suffolk 011B","E01030043",953,94,27,67,207,150,98,81,140,114,22,15,7,47
"2011","Mid Suffolk 011C","E01030061",1047,80,18,62,220,131,96,100,175,163,38,22,16,44
"2011","Mid Suffolk 011D","E01030062",1003,78,22,56,189,169,106,87,185,119,18,14,4,52
"2011","Mid Suffolk 011E","E01030070",1782,169,107,62,576,499,88,132,129,104,31,18,13,54
"2011","Mid Suffolk 012A","E01030042",1174,126,36,90,263,193,173,75,165,115,14,7,7,50
"2011","Mid Suffolk 012B","E01030044",833,51,16,35,162,140,83,61,140,145,16,8,8,35
"2011","Mid Suffolk 012C","E01030045",1251,129,28,101,293,205,134,81,174,145,30,21,9,60
"2011","Mid Suffolk 012D","E01030046",1170,136,28,108,288,174,161,61,158,103,29,17,12,60
"2011","Mid Suffolk 012E","E01030047",942,91,17,74,192,158,91,81,122,138,13,7,6,56
"2011","St Edmundsbury 001A","E01030095",874,125,43,82,214,107,129,49,114,82,7,3,4,47
"2011","St Edmundsbury 001B","E01030096",1084,130,32,98,276,140,163,50,149,98,18,14,4,60
"2011","St Edmundsbury 001C","E01030097",864,86,28,58,186,92,128,70,143,94,19,12,7,46
"2011","St Edmundsbury 001D","E01030145",1006,76,25,51,203,135,137,76,165,138,14,7,7,62
"2011","St Edmundsbury 001E","E01030146",748,53,16,37,172,99,72,51,163,100,17,13,4,21
"2011","St Edmundsbury 002A","E01030094",1018,107,40,67,228,137,114,78,157,94,30,20,10,73
"2011","St Edmundsbury 002B","E01030121",1619,174,59,115,418,193,170,118,238,162,36,27,9,110
"2011","St Edmundsbury 002C","E01030132",1560,220,180,40,403,565,61,75,108,59,27,15,12,42
"2011","St Edmundsbury 002D","E01030133",1087,123,46,77,260,143,151,82,152,100,24,17,7,52
"2011","St Edmundsbury 003A","E01030130",894,71,24,47,148,110,71,80,178,149,29,20,9,58
"2011","St Edmundsbury 003B","E01030131",838,33,12,21,70,78,54,93,220,189,46,33,13,55
"2011","St Edmundsbury 003C","E01030139",1217,41,13,28,145,116,69,124,284,272,66,40,26,100
"2011","St Edmundsbury 003D","E01030140",953,39,12,27,126,110,51,81,276,194,28,16,12,48
"2011","St Edmundsbury 003E","E01030141",1156,56,19,37,172,123,64,116,291,216,35,24,11,83
"2011","St Edmundsbury 004A","E01030103",1435,191,58,133,363,211,143,99,212,124,36,30,6,56
"2011","St Edmundsbury 004B","E01030104",1557,241,79,162,452,246,182,79,153,91,24,16,8,89
"2011","St Edmundsbury 004C","E01030138",1712,156,43,113,351,215,252,119,284,180,53,28,25,102
"2011","St Edmundsbury 005B","E01030127",964,134,45,89,287,150,73,65,121,65,8,4,4,61
"2011","St Edmundsbury 005C","E01030128",1139,178,49,129,314,154,82,77,144,105,19,9,10,66
"2011","St Edmundsbury 005D","E01030129",1095,133,41,92,285,184,87,76,160,91,6,4,2,73
"2011","St Edmundsbury 005E","E01033044",1000,157,46,111,282,147,62,49,127,83,15,10,5,78
"2011","St Edmundsbury 005F","E01033045",762,109,41,68,219,125,53,49,84,54,19,14,5,50
"2011","St Edmundsbury 005G","E01033050",967,172,52,120,271,139,56,69,112,65,21,11,10,62
"2011","St Edmundsbury 006A","E01030091",1358,211,55,156,377,153,133,96,192,103,36,28,8,57
"2011","St Edmundsbury 006B","E01030093",1171,176,40,136,300,138,82,97,159,107,42,30,12,70
"2011","St Edmundsbury 006D","E01030137",1242,135,35,100,335,165,82,103,192,146,24,12,12,60
"2011","St Edmundsbury 006E","E01033043",887,113,30,83,204,101,75,69,145,106,26,17,9,48
"2011","St Edmundsbury 006F","E01033046",890,69,17,52,198,105,82,77,160,132,37,24,13,30
"2011","St Edmundsbury 006G","E01033047",863,114,25,89,234,106,68,48,130,90,24,18,6,49
"2011","St Edmundsbury 007A","E01030092",1246,128,48,80,302,154,88,98,194,127,78,61,17,77
"2011","St Edmundsbury 007B","E01030123",1130,92,18,74,216,117,83,78,218,181,55,32,23,90
"2011","St Edmundsbury 007C","E01030124",1106,106,22,84,277,165,89,93,189,109,29,19,10,49
"2011","St Edmundsbury 007D","E01030125",1099,68,14,54,212,145,76,107,220,173,30,20,10,68
"2011","St Edmundsbury 007E","E01030148",920,78,14,64,199,146,74,72,194,106,12,6,6,39
"2011","St Edmundsbury 007F","E01030149",1066,89,23,66,222,159,89,89,214,131,15,10,5,58
"2011","St Edmundsbury 008A","E01030098",1612,192,45,147,375,214,224,104,233,155,32,18,14,83
"2011","St Edmundsbury 008B","E01030100",1522,223,70,153,356,216,248,76,184,124,28,14,14,67
"2011","St Edmundsbury 008C","E01030119",1626,212,70,142,382,241,192,126,211,153,25,19,6,84
"2011","St Edmundsbury 008D","E01030134",820,99,20,79,185,96,122,49,132,87,10,8,2,40
"2011","St Edmundsbury 008E","E01030135",1030,131,36,95,255,121,129,63,103,88,18,14,4,122
"2011","St Edmundsbury 009B","E01030142",1270,182,50,132,326,206,99,80,173,111,15,7,8,78
"2011","St Edmundsbury 009C","E01030143",1172,77,16,61,250,155,80,127,243,157,29,17,12,54
"2011","St Edmundsbury 009D","E01030144",894,86,24,62,215,131,89,70,130,112,13,9,4,48
"2011","St Edmundsbury 009E","E01030147",1030,127,34,93,268,164,83,70,156,98,29,26,3,35
"2011","St Edmundsbury 009F","E01033048",898,107,32,75,194,77,79,64,174,115,42,27,15,46
"2011","St Edmundsbury 009G","E01033049",815,123,27,96,217,90,75,38,126,81,32,27,5,33
"2011","St Edmundsbury 010A","E01030099",1450,190,55,135,392,182,248,76,154,104,39,19,20,65
"2011","St Edmundsbury 010B","E01030101",1420,184,62,122,324,182,201,75,199,157,33,21,12,65
"2011","St Edmundsbury 010C","E01030150",1622,211,66,145,389,182,281,104,199,145,42,23,19,69
"2011","St Edmundsbury 011A","E01030120",2451,180,57,123,398,275,425,181,316,339,237,195,42,100
"2011","St Edmundsbury 011B","E01030122",1436,165,47,118,327,193,178,122,201,152,39,28,11,59
"2011","St Edmundsbury 011C","E01030151",1749,221,78,143,388,184,291,116,179,177,114,93,21,79
"2011","St Edmundsbury 012A","E01030109",1228,44,19,25,171,143,97,103,294,253,56,24,32,67
"2011","St Edmundsbury 012B","E01030110",1980,122,42,80,350,277,175,212,352,318,60,34,26,114
"2011","St Edmundsbury 012C","E01030111",1040,90,25,65,195,177,99,92,167,123,25,11,14,72
"2011","St Edmundsbury 012D","E01030112",1341,95,32,63,236,192,138,128,233,199,53,26,27,67
"2011","St Edmundsbury 013A","E01030115",1673,106,39,67,283,193,100,164,316,311,94,55,39,106
"2011","St Edmundsbury 013B","E01030116",1613,193,48,145,347,260,151,144,211,165,28,15,13,114
"2011","St Edmundsbury 013C","E01030117",1226,126,28,98,259,228,98,119,172,138,24,14,10,62
"2011","St Edmundsbury 013D","E01030118",1205,82,18,64,221,156,85,116,246,176,42,27,15,81
"2011","St Edmundsbury 014A","E01030105",1385,68,20,48,214,182,97,143,278,272,47,21,26,84
"2011","St Edmundsbury 014B","E01030106",1801,92,28,64,332,224,137,194,342,311,63,34,29,106
"2011","St Edmundsbury 014C","E01030107",1243,101,44,57,270,213,107,112,195,156,30,22,8,59
"2011","St Edmundsbury 014D","E01030108",1389,62,20,42,208,153,99,149,270,293,63,31,32,92
"2011","St Edmundsbury 014E","E01030113",1372,94,24,70,218,180,109,133,238,262,48,27,21,90
"2011","St Edmundsbury 014F","E01030114",1128,35,13,22,122,104,70,118,242,288,62,37,25,87
"2011","Suffolk Coastal 001A","E01030201",1573,155,39,116,369,129,372,102,184,144,40,26,14,78
"2011","Suffolk Coastal 001B","E01030219",1411,161,27,134,356,129,293,100,151,117,31,17,14,73
"2011","Suffolk Coastal 001C","E01030222",1352,181,36,145,327,141,293,86,153,100,26,11,15,45
"2011","Suffolk Coastal 002A","E01030154",1542,270,51,219,469,178,222,59,140,78,31,24,7,95
"2011","Suffolk Coastal 002B","E01030172",1128,152,39,113,282,144,183,68,136,79,23,14,9,61
"2011","Suffolk Coastal 002C","E01030173",1100,94,23,71,259,95,117,74,136,114,25,16,9,186
"2011","Suffolk Coastal 002D","E01030174",1000,129,30,99,245,127,160,52,105,83,29,17,12,70
"2011","Suffolk Coastal 002E","E01030176",1464,190,38,152,369,143,300,71,163,109,40,22,18,79
"2011","Suffolk Coastal 003A","E01030186",1027,79,15,64,180,111,163,100,189,132,24,19,5,49
"2011","Suffolk Coastal 003B","E01030208",929,92,25,67,186,107,169,62,140,85,42,33,9,46
"2011","Suffolk Coastal 003C","E01030209",1037,103,28,75,241,114,162,82,167,102,33,16,17,33
"2011","Suffolk Coastal 003D","E01030210",1475,104,32,72,287,169,158,120,306,189,62,46,16,80
"2011","Suffolk Coastal 003E","E01030212",1423,181,41,140,366,148,257,87,173,128,35,28,7,48
"2011","Suffolk Coastal 004A","E01030152",1263,166,43,123,315,163,238,88,137,107,26,19,7,23
"2011","Suffolk Coastal 004B","E01030153",868,83,25,58,210,78,144,76,132,102,15,9,6,28
"2011","Suffolk Coastal 004C","E01030187",1094,52,8,44,145,94,122,114,254,205,53,33,20,55
"2011","Suffolk Coastal 004D","E01030188",1216,49,11,38,199,108,164,167,229,202,46,30,16,52
"2011","Suffolk Coastal 004E","E01030189",1197,65,11,54,183,131,174,133,244,167,29,14,15,71
"2011","Suffolk Coastal 005A","E01030193",1198,202,47,155,325,134,180,64,120,66,29,23,6,78
"2011","Suffolk Coastal 005B","E01030194",1131,135,32,103,284,148,112,97,175,98,28,17,11,54
"2011","Suffolk Coastal 005C","E01030195",1200,197,40,157,318,172,122,82,148,66,17,6,11,78
"2011","Suffolk Coastal 005D","E01030220",1475,133,41,92,290,190,146,122,283,184,43,22,21,84
"2011","Suffolk Coastal 006A","E01030175",1609,262,53,209,470,207,188,85,168,106,30,15,15,93
"2011","Suffolk Coastal 006B","E01030200",1667,252,53,199,433,195,256,93,180,117,25,15,10,116
"2011","Suffolk Coastal 006C","E01030221",1477,229,40,189,377,224,211,62,167,97,39,26,13,71
"2011","Suffolk Coastal 007C","E01030199",1347,175,32,143,345,131,222,85,191,105,31,20,11,62
"2011","Suffolk Coastal 007F","E01033443",1338,133,73,60,374,325,98,125,128,99,8,4,4,48
"2011","Suffolk Coastal 007G","E01033445",1220,123,35,88,302,179,112,111,188,107,20,11,9,78
"2011","Suffolk Coastal 007H","E01033446",1997,177,57,120,377,268,294,165,274,252,108,81,27,82
"2011","Suffolk Coastal 007I","E01033448",907,113,27,86,214,105,152,51,114,86,23,11,12,49
"2011","Suffolk Coastal 007J","E01033449",1212,123,30,93,280,140,142,107,206,115,26,18,8,73
"2011","Suffolk Coastal 008A","E01030155",1478,148,27,121,305,185,114,117,255,191,45,30,15,118
"2011","Suffolk Coastal 008B","E01030185",1365,130,22,108,272,145,135,107,241,191,52,32,20,92
"2011","Suffolk Coastal 008C","E01030203",1168,229,43,186,389,147,125,39,99,59,17,9,8,64
"2011","Suffolk Coastal 008D","E01030211",1319,234,54,180,435,129,177,68,111,72,34,18,16,59
"2011","Suffolk Coastal 009A","E01030179",1820,267,46,221,521,318,119,121,199,126,46,25,21,103
"2011","Suffolk Coastal 009B","E01030180",997,138,27,111,248,163,93,73,128,73,18,15,3,63
"2011","Suffolk Coastal 009C","E01030183",1383,124,27,97,263,237,158,118,228,163,33,16,17,59
"2011","Suffolk Coastal 009D","E01030184",1179,99,19,80,216,156,122,103,229,145,40,24,16,69
"2011","Suffolk Coastal 009E","E01030207",1050,132,24,108,252,152,124,61,161,94,20,15,5,54
"2011","Suffolk Coastal 010A","E01030181",1409,255,36,219,384,242,85,91,152,73,29,15,14,98
"2011","Suffolk Coastal 010C","E01030190",1295,165,26,139,302,232,148,58,183,123,23,11,12,61
"2011","Suffolk Coastal 010D","E01030191",1181,154,28,126,291,201,86,76,169,113,31,24,7,60
"2011","Suffolk Coastal 010E","E01030192",1135,204,27,177,324,196,81,69,115,54,14,8,6,78
"2011","Suffolk Coastal 010F","E01030198",953,142,39,103,241,121,150,54,85,97,16,10,6,47
"2011","Suffolk Coastal 010G","E01033442",1080,177,45,132,334,200,74,70,93,44,14,7,7,74
"2011","Suffolk Coastal 010H","E01033444",1007,177,34,143,309,159,70,62,88,62,17,5,12,63
"2011","Suffolk Coastal 010I","E01033447",988,124,30,94,288,178,80,75,110,74,9,4,5,50
"2011","Suffolk Coastal 011A","E01030196",1263,199,39,160,301,225,114,82,155,85,14,8,6,88
"2011","Suffolk Coastal 011B","E01030197",1149,177,41,136,307,179,152,56,130,72,12,8,4,64
"2011","Suffolk Coastal 011C","E01030204",1285,237,49,188,341,219,125,66,119,79,14,9,5,85
"2011","Suffolk Coastal 011D","E01030205",946,143,26,117,276,161,88,61,91,48,15,10,5,63
"2011","Suffolk Coastal 011E","E01030206",1060,163,36,127,268,183,105,58,138,66,21,11,10,58
"2011","Suffolk Coastal 012A","E01030171",1432,93,16,77,256,261,107,120,277,214,33,23,10,71
"2011","Suffolk Coastal 012B","E01030214",1020,73,17,56,192,238,79,84,166,103,20,8,12,65
"2011","Suffolk Coastal 012C","E01030215",979,59,12,47,192,169,72,71,167,171,35,20,15,43
"2011","Suffolk Coastal 012D","E01030216",1098,94,15,79,245,211,78,87,180,129,21,16,5,53
"2011","Suffolk Coastal 012E","E01030217",996,99,22,77,239,167,114,68,139,98,25,9,16,47
"2011","Suffolk Coastal 012F","E01030218",1096,96,16,80,236,218,112,80,149,121,37,29,8,47
"2011","Suffolk Coastal 013C","E01030158",1028,122,25,97,284,208,110,59,127,66,15,12,3,37
"2011","Suffolk Coastal 013D","E01030159",1056,55,7,48,241,196,91,83,178,131,24,8,16,57
"2011","Suffolk Coastal 013E","E01030164",1061,128,25,103,269,171,94,65,148,82,23,13,10,81
"2011","Suffolk Coastal 013F","E01030166",1019,166,42,124,318,153,112,45,104,53,15,11,4,53
"2011","Suffolk Coastal 013G","E01033450",1647,140,29,111,398,314,162,115,263,154,30,14,16,71
"2011","Suffolk Coastal 014A","E01030160",987,47,10,37,163,161,76,81,203,168,43,25,18,45
"2011","Suffolk Coastal 014B","E01030161",987,35,9,26,163,146,68,89,205,183,43,31,12,55
"2011","Suffolk Coastal 014C","E01030168",1026,43,12,31,143,133,64,87,188,215,77,49,28,76
"2011","Suffolk Coastal 014D","E01030169",1163,46,10,36,187,193,76,101,237,187,75,32,43,61
"2011","Suffolk Coastal 014E","E01030170",1153,35,5,30,131,128,77,116,285,252,65,41,24,64
"2011","Suffolk Coastal 015A","E01030162",948,55,18,37,186,131,105,85,147,146,51,32,19,42
"2011","Suffolk Coastal 015B","E01030163",1143,60,23,37,195,151,132,97,195,200,67,39,28,46
"2011","Suffolk Coastal 015C","E01030165",1120,91,16,75,267,165,118,70,169,114,45,30,15,81
"2011","Suffolk Coastal 015D","E01030167",904,92,24,68,242,124,92,59,126,79,28,19,9,62
"2011","Waveney 001A","E01030240",1138,108,31,77,297,160,117,84,180,114,29,20,9,49
"2011","Waveney 001B","E01030241",1080,85,30,55,257,144,145,93,171,128,23,14,9,34
"2011","Waveney 001C","E01030242",1034,106,27,79,265,147,105,73,153,97,26,18,8,62
"2011","Waveney 001D","E01030259",843,78,23,55,199,113,104,75,122,90,13,8,5,49
"2011","Waveney 001E","E01030260",1201,99,23,76,181,119,176,112,180,189,93,82,11,52
"2011","Waveney 002A","E01030261",984,20,6,14,106,65,75,78,245,203,115,71,44,77
"2011","Waveney 002B","E01030262",845,37,7,30,116,95,68,71,211,159,40,21,19,48
"2011","Waveney 002C","E01030277",822,27,9,18,93,61,54,63,207,171,71,50,21,75
"2011","Waveney 002D","E01030279",972,20,8,12,98,77,64,67,261,208,117,76,41,60
"2011","Waveney 002E","E01030281",1720,123,37,86,324,226,148,147,332,243,72,57,15,105
"2011","Waveney 003A","E01030266",1158,64,16,48,223,148,118,107,203,157,61,53,8,77
"2011","Waveney 003B","E01030267",981,59,20,39,187,126,85,106,188,129,44,32,12,57
"2011","Waveney 003C","E01030271",1039,43,14,29,171,152,93,115,232,182,16,9,7,35
"2011","Waveney 003D","E01030278",1091,48,12,36,163,121,78,109,244,230,48,33,15,50
"2011","Waveney 003E","E01030280",999,66,27,39,184,156,85,128,179,145,16,6,10,40
"2011","Waveney 004A","E01030246",1017,29,8,21,145,113,66,107,255,174,61,37,24,67
"2011","Waveney 004B","E01030248",1083,47,12,35,174,127,80,105,230,167,75,52,23,78
"2011","Waveney 004C","E01030249",1216,42,11,31,156,114,72,91,316,221,111,56,55,93
"2011","Waveney 004D","E01030250",1326,36,8,28,153,123,106,109,338,229,152,83,69,80
"2011","Waveney 004E","E01030264",994,26,10,16,133,99,67,110,244,209,53,31,22,53
"2011","Waveney 004F","E01030265",1057,29,9,20,154,85,86,101,272,194,70,38,32,66
"2011","Waveney 005A","E01030255",984,34,15,19,123,106,88,114,224,175,58,39,19,62
"2011","Waveney 005B","E01030263",970,55,15,40,163,134,90,99,196,137,63,39,24,33
"2011","Waveney 005C","E01030270",1055,65,19,46,186,142,97,99,228,143,32,23,9,63
"2011","Waveney 005D","E01030289",1042,41,18,23,157,108,106,122,233,183,50,38,12,42
"2011","Waveney 005E","E01030290",1038,48,19,29,173,158,96,103,216,155,41,25,16,48
"2011","Waveney 006A","E01030233",1126,97,35,62,243,199,99,125,188,107,18,12,6,50
"2011","Waveney 006B","E01030235",1028,84,23,61,222,176,97,104,154,116,25,19,6,50
"2011","Waveney 006C","E01030268",983,84,22,62,234,146,96,75,166,98,20,11,9,64
"2011","Waveney 006D","E01030269",1136,116,39,77,257,175,124,91,171,114,33,15,18,55
"2011","Waveney 006E","E01030288",1028,77,24,53,174,151,113,94,199,139,27,17,10,54
"2011","Waveney 007A","E01030247",1053,28,9,19,130,83,82,103,248,193,135,80,55,51
"2011","Waveney 007B","E01030254",1063,32,14,18,157,117,66,98,241,192,85,41,44,75
"2011","Waveney 007C","E01030256",1090,68,13,55,212,105,125,69,198,125,120,88,32,68
"2011","Waveney 007D","E01030258",1150,50,7,43,137,93,113,98,258,206,131,72,59,64
"2011","Waveney 007E","E01030276",894,55,10,45,173,99,80,66,209,137,37,22,15,38
"2011","Waveney 008A","E01030257",1055,56,15,41,144,144,85,101,250,153,52,30,22,70
"2011","Waveney 008B","E01030274",798,35,9,26,113,88,68,62,191,140,55,43,12,46
"2011","Waveney 008C","E01030275",859,59,18,41,176,121,78,67,170,107,21,11,10,60
"2011","Waveney 008D","E01030287",963,21,7,14,114,95,104,95,227,202,59,38,21,46
"2011","Waveney 008E","E01030291",992,23,4,19,88,80,62,103,249,226,87,52,35,74
"2011","Waveney 009A","E01030234",1128,46,10,36,189,145,96,107,234,175,66,37,29,70
"2011","Waveney 009B","E01030236",1235,68,18,50,199,153,122,137,255,199,48,30,18,54
"2011","Waveney 009C","E01030237",2064,159,40,119,475,328,188,189,339,242,33,23,10,111
"2011","Waveney 009D","E01030238",1365,110,28,82,294,195,109,126,255,166,20,16,4,90
"2011","Waveney 010A","E01030223",1190,71,21,50,206,126,129,125,250,177,47,26,21,59
"2011","Waveney 010B","E01030224",1077,122,32,90,270,147,110,85,158,98,35,24,11,52
"2011","Waveney 010C","E01030225",1153,79,22,57,227,128,129,100,227,174,35,21,14,54
"2011","Waveney 010D","E01030227",971,29,10,19,110,88,70,113,250,196,61,41,20,54
"2011","Waveney 010E","E01030228",1227,56,13,43,243,176,124,135,252,156,20,14,6,65
"2011","Waveney 011A","E01030226",1346,68,25,43,191,174,97,152,301,241,46,30,16,76
"2011","Waveney 011B","E01030286",1658,163,38,125,349,197,283,113,249,188,40,18,22,76
"2011","Waveney 011C","E01030292",1050,90,32,58,234,143,105,110,171,110,28,16,12,59
"2011","Waveney 011D","E01030293",1206,117,35,82,301,164,134,107,165,109,22,12,10,87
"2011","Waveney 011E","E01030294",1036,84,25,59,219,160,83,106,166,131,23,9,14,64
"2011","Waveney 012A","E01030239",1444,110,35,75,302,235,152,147,234,131,47,27,20,86
"2011","Waveney 012B","E01030251",1154,79,17,62,221,144,144,89,242,148,33,23,10,54
"2011","Waveney 012C","E01030252",1235,83,22,61,214,165,154,129,249,164,31,21,10,46
"2011","Waveney 012D","E01030253",1252,63,22,41,234,129,108,120,273,178,72,41,31,75
"2011","Waveney 012E","E01030272",1066,72,20,52,208,144,138,82,201,145,32,17,15,44
"2011","Waveney 012F","E01030273",1104,42,12,30,173,133,90,137,251,203,41,25,16,34
"2011","Waveney 013A","E01030230",1267,120,31,89,273,128,175,96,217,151,43,24,19,64
"2011","Waveney 013B","E01030231",1085,54,16,38,184,108,119,95,237,197,34,24,10,57
"2011","Waveney 013C","E01030232",1161,76,19,57,209,116,123,121,216,192,40,32,8,68
"2011","Waveney 013D","E01030285",1650,175,43,132,369,178,342,116,202,132,26,16,10,110
"2011","Waveney 014A","E01030282",711,102,20,82,186,75,122,32,83,61,29,16,13,21
"2011","Waveney 014B","E01030283",911,67,16,51,161,85,134,77,135,133,25,12,13,94
"2011","Waveney 014C","E01030284",801,81,20,61,191,115,137,60,104,68,18,14,4,27
"2011","Waveney 014D","E01030295",1664,155,34,121,325,167,322,123,251,184,44,32,12,93
"2011","Waveney 015A","E01030229",1531,151,57,94,288,186,225,120,251,196,37,25,12,77
"2011","Waveney 015B","E01030243",1030,58,10,48,176,125,129,98,195,157,30,17,13,62
"2011","Waveney 015C","E01030244",1137,74,21,53,240,124,139,92,225,157,39,26,13,47
"2011","Waveney 015D","E01030245",1061,75,23,52,176,128,126,104,236,150,29,17,12,37
"2011","Camden 001A","E01000907",1062,152,13,139,287,107,87,35,103,77,111,78,33,103
"2011","Camden 001B","E01000908",1184,164,26,138,374,118,117,39,119,74,100,70,30,79
"2011","Camden 001C","E01000909",1253,298,41,257,438,100,115,30,78,33,61,45,16,100
"2011","Camden 001D","E01000912",1235,175,24,151,344,116,92,44,131,67,113,87,26,153
"2011","Camden 001E","E01000913",1286,385,80,305,472,76,144,27,40,20,29,24,5,93
"2011","Camden 002A","E01000893",1194,340,44,296,488,69,107,13,44,14,36,19,17,83
"2011","Camden 002B","E01000894",1034,356,62,294,376,60,90,12,28,16,31,21,10,65
"2011","Camden 002C","E01000895",1201,352,55,297,389,93,126,20,59,39,42,35,7,81
"2011","Camden 002D","E01000896",1255,435,76,359,466,80,112,12,22,17,35,22,13,76
"2011","Camden 002E","E01000899",1201,362,94,268,436,77,137,13,41,18,41,30,11,76
"2011","Camden 003A","E01000910",1133,286,39,247,426,81,104,20,51,26,42,28,14,97
"2011","Camden 003B","E01000911",1133,225,34,191,338,99,108,40,94,52,81,56,25,96
"2011","Camden 003C","E01000921",1662,297,37,260,573,184,121,64,111,57,98,69,29,157
"2011","Camden 003D","E01000923",1179,252,30,222,369,105,83,26,93,47,84,60,24,120
"2011","Camden 003E","E01000928",1264,240,32,208,405,95,99,48,107,69,91,74,17,110
"2011","Camden 004A","E01000878",1289,252,55,197,283,87,100,20,49,31,59,50,9,408
"2011","Camden 004B","E01000879",1119,293,58,235,341,66,90,37,54,26,35,25,10,177
"2011","Camden 004C","E01000880",1104,345,80,265,397,85,92,11,39,23,29,20,9,83
"2011","Camden 004D","E01000884",1056,292,76,216,326,74,134,12,48,28,30,18,12,112
"2011","Camden 004E","E01000885",1018,278,58,220,336,78,125,12,48,20,46,37,9,75
"2011","Camden 005A","E01000871",1267,270,34,236,377,113,121,26,80,54,103,84,19,123
"2011","Camden 005B","E01000872",1623,312,22,290,442,155,163,59,126,122,94,64,30,150
"2011","Camden 005C","E01000873",1317,359,59,300,465,110,108,30,73,48,47,39,8,77
"2011","Camden 005D","E01000874",1245,361,62,299,460,102,97,16,36,22,31,21,10,120
"2011","Camden 005E","E01000877",1296,330,63,267,454,118,102,34,46,52,72,60,12,88
"2011","Camden 006A","E01000886",1112,268,29,239,385,83,106,27,68,34,50,37,13,91
"2011","Camden 006B","E01000887",1190,311,42,269,388,95,102,28,73,51,55,39,16,87
"2011","Camden 006C","E01000888",1204,271,36,235,383,91,85,42,69,51,67,47,20,145
"2011","Camden 006D","E01000892",1372,349,54,295,435,89,103,49,85,60,90,68,22,112
"2011","Camden 006E","E01000903",1148,259,33,226,354,80,122,19,67,42,78,57,21,127
"2011","Camden 007A","E01000889",1216,102,9,93,217,129,91,71,161,120,172,131,41,153
"2011","Camden 007B","E01000890",1186,52,13,39,179,132,102,87,177,128,185,150,35,144
"2011","Camden 007C","E01000891",1138,96,11,85,172,102,84,66,155,102,183,148,35,178
"2011","Camden 007D","E01000901",1418,118,20,98,226,117,73,68,159,126,198,157,41,333
"2011","Camden 007E","E01000922",1260,163,21,142,332,109,81,34,102,64,92,72,20,283
"2011","Camden 007F","E01000927",1419,271,31,240,470,104,141,48,100,62,80,70,10,143
"2011","Camden 008A","E01000881",1162,290,52,238,346,105,90,36,46,20,58,39,19,171
"2011","Camden 008B","E01000882",1198,411,88,323,433,87,105,13,35,17,31,18,13,66
"2011","Camden 008C","E01000883",1065,299,44,255,319,80,80,24,43,25,65,48,17,130
"2011","Camden 008D","E01000897",1161,430,103,327,399,70,95,13,37,18,24,12,12,75
"2011","Camden 008E","E01000898",1377,332,41,291,535,89,76,25,67,58,89,66,23,106
"2011","Camden 009A","E01000866",1606,285,50,235,438,167,147,57,119,87,112,87,25,194
"2011","Camden 009B","E01000870",1357,225,32,193,371,120,115,49,127,91,110,91,19,149
"2011","Camden 009C","E01000924",1382,313,28,285,439,125,115,32,82,63,77,60,17,136
"2011","Camden 009D","E01000925",1084,107,20,87,198,96,77,57,129,103,157,116,41,160
"2011","Camden 009E","E01000926",1490,309,43,266,463,173,81,28,91,74,101,83,18,170
"2011","Camden 010A","E01000969",1720,564,84,480,557,127,143,56,62,34,57,34,23,120
"2011","Camden 010B","E01000970",1331,418,60,358,467,129,79,37,50,36,41,27,14,74
"2011","Camden 010C","E01000971",1177,322,42,280,427,73,82,30,70,42,47,33,14,84
"2011","Camden 010D","E01000972",1611,276,51,225,404,191,128,63,118,83,158,127,31,190
"2011","Camden 010E","E01000973",1613,346,40,306,495,151,107,49,117,67,116,82,34,165
"2011","Camden 011A","E01000842",1175,354,70,284,410,89,102,28,44,17,39,26,13,92
"2011","Camden 011B","E01000844",1408,504,90,414,456,104,122,11,63,33,39,25,14,76
"2011","Camden 011C","E01000848",1273,402,100,302,444,89,124,41,55,23,40,29,11,55
"2011","Camden 011D","E01000849",1274,406,61,345,412,121,85,26,53,32,39,28,11,100
"2011","Camden 012A","E01000900",1400,219,34,185,340,138,96,63,150,98,153,124,29,143
"2011","Camden 012B","E01000902",1026,108,20,88,222,101,80,41,119,76,139,112,27,140
"2011","Camden 012C","E01000904",1640,245,31,214,380,155,128,66,164,129,158,118,40,215
"2011","Camden 012D","E01000905",1392,103,18,85,219,144,95,76,205,137,217,186,31,196
"2011","Camden 012E","E01000906",1246,334,54,280,452,80,107,32,54,30,48,29,19,109
"2011","Camden 013A","E01000875",1394,272,36,236,405,122,103,69,108,77,81,59,22,157
"2011","Camden 013B","E01000876",1359,211,48,163,325,132,91,69,125,87,164,117,47,155
"2011","Camden 013C","E01000931",1494,211,33,178,319,131,96,80,166,143,189,149,40,159
"2011","Camden 013D","E01000932",1605,430,49,381,529,127,101,52,121,63,80,58,22,102
"2011","Camden 013E","E01000974",1414,280,44,236,333,118,100,64,129,92,122,94,28,176
"2011","Camden 014A","E01000843",1299,350,51,299,412,94,102,39,63,52,88,68,20,99
"2011","Camden 014B","E01000845",1166,322,67,255,403,89,97,15,50,34,54,43,11,102
"2011","Camden 014C","E01000846",1027,155,36,119,236,109,90,30,94,63,131,107,24,119
"2011","Camden 014D","E01000847",1171,224,44,180,281,98,125,35,89,56,150,125,25,113
"2011","Camden 015A","E01000864",1276,258,30,228,371,97,108,33,97,43,87,60,27,182
"2011","Camden 015B","E01000865",1330,174,27,147,274,53,81,23,38,36,36,24,12,615
"2011","Camden 015C","E01000867",1225,145,12,133,267,111,86,66,91,78,135,117,18,246
"2011","Camden 015D","E01000868",1014,75,20,55,187,105,100,65,119,106,159,118,41,98
"2011","Camden 015E","E01000869",1733,325,43,282,509,134,132,44,117,77,119,93,26,276
"2011","Camden 016A","E01000962",1330,444,66,378,455,107,90,24,49,30,44,22,22,87
"2011","Camden 016B","E01000964",1220,316,51,265,370,112,82,33,79,27,88,64,24,113
"2011","Camden 016C","E01000965",1243,365,59,306,389,105,63,27,70,49,61,49,12,114
"2011","Camden 016D","E01000966",1237,414,62,352,461,80,94,13,35,28,30,22,8,82
"2011","Camden 016E","E01000968",1275,381,57,324,397,111,85,32,80,45,70,53,17,74
"2011","Camden 017A","E01000960",1380,347,43,304,390,125,111,56,67,34,107,76,31,143
"2011","Camden 017B","E01000961",1123,155,38,117,269,94,88,48,98,63,150,120,30,158
"2011","Camden 017C","E01000963",1416,342,92,250,414,116,92,35,55,35,141,124,17,186
"2011","Camden 017D","E01000967",1031,272,75,197,307,68,104,27,53,44,74,66,8,82
"2011","Camden 018A","E01000857",1122,264,43,221,368,87,131,31,72,45,51,43,8,73
"2011","Camden 018B","E01000858",1457,187,23,164,315,128,102,69,138,116,195,161,34,207
"2011","Camden 018C","E01000859",1289,376,86,290,487,60,158,22,51,31,38,17,21,66
"2011","Camden 018D","E01000860",1039,221,50,171,358,73,105,27,48,72,52,34,18,83
"2011","Camden 018E","E01000862",1360,438,95,343,449,86,145,21,44,31,31,21,10,115
"2011","Camden 019A","E01000856",1246,122,13,109,287,95,134,59,116,72,183,148,35,178
"2011","Camden 019B","E01000861",1339,190,14,176,349,98,106,55,88,80,93,77,16,280
"2011","Camden 019C","E01000957",1379,199,22,177,319,122,108,53,117,83,166,132,34,212
"2011","Camden 019D","E01000958",1820,187,28,159,327,131,112,64,181,109,202,165,37,507
"2011","Camden 019E","E01000959",1252,73,9,64,191,118,68,77,172,99,152,121,31,302
"2011","Camden 020A","E01000929",1188,117,20,97,238,100,116,47,150,117,172,136,36,131
"2011","Camden 020B","E01000930",1415,168,25,143,339,114,117,57,147,145,164,127,37,164
"2011","Camden 020C","E01000933",1414,324,46,278,444,141,105,47,92,66,79,50,29,116
"2011","Camden 020D","E01000934",1178,132,20,112,225,123,86,56,158,86,149,113,36,163
"2011","Camden 020E","E01000935",1000,97,18,79,218,102,63,48,134,92,136,108,28,110
"2011","Camden 021A","E01000863",1290,261,33,228,357,91,103,44,81,62,83,52,31,208
"2011","Camden 021B","E01000946",1199,221,56,165,354,93,85,40,68,54,82,67,15,202
"2011","Camden 021C","E01000947",1715,334,29,305,352,106,125,63,106,86,146,112,34,397
"2011","Camden 021D","E01000948",1380,261,58,203,372,110,139,45,129,77,79,58,21,168
"2011","Camden 022A","E01000952",1318,100,22,78,212,105,80,57,165,103,160,129,31,336
"2011","Camden 022B","E01000953",1256,87,13,74,178,119,63,74,175,120,178,158,20,262
"2011","Camden 022C","E01000954",1097,55,8,47,142,94,68,71,160,115,203,168,35,189
"2011","Camden 022D","E01000955",1141,43,5,38,153,124,65,59,154,103,141,111,30,299
"2011","Camden 022E","E01000956",1150,107,12,95,176,98,66,69,92,87,160,130,30,295
"2011","Camden 023A","E01000944",1552,113,26,87,182,86,60,54,124,81,154,129,25,698
"2011","Camden 023B","E01000945",1509,139,14,125,190,88,66,49,93,73,104,87,17,707
"2011","Camden 023C","E01000949",1201,99,29,70,307,160,65,80,124,73,120,91,29,173
"2011","Camden 023D","E01000950",1041,45,8,37,132,71,78,74,118,102,198,171,27,223
"2011","Camden 023E","E01000951",1106,61,6,55,144,93,73,64,117,94,157,128,29,303
"2011","Camden 024A","E01000936",1469,136,22,114,208,65,86,40,97,41,149,108,41,647
"2011","Camden 024B","E01000938",1354,142,15,127,262,125,87,61,88,69,138,94,44,382
"2011","Camden 024C","E01000939",897,58,14,44,127,58,37,49,92,68,168,131,37,240
"2011","Camden 024D","E01000940",875,104,13,91,140,62,43,35,66,41,101,74,27,283
"2011","Camden 025A","E01000853",1231,164,17,147,256,127,87,54,127,80,130,96,34,206
"2011","Camden 025B","E01000937",1322,148,16,132,148,60,66,22,46,37,65,48,17,730
"2011","Camden 025C","E01000941",933,85,13,72,144,77,71,65,117,98,142,115,27,134
"2011","Camden 025D","E01000942",1957,208,24,184,205,72,46,37,58,38,58,41,17,1235
"2011","Camden 025E","E01000943",923,168,21,147,207,52,48,23,45,16,64,41,23,300
"2011","Camden 026A","E01000850",1548,346,34,312,393,83,65,48,52,32,49,35,14,480
"2011","Camden 026B","E01000851",2206,314,48,266,366,98,105,38,75,39,54,40,14,1117
"2011","Camden 026C","E01000852",1475,171,15,156,147,57,46,22,43,32,55,44,11,902
"2011","Camden 026D","E01000854",1559,191,20,171,215,79,69,36,96,63,97,85,12,713
"2011","Camden 027A","E01000915",1158,157,18,139,224,98,87,94,146,70,142,113,29,140
"2011","Camden 027B","E01000916",1492,354,64,290,374,99,102,51,109,57,89,68,21,257
"2011","Camden 027C","E01000917",1415,116,16,100,292,136,105,94,169,112,196,132,64,195
"2011","Camden 027D","E01000920",1619,366,38,328,434,118,156,51,98,51,107,75,32,238
"2011","Camden 028A","E01000855",1623,381,41,340,530,121,87,51,74,46,51,37,14,282
"2011","Camden 028B","E01000914",1524,356,52,304,364,87,112,44,87,56,70,50,20,348
"2011","Camden 028C","E01000918",1800,283,51,232,395,154,123,75,163,84,136,98,38,387
"2011","Camden 028D","E01000919",1797,258,55,203,395,103,107,90,150,54,108,86,22,532
"2011","City of London 001A","E01000001",1221,530,69,461,429,73,68,12,25,8,21,13,8,55
"2011","City of London 001B","E01000002",1196,518,88,430,392,83,85,15,23,9,11,7,4,60
"2011","City of London 001C","E01000003",1102,278,30,248,322,101,66,38,68,49,51,28,23,129
"2011","City of London 001E","E01000005",773,89,20,69,172,71,43,54,100,66,96,78,18,82
"2011","City of London 001F","E01032739",971,376,83,293,337,72,51,13,23,11,13,7,6,75
"2011","City of London 001G","E01032740",1044,446,72,374,320,54,63,19,17,12,23,17,6,90
"2011","Hackney 001A","E01001808",1129,66,16,50,217,149,157,40,78,70,194,178,16,158
"2011","Hackney 001B","E01001809",1205,91,26,65,229,158,133,71,93,90,171,138,33,169
"2011","Hackney 001C","E01001814",1113,99,22,77,224,132,145,50,86,88,148,121,27,141
"2011","Hackney 001D","E01001823",1087,63,17,46,221,145,88,33,119,67,213,173,40,138
"2011","Hackney 001E","E01001825",895,64,25,39,188,124,90,25,63,57,145,125,20,139
"2011","Hackney 002A","E01001714",1149,80,12,68,219,111,82,73,155,108,161,132,29,160
"2011","Hackney 002D","E01001811",1080,32,7,25,154,107,77,59,150,144,216,176,40,141
"2011","Hackney 002E","E01001813",943,48,14,34,119,68,76,63,125,119,137,108,29,188
"2011","Hackney 002F","E01033701",1428,65,9,56,215,121,93,77,181,163,278,223,55,235
"2011","Hackney 003A","E01001799",962,107,16,91,252,122,92,29,70,40,123,100,23,127
"2011","Hackney 003B","E01001802",855,73,16,57,210,87,54,30,91,57,134,107,27,119
"2011","Hackney 003C","E01001804",953,90,15,75,252,99,95,35,80,42,148,132,16,112
"2011","Hackney 003D","E01001807",1275,96,12,84,323,129,142,61,115,96,173,125,48,140
"2011","Hackney 003E","E01001812",1138,83,15,68,248,160,79,52,86,74,203,180,23,153
"2011","Hackney 004A","E01001725",1174,88,19,69,281,135,91,39,126,90,175,134,41,149
"2011","Hackney 004B","E01001726",926,52,8,44,166,81,73,48,131,87,164,124,40,124
"2011","Hackney 004C","E01001800",1033,46,9,37,196,139,68,53,131,84,190,167,23,126
"2011","Hackney 004D","E01001824",932,40,11,29,164,94,90,52,91,76,188,156,32,137
"2011","Hackney 004E","E01001826",1082,55,13,42,213,121,91,51,119,112,190,156,34,130
"2011","Hackney 006A","E01001723",1473,167,35,132,450,162,136,47,112,79,160,135,25,160
"2011","Hackney 006B","E01001724",1817,202,21,181,574,174,192,88,138,127,153,119,34,169
"2011","Hackney 006C","E01001727",1242,133,25,108,302,157,126,38,112,67,147,129,18,160
"2011","Hackney 006D","E01001768",1493,206,31,175,442,147,140,60,110,99,151,116,35,138
"2011","Hackney 006E","E01001769",1310,162,29,133,383,119,130,66,96,93,131,94,37,130
"2011","Hackney 007A","E01001715",1192,254,34,220,395,110,94,53,75,46,61,38,23,104
"2011","Hackney 007B","E01001716",1090,174,27,147,269,98,78,55,100,96,96,73,23,124
"2011","Hackney 007C","E01001717",932,127,27,100,251,122,48,34,62,54,102,91,11,132
"2011","Hackney 007D","E01001718",1597,362,50,312,525,115,134,73,86,66,49,33,16,187
"2011","Hackney 007E","E01001719",873,72,8,64,225,81,62,45,91,88,103,84,19,106
"2011","Hackney 007F","E01001720",1526,313,39,274,543,148,134,51,69,59,61,42,19,148
"2011","Hackney 008A","E01001742",1416,197,45,152,419,130,113,64,120,88,129,96,33,156
"2011","Hackney 008B","E01001801",1006,104,16,88,272,94,76,31,86,62,128,107,21,153
"2011","Hackney 008C","E01001803",1340,226,46,180,450,140,136,28,85,58,96,78,18,121
"2011","Hackney 008D","E01001806",1209,183,36,147,331,127,92,62,92,87,123,91,32,112
"2011","Hackney 009A","E01001741",1149,212,53,159,425,101,106,30,74,45,58,46,12,98
"2011","Hackney 009B","E01001805",995,158,29,129,300,109,86,28,84,56,70,57,13,104
"2011","Hackney 009C","E01001829",1369,287,59,228,497,105,122,48,70,60,72,55,17,108
"2011","Hackney 009D","E01001831",1388,190,25,165,434,140,121,75,107,97,96,73,23,128
"2011","Hackney 009E","E01001832",1339,169,25,144,375,142,132,63,110,90,129,102,27,129
"2011","Hackney 010A","E01001764",1331,120,16,104,384,117,92,64,135,111,156,119,37,152
"2011","Hackney 010B","E01001765",1211,56,15,41,180,110,80,70,178,155,238,178,60,144
"2011","Hackney 010D","E01001767",1242,134,25,109,326,121,109,47,103,96,170,130,40,136
"2011","Hackney 010E","E01001770",1333,83,8,75,270,139,110,78,143,125,226,176,50,159
"2011","Hackney 010F","E01033703",1114,89,7,82,271,101,122,44,117,104,145,107,38,121
"2011","Hackney 010G","E01033713",1074,132,20,112,257,107,95,49,94,99,155,113,42,86
"2011","Hackney 011A","E01001792",1354,142,21,121,293,124,158,58,130,124,170,138,32,155
"2011","Hackney 011B","E01001793",1345,136,19,117,376,119,139,60,144,127,121,85,36,123
"2011","Hackney 011C","E01001794",1470,173,27,146,363,128,165,55,124,111,173,135,38,178
"2011","Hackney 011D","E01001795",1166,143,21,122,339,92,116,54,99,87,129,95,34,107
"2011","Hackney 011E","E01001796",1356,148,22,126,319,112,153,47,146,118,155,109,46,158
"2011","Hackney 012A","E01001736",1310,198,26,172,415,117,116,48,84,70,121,91,30,141
"2011","Hackney 012B","E01001737",1462,279,38,241,535,116,117,44,79,73,100,75,25,119
"2011","Hackney 012C","E01001738",1414,236,29,207,464,133,119,55,97,98,99,65,34,113
"2011","Hackney 012D","E01001739",1675,303,53,250,576,151,153,56,100,99,109,76,33,128
"2011","Hackney 013A","E01001786",1264,54,8,46,192,99,92,75,184,146,217,160,57,205
"2011","Hackney 013B","E01001787",1043,33,4,29,148,108,73,58,160,142,195,147,48,126
"2011","Hackney 013C","E01001788",1067,53,8,45,174,83,85,52,161,125,190,143,47,144
"2011","Hackney 013D","E01001790",914,31,7,24,127,86,53,47,153,107,182,138,44,128
"2011","Hackney 014A","E01001740",1138,92,10,82,224,102,82,69,135,118,190,152,38,126
"2011","Hackney 014B","E01001747",1792,261,33,228,519,127,165,77,146,129,162,127,35,206
"2011","Hackney 014C","E01001830",1556,133,20,113,371,176,133,83,188,155,176,126,50,141
"2011","Hackney 014D","E01001833",1696,218,26,192,474,137,143,52,149,129,191,147,44,203
"2011","Hackney 014E","E01001834",1680,250,35,215,535,152,155,72,158,86,132,102,30,140
"2011","Hackney 014F","E01001835",1031,156,28,128,323,87,89,47,75,71,70,57,13,113
"2011","Hackney 015A","E01001733",1411,161,35,126,374,121,137,77,138,133,147,102,45,123
"2011","Hackney 015B","E01001785",1135,97,20,77,265,126,134,49,94,93,157,115,42,120
"2011","Hackney 015C","E01001789",1343,142,18,124,363,121,109,77,146,106,138,100,38,141
"2011","Hackney 015D","E01001791",1109,75,8,67,195,112,83,60,144,97,190,155,35,153
"2011","Hackney 016A","E01001745",1715,164,32,132,369,127,147,97,209,169,246,183,63,187
"2011","Hackney 016B","E01001746",1119,57,10,47,179,102,75,59,165,135,202,148,54,145
"2011","Hackney 016C","E01001757",1262,51,8,43,214,127,90,50,183,160,199,152,47,188
"2011","Hackney 016D","E01001758",1548,118,17,101,360,136,103,80,186,151,228,171,57,186
"2011","Hackney 016E","E01001759",1427,153,29,124,387,151,117,65,171,89,138,87,51,156
"2011","Hackney 016F","E01001761",1450,128,21,107,358,138,144,79,160,114,174,129,45,155
"2011","Hackney 017A","E01001731",1768,174,28,146,427,170,136,94,203,150,206,143,63,208
"2011","Hackney 017B","E01001734",1500,135,20,115,394,141,182,60,159,123,156,101,55,150
"2011","Hackney 017C","E01001760",1408,151,20,131,350,146,124,78,158,119,148,109,39,134
"2011","Hackney 017D","E01001762",1508,168,27,141,483,149,159,60,112,83,139,96,43,155
"2011","Hackney 018A","E01001846",897,64,12,52,146,117,76,59,104,104,127,90,37,100
"2011","Hackney 018B","E01001847",858,55,9,46,177,82,68,46,121,108,108,79,29,93
"2011","Hackney 018C","E01001848",1212,139,19,120,281,124,89,50,116,102,171,141,30,140
"2011","Hackney 018D","E01001849",1799,139,20,119,489,193,154,71,186,121,233,171,62,213
"2011","Hackney 019A","E01001729",1474,69,12,57,242,155,116,89,224,150,233,165,68,196
"2011","Hackney 019B","E01001730",1338,57,14,43,215,129,90,89,181,170,255,186,69,152
"2011","Hackney 019C","E01001732",1214,61,13,48,164,107,99,79,161,150,223,158,65,170
"2011","Hackney 019D","E01001735",1229,150,29,121,297,109,89,68,135,119,132,101,31,130
"2011","Hackney 019E","E01001838",1179,46,9,37,156,119,72,67,156,144,243,171,72,176
"2011","Hackney 019F","E01001850",1194,54,8,46,159,134,58,71,170,157,225,170,55,166
"2011","Hackney 020A","E01001748",1968,255,33,222,646,154,189,80,142,108,173,116,57,221
"2011","Hackney 020B","E01001749",1411,274,25,249,458,121,148,34,84,78,85,60,25,129
"2011","Hackney 020C","E01001763",1312,163,22,141,352,109,137,46,130,91,140,78,62,144
"2011","Hackney 020D","E01001816",1250,157,20,137,373,108,118,50,98,81,115,79,36,150
"2011","Hackney 020E","E01001819",1260,199,34,165,384,112,125,53,100,82,103,69,34,102
"2011","Hackney 021B","E01001744",1467,189,35,154,359,132,128,61,152,137,136,104,32,173
"2011","Hackney 021C","E01001750",1504,257,45,212,354,137,120,61,139,88,141,115,26,207
"2011","Hackney 021D","E01001751",1318,380,53,327,471,95,135,34,41,40,40,25,15,82
"2011","Hackney 021E","E01001756",1856,349,48,301,637,156,194,69,108,74,95,67,28,174
"2011","Hackney 021F","E01033698",947,83,10,73,220,96,67,39,98,105,131,108,23,108
"2011","Hackney 021G","E01033699",1069,136,18,118,323,80,122,62,72,87,85,54,31,102
"2011","Hackney 021H","E01033700",1361,236,42,194,427,113,121,57,94,91,109,68,41,113
"2011","Hackney 021I","E01033707",1136,124,7,117,301,107,105,49,103,82,115,90,25,150
"2011","Hackney 022A","E01001836",1391,182,35,147,375,155,125,79,131,100,147,109,38,97
"2011","Hackney 022B","E01001840",1211,103,21,82,234,135,98,69,112,133,204,170,34,123
"2011","Hackney 022C","E01001841",1073,153,24,129,240,110,91,49,125,86,119,86,33,100
"2011","Hackney 022D","E01001844",1595,207,41,166,415,141,128,49,95,84,126,93,33,350
"2011","Hackney 022E","E01001845",1137,82,15,67,203,115,73,66,157,136,178,139,39,127
"2011","Hackney 023B","E01001837",1200,265,38,227,384,138,115,43,79,51,63,43,20,62
"2011","Hackney 023C","E01001839",1861,228,32,196,566,155,163,75,142,109,152,113,39,271
"2011","Hackney 023D","E01001842",1185,90,12,78,272,115,92,59,132,94,166,130,36,165
"2011","Hackney 023E","E01001843",944,120,17,103,248,116,70,33,83,76,92,73,19,106
"2011","Hackney 023F","E01033704",1376,283,33,250,479,98,140,57,64,65,72,53,19,118
"2011","Hackney 023G","E01033712",1267,148,19,129,351,127,134,57,99,75,131,94,37,145
"2011","Hackney 024A","E01001772",789,37,6,31,123,89,52,44,119,77,126,80,46,122
"2011","Hackney 024B","E01001774",1647,219,38,181,449,172,101,81,140,116,183,144,39,186
"2011","Hackney 024C","E01001775",1331,94,26,68,264,124,91,80,149,151,197,146,51,181
"2011","Hackney 024D","E01001815",1329,114,22,92,268,131,94,81,140,121,204,168,36,176
"2011","Hackney 024E","E01001820",1126,77,12,65,234,108,72,68,142,115,171,126,45,139
"2011","Hackney 024F","E01001821",1108,67,12,55,242,88,66,56,164,125,170,124,46,130
"2011","Hackney 025A","E01001752",1936,468,68,400,536,167,104,71,146,115,145,103,42,184
"2011","Hackney 025B","E01001753",1185,100,10,90,175,118,86,56,159,120,217,151,66,154
"2011","Hackney 025C","E01001754",1903,250,38,212,491,166,165,85,172,141,232,166,66,201
"2011","Hackney 025D","E01001755",1320,121,13,108,245,121,94,61,150,117,182,143,39,229
"2011","Hackney 025E","E01001773",1621,195,15,180,374,150,114,61,166,115,234,184,50,212
"2011","Hackney 025F","E01001776",1155,95,8,87,230,108,74,61,158,119,184,149,35,126
"2011","Hackney 026A","E01001779",1884,272,54,218,476,162,102,72,148,134,241,185,56,277
"2011","Hackney 026B","E01001781",1285,98,7,91,209,125,94,64,156,129,197,144,53,213
"2011","Hackney 026C","E01001782",1934,416,70,346,494,160,143,70,152,119,179,127,52,201
"2011","Hackney 026D","E01001783",1451,89,15,74,243,116,98,77,189,155,228,163,65,256
"2011","Hackney 027B","E01001777",1874,239,32,207,449,171,128,76,188,161,196,149,47,266
"2011","Hackney 027D","E01001780",1456,180,35,145,317,151,103,60,156,130,165,110,55,194
"2011","Hackney 027E","E01001784",1884,136,23,113,316,133,97,72,186,142,191,145,46,611
"2011","Hackney 027F","E01033706",1402,377,57,320,447,87,124,41,59,42,46,33,13,179
"2011","Hackney 027G","E01033708",1528,395,57,338,521,75,150,35,35,40,37,17,20,240
"2011","Hackney 027H","E01033709",1397,204,28,176,395,157,81,65,109,81,87,64,23,218
"2011","Hackney 027I","E01033711",1016,181,24,157,278,74,63,17,55,43,30,24,6,275
"2011","Hackney 028A","E01001798",1261,71,14,57,218,113,97,66,168,150,225,168,57,153
"2011","Hackney 028B","E01001828",1427,76,18,58,258,125,136,83,191,141,251,188,63,166
"2011","Hackney 028C","E01033702",839,71,10,61,188,89,101,34,99,51,124,97,27,82
"2011","Hackney 028D","E01033705",1012,74,8,66,224,98,84,43,113,98,132,104,28,146
"2011","Hackney 028E","E01033710",853,95,18,77,214,75,95,38,78,76,99,68,31,83
"2011","Hackney 029A","E01001722",1472,112,19,93,302,165,148,86,195,122,212,166,46,130
"2011","Hackney 029B","E01001728",1193,56,27,29,217,181,85,37,131,74,214,180,34,198
"2011","Hackney 029C","E01001822",1232,44,10,34,188,112,110,66,153,146,246,201,45,167
"2011","Hackney 029D","E01001827",1224,71,27,44,191,152,92,49,143,130,226,179,47,170
"2011","Hammersmith and Fulham 001A","E01001874",1722,173,23,150,451,230,118,100,219,139,110,77,33,182
"2011","Hammersmith and Fulham 001B","E01001875",1325,78,19,59,184,147,109,89,196,177,186,152,34,159
"2011","Hammersmith and Fulham 001C","E01001876",1683,185,10,175,335,128,113,100,176,170,225,183,42,251
"2011","Hammersmith and Fulham 001D","E01001877",1041,67,15,52,237,113,98,72,146,119,103,71,32,86
"2011","Hammersmith and Fulham 001E","E01001878",1174,66,7,59,192,136,99,61,156,152,152,115,37,160
"2011","Hammersmith and Fulham 002A","E01001955",1289,87,16,71,205,126,106,71,186,136,215,174,41,157
"2011","Hammersmith and Fulham 002B","E01001957",1171,38,7,31,146,124,96,85,167,151,175,149,26,189
"2011","Hammersmith and Fulham 002C","E01001958",1168,32,5,27,150,121,99,86,175,145,191,152,39,169
"2011","Hammersmith and Fulham 002D","E01001961",1056,51,3,48,139,108,76,63,162,102,195,145,50,160
"2011","Hammersmith and Fulham 003A","E01001954",1153,172,35,137,279,113,108,50,104,108,96,77,19,123
"2011","Hammersmith and Fulham 003B","E01001956",1206,145,33,112,302,123,120,68,101,88,105,73,32,154
"2011","Hammersmith and Fulham 003C","E01001959",1242,104,13,91,237,118,90,73,134,123,171,139,32,192
"2011","Hammersmith and Fulham 003D","E01001960",1557,265,41,224,502,153,129,77,105,92,82,57,25,152
"2011","Hammersmith and Fulham 004A","E01001943",1653,259,32,227,431,160,131,81,146,116,143,110,33,186
"2011","Hammersmith and Fulham 004B","E01001944",1278,91,17,74,199,134,120,74,201,134,197,140,57,128
"2011","Hammersmith and Fulham 004C","E01001945",1381,200,28,172,457,141,140,71,101,84,88,66,22,99
"2011","Hammersmith and Fulham 004D","E01001946",1316,198,29,169,386,134,103,78,106,103,95,70,25,113
"2011","Hammersmith and Fulham 005A","E01001862",1434,201,35,166,390,141,114,82,138,112,140,105,35,116
"2011","Hammersmith and Fulham 005B","E01001940",1291,154,19,135,327,133,114,82,127,89,116,85,31,149
"2011","Hammersmith and Fulham 005C","E01001941",1491,253,30,223,452,164,121,64,112,89,103,78,25,133
"2011","Hammersmith and Fulham 005D","E01001942",1553,234,34,200,449,133,149,99,115,137,112,77,35,125
"2011","Hammersmith and Fulham 006A","E01001858",1441,195,34,161,342,127,111,78,107,107,93,68,25,281
"2011","Hammersmith and Fulham 006B","E01001860",1416,145,17,128,324,125,138,125,132,109,154,110,44,164
"2011","Hammersmith and Fulham 006C","E01001861",1179,162,33,129,321,98,91,64,110,114,110,88,22,109
"2011","Hammersmith and Fulham 006D","E01001863",1216,200,38,162,375,122,118,62,84,82,59,37,22,114
"2011","Hammersmith and Fulham 006E","E01001864",1264,185,23,162,385,130,122,72,89,110,85,65,20,86
"2011","Hammersmith and Fulham 007A","E01001852",1595,406,70,336,501,141,133,52,74,60,57,39,18,171
"2011","Hammersmith and Fulham 007B","E01001853",1245,320,61,259,415,101,106,38,73,59,51,35,16,82
"2011","Hammersmith and Fulham 007C","E01001854",1458,328,61,267,443,151,101,51,97,81,81,51,30,125
"2011","Hammersmith and Fulham 007D","E01001857",1185,148,21,127,262,123,80,66,140,116,140,103,37,110
"2011","Hammersmith and Fulham 008A","E01001859",1945,352,54,298,541,252,114,69,148,106,193,143,50,170
"2011","Hammersmith and Fulham 008B","E01001865",1356,241,49,192,447,133,148,62,92,66,73,34,39,94
"2011","Hammersmith and Fulham 008C","E01001927",1105,233,67,166,361,107,120,36,69,33,37,24,13,109
"2011","Hammersmith and Fulham 008D","E01001930",1392,264,53,211,394,145,102,40,107,95,121,105,16,124
"2011","Hammersmith and Fulham 009A","E01001895",1258,212,46,166,402,118,109,44,93,65,55,45,10,160
"2011","Hammersmith and Fulham 009B","E01001896",1295,220,34,186,319,101,86,51,98,76,78,59,19,266
"2011","Hammersmith and Fulham 009C","E01001897",1088,230,50,180,378,105,115,32,60,56,41,28,13,71
"2011","Hammersmith and Fulham 009D","E01001929",979,233,44,189,398,83,86,23,33,33,30,23,7,60
"2011","Hammersmith and Fulham 010A","E01001851",1267,315,81,234,454,105,117,35,80,52,33,21,12,76
"2011","Hammersmith and Fulham 010B","E01001855",1452,369,59,310,496,126,122,41,59,58,74,48,26,107
"2011","Hammersmith and Fulham 010C","E01001856",1316,238,45,193,358,134,97,41,102,81,126,93,33,139
"2011","Hammersmith and Fulham 010D","E01001869",992,285,68,217,334,67,80,29,40,47,42,37,5,68
"2011","Hammersmith and Fulham 010E","E01001873",1175,220,29,191,340,109,99,44,104,71,88,63,25,100
"2011","Hammersmith and Fulham 011A","E01001928",1289,248,55,193,414,134,103,47,86,65,100,78,22,92
"2011","Hammersmith and Fulham 011B","E01001931",1153,202,32,170,343,110,83,42,84,60,102,68,34,127
"2011","Hammersmith and Fulham 011C","E01001932",1355,282,45,237,414,130,94,43,105,65,81,65,16,141
"2011","Hammersmith and Fulham 011D","E01001933",1037,215,40,175,325,90,90,30,68,51,71,48,23,97
"2011","Hammersmith and Fulham 012A","E01001866",1307,287,59,228,373,96,103,36,63,44,84,69,15,221
"2011","Hammersmith and Fulham 012B","E01001867",1079,218,34,184,255,76,74,41,61,33,74,58,16,247
"2011","Hammersmith and Fulham 012C","E01001868",1050,87,14,73,190,101,75,63,164,116,113,89,24,141
"2011","Hammersmith and Fulham 012D","E01001870",1732,352,73,279,538,149,94,53,106,74,85,62,23,281
"2011","Hammersmith and Fulham 012E","E01001871",1361,300,50,250,373,109,91,34,61,77,95,69,26,221
"2011","Hammersmith and Fulham 012F","E01001872",1426,329,64,265,382,126,84,33,82,54,93,50,43,243
"2011","Hammersmith and Fulham 013A","E01001893",961,99,18,81,186,102,66,52,96,83,115,85,30,162
"2011","Hammersmith and Fulham 013B","E01001894",1074,144,25,119,294,108,73,54,105,82,105,75,30,109
"2011","Hammersmith and Fulham 013C","E01001898",1322,264,39,225,360,134,132,55,87,53,82,44,38,155
"2011","Hammersmith and Fulham 013D","E01001899",1068,102,12,90,214,119,70,72,136,96,140,109,31,119
"2011","Hammersmith and Fulham 013E","E01001900",1360,204,30,174,309,143,84,74,153,97,108,78,30,188
"2011","Hammersmith and Fulham 014A","E01001889",1193,278,50,228,382,113,72,26,52,40,53,37,16,177
"2011","Hammersmith and Fulham 014B","E01001910",1351,332,51,281,405,139,83,50,89,62,62,40,22,129
"2011","Hammersmith and Fulham 014C","E01001913",1406,503,86,417,487,125,65,18,43,31,19,12,7,115
"2011","Hammersmith and Fulham 014D","E01001914",1555,347,51,296,430,130,105,41,102,92,86,67,19,222
"2011","Hammersmith and Fulham 015A","E01001885",954,41,5,36,131,105,68,48,142,135,174,131,43,110
"2011","Hammersmith and Fulham 015B","E01001908",1484,353,71,282,414,119,93,63,82,82,93,55,38,185
"2011","Hammersmith and Fulham 015C","E01001909",1507,296,49,247,416,140,119,59,122,91,99,62,37,165
"2011","Hammersmith and Fulham 015D","E01001911",1312,135,21,114,262,129,85,77,168,126,157,131,26,173
"2011","Hammersmith and Fulham 015E","E01001912",1203,130,21,109,177,90,89,57,130,114,168,137,31,248
"2011","Hammersmith and Fulham 016A","E01001886",1258,188,41,147,257,117,78,82,118,79,112,76,36,227
"2011","Hammersmith and Fulham 016B","E01001887",1248,169,23,146,337,107,92,65,113,102,66,49,17,197
"2011","Hammersmith and Fulham 016C","E01001890",1590,265,28,237,502,122,87,59,96,66,45,30,15,348
"2011","Hammersmith and Fulham 016D","E01001892",1068,156,30,126,261,97,89,44,100,84,86,57,29,151
"2011","Hammersmith and Fulham 017A","E01001880",1223,255,57,198,362,120,99,53,86,86,71,45,26,91
"2011","Hammersmith and Fulham 017B","E01001881",1338,337,77,260,406,144,114,41,55,67,39,24,15,135
"2011","Hammersmith and Fulham 017C","E01001882",1517,388,56,332,474,139,107,48,81,52,63,48,15,165
"2011","Hammersmith and Fulham 017D","E01001883",1241,235,40,195,312,119,90,38,90,75,78,56,22,204
"2011","Hammersmith and Fulham 017E","E01001884",1485,275,54,221,385,139,114,55,134,104,89,65,24,190
"2011","Hammersmith and Fulham 018A","E01001888",1316,261,55,206,409,129,85,49,82,43,49,31,18,209
"2011","Hammersmith and Fulham 018B","E01001891",1797,331,53,278,526,178,117,63,95,100,57,46,11,330
"2011","Hammersmith and Fulham 018C","E01001917",1150,238,56,182,334,120,94,47,90,59,46,35,11,122
"2011","Hammersmith and Fulham 018D","E01001918",1184,271,66,205,371,117,107,35,69,54,45,25,20,115
"2011","Hammersmith and Fulham 018E","E01001919",1149,285,64,221,370,106,109,28,56,40,46,36,10,109
"2011","Hammersmith and Fulham 019A","E01001879",1225,205,35,170,290,102,105,46,134,85,88,63,25,170
"2011","Hammersmith and Fulham 019B","E01001901",1268,333,77,256,420,114,95,34,67,39,49,36,13,117
"2011","Hammersmith and Fulham 019C","E01001902",1466,337,71,266,410,147,107,54,89,81,69,48,21,172
"2011","Hammersmith and Fulham 019D","E01001903",1313,188,37,151,302,124,110,64,125,85,131,111,20,184
"2011","Hammersmith and Fulham 020A","E01001920",1207,179,48,131,338,125,93,61,112,94,77,53,24,128
"2011","Hammersmith and Fulham 020B","E01001921",1241,292,68,224,378,96,118,26,81,51,80,58,22,119
"2011","Hammersmith and Fulham 020C","E01001922",1227,299,80,219,409,137,128,26,48,44,52,33,19,84
"2011","Hammersmith and Fulham 020D","E01001923",1181,304,64,240,345,100,99,35,81,63,54,39,15,100
"2011","Hammersmith and Fulham 020E","E01001924",1197,356,87,269,405,102,109,32,38,35,34,24,10,86
"2011","Hammersmith and Fulham 021A","E01001947",1061,86,21,65,170,113,81,50,140,131,145,106,39,145
"2011","Hammersmith and Fulham 021B","E01001948",1610,428,99,329,597,130,128,35,59,49,84,62,22,100
"2011","Hammersmith and Fulham 021C","E01001949",1256,363,93,270,452,101,87,33,45,33,43,27,16,99
"2011","Hammersmith and Fulham 021D","E01001950",1226,362,76,286,442,99,106,18,45,32,45,28,17,77
"2011","Hammersmith and Fulham 021E","E01001951",1313,325,57,268,430,116,102,46,79,63,77,57,20,75
"2011","Hammersmith and Fulham 021F","E01001953",1104,226,44,182,323,107,83,49,86,59,68,53,15,103
"2011","Hammersmith and Fulham 022A","E01001904",1308,319,63,256,426,147,104,54,59,53,47,34,13,99
"2011","Hammersmith and Fulham 022B","E01001905",1360,341,60,281,485,142,118,32,56,39,39,30,9,108
"2011","Hammersmith and Fulham 022C","E01001906",1235,336,50,286,406,147,78,46,70,39,32,17,15,81
"2011","Hammersmith and Fulham 022D","E01001907",1010,260,53,207,372,93,86,27,42,29,39,32,7,62
"2011","Hammersmith and Fulham 023A","E01001935",1707,371,80,291,524,174,163,64,125,89,93,59,34,104
"2011","Hammersmith and Fulham 023C","E01001939",1838,281,76,205,368,158,131,66,166,101,124,103,21,443
"2011","Hammersmith and Fulham 023D","E01032788",876,144,33,111,254,96,63,37,85,55,74,55,19,68
"2011","Hammersmith and Fulham 023E","E01032789",928,205,39,166,309,90,73,20,44,21,57,44,13,109
"2011","Hammersmith and Fulham 023F","E01032790",826,186,51,135,210,57,96,21,43,24,81,65,16,108
"2011","Hammersmith and Fulham 024A","E01001915",1053,307,65,242,368,83,100,18,47,29,23,10,13,78
"2011","Hammersmith and Fulham 024B","E01001916",1019,279,84,195,355,95,123,28,35,22,27,17,10,55
"2011","Hammersmith and Fulham 024C","E01001926",1136,319,59,260,406,97,114,20,39,36,29,16,13,76
"2011","Hammersmith and Fulham 024D","E01001952",1419,342,76,266,490,138,116,38,68,56,44,26,18,127
"2011","Hammersmith and Fulham 025A","E01001925",1183,306,82,224,399,112,102,24,62,57,32,19,13,89
"2011","Hammersmith and Fulham 025B","E01001934",1231,178,43,135,295,136,100,53,115,97,100,68,32,157
"2011","Hammersmith and Fulham 025C","E01001937",1475,344,66,278,475,135,162,39,77,69,64,40,24,110
"2011","Hammersmith and Fulham 025D","E01001938",1147,140,26,114,330,133,101,69,95,96,94,70,24,89
"2011","Haringey 001A","E01001969",1489,147,22,125,360,158,181,88,132,132,159,112,47,132
"2011","Haringey 001B","E01001971",1476,94,15,79,219,118,194,91,172,169,245,192,53,174
"2011","Haringey 001C","E01001974",1777,205,32,173,425,183,247,110,153,162,130,79,51,162
"2011","Haringey 001D","E01001975",1410,175,23,152,345,152,195,66,133,101,104,78,26,139
"2011","Haringey 002A","E01002036",1136,38,5,33,151,83,110,58,153,156,231,183,48,156
"2011","Haringey 002B","E01002037",1340,64,6,58,139,109,85,86,205,198,285,201,84,169
"2011","Haringey 002C","E01002039",1071,22,2,20,111,86,61,59,174,127,253,202,51,178
"2011","Haringey 002D","E01002040",1447,57,7,50,191,126,172,76,214,196,220,176,44,195
"2011","Haringey 004A","E01001962",1247,226,37,189,401,114,127,39,76,50,90,74,16,124
"2011","Haringey 004B","E01001970",1489,111,19,92,291,137,178,72,178,119,197,154,43,206
"2011","Haringey 004C","E01001972",1270,147,27,120,316,130,132,67,119,101,123,89,34,135
"2011","Haringey 004D","E01001973",1682,222,38,184,462,194,189,83,144,108,117,84,33,163
"2011","Haringey 005A","E01002090",1161,50,14,36,161,126,144,83,148,127,168,142,26,154
"2011","Haringey 005B","E01002093",1239,46,14,32,177,111,130,86,193,122,222,186,36,152
"2011","Haringey 005C","E01002096",1106,43,7,36,153,117,93,68,162,130,163,127,36,177
"2011","Haringey 005D","E01002097",1105,54,11,43,179,101,84,71,163,121,186,145,41,146
"2011","Haringey 006A","E01002091",1212,32,9,23,146,95,134,68,177,151,245,209,36,164
"2011","Haringey 006B","E01002092",1219,65,16,49,163,136,102,65,165,150,226,187,39,147
"2011","Haringey 006C","E01002094",1070,54,9,45,141,107,104,44,152,120,177,149,28,171
"2011","Haringey 006D","E01002095",1132,43,4,39,177,113,84,60,162,154,187,155,32,152
"2011","Haringey 007A","E01002098",1083,147,27,120,304,115,125,46,93,74,65,41,24,114
"2011","Haringey 007B","E01002101",1507,118,27,91,285,116,203,87,171,202,176,157,19,149
"2011","Haringey 007C","E01002102",1502,134,15,119,315,129,172,90,164,148,160,125,35,190
"2011","Haringey 007D","E01002105",1654,97,11,86,306,175,231,128,223,165,139,101,38,190
"2011","Haringey 008A","E01002099",1496,66,7,59,224,144,125,88,197,161,265,214,51,226
"2011","Haringey 008B","E01002100",1421,89,13,76,226,150,162,83,165,163,180,147,33,203
"2011","Haringey 008C","E01002103",1429,103,10,93,266,122,210,103,129,158,140,121,19,198
"2011","Haringey 008D","E01002104",1086,76,11,65,181,123,140,55,157,103,123,93,30,128
"2011","Haringey 009A","E01001963",1298,282,53,229,469,121,126,21,76,45,68,53,15,90
"2011","Haringey 009B","E01001964",1272,224,46,178,466,97,127,45,89,50,57,34,23,117
"2011","Haringey 009C","E01001965",1205,313,57,256,442,92,99,35,62,39,45,32,13,78
"2011","Haringey 009D","E01001966",1131,263,29,234,352,105,148,31,51,31,36,26,10,114
"2011","Haringey 010A","E01002027",1192,95,16,79,250,117,124,73,127,109,120,98,22,177
"2011","Haringey 010B","E01002028",1398,124,28,96,265,146,159,69,186,128,116,92,24,205
"2011","Haringey 010C","E01002032",1363,82,16,66,225,115,168,88,180,130,191,162,29,184
"2011","Haringey 010D","E01002033",1384,71,11,60,232,128,124,117,195,127,199,143,56,191
"2011","Haringey 011A","E01001976",1180,65,13,52,190,94,145,80,147,155,159,132,27,145
"2011","Haringey 011B","E01001977",1126,41,8,33,161,100,145,78,160,146,163,135,28,132
"2011","Haringey 011C","E01001978",1385,65,14,51,171,130,149,66,213,157,225,185,40,209
"2011","Haringey 011D","E01001979",1610,67,12,55,231,130,150,94,184,144,248,207,41,362
"2011","Haringey 012A","E01002074",1426,65,14,51,195,140,139,83,185,171,274,215,59,174
"2011","Haringey 012B","E01002077",1486,40,6,34,148,135,155,69,181,184,213,174,39,361
"2011","Haringey 012C","E01002079",1179,63,11,52,200,110,151,56,145,148,162,131,31,144
"2011","Haringey 012D","E01002081",1328,42,6,36,143,87,94,56,162,159,247,205,42,338
"2011","Haringey 013A","E01002082",1073,26,5,21,110,74,83,65,182,142,207,171,36,184
"2011","Haringey 013B","E01002086",1239,105,19,86,199,96,114,71,147,135,208,165,43,164
"2011","Haringey 013C","E01002088",1437,139,17,122,273,125,171,92,165,141,165,138,27,166
"2011","Haringey 013D","E01002089",1057,24,4,20,89,69,63,70,183,159,222,178,44,178
"2011","Haringey 014A","E01001967",1207,245,52,193,465,93,139,35,48,35,34,23,11,113
"2011","Haringey 014B","E01001968",1428,279,37,242,513,134,167,44,89,48,53,28,25,101
"2011","Haringey 014C","E01001996",1220,230,46,184,429,103,150,43,78,43,55,35,20,89
"2011","Haringey 014D","E01001997",1290,256,38,218,484,150,109,45,69,43,47,25,22,87
"2011","Haringey 015A","E01002075",1289,57,13,44,150,119,128,73,129,93,202,167,35,338
"2011","Haringey 015B","E01002076",1388,49,10,39,194,137,128,96,176,151,194,161,33,263
"2011","Haringey 015C","E01002078",1657,113,22,91,284,179,141,99,230,185,216,174,42,210
"2011","Haringey 015D","E01002080",1256,73,8,65,174,102,143,62,158,153,152,131,21,239
"2011","Haringey 016A","E01002026",1195,61,9,52,170,120,95,63,174,135,219,169,50,158
"2011","Haringey 016B","E01002029",1368,97,21,76,237,125,104,82,161,93,160,131,29,309
"2011","Haringey 016C","E01002030",1294,141,26,115,304,129,140,88,123,93,120,101,19,156
"2011","Haringey 016D","E01002031",1574,110,17,93,333,145,184,109,157,153,165,138,27,218
"2011","Haringey 017A","E01001991",1233,278,43,235,467,132,112,38,54,35,35,29,6,82
"2011","Haringey 017B","E01001992",1241,330,48,282,420,111,134,25,40,32,43,29,14,106
"2011","Haringey 017C","E01001993",1142,346,61,285,396,81,107,19,37,20,34,22,12,102
"2011","Haringey 017D","E01001995",1667,202,25,177,433,170,165,79,157,139,166,131,35,156
"2011","Haringey 018A","E01001980",1463,84,15,69,244,116,190,96,182,172,197,161,36,182
"2011","Haringey 018B","E01001981",1332,93,15,78,209,122,177,77,160,135,184,142,42,175
"2011","Haringey 018C","E01001982",1351,100,15,85,252,100,162,96,163,166,159,119,40,153
"2011","Haringey 018D","E01001983",1237,104,15,89,263,133,111,72,138,125,146,119,27,145
"2011","Haringey 019A","E01002083",1153,89,11,78,237,126,134,75,129,127,104,77,27,132
"2011","Haringey 019B","E01002084",1272,119,17,102,245,120,166,86,147,146,106,80,26,137
"2011","Haringey 019C","E01002085",1676,109,16,93,359,161,177,91,177,178,202,158,44,222
"2011","Haringey 019D","E01002087",1268,127,21,106,240,143,115,85,146,107,170,140,30,135
"2011","Haringey 020B","E01002014",1407,237,29,208,467,137,110,64,111,76,99,68,31,106
"2011","Haringey 020C","E01002015",1159,158,27,131,289,120,106,48,103,103,139,89,50,93
"2011","Haringey 020D","E01002018",1021,160,33,127,306,108,97,26,82,63,98,66,32,81
"2011","Haringey 020E","E01033085",1473,267,34,233,459,161,84,61,102,78,129,83,46,132
"2011","Haringey 020F","E01033086",786,36,9,27,118,90,69,39,106,78,159,124,35,91
"2011","Haringey 021A","E01002020",1233,241,36,205,400,141,122,40,72,56,62,42,20,99
"2011","Haringey 021B","E01002022",1584,324,55,269,610,159,144,63,79,59,60,40,20,86
"2011","Haringey 021C","E01002023",1092,264,49,215,408,92,114,26,49,25,32,24,8,82
"2011","Haringey 021D","E01002025",1268,334,65,269,486,90,115,32,51,18,40,20,20,102
"2011","Haringey 022A","E01002013",1066,237,39,198,389,91,110,32,63,43,40,22,18,61
"2011","Haringey 022B","E01002019",1018,239,49,190,381,81,112,19,39,25,33,20,13,89
"2011","Haringey 022C","E01002021",1133,256,52,204,434,97,126,14,53,22,41,28,13,90
"2011","Haringey 022D","E01002024",963,199,32,167,333,80,93,32,51,43,51,37,14,81
"2011","Haringey 023A","E01001998",1726,246,32,214,479,177,171,93,153,120,115,87,28,172
"2011","Haringey 023B","E01001999",1652,211,47,164,412,129,177,92,160,143,155,126,29,173
"2011","Haringey 023C","E01002003",1674,106,12,94,324,128,181,121,205,150,228,180,48,231
"2011","Haringey 023D","E01002004",1538,215,35,180,391,122,143,72,137,120,135,99,36,203
"2011","Haringey 024A","E01002067",1293,72,10,62,195,111,163,66,158,169,205,155,50,154
"2011","Haringey 024B","E01002069",1544,93,15,78,266,126,187,91,188,176,211,158,53,206
"2011","Haringey 024C","E01002070",1538,134,14,120,310,155,183,81,158,147,197,165,32,173
"2011","Haringey 024D","E01002073",1315,68,9,59,219,108,167,71,160,168,192,157,35,162
"2011","Haringey 025A","E01002066",1328,68,19,49,209,119,113,88,168,138,215,182,33,210
"2011","Haringey 025B","E01002068",1480,124,16,108,278,117,224,77,172,140,169,125,44,179
"2011","Haringey 025C","E01002071",1158,55,10,45,146,106,115,69,175,130,173,144,29,189
"2011","Haringey 025D","E01002072",1467,73,20,53,245,108,136,100,166,138,208,169,39,293
"2011","Haringey 026A","E01002043",1539,108,19,89,282,133,153,95,193,181,191,165,26,203
"2011","Haringey 026B","E01002045",1684,133,12,121,295,160,151,84,199,204,230,173,57,228
"2011","Haringey 026C","E01002046",1257,79,15,64,211,122,144,90,158,151,147,114,33,155
"2011","Haringey 026D","E01002049",1405,100,12,88,252,124,149,84,159,152,198,177,21,187
"2011","Haringey 027A","E01002042",1183,91,16,75,256,95,136,80,141,135,102,81,21,147
"2011","Haringey 027B","E01002044",1435,140,15,125,329,123,130,111,155,141,122,96,26,184
"2011","Haringey 027C","E01002047",1394,139,22,117,327,114,102,87,147,152,100,80,20,226
"2011","Haringey 027D","E01002048",1525,141,26,115,323,141,139,99,156,170,189,148,41,167
"2011","Haringey 028A","E01002016",1543,261,51,210,546,156,114,55,114,78,83,60,23,136
"2011","Haringey 028B","E01002017",1469,221,38,183,507,143,92,49,111,88,112,75,37,146
"2011","Haringey 028C","E01002059",1255,190,40,150,395,110,134,43,98,65,101,66,35,119
"2011","Haringey 028D","E01002060",1403,312,55,257,544,128,126,36,69,47,40,21,19,101
"2011","Haringey 029A","E01002050",1083,67,19,48,197,143,154,45,117,104,123,112,11,133
"2011","Haringey 029B","E01002051",1286,64,10,54,202,95,207,68,158,191,149,115,34,152
"2011","Haringey 029C","E01002052",1112,77,27,50,195,169,105,56,126,75,180,154,26,129
"2011","Haringey 029D","E01002055",985,48,9,39,193,139,155,48,106,83,103,94,9,110
"2011","Haringey 030A","E01001994",1366,326,51,275,423,131,153,38,71,45,61,48,13,118
"2011","Haringey 030B","E01002008",1113,318,82,236,350,90,117,23,55,22,59,45,14,79
"2011","Haringey 030C","E01002010",1214,292,52,240,376,115,128,36,81,54,58,41,17,74
"2011","Haringey 030D","E01002011",1381,335,48,287,440,120,132,50,68,59,68,51,17,109
"2011","Haringey 031A","E01002000",1343,167,29,138,384,131,126,73,126,105,97,77,20,134
"2011","Haringey 031B","E01002001",1406,189,31,158,414,123,123,77,105,81,101,87,14,193
"2011","Haringey 031C","E01002002",1510,197,26,171,383,127,125,93,143,108,127,101,26,207
"2011","Haringey 031D","E01002058",1393,162,18,144,339,119,133,103,120,133,136,100,36,148
"2011","Haringey 032A","E01002053",1286,71,9,62,200,144,150,69,164,128,195,159,36,165
"2011","Haringey 032B","E01002054",1237,54,13,41,133,98,146,99,164,143,238,192,46,162
"2011","Haringey 032C","E01002056",1536,120,18,102,305,112,205,91,159,167,151,125,26,226
"2011","Haringey 032D","E01002057",1225,93,11,82,243,109,124,78,136,102,148,115,33,192
"2011","Haringey 033A","E01001984",1303,282,45,237,503,135,137,45,63,31,43,23,20,64
"2011","Haringey 033B","E01001985",1299,373,58,315,473,114,119,22,43,30,51,35,16,74
"2011","Haringey 033C","E01001987",1466,453,75,378,530,114,121,22,53,25,33,21,12,115
"2011","Haringey 033D","E01001989",1338,343,55,288,478,121,140,22,53,38,50,27,23,93
"2011","Haringey 034A","E01001986",1284,307,61,246,486,106,136,35,55,35,38,27,11,86
"2011","Haringey 034B","E01001988",1431,319,53,266,581,121,131,43,63,55,52,38,14,66
"2011","Haringey 034C","E01001990",1842,316,54,262,830,163,154,59,94,60,50,35,15,116
"2011","Haringey 034D","E01002062",1545,308,40,268,602,146,145,30,89,59,76,50,26,90
"2011","Haringey 035A","E01002005",1444,375,48,327,518,134,115,65,78,51,31,17,14,77
"2011","Haringey 035B","E01002006",1365,386,58,328,485,111,89,54,51,39,45,21,24,105
"2011","Haringey 035C","E01002007",1295,393,46,347,467,97,103,28,53,29,37,20,17,88
"2011","Haringey 035D","E01002009",1387,353,59,294,458,92,126,21,56,34,35,20,15,212
"2011","Haringey 036A","E01002061",1401,338,39,299,525,120,117,40,43,48,47,26,21,123
"2011","Haringey 036B","E01002063",1270,260,42,218,431,112,94,46,87,60,75,61,14,105
"2011","Haringey 036C","E01002064",1193,181,15,166,358,98,94,45,100,91,105,77,28,121
"2011","Haringey 036D","E01002065",1444,281,38,243,460,150,132,46,103,93,61,47,14,118
"2011","Haringey 037A","E01002034",1288,26,5,21,166,85,116,81,185,177,287,216,71,165
"2011","Haringey 037B","E01002038",1137,36,4,32,132,74,146,43,194,157,227,189,38,128
"2011","Haringey 037C","E01002041",1324,56,8,48,220,101,147,78,149,151,235,193,42,187
"2011","Haringey 037D","E01032575",1296,66,10,56,180,100,119,66,173,142,269,232,37,181
"2011","Islington 001A","E01002755",1012,95,16,79,242,108,86,61,119,89,144,108,36,68
"2011","Islington 001B","E01002756",1087,196,24,172,332,127,95,37,74,67,75,52,23,84
"2011","Islington 001C","E01002758",1186,86,11,75,254,118,82,76,120,115,210,164,46,125
"2011","Islington 001D","E01002804",1305,133,22,111,296,119,86,70,166,109,178,141,37,148
"2011","Islington 001E","E01002807",1366,145,20,125,336,159,97,66,146,130,144,109,35,143
"2011","Islington 001F","E01002811",1132,125,22,103,279,121,95,62,94,121,134,94,40,101
"2011","Islington 002A","E01002753",1154,139,20,119,254,142,86,46,121,101,120,82,38,145
"2011","Islington 002B","E01002754",1176,230,41,189,385,89,107,50,71,51,79,57,22,114
"2011","Islington 002C","E01002757",1088,182,28,154,275,110,101,39,81,70,123,94,29,107
"2011","Islington 002D","E01002759",1276,269,41,228,393,129,101,59,92,59,60,49,11,114
"2011","Islington 002E","E01002760",1135,82,14,68,217,132,66,67,148,101,170,133,37,152
"2011","Islington 002F","E01002772",1481,217,21,196,407,151,115,67,118,100,124,93,31,182
"2011","Islington 003A","E01002735",1351,189,23,166,392,143,113,68,124,96,101,75,26,125
"2011","Islington 003B","E01002805",1329,229,33,196,412,155,98,63,101,77,95,68,27,99
"2011","Islington 003C","E01002806",1274,199,40,159,426,132,86,52,116,67,97,62,35,99
"2011","Islington 003D","E01002808",1556,256,41,215,473,135,115,59,131,108,139,117,22,140
"2011","Islington 003E","E01002809",1300,169,21,148,329,139,102,65,98,92,137,105,32,169
"2011","Islington 003F","E01002810",1247,130,17,113,360,119,91,59,117,111,142,103,39,118
"2011","Islington 004A","E01002768",1289,196,37,159,374,156,114,53,124,92,84,55,29,96
"2011","Islington 004B","E01002770",1226,218,33,185,353,131,90,46,121,63,78,50,28,126
"2011","Islington 004C","E01002771",1157,174,21,153,334,127,87,48,111,66,105,63,42,105
"2011","Islington 004D","E01002773",1052,84,15,69,188,100,76,58,158,144,142,109,33,102
"2011","Islington 004E","E01002774",1704,224,21,203,494,193,118,69,162,129,148,99,49,167
"2011","Islington 005A","E01002732",1446,152,23,129,277,126,98,87,155,124,251,179,72,176
"2011","Islington 005B","E01002734",1180,63,7,56,192,98,82,75,148,140,230,186,44,152
"2011","Islington 005C","E01002736",1023,69,9,60,158,89,67,51,160,129,186,162,24,114
"2011","Islington 005D","E01002737",1369,126,23,103,259,118,97,68,168,123,241,183,58,169
"2011","Islington 005E","E01002751",1390,139,14,125,288,141,117,69,164,131,199,146,53,142
"2011","Islington 006A","E01002742",1271,358,45,313,446,93,83,27,67,53,36,22,14,108
"2011","Islington 006B","E01002747",1333,275,30,245,413,104,109,39,100,58,68,52,16,167
"2011","Islington 006C","E01002748",1142,156,29,127,302,97,73,56,109,86,148,109,39,115
"2011","Islington 006D","E01002749",972,164,20,144,253,96,66,45,81,73,75,66,9,119
"2011","Islington 006F","E01033493",1229,457,53,404,451,99,53,18,27,11,18,10,8,95
"2011","Islington 006G","E01033494",1236,325,51,274,413,97,79,44,67,63,50,37,13,98
"2011","Islington 007A","E01002730",1509,214,22,192,369,148,121,71,149,93,115,84,31,229
"2011","Islington 007B","E01002731",2108,371,55,316,618,149,148,108,135,132,158,138,20,289
"2011","Islington 007C","E01002733",1172,256,33,223,357,106,83,38,74,48,65,45,20,145
"2011","Islington 007D","E01002763",1201,108,21,87,246,112,68,51,113,97,86,63,23,320
"2011","Islington 008A","E01002769",1702,292,44,248,438,110,100,54,81,69,64,48,16,494
"2011","Islington 008B","E01002785",1497,321,45,276,448,119,133,48,99,73,118,94,24,138
"2011","Islington 008C","E01002788",1575,343,46,297,527,139,127,47,96,76,94,60,34,126
"2011","Islington 008D","E01002789",1538,393,65,328,551,136,129,31,60,48,52,36,16,138
"2011","Islington 009A","E01002738",1397,341,60,281,413,125,105,47,90,69,113,73,40,94
"2011","Islington 009B","E01002741",1104,131,29,102,229,105,77,48,133,89,154,125,29,138
"2011","Islington 009C","E01002743",1239,277,37,240,359,78,86,41,90,62,92,69,23,154
"2011","Islington 009D","E01002744",1205,290,29,261,392,110,74,45,78,63,70,41,29,83
"2011","Islington 009E","E01002752",1162,246,43,203,304,101,84,43,100,68,113,86,27,103
"2011","Islington 010A","E01002764",1359,180,27,153,310,130,103,73,154,98,136,107,29,175
"2011","Islington 010B","E01002783",1185,126,21,105,285,112,77,49,123,123,132,101,31,158
"2011","Islington 010C","E01002784",1353,161,17,144,293,116,89,60,159,129,159,112,47,187
"2011","Islington 010D","E01002786",1394,173,26,147,346,141,90,78,130,107,150,116,34,179
"2011","Islington 010E","E01002787",1369,125,37,88,230,141,97,64,158,148,199,174,25,207
"2011","Islington 011C","E01002762",1693,341,39,302,539,132,112,71,105,100,101,68,33,192
"2011","Islington 011D","E01002767",1628,178,29,149,350,210,118,77,191,137,161,125,36,206
"2011","Islington 011E","E01033486",830,129,17,112,173,77,48,39,101,56,95,72,23,112
"2011","Islington 011F","E01033487",1055,305,44,261,381,78,35,23,37,21,30,21,9,145
"2011","Islington 011G","E01033488",972,132,20,112,270,83,42,41,93,71,97,75,22,143
"2011","Islington 011H","E01033491",1449,265,35,230,398,124,89,63,139,108,102,66,36,161
"2011","Islington 011I","E01033492",1211,368,45,323,446,109,45,35,48,18,42,29,13,100
"2011","Islington 012A","E01002777",1378,280,27,253,437,148,109,49,103,64,96,77,19,92
"2011","Islington 012B","E01002778",1223,103,15,88,245,118,86,62,139,101,187,144,43,182
"2011","Islington 012C","E01002779",1563,303,39,264,416,135,106,57,87,69,101,79,22,289
"2011","Islington 012D","E01002781",1046,156,25,131,268,89,87,47,102,67,115,90,25,115
"2011","Islington 012E","E01002782",1058,90,11,79,198,97,80,38,134,101,193,153,40,127
"2011","Islington 013A","E01002739",1451,403,49,354,468,114,108,42,85,47,75,48,27,109
"2011","Islington 013B","E01002740",1461,449,84,365,518,104,113,27,55,42,47,34,13,106
"2011","Islington 013C","E01002745",1206,334,44,290,338,95,93,34,70,65,65,44,21,112
"2011","Islington 013D","E01002795",1643,374,48,326,438,135,102,51,133,111,139,105,34,160
"2011","Islington 013E","E01002796",889,204,26,178,269,67,56,26,67,55,64,42,22,81
"2011","Islington 014A","E01002716",1736,234,37,197,415,185,111,63,166,157,206,170,36,199
"2011","Islington 014B","E01002718",1417,406,57,349,445,121,104,46,62,59,74,55,19,100
"2011","Islington 014C","E01002721",1346,295,51,244,371,132,101,39,110,81,119,79,40,98
"2011","Islington 014D","E01002775",1229,308,53,255,419,85,97,43,85,48,68,48,20,76
"2011","Islington 014E","E01002776",1254,233,31,202,352,100,93,64,115,70,108,81,27,119
"2011","Islington 014F","E01002780",1327,272,54,218,396,119,89,52,100,94,118,81,37,87
"2011","Islington 015A","E01002708",1632,203,32,171,319,170,98,75,144,125,99,76,23,399
"2011","Islington 015B","E01002712",1562,187,23,164,275,104,141,93,148,212,255,203,52,147
"2011","Islington 015C","E01002713",1170,95,18,77,210,142,91,62,172,129,150,114,36,119
"2011","Islington 015D","E01002765",1958,135,30,105,372,176,117,93,188,132,218,174,44,527
"2011","Islington 015E","E01002766",1366,71,19,52,219,138,72,76,149,134,153,120,33,354
"2011","Islington 016A","E01002717",1033,255,36,219,280,103,57,35,87,75,67,48,19,74
"2011","Islington 016B","E01002719",1177,340,59,281,356,105,82,38,68,74,41,31,10,73
"2011","Islington 016C","E01002720",1671,167,21,146,331,187,108,72,195,186,226,184,42,199
"2011","Islington 016D","E01002790",1118,145,17,128,255,157,76,57,127,113,94,61,33,94
"2011","Islington 016E","E01002791",1255,322,52,270,421,103,88,40,94,47,71,53,18,69
"2011","Islington 016F","E01002793",1562,313,50,263,425,159,82,56,147,127,142,97,45,111
"2011","Islington 017A","E01002698",1745,483,71,412,545,155,126,37,91,68,104,60,44,136
"2011","Islington 017B","E01002699",1287,348,55,293,409,105,93,39,80,59,65,42,23,89
"2011","Islington 017C","E01002700",1196,400,49,351,367,87,106,28,29,35,54,41,13,90
"2011","Islington 017D","E01002714",1422,402,62,340,426,108,109,43,72,58,46,35,11,158
"2011","Islington 017E","E01002792",1559,419,62,357,509,125,111,47,104,50,69,41,28,125
"2011","Islington 018A","E01002722",1032,153,22,131,266,102,84,46,99,73,114,82,32,95
"2011","Islington 018B","E01002797",1539,275,51,224,383,178,92,61,146,102,153,98,55,149
"2011","Islington 018C","E01002798",1640,476,72,404,468,131,127,55,78,108,84,68,16,113
"2011","Islington 018D","E01002799",1381,233,33,200,328,139,102,59,142,94,169,123,46,115
"2011","Islington 018E","E01002800",742,71,7,64,113,72,44,38,90,93,132,107,25,89
"2011","Islington 019A","E01002694",1114,126,20,106,197,109,69,48,147,104,159,127,32,155
"2011","Islington 019B","E01002697",1643,115,12,103,245,95,76,62,155,90,173,139,34,632
"2011","Islington 019C","E01002709",1389,185,11,174,266,145,89,67,139,108,145,113,32,245
"2011","Islington 019D","E01002710",1238,173,25,148,220,146,71,61,132,97,171,135,36,167
"2011","Islington 019E","E01002715",1108,80,6,74,176,105,73,54,133,131,153,110,43,203
"2011","Islington 020A","E01002696",1535,476,79,397,446,138,103,41,66,58,97,69,28,110
"2011","Islington 020B","E01002794",1477,412,78,334,477,106,99,40,82,58,79,58,21,124
"2011","Islington 020C","E01002801",1299,436,59,377,404,83,75,26,52,47,61,37,24,115
"2011","Islington 020D","E01002802",1214,386,72,314,365,83,94,36,62,46,62,40,22,80
"2011","Islington 020E","E01002803",1731,428,70,358,431,125,112,35,95,84,112,86,26,309
"2011","Islington 021A","E01002695",1349,305,32,273,344,133,94,45,103,85,93,78,15,147
"2011","Islington 021B","E01002711",1698,360,59,301,417,150,121,57,129,72,114,88,26,278
"2011","Islington 021C","E01002727",1364,368,44,324,380,113,88,41,100,84,84,65,19,106
"2011","Islington 021D","E01002728",1440,132,12,120,201,60,47,38,67,60,89,65,24,746
"2011","Islington 021E","E01002729",1289,279,45,234,342,105,110,52,89,73,121,97,24,118
"2011","Islington 022B","E01002707",1482,350,56,294,342,139,72,48,97,83,90,62,28,261
"2011","Islington 022C","E01002723",1209,164,26,138,262,96,81,52,123,104,94,71,23,233
"2011","Islington 022D","E01002724",1795,509,89,420,490,90,115,35,53,46,44,38,6,413
"2011","Islington 022E","E01002725",1137,137,26,111,217,80,55,47,103,105,89,68,21,304
"2011","Islington 022F","E01002726",1362,322,37,285,316,92,109,61,105,77,114,84,30,166
"2011","Islington 022G","E01033489",1747,429,87,342,362,44,84,9,29,19,32,23,9,739
"2011","Islington 022H","E01033490",1463,250,34,216,262,86,66,24,68,38,80,58,22,589
"2011","Islington 023A","E01002701",1261,162,23,139,259,110,85,53,139,93,120,81,39,240
"2011","Islington 023B","E01002702",1554,203,41,162,274,145,81,65,117,112,168,127,41,389
"2011","Islington 023C","E01002703",1296,177,23,154,257,106,82,57,134,99,127,93,34,257
"2011","Islington 023D","E01002704",1764,325,60,265,366,151,118,66,152,108,139,105,34,339
"2011","Islington 023E","E01002706",1536,280,38,242,323,155,127,61,144,104,126,89,37,216
"2011","Kensington and Chelsea 001A","E01002852",1411,105,22,83,244,144,118,100,190,166,215,163,52,129
"2011","Kensington and Chelsea 001B","E01002853",837,65,13,52,153,55,70,51,96,105,151,124,27,91
"2011","Kensington and Chelsea 001C","E01002854",805,45,8,37,149,76,64,34,125,90,133,98,35,89
"2011","Kensington and Chelsea 001D","E01002855",1344,108,29,79,301,138,113,66,169,126,194,143,51,129
"2011","Kensington and Chelsea 001E","E01002857",1002,44,4,40,128,100,77,63,154,155,174,121,53,107
"2011","Kensington and Chelsea 002A","E01002904",879,28,4,24,137,118,66,50,128,102,159,121,38,91
"2011","Kensington and Chelsea 002B","E01002905",1188,105,25,80,240,135,90,64,155,108,169,133,36,122
"2011","Kensington and Chelsea 002C","E01002906",1251,151,40,111,286,124,117,65,117,109,152,114,38,130
"2011","Kensington and Chelsea 002D","E01002907",922,38,6,32,125,94,73,45,131,113,173,131,42,130
"2011","Kensington and Chelsea 003A","E01002876",1305,229,69,160,411,100,133,46,106,73,102,74,28,105
"2011","Kensington and Chelsea 003B","E01002877",1222,98,17,81,222,136,102,72,119,135,164,129,35,174
"2011","Kensington and Chelsea 003C","E01002878",1321,204,33,171,398,133,124,50,111,99,108,66,42,94
"2011","Kensington and Chelsea 003D","E01002908",1066,148,29,119,298,97,137,50,100,64,80,61,19,92
"2011","Kensington and Chelsea 003E","E01002909",1795,308,67,241,601,137,192,70,146,93,118,74,44,130
"2011","Kensington and Chelsea 004A","E01002829",1251,171,35,136,397,90,140,58,117,89,92,63,29,97
"2011","Kensington and Chelsea 004B","E01002830",1444,202,41,161,398,117,137,62,165,139,117,70,47,107
"2011","Kensington and Chelsea 004C","E01002831",1599,249,48,201,425,153,179,58,150,119,153,107,46,113
"2011","Kensington and Chelsea 004D","E01002832",1375,245,56,189,367,109,158,50,137,75,113,75,38,121
"2011","Kensington and Chelsea 004E","E01002856",1490,217,38,179,445,122,160,63,139,91,133,90,43,120
"2011","Kensington and Chelsea 005A","E01002870",1064,75,7,68,194,109,117,67,135,111,128,100,28,128
"2011","Kensington and Chelsea 005B","E01002872",1016,157,45,112,215,97,82,56,133,98,104,76,28,74
"2011","Kensington and Chelsea 005C","E01002879",1155,125,25,100,223,106,78,66,142,126,154,106,48,135
"2011","Kensington and Chelsea 005D","E01002880",1142,62,12,50,199,110,80,91,153,134,174,121,53,139
"2011","Kensington and Chelsea 005E","E01002881",1039,90,25,65,222,101,82,47,120,113,155,124,31,109
"2011","Kensington and Chelsea 006A","E01002882",1027,229,79,150,379,59,97,30,76,40,61,37,24,56
"2011","Kensington and Chelsea 006B","E01002883",1395,368,110,258,464,109,135,17,53,43,79,66,13,127
"2011","Kensington and Chelsea 006C","E01002884",1219,267,69,198,373,86,108,28,56,44,44,34,10,213
"2011","Kensington and Chelsea 006D","E01002885",1349,349,89,260,440,118,91,40,90,49,50,36,14,122
"2011","Kensington and Chelsea 006E","E01002886",1230,357,105,252,438,89,121,21,53,40,31,24,7,80
"2011","Kensington and Chelsea 007A","E01002833",1206,313,75,238,440,82,125,22,58,47,53,33,20,66
"2011","Kensington and Chelsea 007B","E01002871",1302,380,112,268,442,87,142,21,44,37,67,49,18,82
"2011","Kensington and Chelsea 007C","E01002873",1045,246,63,183,312,87,111,26,64,43,68,49,19,88
"2011","Kensington and Chelsea 007D","E01002874",1135,271,69,202,350,81,92,26,88,52,67,52,15,108
"2011","Kensington and Chelsea 007E","E01002875",1075,294,102,192,342,82,117,15,51,47,54,46,8,73
"2011","Kensington and Chelsea 008A","E01002824",1199,359,123,236,389,80,98,36,50,39,56,48,8,92
"2011","Kensington and Chelsea 008B","E01002825",1486,371,137,234,460,105,137,28,86,41,115,97,18,143
"2011","Kensington and Chelsea 008C","E01002826",1263,358,96,262,424,80,88,49,62,39,60,44,16,103
"2011","Kensington and Chelsea 008D","E01002827",1462,418,146,272,560,77,137,25,44,35,46,24,22,120
"2011","Kensington and Chelsea 008E","E01002828",1063,301,66,235,361,75,112,19,51,34,41,32,9,69
"2011","Kensington and Chelsea 009A","E01002864",1042,234,80,154,324,65,108,13,61,41,96,85,11,100
"2011","Kensington and Chelsea 009B","E01002866",1417,272,75,197,492,103,124,37,112,67,94,78,16,116
"2011","Kensington and Chelsea 009C","E01002867",1593,310,53,257,415,115,168,58,122,59,146,117,29,200
"2011","Kensington and Chelsea 009D","E01002868",1272,343,129,214,437,89,122,25,58,31,72,63,9,95
"2011","Kensington and Chelsea 009E","E01002869",1217,292,73,219,380,111,108,35,64,37,92,72,20,98
"2011","Kensington and Chelsea 010A","E01002887",1192,367,98,269,367,64,102,17,44,23,51,34,17,157
"2011","Kensington and Chelsea 010B","E01002889",1036,250,81,169,317,57,88,11,32,29,46,35,11,206
"2011","Kensington and Chelsea 010C","E01002890",1277,367,122,245,439,81,118,17,52,35,65,58,7,103
"2011","Kensington and Chelsea 010D","E01002891",1172,324,110,214,344,55,119,12,46,42,82,67,15,148
"2011","Kensington and Chelsea 010E","E01002892",1544,401,117,284,455,124,127,11,39,46,56,46,10,285
"2011","Kensington and Chelsea 011A","E01002813",1376,403,122,281,463,106,161,24,38,34,56,39,17,91
"2011","Kensington and Chelsea 011B","E01002815",1160,318,67,251,305,91,95,25,48,41,79,65,14,158
"2011","Kensington and Chelsea 011C","E01002816",1073,287,76,211,344,74,101,28,40,21,58,49,9,120
"2011","Kensington and Chelsea 011D","E01002817",1215,295,95,200,422,71,138,18,64,31,74,60,14,102
"2011","Kensington and Chelsea 011E","E01002865",1010,289,125,164,263,78,91,12,39,31,102,94,8,105
"2011","Kensington and Chelsea 012A","E01002818",1685,376,125,251,508,92,209,33,94,40,119,99,20,214
"2011","Kensington and Chelsea 012B","E01002819",1309,320,113,207,420,69,150,19,55,30,66,57,9,180
"2011","Kensington and Chelsea 012C","E01002859",1332,376,111,265,440,79,131,21,89,31,62,54,8,103
"2011","Kensington and Chelsea 012D","E01002860",1221,394,113,281,399,64,128,15,41,26,55,48,7,99
"2011","Kensington and Chelsea 012E","E01002863",1164,292,104,188,366,62,146,23,82,37,73,65,8,83
"2011","Kensington and Chelsea 013A","E01002812",1551,378,100,278,428,127,120,39,56,45,100,79,21,258
"2011","Kensington and Chelsea 013B","E01002834",1140,306,82,224,358,85,77,23,35,30,53,39,14,173
"2011","Kensington and Chelsea 013C","E01002839",1359,342,89,253,371,72,86,30,76,41,114,63,51,227
"2011","Kensington and Chelsea 013D","E01002850",1238,217,42,175,323,65,88,42,58,58,84,64,20,303
"2011","Kensington and Chelsea 013E","E01002888",1815,464,136,328,518,134,133,26,63,29,70,56,14,378
"2011","Kensington and Chelsea 014A","E01002821",1158,306,92,214,367,63,101,14,59,26,50,44,6,172
"2011","Kensington and Chelsea 014B","E01002823",1038,154,47,107,279,86,115,43,112,65,92,67,25,92
"2011","Kensington and Chelsea 014C","E01002858",1010,176,40,136,214,71,78,35,70,57,121,89,32,188
"2011","Kensington and Chelsea 014D","E01002861",1121,297,75,222,375,101,97,21,59,33,73,58,15,65
"2011","Kensington and Chelsea 014E","E01002862",1260,200,54,146,288,138,132,52,127,78,104,77,27,141
"2011","Kensington and Chelsea 015A","E01002814",1548,287,70,217,336,120,126,72,146,72,186,148,38,203
"2011","Kensington and Chelsea 015B","E01002847",1392,355,90,265,432,85,112,35,74,66,58,34,24,175
"2011","Kensington and Chelsea 015C","E01002848",1348,295,72,223,376,103,92,63,104,68,91,62,29,156
"2011","Kensington and Chelsea 015D","E01002851",1395,206,51,155,344,115,118,80,136,95,159,112,47,142
"2011","Kensington and Chelsea 016A","E01002820",1042,277,88,189,353,73,102,24,49,23,43,35,8,98
"2011","Kensington and Chelsea 016B","E01002822",904,251,86,165,340,53,99,10,38,23,39,30,9,51
"2011","Kensington and Chelsea 016C","E01002835",1261,369,112,257,407,85,102,15,35,24,48,23,25,176
"2011","Kensington and Chelsea 016D","E01002836",1183,343,102,241,404,59,85,21,39,23,44,36,8,165
"2011","Kensington and Chelsea 016E","E01002837",1092,309,105,204,370,66,110,13,27,24,41,32,9,132
"2011","Kensington and Chelsea 017A","E01002846",1155,259,58,201,347,83,89,38,85,66,71,39,32,117
"2011","Kensington and Chelsea 017B","E01002849",1259,328,77,251,391,79,99,41,66,41,56,37,19,158
"2011","Kensington and Chelsea 017C","E01002893",1504,364,105,259,456,126,143,37,93,48,92,65,27,145
"2011","Kensington and Chelsea 017D","E01002894",1197,330,107,223,400,97,101,41,40,20,64,37,27,104
"2011","Kensington and Chelsea 017E","E01002898",1178,308,109,199,426,88,126,19,45,31,50,37,13,85
"2011","Kensington and Chelsea 018A","E01002899",1074,250,78,172,302,110,109,30,101,50,73,61,12,49
"2011","Kensington and Chelsea 018B","E01002900",1150,308,98,210,393,70,142,9,53,42,49,31,18,84
"2011","Kensington and Chelsea 018C","E01002901",776,180,53,127,266,57,81,26,61,29,39,34,5,37
"2011","Kensington and Chelsea 018D","E01002902",1413,406,152,254,441,114,113,39,76,46,68,40,28,110
"2011","Kensington and Chelsea 018E","E01002903",1177,367,137,230,400,83,140,14,57,22,36,32,4,58
"2011","Kensington and Chelsea 019A","E01002844",1103,260,82,178,368,87,105,36,79,32,49,36,13,87
"2011","Kensington and Chelsea 019B","E01002845",1088,226,48,178,328,86,106,32,85,57,76,61,15,92
"2011","Kensington and Chelsea 019C","E01002910",1086,260,80,180,363,91,119,16,59,39,70,54,16,69
"2011","Kensington and Chelsea 019D","E01002911",1309,334,99,235,505,87,145,17,51,28,56,45,11,86
"2011","Kensington and Chelsea 019E","E01002914",1191,318,93,225,453,78,116,19,44,35,47,37,10,81
"2011","Kensington and Chelsea 020A","E01002838",1421,265,95,170,315,55,90,15,28,8,31,27,4,614
"2011","Kensington and Chelsea 020B","E01002895",1045,273,88,185,389,63,118,10,30,25,58,47,11,79
"2011","Kensington and Chelsea 020C","E01002896",1445,440,142,298,464,116,151,16,55,41,48,38,10,114
"2011","Kensington and Chelsea 020D","E01002897",1123,240,62,178,366,89,135,29,51,37,56,37,19,120
"2011","Kensington and Chelsea 020E","E01002912",1335,319,95,224,508,105,119,31,68,37,58,45,13,90
"2011","Kensington and Chelsea 021A","E01002840",984,105,23,82,247,84,99,37,115,94,114,79,35,89
"2011","Kensington and Chelsea 021B","E01002841",1130,180,42,138,345,115,130,41,109,49,81,48,33,80
"2011","Kensington and Chelsea 021C","E01002842",917,67,12,55,138,78,71,61,147,100,168,139,29,87
"2011","Kensington and Chelsea 021D","E01002843",954,91,17,74,202,96,91,52,134,100,105,76,29,83
"2011","Kensington and Chelsea 021E","E01002913",1525,315,109,206,484,89,166,41,125,50,114,82,32,141
"2011","Lambeth 002A","E01003015",1244,152,25,127,254,115,71,62,148,108,145,102,43,189
"2011","Lambeth 002B","E01003108",1174,149,25,124,280,122,82,63,124,114,130,80,50,110
"2011","Lambeth 002C","E01003110",1548,389,66,323,477,130,86,53,118,69,79,60,19,147
"2011","Lambeth 002D","E01003111",1125,70,9,61,173,112,55,78,190,165,150,99,51,132
"2011","Lambeth 002E","E01003112",1220,161,36,125,239,109,87,67,174,100,103,74,29,180
"2011","Lambeth 003A","E01003101",1245,206,32,174,342,121,81,43,88,129,87,66,21,148
"2011","Lambeth 003B","E01003105",1267,152,25,127,319,132,76,74,135,112,107,85,22,160
"2011","Lambeth 003C","E01003106",1535,295,55,240,483,145,100,61,129,90,86,45,41,146
"2011","Lambeth 003D","E01003107",1603,383,74,309,540,144,109,59,95,64,60,35,25,149
"2011","Lambeth 003E","E01003109",1792,269,62,207,442,166,121,97,154,160,157,112,45,226
"2011","Lambeth 004A","E01003102",1467,289,38,251,456,180,84,71,89,91,79,50,29,128
"2011","Lambeth 004C","E01003104",1370,239,45,194,411,110,71,68,124,129,59,41,18,159
"2011","Lambeth 004D","E01003122",1507,245,39,206,428,150,120,71,117,109,102,77,25,165
"2011","Lambeth 004E","E01003129",1537,252,38,214,399,134,108,91,138,143,104,63,41,168
"2011","Lambeth 004F","E01033207",1333,165,26,139,313,112,96,90,145,145,140,103,37,127
"2011","Lambeth 004G","E01033208",1493,413,93,320,416,137,71,29,71,48,75,50,25,233
"2011","Lambeth 005A","E01003098",1219,203,34,169,347,113,80,50,85,107,95,62,33,139
"2011","Lambeth 005B","E01003099",1271,190,20,170,329,116,105,53,95,132,86,61,25,165
"2011","Lambeth 005C","E01003100",1770,414,53,361,653,144,98,86,88,99,43,28,15,145
"2011","Lambeth 005D","E01003180",1212,174,33,141,308,125,86,65,113,85,116,86,30,140
"2011","Lambeth 005E","E01003183",1188,112,21,91,286,117,65,71,137,110,133,91,42,157
"2011","Lambeth 006A","E01003097",1319,91,16,75,255,136,100,88,170,170,117,77,40,192
"2011","Lambeth 006B","E01003121",1183,84,14,70,191,117,79,69,178,172,156,102,54,137
"2011","Lambeth 006C","E01003123",1250,247,51,196,412,102,123,59,83,83,51,25,26,90
"2011","Lambeth 006D","E01003124",1155,130,23,107,269,104,84,61,111,154,96,69,27,146
"2011","Lambeth 006E","E01003125",1222,59,7,52,164,119,96,85,176,202,154,112,42,167
"2011","Lambeth 007A","E01003181",1171,129,20,109,294,125,92,68,128,98,116,83,33,121
"2011","Lambeth 007B","E01003184",979,54,4,50,156,96,48,51,160,132,136,91,45,146
"2011","Lambeth 007C","E01003185",1343,236,36,200,402,119,67,60,105,123,103,72,31,128
"2011","Lambeth 007D","E01003186",1622,291,44,247,509,142,121,70,113,93,99,60,39,184
"2011","Lambeth 007E","E01003187",1200,84,12,72,217,135,71,75,144,134,133,86,47,207
"2011","Lambeth 008A","E01003089",1439,92,12,80,238,116,95,102,186,205,149,112,37,256
"2011","Lambeth 008B","E01003091",1280,161,28,133,359,126,92,52,101,120,102,66,36,167
"2011","Lambeth 008C","E01003092",1326,108,19,89,260,136,92,90,172,157,149,103,46,162
"2011","Lambeth 008D","E01003126",1171,112,17,95,230,107,93,64,141,157,117,74,43,150
"2011","Lambeth 008E","E01003128",1143,83,11,72,226,121,85,82,162,139,121,80,41,124
"2011","Lambeth 009A","E01003046",1233,72,12,60,178,120,93,74,179,172,173,111,62,172
"2011","Lambeth 009B","E01003048",1232,62,9,53,174,108,85,72,174,178,188,126,62,191
"2011","Lambeth 009C","E01003075",1180,54,13,41,155,133,89,91,176,169,139,90,49,174
"2011","Lambeth 009D","E01003182",1420,139,22,117,357,127,123,72,123,132,144,105,39,203
"2011","Lambeth 009E","E01003188",1029,73,14,59,185,110,69,74,150,101,145,103,42,122
"2011","Lambeth 010A","E01003088",1473,245,39,206,404,161,78,54,134,109,133,72,61,155
"2011","Lambeth 010B","E01003093",1673,139,21,118,319,161,90,115,226,197,205,156,49,221
"2011","Lambeth 010C","E01003094",1289,213,33,180,384,134,77,55,119,99,97,70,27,111
"2011","Lambeth 010D","E01003096",1875,420,70,350,694,163,101,75,96,89,85,48,37,152
"2011","Lambeth 010E","E01003127",1422,243,43,200,351,128,134,64,122,132,113,59,54,135
"2011","Lambeth 011A","E01003045",1410,88,11,77,251,133,81,84,176,170,217,157,60,210
"2011","Lambeth 011B","E01003047",1310,153,30,123,319,133,92,58,150,123,131,101,30,151
"2011","Lambeth 011C","E01003049",1220,102,17,85,224,141,76,71,156,140,146,107,39,164
"2011","Lambeth 011D","E01003059",1245,72,13,59,174,115,98,91,180,219,133,102,31,163
"2011","Lambeth 011E","E01003060",1176,49,13,36,174,101,83,90,178,185,156,127,29,160
"2011","Lambeth 011F","E01003061",1031,126,16,110,223,82,64,59,105,167,92,62,30,113
"2011","Lambeth 012A","E01003034",1384,314,47,267,424,121,95,50,113,84,82,48,34,101
"2011","Lambeth 012B","E01003035",1390,360,54,306,466,144,94,33,88,68,54,37,17,83
"2011","Lambeth 012C","E01003036",1311,296,43,253,430,114,92,41,103,67,72,57,15,96
"2011","Lambeth 012D","E01003090",2029,432,70,362,706,189,106,77,143,111,97,67,30,168
"2011","Lambeth 012E","E01003095",1487,346,61,285,465,129,111,44,103,80,85,72,13,124
"2011","Lambeth 013A","E01003037",1100,159,20,139,277,124,65,56,112,102,103,63,40,102
"2011","Lambeth 013B","E01003038",1272,370,74,296,473,106,93,27,46,44,29,18,11,84
"2011","Lambeth 013C","E01003039",1724,552,107,445,639,139,110,43,70,40,52,34,18,79
"2011","Lambeth 013D","E01003040",1044,281,63,218,370,94,58,26,59,45,50,30,20,61
"2011","Lambeth 013E","E01003042",877,175,30,145,267,79,63,36,84,71,51,27,24,51
"2011","Lambeth 014A","E01003072",1336,311,47,264,415,142,132,41,88,67,56,39,17,84
"2011","Lambeth 014B","E01003073",1281,177,26,151,325,162,91,65,122,97,109,76,33,133
"2011","Lambeth 014C","E01003076",1581,201,24,177,438,151,123,100,120,152,77,51,26,219
"2011","Lambeth 014D","E01003077",1466,203,33,170,406,134,100,63,147,107,82,59,23,224
"2011","Lambeth 014E","E01003078",1227,284,49,235,397,128,93,51,85,41,50,39,11,98
"2011","Lambeth 015A","E01003019",1796,433,64,369,600,177,102,66,132,89,71,50,21,126
"2011","Lambeth 015B","E01003053",1532,321,46,275,574,154,73,63,91,98,53,29,24,105
"2011","Lambeth 015C","E01003054",1682,458,56,402,679,161,80,38,65,59,50,27,23,92
"2011","Lambeth 015D","E01003056",1682,360,53,307,585,173,76,70,126,73,94,62,32,125
"2011","Lambeth 015E","E01003058",1705,330,43,287,632,185,89,61,103,88,78,48,30,139
"2011","Lambeth 016A","E01003020",1444,237,45,192,462,159,83,70,114,91,103,62,41,125
"2011","Lambeth 016B","E01003050",1417,253,28,225,472,124,106,46,100,71,106,74,32,139
"2011","Lambeth 016C","E01003052",1334,65,12,53,211,124,108,73,193,163,184,111,73,213
"2011","Lambeth 016D","E01003055",1330,228,36,192,430,131,90,43,121,102,101,65,36,84
"2011","Lambeth 016E","E01003176",1305,108,18,90,272,134,86,89,159,147,162,129,33,148
"2011","Lambeth 017A","E01003029",1503,348,54,294,542,155,99,41,90,71,60,35,25,97
"2011","Lambeth 017B","E01003032",1417,245,49,196,390,155,84,67,119,110,104,66,38,143
"2011","Lambeth 017C","E01003041",1239,187,27,160,329,139,50,63,143,112,105,81,24,111
"2011","Lambeth 017D","E01003057",1357,191,34,157,382,161,68,46,154,107,116,81,35,132
"2011","Lambeth 018A","E01003043",1345,225,33,192,504,108,86,50,90,81,89,52,37,112
"2011","Lambeth 018B","E01003044",961,50,8,42,186,92,67,50,144,123,128,76,52,121
"2011","Lambeth 018C","E01003051",1272,105,15,90,302,108,89,56,149,119,151,103,48,193
"2011","Lambeth 018D","E01003071",1912,405,79,326,711,181,133,74,112,72,88,62,26,136
"2011","Lambeth 018E","E01003074",1897,340,54,286,647,177,171,76,127,92,148,110,38,119
"2011","Lambeth 019A","E01003026",1262,401,60,341,457,120,84,27,41,41,26,18,8,65
"2011","Lambeth 019B","E01003027",1040,370,67,303,345,72,74,18,31,27,33,22,11,70
"2011","Lambeth 019C","E01003028",1144,284,57,227,394,105,69,43,69,44,59,40,19,77
"2011","Lambeth 019D","E01003030",1515,486,95,391,566,135,108,34,43,31,40,29,11,72
"2011","Lambeth 019E","E01003033",1175,351,87,264,372,99,97,24,51,44,43,25,18,94
"2011","Lambeth 020A","E01003018",1793,333,51,282,627,180,133,87,105,93,79,50,29,156
"2011","Lambeth 020B","E01003171",1407,224,29,195,459,160,101,68,93,78,97,58,39,127
"2011","Lambeth 020C","E01003173",1312,199,31,168,442,149,123,52,111,70,53,34,19,113
"2011","Lambeth 020D","E01003177",1333,199,29,170,422,113,100,57,124,100,93,64,29,125
"2011","Lambeth 020E","E01003178",1354,255,38,217,472,141,105,60,86,65,74,44,30,96
"2011","Lambeth 021A","E01003021",1492,121,29,92,268,142,136,103,176,188,232,180,52,126
"2011","Lambeth 021B","E01003022",1428,242,52,190,440,167,107,73,106,75,80,58,22,138
"2011","Lambeth 021C","E01003023",1970,286,39,247,611,213,165,109,151,156,105,66,39,174
"2011","Lambeth 021D","E01003024",1322,95,9,86,268,168,86,88,148,163,139,101,38,167
"2011","Lambeth 021E","E01003025",1562,183,25,158,398,145,126,84,167,160,133,87,46,166
"2011","Lambeth 022A","E01003136",1255,156,32,124,360,140,120,56,125,88,97,62,35,113
"2011","Lambeth 022B","E01003137",1125,82,16,66,257,141,88,74,138,117,117,78,39,111
"2011","Lambeth 022C","E01003159",1135,99,18,81,269,130,79,67,127,140,94,56,38,130
"2011","Lambeth 022D","E01003160",1065,51,9,42,164,113,89,71,153,147,128,99,29,149
"2011","Lambeth 022E","E01003162",1496,72,12,60,209,131,111,111,242,235,188,128,60,197
"2011","Lambeth 023A","E01003031",1391,307,50,257,391,159,88,48,109,81,91,54,37,117
"2011","Lambeth 023B","E01003156",1206,252,48,204,390,118,90,55,75,71,60,36,24,95
"2011","Lambeth 023C","E01003157",1171,337,64,273,394,111,62,31,60,54,68,46,22,54
"2011","Lambeth 023D","E01003158",1319,412,80,332,490,136,81,43,57,30,25,13,12,45
"2011","Lambeth 023E","E01003161",931,230,38,192,281,101,61,25,53,46,51,35,16,83
"2011","Lambeth 023F","E01003163",1154,192,32,160,337,147,113,55,102,47,65,40,25,96
"2011","Lambeth 024A","E01003132",1033,82,16,66,177,120,103,66,124,124,119,86,33,118
"2011","Lambeth 024B","E01003172",1460,144,22,122,361,162,99,71,172,142,147,97,50,162
"2011","Lambeth 024C","E01003174",1442,73,13,60,259,172,86,119,190,187,165,118,47,191
"2011","Lambeth 024D","E01003175",1143,91,22,69,182,144,70,82,156,125,129,90,39,164
"2011","Lambeth 024E","E01003179",1205,76,12,64,194,100,75,88,158,156,157,107,50,201
"2011","Lambeth 025A","E01003164",1645,210,31,179,484,188,135,70,158,122,121,77,44,157
"2011","Lambeth 025B","E01003165",1172,238,41,197,333,125,101,41,98,57,77,55,22,102
"2011","Lambeth 025C","E01003168",1159,80,16,64,221,152,79,59,178,107,132,86,46,151
"2011","Lambeth 025D","E01003169",1894,295,45,250,604,208,117,95,152,129,134,77,57,160
"2011","Lambeth 025E","E01003170",1335,321,49,272,459,158,111,30,81,50,51,33,18,74
"2011","Lambeth 026A","E01003130",1384,236,52,184,409,141,136,87,108,85,83,51,32,99
"2011","Lambeth 026B","E01003131",1141,211,44,167,324,135,110,51,85,70,51,32,19,104
"2011","Lambeth 026C","E01003135",1336,177,41,136,341,143,155,83,119,113,108,76,32,97
"2011","Lambeth 026D","E01003138",1266,312,60,252,475,123,108,38,64,44,45,25,20,57
"2011","Lambeth 026E","E01003151",1314,96,19,77,258,174,110,70,156,123,175,126,49,152
"2011","Lambeth 027A","E01003079",1262,138,22,116,300,141,122,61,127,112,112,81,31,149
"2011","Lambeth 027B","E01003080",1247,160,32,128,380,136,133,47,107,100,97,68,29,87
"2011","Lambeth 027C","E01003133",1351,208,31,177,398,137,128,65,116,97,100,62,38,102
"2011","Lambeth 027D","E01003134",1184,170,27,143,336,145,120,57,108,74,90,60,30,84
"2011","Lambeth 027E","E01003152",1502,242,40,202,428,154,170,85,124,84,87,64,23,128
"2011","Lambeth 028A","E01003064",1190,274,48,226,405,120,90,38,82,39,57,37,20,85
"2011","Lambeth 028B","E01003066",1254,138,26,112,256,143,103,79,131,128,127,92,35,149
"2011","Lambeth 028C","E01003081",1363,141,24,117,340,138,130,88,145,124,111,68,43,146
"2011","Lambeth 028D","E01003166",1771,295,36,259,493,191,142,90,150,149,125,67,58,136
"2011","Lambeth 028E","E01003167",1258,276,50,226,451,129,103,41,76,52,55,33,22,75
"2011","Lambeth 029A","E01003116",1217,209,45,164,350,123,139,43,88,73,82,68,14,110
"2011","Lambeth 029B","E01003117",1558,233,59,174,457,173,171,85,119,100,110,74,36,110
"2011","Lambeth 029C","E01003118",1375,225,43,182,403,145,154,67,92,88,96,78,18,105
"2011","Lambeth 029D","E01003153",1786,239,41,198,543,178,196,141,125,128,66,43,23,170
"2011","Lambeth 029E","E01003155",1442,185,40,145,366,191,193,88,128,99,101,78,23,91
"2011","Lambeth 030A","E01003083",1127,179,33,146,303,132,118,55,92,80,75,49,26,93
"2011","Lambeth 030B","E01003084",1231,192,32,160,373,148,124,51,97,78,89,52,37,79
"2011","Lambeth 030C","E01003085",1253,159,28,131,328,174,146,58,103,95,62,33,29,128
"2011","Lambeth 030D","E01003149",1327,189,40,149,413,118,176,59,98,82,98,72,26,94
"2011","Lambeth 030E","E01003154",1388,124,33,91,301,184,125,91,142,123,137,90,47,161
"2011","Lambeth 031A","E01003065",1034,75,21,54,210,129,93,58,143,110,108,70,38,108
"2011","Lambeth 031B","E01003068",1088,118,26,92,248,137,106,71,126,87,114,80,34,81
"2011","Lambeth 031C","E01003082",1032,105,24,81,254,101,100,53,115,107,103,62,41,94
"2011","Lambeth 031D","E01003086",1108,79,14,65,199,140,81,54,143,129,154,101,53,129
"2011","Lambeth 031E","E01003087",1075,78,15,63,171,114,92,57,172,117,151,105,46,123
"2011","Lambeth 032A","E01003113",1588,228,45,183,437,174,177,66,136,103,130,99,31,137
"2011","Lambeth 032B","E01003114",1465,194,33,161,425,166,145,82,126,108,91,59,32,128
"2011","Lambeth 032C","E01003119",1516,216,38,178,409,156,175,70,115,118,106,82,24,151
"2011","Lambeth 032D","E01003120",1613,163,30,133,413,170,169,121,133,168,142,97,45,134
"2011","Lambeth 032E","E01003148",1360,210,36,174,400,136,149,57,112,101,105,79,26,90
"2011","Lambeth 032F","E01003150",1275,149,24,125,322,132,117,72,147,104,124,84,40,108
"2011","Lambeth 033A","E01003062",1340,206,38,168,420,154,120,63,117,108,63,33,30,89
"2011","Lambeth 033B","E01003063",1061,102,25,77,226,125,72,57,144,113,120,74,46,102
"2011","Lambeth 033C","E01003067",1117,162,32,130,346,129,105,50,93,63,71,56,15,98
"2011","Lambeth 033D","E01003069",947,88,15,73,229,111,90,46,101,91,100,68,32,91
"2011","Lambeth 033E","E01003070",1103,107,25,82,222,138,85,51,132,98,143,89,54,127
"2011","Lambeth 034A","E01003115",1255,155,36,119,338,135,144,84,115,83,91,67,24,110
"2011","Lambeth 034B","E01003141",1262,129,26,103,288,169,120,65,153,104,120,90,30,114
"2011","Lambeth 034C","E01003144",1149,196,40,156,313,129,146,36,73,59,77,57,20,120
"2011","Lambeth 034D","E01003145",1357,150,20,130,354,162,167,65,149,103,108,74,34,99
"2011","Lambeth 034E","E01003147",1534,186,31,155,362,187,178,78,149,119,109,75,34,166
"2011","Lambeth 035A","E01003139",1138,103,19,84,213,156,166,71,108,102,95,70,25,124
"2011","Lambeth 035B","E01003140",1078,80,22,58,211,151,162,55,127,82,87,60,27,123
"2011","Lambeth 035C","E01003142",961,75,12,63,141,138,136,55,129,75,91,64,27,121
"2011","Lambeth 035D","E01003143",1018,78,16,62,179,122,121,71,112,91,100,78,22,144
"2011","Lambeth 035E","E01003146",1118,93,14,79,176,139,163,80,125,99,103,69,34,140
"2011","Lambeth 036A","E01003013",1478,442,72,370,422,100,62,43,56,34,29,21,8,290
"2011","Lambeth 036B","E01003014",1281,208,40,168,299,120,74,49,117,99,68,52,16,247
"2011","Lambeth 036C","E01003016",1251,171,25,146,210,69,57,23,63,35,65,55,10,558
"2011","Lambeth 036D","E01003017",1389,241,57,184,343,135,115,83,142,104,84,55,29,142
"2011","Lambeth 036E","E01032582",1587,274,45,229,392,151,89,81,155,118,105,75,30,222
"2011","Lewisham 001A","E01003244",1075,64,6,58,167,103,73,92,164,116,141,100,41,155
"2011","Lewisham 001B","E01003245",1044,67,8,59,172,113,65,63,160,104,127,100,27,173
"2011","Lewisham 001C","E01003247",1476,191,23,168,363,146,105,103,130,141,92,69,23,205
"2011","Lewisham 001D","E01003249",1551,199,27,172,338,183,84,98,153,127,158,113,45,211
"2011","Lewisham 001E","E01003250",1378,165,24,141,327,133,71,79,164,116,145,100,45,178
"2011","Lewisham 002A","E01003246",1088,76,10,66,162,105,75,83,166,111,122,98,24,188
"2011","Lewisham 002B","E01003248",1179,105,8,97,212,121,87,87,161,108,147,99,48,151
"2011","Lewisham 002C","E01003251",1389,65,16,49,199,114,99,118,222,153,208,157,51,211
"2011","Lewisham 002D","E01003252",1038,33,6,27,114,104,69,74,178,116,189,143,46,161
"2011","Lewisham 002E","E01003253",1109,104,18,86,189,113,94,57,139,126,138,109,29,149
"2011","Lewisham 003A","E01003297",1170,105,15,90,240,130,71,99,180,101,105,53,52,139
"2011","Lewisham 003B","E01003299",1238,99,20,79,249,120,94,44,132,141,138,99,39,221
"2011","Lewisham 003C","E01003301",1767,171,24,147,307,184,132,99,162,139,102,61,41,471
"2011","Lewisham 003D","E01003302",1151,73,12,61,206,130,90,86,183,109,128,85,43,146
"2011","Lewisham 003E","E01003305",989,78,12,66,186,124,60,54,127,101,91,68,23,168
"2011","Lewisham 005A","E01003207",1069,51,9,42,192,96,68,58,159,135,102,73,29,208
"2011","Lewisham 005B","E01003209",1606,116,37,79,311,195,106,100,186,100,96,53,43,396
"2011","Lewisham 005C","E01003210",1460,206,26,180,443,142,120,71,111,84,98,74,24,185
"2011","Lewisham 005D","E01003212",1619,182,33,149,438,212,126,74,150,91,83,45,38,263
"2011","Lewisham 005E","E01003215",1662,119,10,109,328,127,101,53,129,87,75,48,27,643
"2011","Lewisham 006A","E01003338",1328,63,10,53,215,143,84,101,193,137,193,137,56,199
"2011","Lewisham 006B","E01003339",1370,151,28,123,302,117,145,82,136,100,93,72,21,244
"2011","Lewisham 006C","E01003340",1619,184,31,153,463,174,121,54,112,104,84,55,29,323
"2011","Lewisham 006D","E01003341",1177,208,38,170,342,100,123,54,79,56,56,36,20,159
"2011","Lewisham 006E","E01003343",1060,119,33,86,291,103,107,45,93,79,82,54,28,141
"2011","Lewisham 007A","E01003199",1358,350,68,282,460,137,95,43,83,45,55,35,20,90
"2011","Lewisham 007B","E01003201",1224,178,25,153,297,144,101,54,144,82,93,62,31,131
"2011","Lewisham 007C","E01003204",1055,218,38,180,294,109,73,30,84,52,99,62,37,96
"2011","Lewisham 007D","E01003205",937,56,7,49,138,85,84,33,153,88,133,106,27,167
"2011","Lewisham 007E","E01003206",1209,288,51,237,384,108,125,33,69,48,65,49,16,89
"2011","Lewisham 008B","E01003211",1292,228,36,192,409,136,102,56,95,77,74,53,21,115
"2011","Lewisham 008C","E01003213",1604,235,51,184,513,143,125,71,129,76,83,52,31,229
"2011","Lewisham 008D","E01003214",1376,135,20,115,345,154,90,81,169,106,118,81,37,178
"2011","Lewisham 008E","E01033324",1242,146,22,124,296,133,87,55,166,89,97,77,20,173
"2011","Lewisham 008F","E01033325",1134,382,53,329,403,113,37,32,42,22,31,17,14,72
"2011","Lewisham 009A","E01003198",1051,269,55,214,334,83,74,29,83,57,54,33,21,68
"2011","Lewisham 009B","E01003200",1251,367,63,304,433,118,82,41,57,37,25,18,7,91
"2011","Lewisham 009C","E01003202",1194,325,48,277,451,150,68,32,46,40,21,15,6,61
"2011","Lewisham 009D","E01003203",1424,233,35,198,421,167,95,58,151,91,89,58,31,119
"2011","Lewisham 010A","E01003336",964,53,11,42,154,130,57,55,140,123,113,85,28,139
"2011","Lewisham 010B","E01003337",1081,40,5,35,171,154,115,72,184,98,120,88,32,127
"2011","Lewisham 010C","E01003342",1307,172,41,131,393,162,98,74,120,74,87,62,25,127
"2011","Lewisham 010D","E01003344",1404,195,24,171,349,132,121,59,134,87,90,60,30,237
"2011","Lewisham 010E","E01003345",1426,188,36,152,385,175,106,60,131,89,123,100,23,169
"2011","Lewisham 011A","E01003273",1634,163,39,124,301,120,96,47,145,73,129,115,14,560
"2011","Lewisham 011B","E01003277",1376,211,42,169,454,133,120,54,121,57,85,47,38,141
"2011","Lewisham 011C","E01003278",1526,186,45,141,387,178,87,121,150,118,77,58,19,222
"2011","Lewisham 011D","E01003279",1257,178,32,146,399,142,102,60,119,54,55,34,21,148
"2011","Lewisham 012A","E01003288",1331,112,26,86,269,163,95,87,194,126,127,85,42,158
"2011","Lewisham 012C","E01003290",1386,129,19,110,352,136,100,71,147,133,152,93,59,166
"2011","Lewisham 012D","E01003291",1069,79,15,64,194,99,67,79,157,131,156,110,46,107
"2011","Lewisham 012E","E01003296",1649,279,28,251,430,163,97,91,166,94,152,126,26,177
"2011","Lewisham 012F","E01033327",1240,153,26,127,339,151,104,74,105,75,95,61,34,144
"2011","Lewisham 012G","E01033341",964,82,10,72,244,102,65,53,124,81,102,73,29,111
"2011","Lewisham 013A","E01003282",1981,262,41,221,666,208,161,113,174,114,120,88,32,163
"2011","Lewisham 013B","E01003283",1561,332,57,275,549,141,130,62,112,62,58,26,32,115
"2011","Lewisham 013C","E01003284",1350,215,40,175,423,158,96,75,120,70,76,51,25,117
"2011","Lewisham 013D","E01003286",1134,106,18,88,251,151,81,53,183,102,115,80,35,92
"2011","Lewisham 014A","E01003272",1592,202,35,167,433,140,131,84,146,89,67,41,26,300
"2011","Lewisham 014B","E01003274",1333,179,34,145,415,153,111,57,126,79,84,61,23,129
"2011","Lewisham 014C","E01003275",1196,93,18,75,271,145,108,62,138,101,116,90,26,162
"2011","Lewisham 014D","E01003276",1375,191,36,155,357,191,130,53,143,84,73,47,26,153
"2011","Lewisham 015A","E01003225",1162,160,45,115,351,138,127,68,101,68,48,30,18,101
"2011","Lewisham 015B","E01003231",1234,160,26,134,333,149,117,59,112,75,84,60,24,145
"2011","Lewisham 015C","E01003232",1283,173,27,146,372,174,129,58,129,61,64,44,20,123
"2011","Lewisham 015D","E01003233",1297,147,23,124,417,168,108,51,112,82,89,65,24,123
"2011","Lewisham 016A","E01003280",1150,107,15,92,247,176,118,54,148,83,95,74,21,122
"2011","Lewisham 016B","E01003281",1115,171,46,125,327,156,106,48,92,63,61,42,19,91
"2011","Lewisham 016C","E01003285",1249,222,40,182,341,192,104,58,106,60,60,37,23,106
"2011","Lewisham 016D","E01003287",1459,306,52,254,491,162,126,47,90,57,66,46,20,114
"2011","Lewisham 017A","E01003292",1245,180,24,156,364,142,103,57,106,73,75,48,27,145
"2011","Lewisham 017B","E01003293",1167,133,27,106,296,128,82,54,148,89,107,86,21,130
"2011","Lewisham 017D","E01003295",1280,152,29,123,292,114,125,52,137,90,114,65,49,204
"2011","Lewisham 017E","E01033320",1167,141,26,115,343,139,66,42,126,82,123,100,23,105
"2011","Lewisham 017F","E01033322",1050,210,31,179,345,133,62,46,72,51,69,46,23,62
"2011","Lewisham 018A","E01003319",1285,113,18,95,237,167,119,85,193,89,116,89,27,166
"2011","Lewisham 018B","E01003320",1088,72,15,57,203,164,93,58,144,103,121,81,40,130
"2011","Lewisham 018C","E01003323",1131,105,21,84,275,140,83,66,129,79,109,71,38,145
"2011","Lewisham 018D","E01003325",1225,111,15,96,265,150,110,81,141,101,139,98,41,127
"2011","Lewisham 019A","E01003226",1365,203,39,164,423,142,135,53,117,82,67,46,21,143
"2011","Lewisham 019B","E01003227",1277,204,40,164,434,136,125,53,99,60,73,44,29,93
"2011","Lewisham 019C","E01003228",1168,224,31,193,415,136,94,40,85,49,68,51,17,57
"2011","Lewisham 019D","E01003229",1156,106,19,87,279,169,90,58,132,93,126,84,42,103
"2011","Lewisham 019E","E01003230",1458,179,38,141,368,200,122,76,181,91,113,78,35,128
"2011","Lewisham 020A","E01003317",1348,135,23,112,325,181,123,77,151,61,119,87,32,176
"2011","Lewisham 020B","E01003318",1263,91,19,72,260,116,135,74,163,92,181,136,45,151
"2011","Lewisham 020C","E01003321",1455,116,13,103,324,167,175,111,187,119,123,86,37,133
"2011","Lewisham 020D","E01003322",1078,103,22,81,243,134,112,53,121,88,81,49,32,143
"2011","Lewisham 020E","E01003324",1096,67,17,50,209,111,115,64,169,108,128,77,51,125
"2011","Lewisham 021A","E01003254",1090,210,33,177,393,107,123,35,66,40,44,32,12,72
"2011","Lewisham 021B","E01003255",1569,251,42,209,555,179,142,69,121,76,87,55,32,89
"2011","Lewisham 021C","E01003260",1246,193,28,165,359,154,131,63,97,62,71,34,37,116
"2011","Lewisham 021D","E01003261",1115,183,26,157,344,154,101,52,81,44,59,31,28,97
"2011","Lewisham 021E","E01003262",1005,171,24,147,307,114,78,55,89,61,52,32,20,78
"2011","Lewisham 022A","E01003217",1169,109,31,78,293,173,114,69,136,80,76,57,19,119
"2011","Lewisham 022B","E01003218",1092,105,20,85,292,156,95,59,125,69,69,49,20,122
"2011","Lewisham 022C","E01003220",1159,132,28,104,291,148,92,59,147,64,106,76,30,120
"2011","Lewisham 022D","E01003222",1181,110,33,77,272,161,95,52,148,94,112,76,36,137
"2011","Lewisham 022E","E01003224",1249,111,22,89,319,184,111,45,140,83,107,77,30,149
"2011","Lewisham 023A","E01003263",1138,117,31,86,225,162,135,68,146,103,103,69,34,79
"2011","Lewisham 023B","E01003268",1271,125,33,92,341,193,126,73,116,76,87,48,39,134
"2011","Lewisham 023C","E01003269",1168,137,30,107,295,135,114,62,143,92,83,53,30,107
"2011","Lewisham 023D","E01003270",1264,157,36,121,343,201,128,70,138,70,58,41,17,99
"2011","Lewisham 023E","E01003271",1265,163,33,130,343,218,153,61,138,74,39,32,7,76
"2011","Lewisham 024A","E01003307",1125,148,34,114,328,140,99,61,133,67,64,39,25,85
"2011","Lewisham 024B","E01003308",1359,193,50,143,362,151,99,68,129,112,115,85,30,130
"2011","Lewisham 024C","E01003314",1224,195,28,167,402,156,116,41,103,68,67,43,24,76
"2011","Lewisham 024D","E01003315",1004,162,24,138,309,113,97,35,96,49,74,47,27,69
"2011","Lewisham 024E","E01003316",1109,162,38,124,333,157,108,49,93,59,61,46,15,87
"2011","Lewisham 025A","E01003216",1390,149,34,115,308,169,137,56,150,104,126,88,38,191
"2011","Lewisham 025B","E01003219",1216,105,27,78,298,180,123,70,132,88,72,52,20,148
"2011","Lewisham 025C","E01003221",1428,148,35,113,335,209,115,69,164,99,140,104,36,149
"2011","Lewisham 025D","E01003223",1249,142,19,123,279,173,138,54,132,96,86,69,17,149
"2011","Lewisham 026A","E01003346",1061,53,8,45,196,139,85,86,148,122,101,77,24,131
"2011","Lewisham 026B","E01003349",921,56,9,47,152,110,82,68,136,98,107,75,32,112
"2011","Lewisham 026C","E01003351",945,44,8,36,166,131,90,66,159,108,89,61,28,92
"2011","Lewisham 026D","E01003354",1202,119,28,91,292,162,107,73,140,83,93,63,30,133
"2011","Lewisham 027A","E01003309",1059,92,14,78,204,129,101,62,158,94,100,80,20,119
"2011","Lewisham 027B","E01003310",1230,125,18,107,344,144,104,63,125,83,108,77,31,134
"2011","Lewisham 027C","E01003311",1150,167,21,146,343,146,112,57,98,71,58,45,13,98
"2011","Lewisham 027D","E01003312",1344,167,28,139,441,183,100,61,140,76,81,54,27,95
"2011","Lewisham 027E","E01003313",1068,89,11,78,258,140,92,45,143,84,105,66,39,112
"2011","Lewisham 028A","E01003256",1555,181,37,144,355,185,132,78,155,117,153,103,50,199
"2011","Lewisham 028B","E01003257",1152,150,31,119,295,136,128,57,129,77,84,63,21,96
"2011","Lewisham 028C","E01003258",1001,65,15,50,197,102,76,71,130,98,118,75,43,144
"2011","Lewisham 028D","E01003259",1257,200,46,154,378,158,93,57,116,80,67,42,25,108
"2011","Lewisham 029A","E01003193",1138,93,21,72,225,171,104,88,156,119,94,61,33,88
"2011","Lewisham 029B","E01003194",1218,84,21,63,250,188,110,72,203,107,104,69,35,100
"2011","Lewisham 029C","E01003195",1099,100,19,81,275,185,92,70,113,94,62,43,19,108
"2011","Lewisham 029D","E01003196",1130,68,8,60,153,184,103,70,185,145,102,80,22,120
"2011","Lewisham 029E","E01003197",1156,62,9,53,180,141,83,70,208,140,146,103,43,126
"2011","Lewisham 030A","E01003347",1112,45,8,37,162,114,78,54,223,127,182,140,42,127
"2011","Lewisham 030B","E01003348",1027,72,11,61,175,143,119,69,143,98,93,69,24,115
"2011","Lewisham 030C","E01003350",942,43,11,32,167,107,93,66,151,116,96,69,27,103
"2011","Lewisham 030D","E01003352",1249,74,17,57,218,163,121,85,193,128,144,98,46,123
"2011","Lewisham 030E","E01003353",1245,94,15,79,231,202,163,73,166,101,95,71,24,120
"2011","Lewisham 031A","E01003264",1140,97,29,68,279,158,121,74,132,94,82,56,26,103
"2011","Lewisham 031B","E01003265",1118,82,15,67,239,136,104,80,147,99,117,66,51,114
"2011","Lewisham 031C","E01003266",1214,53,14,39,211,154,116,97,211,124,121,93,28,127
"2011","Lewisham 031D","E01003267",1092,55,9,46,163,155,102,94,158,138,117,79,38,110
"2011","Lewisham 033A","E01003329",1201,145,32,113,338,179,130,58,114,66,72,53,19,99
"2011","Lewisham 033B","E01003330",1021,98,17,81,192,153,85,76,134,96,109,76,33,78
"2011","Lewisham 033C","E01003331",997,99,19,80,227,138,90,50,133,81,88,62,26,91
"2011","Lewisham 033D","E01003332",1115,158,33,125,275,139,92,50,123,98,87,59,28,93
"2011","Lewisham 033E","E01003334",1254,164,33,131,296,174,104,80,166,89,105,72,33,76
"2011","Lewisham 034A","E01003189",1101,57,11,46,176,132,85,67,187,131,134,105,29,132
"2011","Lewisham 034B","E01003190",1284,66,15,51,230,171,101,81,236,121,147,105,42,131
"2011","Lewisham 034C","E01003191",1044,46,13,33,202,150,90,73,177,115,102,64,38,89
"2011","Lewisham 034D","E01003192",1164,48,6,42,207,128,77,89,218,133,158,118,40,106
"2011","Lewisham 035A","E01003326",1055,105,21,84,265,151,70,67,127,78,76,55,21,116
"2011","Lewisham 035B","E01003327",1408,202,45,157,351,131,113,68,123,77,88,70,18,255
"2011","Lewisham 035C","E01003328",1311,188,30,158,375,169,117,66,123,84,103,70,33,86
"2011","Lewisham 035D","E01003333",1173,106,21,85,317,161,96,50,140,66,81,63,18,156
"2011","Lewisham 035E","E01003335",1012,97,26,71,244,113,82,49,130,84,108,71,37,105
"2011","Lewisham 037A","E01003236",1061,61,14,47,200,126,108,66,155,129,118,88,30,98
"2011","Lewisham 037B","E01003237",1002,39,9,30,181,122,70,80,187,128,89,60,29,106
"2011","Lewisham 037C","E01003238",959,45,13,32,158,143,77,72,177,97,104,70,34,86
"2011","Lewisham 037D","E01003239",964,39,8,31,160,151,73,63,171,109,89,58,31,109
"2011","Lewisham 037E","E01032564",866,46,16,30,136,128,61,56,151,89,105,71,34,94
"2011","Lewisham 038A","E01003235",930,87,26,61,168,133,95,43,134,88,85,56,29,97
"2011","Lewisham 038B","E01003240",1230,57,19,38,208,197,102,70,217,154,121,85,36,104
"2011","Lewisham 038C","E01003241",1116,73,13,60,199,151,130,55,157,117,131,95,36,103
"2011","Lewisham 038D","E01003243",936,53,5,48,151,130,100,54,141,103,102,75,27,102
"2011","Lewisham 038E","E01032565",926,50,16,34,168,131,90,71,125,95,88,58,30,108
"2011","Lewisham 039A","E01003298",950,72,11,61,148,114,55,54,134,81,124,97,27,168
"2011","Lewisham 039B","E01003300",1012,53,15,38,166,95,73,60,164,109,151,110,41,141
"2011","Lewisham 039C","E01003303",1227,67,13,54,168,97,82,84,149,130,132,101,31,318
"2011","Lewisham 039D","E01003304",1534,112,19,93,323,143,100,117,194,140,162,118,44,243
"2011","Lewisham 039E","E01032579",1142,68,14,54,252,118,82,69,167,89,118,93,25,179
"2011","Newham 001A","E01003543",1868,128,23,105,392,167,204,92,219,191,186,155,31,289
"2011","Newham 001B","E01003544",1457,52,12,40,241,129,216,70,171,167,198,149,49,213
"2011","Newham 001C","E01003546",1365,51,8,43,220,127,112,66,217,104,211,171,40,257
"2011","Newham 001D","E01003550",1316,84,16,68,229,135,115,67,171,117,177,146,31,221
"2011","Newham 002A","E01003576",1309,48,4,44,138,112,87,88,202,126,250,214,36,258
"2011","Newham 002B","E01003581",1352,60,9,51,141,104,129,70,186,111,260,224,36,291
"2011","Newham 002C","E01003582",1132,48,8,40,128,107,84,66,156,110,195,164,31,238
"2011","Newham 002D","E01003583",1352,63,6,57,136,130,133,79,170,130,257,198,59,254
"2011","Newham 003A","E01003578",1395,41,6,35,147,102,134,78,191,144,226,178,48,332
"2011","Newham 003B","E01003584",1533,142,35,107,243,137,159,67,149,112,251,213,38,273
"2011","Newham 003C","E01003586",1374,74,16,58,146,127,118,64,197,106,246,210,36,296
"2011","Newham 003D","E01003590",1068,81,10,71,167,111,71,44,161,94,194,155,39,145
"2011","Newham 004A","E01003579",1327,58,1,57,152,106,106,60,182,141,261,232,29,261
"2011","Newham 004B","E01003585",1187,40,8,32,124,107,101,65,148,99,261,231,30,242
"2011","Newham 004C","E01003587",1800,125,16,109,233,169,167,92,239,139,282,235,47,354
"2011","Newham 004D","E01003591",1580,73,10,63,142,113,144,80,191,152,316,272,44,369
"2011","Newham 005A","E01003528",933,30,5,25,106,88,69,53,137,86,171,155,16,193
"2011","Newham 005B","E01003575",1177,52,7,45,147,111,110,59,144,110,232,195,37,212
"2011","Newham 005C","E01003577",1236,41,7,34,136,125,70,70,168,145,257,210,47,224
"2011","Newham 005D","E01003580",1226,40,9,31,166,114,108,71,170,136,202,164,38,219
"2011","Newham 006A","E01003545",1275,72,9,63,212,146,116,85,148,122,145,117,28,229
"2011","Newham 006B","E01003548",1837,86,15,71,286,161,248,104,180,168,170,142,28,434
"2011","Newham 006C","E01003549",1684,95,18,77,269,182,199,100,205,167,159,129,30,308
"2011","Newham 006D","E01003557",1583,104,14,90,210,153,182,84,194,139,266,219,47,251
"2011","Newham 007A","E01003547",1484,140,20,120,346,154,139,69,152,112,124,101,23,248
"2011","Newham 007B","E01003555",1419,103,19,84,248,109,157,65,172,107,209,182,27,249
"2011","Newham 007C","E01003561",1434,64,12,52,147,142,115,76,196,113,229,199,30,352
"2011","Newham 007D","E01003567",1374,57,11,46,148,103,126,78,192,114,266,214,52,290
"2011","Newham 008A","E01003556",1502,57,9,48,188,110,118,65,170,111,174,139,35,509
"2011","Newham 008B","E01003558",1191,44,9,35,133,75,120,61,144,131,221,188,33,262
"2011","Newham 008C","E01003570",1571,62,9,53,168,139,160,87,217,128,290,234,56,320
"2011","Newham 008D","E01003571",1706,66,8,58,187,132,143,76,217,121,320,289,31,444
"2011","Newham 008E","E01003572",1299,41,8,33,139,110,90,83,175,108,247,218,29,306
"2011","Newham 009A","E01003551",1382,82,15,67,239,123,129,64,157,107,199,162,37,282
"2011","Newham 009B","E01003553",1472,80,10,70,201,139,148,117,175,153,176,137,39,283
"2011","Newham 009C","E01003554",1538,123,20,103,297,120,190,75,172,161,139,123,16,261
"2011","Newham 009D","E01003559",2124,251,33,218,487,209,224,118,192,187,160,116,44,296
"2011","Newham 010A","E01003529",1850,113,12,101,205,200,143,87,239,130,358,326,32,375
"2011","Newham 010B","E01003530",1385,91,13,78,156,127,82,67,167,112,213,190,23,370
"2011","Newham 010C","E01003531",1526,90,13,77,169,155,112,92,186,115,243,218,25,364
"2011","Newham 010D","E01003532",1534,112,11,101,174,168,89,68,202,131,263,241,22,327
"2011","Newham 010E","E01003534",1726,82,10,72,209,166,152,75,218,126,327,287,40,371
"2011","Newham 011A","E01003533",1374,58,5,53,167,158,111,75,187,107,249,224,25,262
"2011","Newham 011B","E01003560",1348,42,5,37,140,117,109,64,188,124,225,202,23,339
"2011","Newham 011C","E01003563",1507,73,12,61,169,112,131,70,174,139,311,280,31,328
"2011","Newham 011D","E01003588",1313,48,7,41,128,102,78,77,208,110,230,198,32,332
"2011","Newham 011E","E01003589",1360,77,9,68,164,120,123,61,172,122,249,209,40,272
"2011","Newham 012A","E01003616",1368,111,11,100,206,126,165,61,167,125,161,127,34,246
"2011","Newham 012B","E01003617",2242,257,30,227,482,198,171,132,262,172,193,146,47,375
"2011","Newham 012C","E01003618",1828,157,21,136,389,167,203,104,190,152,155,125,30,311
"2011","Newham 012D","E01003619",1885,222,40,182,401,200,115,86,186,125,208,151,57,342
"2011","Newham 013C","E01003615",1432,87,16,71,206,140,213,79,167,147,150,115,35,243
"2011","Newham 013E","E01033578",1079,167,26,141,235,101,56,51,85,62,89,59,30,233
"2011","Newham 013F","E01033579",1140,215,26,189,279,128,57,64,51,51,58,44,14,237
"2011","Newham 013G","E01033583",2510,237,38,199,509,239,251,159,255,211,244,195,49,405
"2011","Newham 013H","E01033586",1103,107,15,92,214,125,97,64,127,98,115,76,39,156
"2011","Newham 014A","E01003562",1732,57,10,47,189,143,139,90,245,172,299,255,44,398
"2011","Newham 014B","E01003564",1847,90,9,81,221,130,150,76,282,154,296,257,39,448
"2011","Newham 014C","E01003565",1400,62,4,58,134,120,111,77,165,100,270,243,27,361
"2011","Newham 014D","E01003566",1325,67,8,59,135,115,92,74,175,113,254,222,32,300
"2011","Newham 015A","E01003625",1239,61,8,53,143,97,98,62,187,114,243,203,40,234
"2011","Newham 015B","E01003626",1204,70,11,59,140,104,104,63,176,102,175,155,20,270
"2011","Newham 015C","E01003627",1232,68,5,63,154,103,102,64,189,100,215,193,22,237
"2011","Newham 015D","E01003628",1230,80,4,76,155,90,87,63,188,116,213,190,23,238
"2011","Newham 015E","E01003629",1191,72,8,64,137,91,67,73,183,110,226,192,34,232
"2011","Newham 016A","E01003552",1272,74,16,58,176,100,171,74,163,105,212,171,41,197
"2011","Newham 016B","E01003596",1291,75,13,62,184,106,154,69,196,110,184,157,27,213
"2011","Newham 016C","E01003597",1221,51,7,44,175,127,106,59,160,129,204,172,32,210
"2011","Newham 016D","E01003635",1578,114,18,96,269,183,226,100,180,123,133,104,29,250
"2011","Newham 017A","E01003568",1762,89,12,77,228,172,130,74,216,144,298,252,46,411
"2011","Newham 017B","E01003569",1520,73,10,63,154,114,127,73,168,136,278,258,20,397
"2011","Newham 017C","E01003573",1619,74,9,65,162,129,139,78,233,138,298,255,43,368
"2011","Newham 017D","E01003574",2017,120,11,109,230,177,150,116,267,180,328,288,40,449
"2011","Newham 018A","E01003520",1530,80,8,72,173,134,93,61,210,116,250,226,24,413
"2011","Newham 018B","E01003521",1804,177,7,170,196,118,119,76,310,127,240,219,21,441
"2011","Newham 018C","E01003522",1369,66,20,46,161,131,91,94,206,92,234,206,28,294
"2011","Newham 018D","E01003525",1485,89,8,81,186,107,132,104,185,118,267,237,30,297
"2011","Newham 018E","E01003526",1391,71,18,53,175,110,123,75,153,132,284,257,27,268
"2011","Newham 019A","E01003488",1325,70,9,61,136,145,100,75,190,132,285,242,43,192
"2011","Newham 019B","E01003489",1239,43,6,37,125,76,92,69,190,121,241,207,34,282
"2011","Newham 019C","E01003490",1330,67,6,61,140,112,111,86,187,125,227,188,39,275
"2011","Newham 019D","E01003524",1520,57,5,52,145,126,106,89,211,139,287,252,35,360
"2011","Newham 020A","E01003631",1431,111,9,102,212,145,138,102,203,137,162,122,40,221
"2011","Newham 020B","E01003632",1718,107,16,91,272,168,212,88,249,184,164,137,27,274
"2011","Newham 020C","E01003633",1327,63,13,50,151,133,100,97,197,144,194,138,56,248
"2011","Newham 020D","E01003634",1353,62,11,51,194,114,127,80,192,136,198,162,36,250
"2011","Newham 020E","E01003636",1426,78,9,69,220,131,129,99,177,114,205,178,27,273
"2011","Newham 021A","E01003598",1334,44,9,35,201,126,107,76,159,126,251,196,55,244
"2011","Newham 021B","E01003600",1336,60,10,50,172,136,102,98,190,172,200,156,44,206
"2011","Newham 021C","E01003630",1493,67,4,63,238,129,152,88,225,144,181,156,25,269
"2011","Newham 021D","E01003637",1418,88,14,74,223,133,158,100,149,128,141,107,34,298
"2011","Newham 022A","E01003491",1538,72,10,62,146,128,125,73,225,125,274,244,30,370
"2011","Newham 022B","E01003592",1364,55,8,47,157,104,130,128,196,169,176,154,22,249
"2011","Newham 022C","E01003599",1173,38,6,32,135,90,101,86,153,117,189,164,25,264
"2011","Newham 022D","E01003606",1547,62,8,54,216,145,143,88,214,154,231,191,40,294
"2011","Newham 023A","E01003535",1168,44,9,35,113,133,96,75,161,116,211,174,37,219
"2011","Newham 023B","E01003536",1275,58,6,52,175,152,126,65,175,130,182,150,32,212
"2011","Newham 023C","E01003621",1177,47,5,42,120,115,101,68,184,110,194,174,20,238
"2011","Newham 023D","E01003622",1120,47,3,44,123,108,94,68,166,90,200,163,37,224
"2011","Newham 023E","E01003623",1182,33,6,27,129,103,92,54,158,127,231,195,36,255
"2011","Newham 024A","E01003523",1465,59,11,48,190,128,129,97,207,130,234,197,37,291
"2011","Newham 024B","E01003527",1239,76,16,60,216,159,132,78,148,93,150,119,31,187
"2011","Newham 024C","E01003537",1472,71,14,57,233,161,159,93,206,150,175,146,29,224
"2011","Newham 024D","E01003542",1292,40,8,32,159,140,107,96,191,159,204,171,33,196
"2011","Newham 024E","E01003624",1110,54,6,48,147,119,91,64,138,113,180,144,36,204
"2011","Newham 025A","E01003492",1433,68,11,57,173,115,145,90,187,134,226,191,35,295
"2011","Newham 025B","E01003493",1708,66,8,58,209,156,153,100,234,192,247,219,28,351
"2011","Newham 025C","E01003494",1419,85,14,71,220,172,128,95,169,123,178,151,27,249
"2011","Newham 025D","E01003495",1513,113,21,92,274,186,144,109,179,132,139,122,17,237
"2011","Newham 026A","E01003594",1300,57,11,46,179,135,117,76,170,134,196,147,49,236
"2011","Newham 026B","E01003595",1138,44,5,39,128,107,112,72,175,138,167,142,25,195
"2011","Newham 026C","E01003602",1503,72,15,57,180,138,194,104,196,171,195,151,44,253
"2011","Newham 026D","E01003607",1216,57,10,47,162,134,128,82,141,131,161,134,27,220
"2011","Newham 027A","E01003496",1146,72,13,59,201,125,97,61,149,99,132,109,23,210
"2011","Newham 027B","E01003498",1287,52,9,43,179,96,123,89,207,155,168,139,29,218
"2011","Newham 027C","E01003500",1492,76,19,57,213,149,176,107,188,166,211,145,66,206
"2011","Newham 027D","E01003593",1152,41,5,36,132,107,101,77,164,110,201,161,40,219
"2011","Newham 028A","E01003601",1503,60,16,44,193,145,128,98,233,177,223,187,36,246
"2011","Newham 028B","E01003603",1386,69,11,58,212,140,148,89,179,151,189,134,55,209
"2011","Newham 028C","E01003605",1516,56,11,45,169,133,131,98,193,175,232,199,33,329
"2011","Newham 028D","E01003608",1499,98,19,79,274,177,146,110,168,155,154,117,37,217
"2011","Newham 029A","E01003538",1404,58,10,48,203,132,126,70,201,163,228,188,40,223
"2011","Newham 029B","E01003539",1512,90,17,73,206,159,163,90,194,164,213,176,37,233
"2011","Newham 029C","E01003540",1254,45,7,38,149,120,124,85,183,140,196,155,41,212
"2011","Newham 029D","E01003541",1259,45,9,36,190,135,137,71,166,138,146,124,22,231
"2011","Newham 030A","E01003499",1547,46,14,32,192,123,171,107,212,201,246,193,53,249
"2011","Newham 030B","E01003501",1512,66,12,54,179,147,144,106,199,201,225,169,56,245
"2011","Newham 030C","E01003502",1400,46,8,38,178,113,151,80,188,186,199,153,46,259
"2011","Newham 030D","E01003503",1241,46,10,36,160,106,110,81,182,156,214,155,59,186
"2011","Newham 031A","E01003507",1542,60,5,55,242,143,181,96,192,192,214,164,50,222
"2011","Newham 031B","E01003508",1130,47,9,38,140,90,134,68,143,151,166,136,30,191
"2011","Newham 031C","E01003509",1443,67,9,58,188,164,203,96,196,184,175,128,47,170
"2011","Newham 031D","E01003604",1647,58,13,45,237,141,166,94,247,227,217,178,39,260
"2011","Newham 032A","E01003483",1103,47,8,39,143,131,104,65,153,104,151,111,40,205
"2011","Newham 032B","E01003484",1221,100,21,79,204,123,190,72,126,115,121,95,26,170
"2011","Newham 032C","E01003516",1327,52,7,45,159,122,151,82,184,202,193,144,49,182
"2011","Newham 032D","E01003518",1209,103,20,83,206,115,172,88,141,143,102,78,24,139
"2011","Newham 032E","E01003519",1204,63,9,54,153,105,144,74,180,161,124,93,31,200
"2011","Newham 033A","E01003480",1762,97,18,79,199,127,156,84,162,165,143,119,24,629
"2011","Newham 033B","E01003482",2038,237,30,207,391,201,236,97,176,149,236,186,50,315
"2011","Newham 033C","E01003486",877,29,6,23,107,100,50,50,124,98,162,138,24,157
"2011","Newham 033D","E01003487",988,33,5,28,130,123,102,44,138,92,185,157,28,141
"2011","Newham 034A","E01003497",1275,49,10,39,147,118,169,96,208,174,148,121,27,166
"2011","Newham 034D","E01003506",1073,42,10,32,108,105,102,67,182,147,143,114,29,177
"2011","Newham 034F","E01033574",1013,295,54,241,294,78,99,27,40,18,45,31,14,117
"2011","Newham 034G","E01033575",965,279,47,232,288,88,63,25,47,10,27,16,11,138
"2011","Newham 034H","E01033576",1098,195,42,153,259,107,85,47,86,94,85,65,20,140
"2011","Newham 034I","E01033584",1109,58,6,52,154,102,113,61,139,142,160,135,25,180
"2011","Newham 034J","E01033585",1868,113,10,103,280,180,178,112,233,229,222,170,52,321
"2011","Newham 035A","E01003479",1118,79,7,72,193,123,160,66,130,133,111,77,34,123
"2011","Newham 035B","E01003481",1218,47,13,34,124,105,146,54,119,123,102,75,27,398
"2011","Newham 035C","E01003485",1148,82,16,66,181,127,195,81,142,94,109,77,32,137
"2011","Newham 035D","E01003513",1171,97,26,71,176,128,184,63,114,129,98,72,26,182
"2011","Newham 036A","E01003511",893,29,8,21,112,91,57,70,123,116,139,113,26,156
"2011","Newham 036B","E01003512",1329,50,13,37,170,118,176,76,188,188,159,121,38,204
"2011","Newham 036C","E01003514",1086,48,6,42,124,126,142,74,141,135,171,136,35,125
"2011","Newham 036D","E01003515",1271,47,10,37,181,137,117,90,193,165,165,125,40,176
"2011","Newham 036E","E01003517",1231,55,10,45,151,137,131,99,176,133,143,113,30,206
"2011","Newham 037A","E01003609",2021,223,36,187,432,248,163,112,201,166,198,145,53,278
"2011","Newham 037C","E01003611",1215,68,8,60,175,128,83,70,186,135,175,125,50,195
"2011","Newham 037E","E01033577",1193,229,37,192,297,126,99,51,92,70,84,62,22,145
"2011","Newham 037F","E01033580",1346,310,51,259,415,150,91,65,88,70,52,42,10,105
"2011","Newham 037G","E01033581",1322,106,24,82,218,134,129,75,185,140,158,116,42,177
"2011","Newham 037H","E01033582",1161,225,30,195,335,117,161,36,60,41,57,39,18,129
"2011","Southwark 001A","E01004029",1587,413,65,348,450,158,72,59,93,79,56,41,15,207
"2011","Southwark 001B","E01004032",1510,419,55,364,411,158,92,52,73,43,53,37,16,209
"2011","Southwark 001C","E01004053",1614,487,89,398,514,147,111,60,60,47,45,29,16,143
"2011","Southwark 001D","E01004054",1460,448,76,372,464,140,95,54,61,39,47,24,23,112
"2011","Southwark 001E","E01004055",978,88,17,71,158,118,63,61,167,126,99,66,33,98
"2011","Southwark 002A","E01003927",2084,431,54,377,505,138,99,73,117,92,85,53,32,544
"2011","Southwark 002B","E01003929",1883,507,82,425,549,153,101,56,113,98,83,51,32,223
"2011","Southwark 002C","E01003934",1165,263,65,198,343,93,103,52,84,47,60,34,26,120
"2011","Southwark 002D","E01003935",1168,147,31,116,212,107,41,40,66,40,61,47,14,454
"2011","Southwark 002E","E01003939",1593,373,59,314,481,133,74,48,95,73,80,50,30,236
"2011","Southwark 003A","E01003976",1576,327,52,275,337,150,97,68,161,108,135,92,43,193
"2011","Southwark 003E","E01004027",1765,385,69,316,429,174,125,69,137,106,108,70,38,232
"2011","Southwark 003F","E01032637",1187,498,122,376,317,87,44,7,10,3,12,8,4,209
"2011","Southwark 003G","E01032638",1093,449,84,365,404,71,67,14,15,15,9,6,3,49
"2011","Southwark 003H","E01032640",1172,514,116,398,401,64,52,24,15,25,25,15,10,52
"2011","Southwark 003I","E01032646",1408,469,85,384,430,94,88,37,77,48,42,29,13,123
"2011","Southwark 003J","E01032803",1207,480,66,414,356,92,48,21,33,29,26,16,10,122
"2011","Southwark 003K","E01032834",1064,470,101,369,352,75,68,15,25,10,10,2,8,39
"2011","Southwark 004A","E01003975",1175,124,18,106,205,120,51,73,165,125,130,88,42,182
"2011","Southwark 004B","E01003978",1509,321,43,278,399,105,81,63,122,97,96,65,31,225
"2011","Southwark 004C","E01004022",2005,331,57,274,509,238,104,97,196,152,130,86,44,248
"2011","Southwark 004D","E01004023",1172,153,21,132,241,133,76,87,157,121,100,73,27,104
"2011","Southwark 004E","E01004028",1287,179,29,150,284,142,75,87,143,104,115,71,44,158
"2011","Southwark 006A","E01003938",1446,216,30,186,359,137,73,69,146,97,121,79,42,228
"2011","Southwark 006B","E01003940",1107,126,28,98,209,100,61,64,130,102,110,73,37,205
"2011","Southwark 006C","E01003941",1645,443,75,368,406,125,104,56,110,63,92,73,19,246
"2011","Southwark 006D","E01003942",1275,108,18,90,199,121,52,62,113,82,97,76,21,441
"2011","Southwark 006E","E01003979",1442,257,38,219,341,119,83,56,123,100,102,68,34,261
"2011","Southwark 006F","E01003981",1455,249,31,218,288,113,88,54,111,84,58,40,18,410
"2011","Southwark 007A","E01004030",1237,172,26,146,356,137,83,56,108,118,72,46,26,135
"2011","Southwark 007B","E01004031",1618,247,28,219,366,153,106,70,140,124,119,90,29,293
"2011","Southwark 007C","E01004033",1156,138,16,122,234,129,67,72,149,93,122,83,39,152
"2011","Southwark 007D","E01004034",1115,100,17,83,213,100,75,85,151,122,114,85,29,155
"2011","Southwark 007E","E01004036",1427,104,23,81,234,144,131,89,181,139,169,121,48,236
"2011","Southwark 008A","E01004056",1752,398,62,336,450,168,113,74,132,86,110,81,29,221
"2011","Southwark 008B","E01004057",1253,230,32,198,335,151,97,64,118,80,71,45,26,107
"2011","Southwark 008C","E01004058",1570,455,63,392,566,144,108,47,50,38,29,18,11,133
"2011","Southwark 008D","E01004059",1403,401,53,348,446,142,57,40,53,25,39,28,11,200
"2011","Southwark 008E","E01004060",1434,229,36,193,335,146,103,73,136,114,115,72,43,183
"2011","Southwark 009A","E01003936",1731,394,51,343,363,89,49,16,25,18,19,15,4,758
"2011","Southwark 009B","E01003937",1382,325,55,270,373,124,63,53,84,59,69,52,17,232
"2011","Southwark 009C","E01003943",1017,85,7,78,165,89,53,61,145,119,104,78,26,196
"2011","Southwark 009F","E01032720",1390,140,12,128,235,101,68,63,138,146,167,141,26,332
"2011","Southwark 010A","E01003977",1321,105,13,92,236,182,100,89,168,141,141,99,42,159
"2011","Southwark 010B","E01004037",1528,153,12,141,308,177,127,86,162,163,153,108,45,199
"2011","Southwark 010C","E01004038",1746,161,31,130,345,210,134,140,200,166,164,111,53,226
"2011","Southwark 010D","E01004042",1314,72,12,60,196,145,127,80,188,187,155,114,41,164
"2011","Southwark 010E","E01004043",1092,133,23,110,211,134,96,68,126,112,72,51,21,140
"2011","Southwark 011A","E01003986",883,48,7,41,111,93,52,74,152,120,125,78,47,108
"2011","Southwark 011B","E01003987",1296,83,11,72,190,167,87,91,201,149,137,102,35,191
"2011","Southwark 011C","E01004024",1418,97,14,83,211,141,98,90,225,176,137,79,58,243
"2011","Southwark 011D","E01004035",1172,74,22,52,180,143,87,94,187,134,149,120,29,124
"2011","Southwark 012A","E01003960",1485,193,25,168,322,133,94,83,133,88,99,68,31,340
"2011","Southwark 012B","E01003961",1534,93,14,79,226,152,89,110,233,212,167,121,46,252
"2011","Southwark 012E","E01003994",1215,125,16,109,187,126,110,86,139,118,117,82,35,207
"2011","Southwark 012F","E01032722",1737,160,26,134,368,171,142,115,187,149,159,113,46,286
"2011","Southwark 013A","E01003980",1608,110,17,93,280,136,87,74,192,169,128,100,28,432
"2011","Southwark 013B","E01004039",1257,160,29,131,221,119,81,92,134,112,101,82,19,237
"2011","Southwark 013C","E01004040",1262,77,13,64,215,134,77,84,166,147,148,109,39,214
"2011","Southwark 013D","E01004041",1248,72,13,59,224,143,77,111,170,142,135,91,44,174
"2011","Southwark 013E","E01004044",1016,64,16,48,158,105,65,79,146,136,103,77,26,160
"2011","Southwark 014A","E01003992",1069,62,10,52,192,102,63,72,143,125,112,77,35,198
"2011","Southwark 014B","E01003995",1075,127,24,103,271,104,68,77,105,112,109,64,45,102
"2011","Southwark 014D","E01003998",1114,229,26,203,275,107,86,64,96,67,79,49,30,111
"2011","Southwark 014E","E01003999",1118,143,22,121,266,113,68,60,133,109,108,67,41,118
"2011","Southwark 014F","E01032639",1434,216,24,192,348,123,71,69,99,92,74,48,26,342
"2011","Southwark 014G","E01032719",981,125,20,105,180,72,58,70,112,85,92,56,36,187
"2011","Southwark 015A","E01003964",1522,122,27,95,298,137,109,91,200,179,153,108,45,233
"2011","Southwark 015B","E01003966",1499,80,8,72,202,156,101,108,168,171,185,150,35,328
"2011","Southwark 015C","E01003968",1027,49,9,40,130,85,50,90,175,129,166,121,45,153
"2011","Southwark 015D","E01003971",1193,52,10,42,139,88,86,89,193,161,207,147,60,178
"2011","Southwark 015E","E01003974",922,38,5,33,118,91,63,61,168,122,119,95,24,142
"2011","Southwark 016A","E01003963",1220,76,14,62,175,127,89,91,163,133,161,119,42,205
"2011","Southwark 016B","E01003967",1250,56,8,48,177,131,71,84,200,176,191,122,69,164
"2011","Southwark 016C","E01003970",1078,60,13,47,138,111,77,84,177,127,128,95,33,176
"2011","Southwark 016D","E01003972",1251,86,15,71,246,145,107,77,165,125,111,78,33,189
"2011","Southwark 016E","E01003973",1221,78,17,61,206,157,101,95,182,139,109,73,36,154
"2011","Southwark 017A","E01003923",1402,176,31,145,393,139,90,60,129,134,108,66,42,173
"2011","Southwark 017B","E01003969",1516,165,21,144,346,136,134,72,166,156,80,55,25,261
"2011","Southwark 017C","E01003991",925,58,11,47,131,109,81,67,137,110,103,79,24,129
"2011","Southwark 017D","E01003993",1230,57,13,44,208,141,72,82,184,159,128,89,39,199
"2011","Southwark 017E","E01003997",963,101,18,83,219,98,60,51,101,70,90,63,27,173
"2011","Southwark 018A","E01003983",1398,52,12,40,190,144,76,81,225,182,189,122,67,259
"2011","Southwark 018B","E01003988",1628,107,23,84,265,147,111,113,273,213,180,128,52,219
"2011","Southwark 018C","E01003989",1364,38,9,29,222,114,116,84,189,160,183,139,44,258
"2011","Southwark 018D","E01003990",1527,69,22,47,258,179,109,109,225,162,176,118,58,240
"2011","Southwark 018E","E01004007",882,32,4,28,139,96,51,56,118,100,111,85,26,179
"2011","Southwark 019A","E01003912",1095,40,7,33,151,107,62,63,189,143,152,112,40,188
"2011","Southwark 019B","E01004011",1474,63,8,55,225,195,83,85,219,151,195,140,55,258
"2011","Southwark 019C","E01004012",1837,162,18,144,387,168,116,141,232,173,196,142,54,262
"2011","Southwark 019D","E01004013",1218,81,11,70,208,118,64,62,173,141,158,117,41,213
"2011","Southwark 019E","E01004014",1283,66,8,58,194,119,79,95,191,159,175,137,38,205
"2011","Southwark 020A","E01003911",1451,120,13,107,333,132,99,91,194,150,140,91,49,192
"2011","Southwark 020B","E01003916",1762,151,28,123,361,171,110,92,168,159,143,94,49,407
"2011","Southwark 020C","E01003917",1413,140,32,108,338,124,97,96,149,164,137,103,34,168
"2011","Southwark 020D","E01003918",1173,63,14,49,191,123,71,100,162,135,154,116,38,174
"2011","Southwark 020E","E01003925",953,59,11,48,152,108,59,56,125,133,113,83,30,148
"2011","Southwark 021A","E01003919",1426,161,28,133,368,142,103,61,149,112,98,71,27,232
"2011","Southwark 021B","E01003920",1318,86,15,71,212,135,83,103,188,166,154,113,41,191
"2011","Southwark 021C","E01003921",1164,85,18,67,175,136,79,79,186,159,127,90,37,138
"2011","Southwark 021D","E01003922",1453,104,16,88,311,152,111,93,174,170,150,106,44,188
"2011","Southwark 021E","E01003924",1433,73,15,58,200,129,110,106,248,215,160,116,44,192
"2011","Southwark 021F","E01003926",1051,61,13,48,182,117,72,71,144,114,108,86,22,182
"2011","Southwark 022B","E01004008",1598,90,16,74,249,171,117,83,245,169,207,138,69,267
"2011","Southwark 022D","E01004010",1139,88,20,68,187,96,94,80,149,140,136,102,34,169
"2011","Southwark 022E","E01004067",1641,118,14,104,312,141,94,104,222,192,203,147,56,255
"2011","Southwark 022F","E01032805",1880,91,18,73,297,183,136,136,277,201,238,174,64,321
"2011","Southwark 023A","E01003984",1604,103,21,82,368,124,112,105,215,187,153,104,49,237
"2011","Southwark 023B","E01004003",1312,83,19,64,233,155,95,104,179,145,174,120,54,144
"2011","Southwark 023C","E01004004",1967,218,34,184,439,211,174,112,196,196,180,127,53,241
"2011","Southwark 023D","E01004005",1578,113,20,93,250,142,125,100,228,211,229,166,63,180
"2011","Southwark 023E","E01004006",1563,142,25,117,310,138,125,95,196,169,177,112,65,211
"2011","Southwark 024A","E01003913",1494,251,32,219,458,134,83,63,108,88,81,52,29,228
"2011","Southwark 024B","E01003914",1464,222,35,187,401,125,108,70,135,105,97,63,34,201
"2011","Southwark 024C","E01003915",1511,135,29,106,356,144,94,77,184,149,150,95,55,222
"2011","Southwark 024D","E01004050",1224,273,43,230,412,97,106,37,63,45,57,38,19,134
"2011","Southwark 024E","E01004052",1411,308,37,271,456,139,134,40,86,79,59,42,17,110
"2011","Southwark 025A","E01004061",1428,237,50,187,442,137,128,56,129,72,86,61,25,141
"2011","Southwark 025B","E01004062",1454,163,18,145,355,150,143,87,163,126,120,91,29,147
"2011","Southwark 025C","E01004063",1570,247,34,213,475,159,140,69,116,111,101,71,30,152
"2011","Southwark 025D","E01004065",1198,230,32,198,400,107,94,51,93,62,62,38,24,99
"2011","Southwark 025E","E01004066",1616,178,28,150,400,131,129,90,169,138,150,105,45,231
"2011","Southwark 026A","E01004000",1469,127,25,102,318,176,132,80,184,135,136,96,40,181
"2011","Southwark 026B","E01004001",1239,82,19,63,235,124,103,76,186,142,139,114,25,152
"2011","Southwark 026C","E01004019",1752,189,38,151,457,173,147,95,211,138,145,107,38,197
"2011","Southwark 026D","E01004064",1436,117,21,96,320,141,124,67,201,141,157,115,42,168
"2011","Southwark 026E","E01004068",1452,115,26,89,293,156,103,84,210,142,174,125,49,175
"2011","Southwark 027A","E01004045",1078,82,11,71,184,123,78,63,155,109,135,75,60,149
"2011","Southwark 027B","E01004047",1128,76,9,67,190,119,74,79,142,138,121,85,36,189
"2011","Southwark 027C","E01004048",1214,217,33,184,335,150,102,47,109,58,56,39,17,140
"2011","Southwark 027D","E01004049",1293,97,18,79,238,82,71,59,119,87,93,68,25,447
"2011","Southwark 027E","E01004051",1095,258,38,220,351,92,90,34,62,33,35,23,12,140
"2011","Southwark 028A","E01003953",1734,374,66,308,606,150,128,60,135,79,88,57,31,114
"2011","Southwark 028B","E01003955",1454,257,46,211,517,158,120,50,87,84,80,46,34,101
"2011","Southwark 028C","E01004015",1180,219,41,178,383,139,108,48,88,55,52,29,23,88
"2011","Southwark 028D","E01004021",1767,378,60,318,601,191,113,82,113,80,68,35,33,141
"2011","Southwark 028E","E01004046",1280,268,38,230,440,112,93,36,82,71,76,55,21,102
"2011","Southwark 029A","E01004002",1252,180,28,152,350,142,117,62,107,75,106,75,31,113
"2011","Southwark 029B","E01004016",1711,230,54,176,489,176,159,93,153,138,127,81,46,146
"2011","Southwark 029C","E01004017",1175,172,33,139,389,132,132,49,84,64,62,46,16,91
"2011","Southwark 029D","E01004020",1227,106,24,82,247,148,97,66,149,125,144,94,50,145
"2011","Southwark 030A","E01003952",1295,250,31,219,461,127,101,47,95,61,53,33,20,100
"2011","Southwark 030B","E01003954",1230,225,56,169,430,140,103,53,91,71,46,27,19,71
"2011","Southwark 030C","E01003956",1318,308,54,254,449,144,114,45,98,51,41,25,16,68
"2011","Southwark 030D","E01004071",1198,215,31,184,376,114,108,43,87,72,77,55,22,106
"2011","Southwark 030E","E01004072",1277,314,63,251,456,100,107,42,57,45,39,30,9,117
"2011","Southwark 031A","E01004069",989,299,57,242,322,80,100,21,42,18,19,12,7,88
"2011","Southwark 031B","E01004070",1438,371,60,311,450,118,98,49,98,71,59,38,21,124
"2011","Southwark 031C","E01004073",1384,406,60,346,454,118,110,36,77,52,45,26,19,86
"2011","Southwark 031D","E01004074",1291,392,71,321,410,87,119,20,66,26,28,17,11,143
"2011","Southwark 031E","E01004075",1239,395,64,331,439,95,109,22,41,18,30,21,9,90
"2011","Southwark 032A","E01003949",1473,306,45,261,484,168,148,56,96,65,65,48,17,85
"2011","Southwark 032B","E01003950",1421,119,21,98,354,161,106,71,179,114,153,112,41,164
"2011","Southwark 032C","E01003957",1346,270,61,209,421,147,116,54,102,74,54,37,17,108
"2011","Southwark 032D","E01003958",1266,229,53,176,400,148,121,38,125,68,55,37,18,82
"2011","Southwark 032E","E01004018",1459,265,53,212,519,158,141,54,100,63,55,42,13,104
"2011","Southwark 033A","E01003945",1247,303,61,242,408,126,117,41,75,56,37,30,7,84
"2011","Southwark 033B","E01003946",1230,285,45,240,362,137,89,39,70,52,95,69,26,101
"2011","Southwark 033C","E01003947",1027,94,18,76,179,124,73,53,144,110,126,80,46,124
"2011","Southwark 033D","E01003948",1219,245,53,192,396,127,106,58,94,48,87,63,24,58
"2011","Southwark 033E","E01003951",1118,268,59,209,294,88,94,32,58,46,52,33,19,186
"2011","Southwark 034A","E01003930",1308,124,25,99,190,78,63,45,82,75,89,46,43,562
"2011","Southwark 034B","E01003932",1309,127,26,101,250,134,66,77,130,87,176,125,51,262
"2011","Southwark 034C","E01003933",1515,193,48,145,279,99,49,55,96,60,114,94,20,570
"2011","Southwark 034D","E01032583",1359,212,33,179,293,102,68,54,118,101,105,76,29,306
"2011","Southwark 034E","E01032584",1045,163,31,132,246,99,58,47,96,74,82,58,24,180
"2011","Tower Hamlets 001A","E01004222",1797,132,19,113,321,187,132,116,207,190,296,231,65,216
"2011","Tower Hamlets 001B","E01004223",1537,137,28,109,346,168,121,86,210,137,187,139,48,145
"2011","Tower Hamlets 001C","E01004224",1545,156,23,133,332,170,110,86,167,123,193,150,43,208
"2011","Tower Hamlets 001D","E01004226",1264,103,18,85,234,126,79,81,153,134,171,126,45,183
"2011","Tower Hamlets 002A","E01004197",1853,191,31,160,490,186,120,93,172,126,234,186,48,241
"2011","Tower Hamlets 002B","E01004198",1159,81,11,70,229,119,73,72,139,108,208,166,42,130
"2011","Tower Hamlets 002C","E01004199",1107,53,10,43,185,104,73,71,126,112,235,200,35,148
"2011","Tower Hamlets 002D","E01004201",1184,142,14,128,295,131,79,48,130,72,148,117,31,139
"2011","Tower Hamlets 003A","E01004228",1493,253,44,209,439,163,106,58,130,96,107,79,28,141
"2011","Tower Hamlets 003B","E01004230",1600,165,27,138,383,169,113,86,154,135,186,149,37,209
"2011","Tower Hamlets 003C","E01004232",1419,268,45,223,404,116,80,57,88,60,90,71,19,256
"2011","Tower Hamlets 003D","E01004233",1299,97,15,82,242,124,108,63,175,131,204,166,38,155
"2011","Tower Hamlets 003E","E01004234",1780,306,54,252,546,177,130,55,127,106,103,80,23,230
"2011","Tower Hamlets 004A","E01004225",1936,480,62,418,672,232,108,66,100,64,58,46,12,156
"2011","Tower Hamlets 004C","E01004229",1151,119,28,91,239,120,63,57,132,83,140,114,26,198
"2011","Tower Hamlets 004D","E01004231",1249,75,8,67,181,125,80,86,153,112,214,177,37,223
"2011","Tower Hamlets 004E","E01032764",1112,196,26,170,351,107,54,48,99,76,80,62,18,101
"2011","Tower Hamlets 004F","E01032765",1207,177,27,150,283,148,58,57,104,84,125,100,25,171
"2011","Tower Hamlets 004G","E01032784",1241,211,27,184,359,135,60,56,86,58,82,70,12,194
"2011","Tower Hamlets 005A","E01004200",1380,186,27,159,345,110,76,42,95,58,91,74,17,377
"2011","Tower Hamlets 005B","E01004202",1406,217,28,189,395,124,107,45,101,81,179,144,35,157
"2011","Tower Hamlets 005C","E01004203",1424,177,17,160,366,157,79,83,136,110,137,111,26,179
"2011","Tower Hamlets 005D","E01004204",1145,81,11,70,193,102,77,65,125,111,227,189,38,164
"2011","Tower Hamlets 006A","E01004311",1138,101,14,87,226,119,97,61,124,105,168,132,36,137
"2011","Tower Hamlets 006B","E01004314",883,175,24,151,305,63,103,28,47,40,54,44,10,68
"2011","Tower Hamlets 006C","E01004315",1367,187,19,168,311,110,112,83,143,93,179,143,36,149
"2011","Tower Hamlets 006D","E01004318",1096,78,16,62,253,104,75,53,144,91,161,114,47,137
"2011","Tower Hamlets 007A","E01004259",1424,213,29,184,419,139,92,75,120,95,112,79,33,159
"2011","Tower Hamlets 007B","E01004260",1282,123,12,111,239,131,74,78,158,117,192,160,32,170
"2011","Tower Hamlets 007C","E01004263",1004,59,13,46,146,118,62,52,147,103,160,126,34,157
"2011","Tower Hamlets 007D","E01004266",1193,148,27,121,301,134,60,55,121,93,134,98,36,147
"2011","Tower Hamlets 008A","E01004235",935,48,9,39,139,82,49,60,145,91,176,148,28,145
"2011","Tower Hamlets 008B","E01004236",1147,45,8,37,124,94,69,72,160,100,262,223,39,221
"2011","Tower Hamlets 008C","E01004237",856,74,3,71,183,87,55,55,90,75,119,94,25,118
"2011","Tower Hamlets 008D","E01004238",2007,159,15,144,396,222,99,108,202,146,341,274,67,334
"2011","Tower Hamlets 008E","E01004239",1152,54,8,46,142,127,78,84,162,115,218,175,43,172
"2011","Tower Hamlets 009A","E01004312",1199,98,9,89,202,130,87,50,137,121,219,180,39,155
"2011","Tower Hamlets 009B","E01004313",1504,162,22,140,361,144,85,76,150,114,201,168,33,211
"2011","Tower Hamlets 009C","E01004316",919,106,14,92,227,65,67,46,80,59,142,112,30,127
"2011","Tower Hamlets 009D","E01004317",2338,500,78,422,721,190,152,77,138,83,221,181,40,256
"2011","Tower Hamlets 010A","E01004261",2142,43,4,39,99,75,58,38,84,82,191,165,26,1472
"2011","Tower Hamlets 010B","E01004262",1451,66,12,54,158,81,51,59,104,76,145,118,27,711
"2011","Tower Hamlets 010C","E01004264",1069,58,11,47,123,80,58,56,100,90,258,214,44,246
"2011","Tower Hamlets 010E","E01032785",1108,249,39,210,400,109,51,38,68,33,82,57,25,78
"2011","Tower Hamlets 010F","E01032786",1118,112,18,94,276,113,80,64,127,101,135,100,35,110
"2011","Tower Hamlets 011A","E01004207",1100,72,12,60,177,93,66,66,111,83,146,123,23,286
"2011","Tower Hamlets 011B","E01004209",951,44,5,39,154,93,44,72,115,76,224,189,35,129
"2011","Tower Hamlets 011D","E01004212",1451,136,15,121,248,107,88,62,110,76,164,141,23,460
"2011","Tower Hamlets 011F","E01032787",1842,95,8,87,308,170,109,117,204,148,380,330,50,311
"2011","Tower Hamlets 012A","E01004240",1226,66,14,52,160,119,70,86,161,124,240,203,37,200
"2011","Tower Hamlets 012B","E01004241",1124,45,10,35,145,91,74,71,140,121,237,183,54,200
"2011","Tower Hamlets 012C","E01004242",1770,158,14,144,302,180,91,109,193,126,308,262,46,303
"2011","Tower Hamlets 012D","E01004267",1431,207,37,170,324,127,79,71,129,71,187,147,40,236
"2011","Tower Hamlets 012E","E01004268",1290,82,8,74,202,113,72,95,136,137,281,211,70,172
"2011","Tower Hamlets 013A","E01004205",1541,69,11,58,217,131,85,78,195,120,368,311,57,278
"2011","Tower Hamlets 013B","E01004206",1131,52,5,47,150,110,60,71,123,109,236,206,30,220
"2011","Tower Hamlets 013C","E01004208",1721,270,33,237,421,140,100,72,95,67,157,123,34,399
"2011","Tower Hamlets 013D","E01004211",1307,200,23,177,399,127,92,42,94,55,133,107,26,165
"2011","Tower Hamlets 014A","E01004269",1472,102,13,89,251,91,76,83,181,138,240,200,40,310
"2011","Tower Hamlets 014B","E01004270",1856,214,22,192,417,149,93,68,153,109,199,170,29,454
"2011","Tower Hamlets 014C","E01004271",1056,45,11,34,162,124,62,65,153,92,198,152,46,155
"2011","Tower Hamlets 014D","E01004272",1402,53,7,46,151,115,65,108,195,135,346,305,41,234
"2011","Tower Hamlets 014E","E01004273",1319,60,11,49,190,112,52,85,167,111,318,274,44,224
"2011","Tower Hamlets 015A","E01004306",1486,256,47,209,365,136,107,49,103,72,208,177,31,190
"2011","Tower Hamlets 015B","E01004307",2031,471,81,390,541,137,100,37,83,44,101,70,31,517
"2011","Tower Hamlets 015C","E01004308",1161,105,14,91,272,104,58,50,118,67,193,169,24,194
"2011","Tower Hamlets 015D","E01004309",2320,196,28,168,399,165,86,107,216,147,497,383,114,507
"2011","Tower Hamlets 015E","E01004310",1647,220,34,186,322,162,93,89,135,109,294,229,65,223
"2011","Tower Hamlets 016A","E01004283",1695,103,24,79,244,162,107,109,172,145,278,245,33,375
"2011","Tower Hamlets 016B","E01004287",1544,124,17,107,244,158,98,96,186,158,235,203,32,245
"2011","Tower Hamlets 016C","E01004289",1386,103,21,82,217,146,95,60,129,107,203,172,31,326
"2011","Tower Hamlets 016D","E01004290",1034,161,25,136,225,98,73,57,88,49,76,56,20,207
"2011","Tower Hamlets 017A","E01004322",997,89,17,72,184,74,39,60,87,69,133,106,27,262
"2011","Tower Hamlets 017B","E01004323",1143,106,12,94,251,107,64,61,95,88,190,169,21,181
"2011","Tower Hamlets 017C","E01004324",1137,76,13,63,162,118,61,46,146,105,234,205,29,189
"2011","Tower Hamlets 017D","E01004326",1124,110,8,102,230,101,84,71,113,71,145,122,23,199
"2011","Tower Hamlets 018A","E01004245",988,32,7,25,110,109,63,69,103,89,242,207,35,171
"2011","Tower Hamlets 018B","E01004246",1476,166,31,135,326,139,128,105,137,94,182,150,32,199
"2011","Tower Hamlets 018C","E01004248",839,31,3,28,98,86,51,44,124,97,183,152,31,125
"2011","Tower Hamlets 018D","E01004249",1429,71,14,57,208,142,115,103,181,155,275,224,51,179
"2011","Tower Hamlets 019A","E01004284",1699,187,33,154,442,184,68,82,133,101,292,236,56,210
"2011","Tower Hamlets 019B","E01004285",1545,57,13,44,180,148,100,85,193,125,366,309,57,291
"2011","Tower Hamlets 019C","E01004286",1670,151,33,118,286,192,89,89,165,132,348,292,56,218
"2011","Tower Hamlets 019D","E01004288",1071,72,7,65,154,103,71,54,152,96,221,181,40,148
"2011","Tower Hamlets 020A","E01004243",1212,49,11,38,174,103,86,83,158,105,273,233,40,181
"2011","Tower Hamlets 020B","E01004244",1264,76,10,66,180,118,85,75,178,136,250,187,63,166
"2011","Tower Hamlets 020C","E01004247",1383,77,13,64,178,116,82,106,173,138,292,238,54,221
"2011","Tower Hamlets 020D","E01004250",1588,92,14,78,228,177,91,114,221,158,325,261,64,182
"2011","Tower Hamlets 021A","E01004319",1411,102,13,89,225,106,75,65,162,95,327,292,35,254
"2011","Tower Hamlets 021C","E01004321",1445,149,21,128,281,105,87,67,129,67,291,256,35,269
"2011","Tower Hamlets 021D","E01004325",2149,528,75,453,582,155,95,70,140,64,196,162,34,319
"2011","Tower Hamlets 021E","E01032766",1131,255,34,221,308,97,54,33,62,30,101,86,15,191
"2011","Tower Hamlets 021F","E01032767",1509,523,90,433,495,110,44,33,45,21,51,42,9,187
"2011","Tower Hamlets 022A","E01004298",1245,112,14,98,221,99,68,75,134,87,275,220,55,174
"2011","Tower Hamlets 022B","E01004300",966,70,17,53,167,87,63,65,124,99,161,136,25,130
"2011","Tower Hamlets 022C","E01004304",1418,102,17,85,226,121,89,87,161,102,301,263,38,229
"2011","Tower Hamlets 022D","E01004305",1379,92,15,77,225,135,96,70,155,146,245,198,47,215
"2011","Tower Hamlets 023A","E01004251",1471,119,26,93,224,159,110,97,181,127,261,211,50,193
"2011","Tower Hamlets 023B","E01004254",1883,639,103,536,620,174,87,34,64,49,88,67,21,128
"2011","Tower Hamlets 023C","E01004255",1224,125,20,105,193,110,79,85,157,93,243,212,31,139
"2011","Tower Hamlets 023D","E01004258",1231,312,64,248,344,103,74,43,75,77,102,77,25,101
"2011","Tower Hamlets 024A","E01004252",2025,263,34,229,393,199,129,134,223,157,298,234,64,229
"2011","Tower Hamlets 024B","E01004253",1623,101,10,91,216,193,130,114,212,164,274,221,53,219
"2011","Tower Hamlets 024C","E01004256",1224,77,11,66,167,118,75,97,156,117,245,209,36,172
"2011","Tower Hamlets 024D","E01004257",1258,56,10,46,154,120,90,90,174,108,267,203,64,199
"2011","Tower Hamlets 025B","E01004301",932,83,11,72,154,69,58,51,98,67,192,170,22,160
"2011","Tower Hamlets 025C","E01004302",1364,111,12,99,216,109,65,82,170,88,289,257,32,234
"2011","Tower Hamlets 025D","E01004303",1779,286,62,224,370,179,100,87,158,107,211,164,47,281
"2011","Tower Hamlets 025E","E01032768",1172,452,91,361,395,101,39,17,29,20,40,24,16,79
"2011","Tower Hamlets 025F","E01032769",1042,295,62,233,318,98,60,34,53,29,87,73,14,68
"2011","Tower Hamlets 026A","E01004292",1546,537,63,474,499,149,73,34,48,23,58,43,15,125
"2011","Tower Hamlets 026B","E01004294",1525,419,93,326,404,140,77,52,100,77,121,79,42,135
"2011","Tower Hamlets 026C","E01004295",1030,61,11,50,152,89,57,72,150,83,228,194,34,138
"2011","Tower Hamlets 026D","E01004296",1251,217,31,186,268,127,70,50,136,81,163,133,30,139
"2011","Tower Hamlets 027A","E01004291",1601,508,100,408,540,137,98,43,65,46,82,59,23,82
"2011","Tower Hamlets 027B","E01004293",1864,666,131,535,584,147,93,51,75,43,90,60,30,115
"2011","Tower Hamlets 027C","E01004297",1577,558,114,444,477,130,84,38,67,45,69,58,11,109
"2011","Tower Hamlets 028A","E01004215",2125,399,70,329,502,216,130,87,168,94,258,198,60,271
"2011","Tower Hamlets 028B","E01004219",1722,240,30,210,329,161,95,91,180,110,293,245,48,223
"2011","Tower Hamlets 028D","E01004221",1537,330,39,291,405,170,94,67,101,71,141,99,42,158
"2011","Tower Hamlets 028E","E01032776",973,318,67,251,301,80,42,22,25,19,43,31,12,123
"2011","Tower Hamlets 028F","E01032777",941,197,43,154,273,110,41,33,65,34,76,64,12,112
"2011","Tower Hamlets 028G","E01032778",965,294,49,245,289,96,38,26,51,14,54,44,10,103
"2011","Tower Hamlets 028H","E01032779",892,266,55,211,298,65,39,17,39,35,51,35,16,82
"2011","Tower Hamlets 028I","E01032780",1209,448,88,360,395,75,45,18,56,20,41,27,14,111
"2011","Tower Hamlets 030A","E01004214",1163,61,6,55,162,121,90,76,150,136,218,164,54,149
"2011","Tower Hamlets 030B","E01004216",1309,291,47,244,332,140,86,70,78,58,91,60,31,163
"2011","Tower Hamlets 030C","E01004217",1347,215,38,177,281,184,91,94,128,98,147,118,29,109
"2011","Tower Hamlets 030D","E01004218",1424,308,48,260,344,166,101,58,105,76,101,69,32,165
"2011","Tower Hamlets 031A","E01004274",1497,200,40,160,291,130,77,73,144,87,269,225,44,226
"2011","Tower Hamlets 031B","E01004275",1474,296,39,257,371,144,94,78,122,103,105,74,31,161
"2011","Tower Hamlets 031C","E01004276",1841,640,101,539,642,154,97,38,58,21,40,24,16,151
"2011","Tower Hamlets 031D","E01004281",1524,428,44,384,457,152,70,53,69,39,91,63,28,165
"2011","Tower Hamlets 031F","E01032775",981,328,51,277,304,83,66,23,33,22,43,27,16,79
"2011","Tower Hamlets 031G","E01032783",1187,268,36,232,330,126,65,42,90,46,103,75,28,117
"2011","Tower Hamlets 032A","E01004280",1435,287,50,237,325,150,71,63,134,79,188,142,46,138
"2011","Tower Hamlets 032B","E01032770",1004,314,53,261,252,82,43,43,58,37,98,72,26,77
"2011","Tower Hamlets 032C","E01032772",943,186,33,153,207,71,52,39,66,41,113,94,19,168
"2011","Tower Hamlets 032D","E01032773",1291,367,61,306,368,111,47,37,68,38,111,89,22,144
"2011","Tower Hamlets 032E","E01032774",999,212,36,176,200,115,50,64,99,45,116,87,29,98
"2011","Tower Hamlets 033A","E01004277",1474,569,143,426,502,121,63,16,37,17,54,45,9,95
"2011","Tower Hamlets 033B","E01032771",914,284,59,225,231,74,24,33,47,23,88,72,16,110
"2011","Tower Hamlets 033C","E01032781",1362,433,99,334,427,142,61,37,54,35,69,50,19,104
"2011","Tower Hamlets 033D","E01032782",1265,271,48,223,318,107,52,35,87,52,132,106,26,211
"2011","Wandsworth 001A","E01004560",1661,394,88,306,555,144,158,58,107,73,73,44,29,99
"2011","Wandsworth 001B","E01004566",1299,394,82,312,450,117,113,28,52,46,35,21,14,64
"2011","Wandsworth 001C","E01004582",1741,415,103,312,517,150,159,58,105,88,77,54,23,172
"2011","Wandsworth 001D","E01004583",1393,319,69,250,424,127,137,60,95,64,63,46,17,104
"2011","Wandsworth 002B","E01004562",1395,148,30,118,276,146,115,81,172,173,124,98,26,160
"2011","Wandsworth 002C","E01004563",1551,168,42,126,322,154,124,77,205,180,136,99,37,185
"2011","Wandsworth 002D","E01004564",1546,333,61,272,487,173,95,63,109,105,66,40,26,115
"2011","Wandsworth 002E","E01004567",1745,170,37,133,350,171,103,100,241,227,170,113,57,213
"2011","Wandsworth 002F","E01033098",926,230,53,177,295,64,60,14,33,11,31,25,6,188
"2011","Wandsworth 002G","E01033100",1050,101,16,85,281,112,86,79,130,109,70,46,24,82
"2011","Wandsworth 002H","E01033132",904,172,32,140,271,75,50,41,54,48,50,26,24,143
"2011","Wandsworth 003A","E01004539",1470,99,18,81,258,144,114,119,200,193,170,119,51,173
"2011","Wandsworth 003B","E01004540",1657,259,53,206,502,190,135,81,147,121,105,70,35,117
"2011","Wandsworth 003C","E01004577",1559,329,60,269,494,154,141,51,109,97,51,40,11,133
"2011","Wandsworth 003D","E01004584",1237,57,6,51,233,137,64,85,176,139,155,107,48,191
"2011","Wandsworth 004B","E01004579",1279,288,57,231,399,119,107,53,103,75,72,41,31,63
"2011","Wandsworth 004C","E01004580",1701,285,61,224,539,172,117,93,131,109,81,50,31,174
"2011","Wandsworth 004D","E01004581",1551,296,49,247,490,154,113,74,103,94,78,57,21,149
"2011","Wandsworth 004E","E01033099",863,150,29,121,239,87,62,42,86,63,48,31,17,86
"2011","Wandsworth 004F","E01033101",1106,356,73,283,416,81,107,13,28,19,24,15,9,62
"2011","Wandsworth 004G","E01033133",1043,295,48,247,369,93,74,43,39,32,32,19,13,66
"2011","Wandsworth 005A","E01004565",1431,327,58,269,516,154,78,35,107,67,59,37,22,88
"2011","Wandsworth 005B","E01004590",1379,196,42,154,350,167,137,90,125,113,95,69,26,106
"2011","Wandsworth 005C","E01004591",1503,318,43,275,468,202,88,67,115,71,79,45,34,95
"2011","Wandsworth 005D","E01004592",1308,224,45,179,378,150,113,73,126,100,70,50,20,74
"2011","Wandsworth 006A","E01004604",1200,372,82,290,418,119,124,16,30,24,28,17,11,69
"2011","Wandsworth 006B","E01004605",1339,316,67,249,446,140,124,41,92,53,51,39,12,76
"2011","Wandsworth 006C","E01004606",1398,435,72,363,537,129,114,26,50,30,20,12,8,57
"2011","Wandsworth 006D","E01004607",1330,379,79,300,487,122,114,37,53,34,28,15,13,76
"2011","Wandsworth 006E","E01004608",1391,391,78,313,489,143,91,39,85,50,50,28,22,53
"2011","Wandsworth 007A","E01004535",1230,60,8,52,209,145,86,81,165,140,187,128,59,157
"2011","Wandsworth 007B","E01004537",1441,111,15,96,317,181,90,81,192,150,153,114,39,166
"2011","Wandsworth 007C","E01004538",1546,178,23,155,385,176,106,95,194,144,122,78,44,146
"2011","Wandsworth 007D","E01004541",1267,124,21,103,233,160,91,62,184,140,136,105,31,137
"2011","Wandsworth 008A","E01004534",1578,380,62,318,618,151,145,53,76,69,37,24,13,49
"2011","Wandsworth 008B","E01004536",1688,277,30,247,514,174,109,91,145,95,124,82,42,159
"2011","Wandsworth 008C","E01004552",1799,623,107,516,667,152,103,36,75,42,35,17,18,66
"2011","Wandsworth 008D","E01004585",1595,423,63,360,588,157,93,44,84,67,47,25,22,92
"2011","Wandsworth 008E","E01004588",1657,570,96,474,587,156,84,37,68,41,41,30,11,73
"2011","Wandsworth 009A","E01004554",1240,454,89,365,457,99,77,18,46,31,18,9,9,40
"2011","Wandsworth 009B","E01004556",1148,390,94,296,436,78,100,19,43,22,22,12,10,38
"2011","Wandsworth 009C","E01004586",1597,552,91,461,561,148,92,34,68,36,34,18,16,72
"2011","Wandsworth 009D","E01004587",1439,448,81,367,523,142,108,35,56,41,39,26,13,47
"2011","Wandsworth 009E","E01004589",1403,435,79,356,541,141,99,26,40,27,20,10,10,74
"2011","Wandsworth 010A","E01004509",1974,521,97,424,674,238,120,80,92,52,55,35,20,142
"2011","Wandsworth 010B","E01004511",1443,442,67,375,523,144,104,43,55,51,12,6,6,69
"2011","Wandsworth 010C","E01004602",1376,401,70,331,491,125,119,50,65,39,28,16,12,58
"2011","Wandsworth 010E","E01004609",1854,553,104,449,704,186,110,54,67,51,34,24,10,95
"2011","Wandsworth 010F","E01033093",1307,447,115,332,531,80,110,18,31,19,29,22,7,42
"2011","Wandsworth 010G","E01033135",874,303,69,234,347,74,49,15,23,11,13,7,6,39
"2011","Wandsworth 011A","E01004506",1605,541,102,439,546,151,79,44,80,39,46,32,14,79
"2011","Wandsworth 011B","E01004638",1046,314,83,231,328,92,112,21,32,29,46,35,11,72
"2011","Wandsworth 011C","E01004639",1384,282,53,229,450,163,116,49,104,58,55,49,6,107
"2011","Wandsworth 011D","E01004640",1415,400,69,331,519,145,105,38,33,38,42,29,13,95
"2011","Wandsworth 011E","E01004641",1443,270,56,214,373,152,151,64,130,97,61,43,18,145
"2011","Wandsworth 012A","E01004508",1754,513,102,411,596,178,129,48,85,54,51,31,20,100
"2011","Wandsworth 012B","E01004510",1686,388,75,313,669,223,117,36,87,59,50,32,18,57
"2011","Wandsworth 012C","E01004514",1435,426,81,345,533,111,107,36,70,57,42,29,13,53
"2011","Wandsworth 012D","E01004515",1438,341,50,291,487,156,71,51,101,68,70,43,27,93
"2011","Wandsworth 012E","E01004551",1552,341,55,286,528,167,84,54,118,107,63,43,20,90
"2011","Wandsworth 013A","E01004568",1343,37,3,34,107,80,78,45,93,84,113,83,30,706
"2011","Wandsworth 013B","E01004574",1246,55,6,49,151,109,111,73,199,118,167,114,53,263
"2011","Wandsworth 013C","E01004575",1355,113,25,88,191,119,135,95,142,125,109,88,21,326
"2011","Wandsworth 013D","E01004576",1144,83,25,58,198,106,162,61,155,104,84,61,23,191
"2011","Wandsworth 014A","E01004500",1360,353,56,297,486,160,67,50,82,46,46,29,17,70
"2011","Wandsworth 014B","E01004501",1267,288,56,232,381,163,82,39,97,74,70,56,14,73
"2011","Wandsworth 014C","E01004503",1348,336,84,252,442,146,83,46,83,52,69,47,22,91
"2011","Wandsworth 014D","E01004505",1329,358,71,287,483,159,103,40,52,34,41,31,10,59
"2011","Wandsworth 014E","E01004507",1564,473,99,374,534,161,100,42,85,52,38,31,7,79
"2011","Wandsworth 015A","E01004553",1373,431,72,359,485,122,107,39,69,35,44,24,20,41
"2011","Wandsworth 015B","E01004557",1156,345,76,269,403,111,102,24,48,41,42,30,12,40
"2011","Wandsworth 015C","E01004558",1251,380,94,286,476,88,114,32,40,33,38,29,9,50
"2011","Wandsworth 015D","E01004559",985,331,65,266,334,84,79,9,28,36,23,17,6,61
"2011","Wandsworth 015E","E01004619",1028,295,70,225,358,82,89,29,45,33,31,21,10,66
"2011","Wandsworth 016A","E01004572",1256,178,46,132,310,106,133,66,136,91,91,58,33,145
"2011","Wandsworth 016B","E01004642",1398,159,28,131,315,162,101,60,147,94,78,58,20,282
"2011","Wandsworth 016C","E01004643",1499,226,40,186,376,152,133,75,154,112,129,103,26,142
"2011","Wandsworth 016D","E01004644",1449,231,53,178,391,164,127,69,119,95,80,60,20,173
"2011","Wandsworth 016E","E01004645",1423,135,28,107,319,167,125,80,165,126,160,120,40,146
"2011","Wandsworth 017A","E01004477",1194,392,98,294,456,90,96,14,29,38,20,13,7,59
"2011","Wandsworth 017B","E01004478",1077,357,71,286,388,82,76,17,39,25,33,27,6,60
"2011","Wandsworth 017C","E01004479",1167,344,77,267,409,105,98,22,57,25,35,16,19,72
"2011","Wandsworth 017D","E01004550",1014,272,49,223,326,80,86,24,58,46,53,41,12,69
"2011","Wandsworth 017E","E01004555",1178,395,98,297,420,80,109,23,34,36,28,20,8,53
"2011","Wandsworth 018A","E01004494",1377,266,57,209,450,155,102,55,106,71,83,64,19,89
"2011","Wandsworth 018B","E01004513",1466,277,46,231,385,170,119,73,133,106,93,70,23,110
"2011","Wandsworth 018C","E01004600",1579,212,30,182,387,172,103,64,207,105,138,108,30,191
"2011","Wandsworth 018D","E01004601",1754,341,54,287,556,177,135,75,151,71,112,98,14,136
"2011","Wandsworth 019A","E01004493",1469,313,68,245,502,167,121,52,84,71,76,53,23,83
"2011","Wandsworth 019B","E01004512",1140,272,57,215,414,99,107,37,51,52,41,29,12,67
"2011","Wandsworth 019C","E01004620",1277,295,64,231,426,138,126,39,83,52,49,31,18,69
"2011","Wandsworth 019D","E01004621",1319,301,52,249,435,138,125,36,81,60,60,49,11,83
"2011","Wandsworth 019E","E01004623",1316,348,72,276,451,138,111,33,70,53,46,34,12,66
"2011","Wandsworth 019F","E01004627",1222,305,71,234,401,130,127,34,58,52,39,25,14,76
"2011","Wandsworth 020A","E01004499",1321,377,64,313,447,136,94,45,62,35,47,31,16,78
"2011","Wandsworth 020B","E01004502",1279,366,79,287,437,120,95,46,59,41,27,18,9,88
"2011","Wandsworth 020C","E01004504",1134,278,86,192,368,97,120,22,54,40,69,63,6,86
"2011","Wandsworth 020D","E01004594",1250,275,58,217,429,139,125,28,71,32,47,39,8,104
"2011","Wandsworth 020E","E01004596",1224,346,81,265,423,114,120,27,55,42,22,16,6,75
"2011","Wandsworth 020F","E01004629",1192,260,56,204,363,120,122,35,68,51,55,44,11,118
"2011","Wandsworth 021A","E01004472",1425,420,81,339,512,131,96,36,61,53,49,29,20,67
"2011","Wandsworth 021B","E01004474",1656,435,79,356,590,189,86,56,89,64,69,42,27,78
"2011","Wandsworth 021C","E01004476",1424,362,69,293,532,158,77,38,75,45,62,35,27,75
"2011","Wandsworth 021D","E01004542",1234,388,88,300,424,128,91,26,53,35,33,16,17,56
"2011","Wandsworth 021E","E01004544",1165,346,74,272,403,90,80,27,70,40,39,25,14,70
"2011","Wandsworth 022A","E01004628",1880,350,59,291,540,213,139,89,162,95,151,132,19,141
"2011","Wandsworth 022B","E01004630",1263,81,20,61,240,150,102,82,174,142,135,105,30,157
"2011","Wandsworth 022C","E01004631",1133,157,20,137,251,142,99,84,131,77,90,70,20,102
"2011","Wandsworth 022D","E01004633",1195,90,19,71,256,131,104,78,146,118,122,99,23,150
"2011","Wandsworth 023A","E01004569",1942,137,22,115,306,126,158,58,157,103,154,136,18,743
"2011","Wandsworth 023B","E01004570",1423,48,8,40,160,107,109,105,208,173,127,95,32,386
"2011","Wandsworth 023C","E01004571",1284,77,20,57,192,95,114,84,172,136,129,96,33,285
"2011","Wandsworth 023D","E01004573",1248,108,28,80,256,115,193,73,149,99,92,68,24,163
"2011","Wandsworth 024A","E01004495",1184,155,27,128,261,107,89,43,124,106,139,116,23,160
"2011","Wandsworth 024B","E01004496",1743,466,85,381,625,166,137,51,98,67,63,48,15,70
"2011","Wandsworth 024C","E01004497",1062,216,43,173,293,133,99,41,99,60,50,36,14,71
"2011","Wandsworth 024D","E01004622",2041,212,40,172,429,138,327,151,177,222,298,261,37,87
"2011","Wandsworth 024E","E01004624",1255,282,64,218,367,162,98,44,81,61,59,46,13,101
"2011","Wandsworth 025A","E01004593",1512,318,71,247,535,163,146,72,91,69,54,39,15,64
"2011","Wandsworth 025B","E01004595",1442,352,61,291,520,163,128,39,69,52,42,28,14,77
"2011","Wandsworth 025C","E01004597",1364,358,69,289,469,145,85,52,93,51,47,27,20,64
"2011","Wandsworth 025D","E01004598",1512,419,75,344,581,161,90,55,63,51,37,23,14,55
"2011","Wandsworth 025E","E01004599",1086,308,67,241,392,113,96,30,40,32,24,14,10,51
"2011","Wandsworth 026A","E01004473",1422,417,73,344,492,143,74,40,83,59,44,35,9,70
"2011","Wandsworth 026B","E01004475",1178,344,54,290,383,123,80,33,71,39,56,41,15,49
"2011","Wandsworth 026C","E01004480",1418,464,84,380,539,118,72,42,44,34,35,30,5,70
"2011","Wandsworth 026D","E01004483",1746,449,64,385,601,209,110,68,102,59,65,53,12,83
"2011","Wandsworth 026E","E01004484",1284,313,43,270,445,141,87,36,70,53,62,38,24,77
"2011","Wandsworth 026F","E01004486",1261,342,65,277,442,133,95,39,60,45,44,31,13,61
"2011","Wandsworth 027A","E01004543",1364,406,78,328,518,107,100,33,57,45,22,16,6,76
"2011","Wandsworth 027B","E01004545",1414,414,61,353,566,145,61,37,61,39,25,18,7,66
"2011","Wandsworth 027C","E01004546",1241,346,62,284,481,108,103,31,43,33,49,34,15,47
"2011","Wandsworth 027D","E01004549",1311,283,61,222,414,154,103,41,99,75,65,53,12,77
"2011","Wandsworth 027E","E01004625",962,236,48,188,365,81,105,20,49,13,20,13,7,73
"2011","Wandsworth 027F","E01004626",1441,353,73,280,495,148,118,42,86,58,57,49,8,84
"2011","Wandsworth 028A","E01004632",1142,230,36,194,344,148,126,32,85,51,43,28,15,83
"2011","Wandsworth 028B","E01004634",1207,265,51,214,361,125,125,47,84,63,72,54,18,65
"2011","Wandsworth 028C","E01004635",1294,254,38,216,347,151,132,48,96,71,97,80,17,98
"2011","Wandsworth 028D","E01004636",1134,213,34,179,360,126,84,44,88,71,67,48,19,81
"2011","Wandsworth 028E","E01004637",1133,189,27,162,297,118,100,47,121,74,84,57,27,103
"2011","Wandsworth 029A","E01004481",1460,317,43,274,492,178,93,57,89,72,61,47,14,101
"2011","Wandsworth 029B","E01004488",1197,275,35,240,383,106,92,29,92,61,68,51,17,91
"2011","Wandsworth 029C","E01004547",1072,239,54,185,303,99,80,39,89,62,86,61,25,75
"2011","Wandsworth 029D","E01004548",1760,352,68,284,622,194,121,60,127,76,85,62,23,123
"2011","Wandsworth 030A","E01004482",1250,244,45,199,378,147,106,44,100,55,56,43,13,120
"2011","Wandsworth 030B","E01004485",1331,322,60,262,420,149,128,44,72,49,59,45,14,88
"2011","Wandsworth 030C","E01004487",1281,308,55,253,412,142,92,33,69,46,107,72,35,72
"2011","Wandsworth 030D","E01004489",1116,255,52,203,360,130,82,38,72,61,43,28,15,75
"2011","Wandsworth 031A","E01004490",1190,322,66,256,426,120,83,28,70,42,31,23,8,68
"2011","Wandsworth 031B","E01004491",1770,197,25,172,551,174,84,54,97,78,94,76,18,441
"2011","Wandsworth 031C","E01004492",1423,293,59,234,416,170,120,62,97,72,74,53,21,119
"2011","Wandsworth 031D","E01004498",1433,397,78,319,490,158,108,54,61,47,37,22,15,81
"2011","Wandsworth 032A","E01004532",1166,203,23,180,372,119,84,44,112,78,74,47,27,80
"2011","Wandsworth 032B","E01004611",1228,204,32,172,357,140,97,53,108,56,94,79,15,119
"2011","Wandsworth 032C","E01004612",1348,160,25,135,314,152,127,49,137,70,149,129,20,190
"2011","Wandsworth 032D","E01004618",1214,257,56,201,345,136,108,40,73,51,65,52,13,139
"2011","Wandsworth 033A","E01004531",1268,148,22,126,319,157,111,57,141,93,102,78,24,140
"2011","Wandsworth 033B","E01004533",1057,136,23,113,248,114,102,44,115,81,100,69,31,117
"2011","Wandsworth 033C","E01004610",1544,158,25,133,340,158,131,69,173,100,105,86,19,310
"2011","Wandsworth 033D","E01004613",1215,112,21,91,233,121,98,67,149,96,126,98,28,213
"2011","Wandsworth 034A","E01004614",1695,189,44,145,392,156,142,76,145,122,110,82,28,363
"2011","Wandsworth 034B","E01004615",1284,106,32,74,257,131,107,68,155,112,143,108,35,205
"2011","Wandsworth 034C","E01004616",1793,194,27,167,443,176,148,68,160,121,138,97,41,345
"2011","Wandsworth 034D","E01004617",1369,135,19,116,279,137,84,54,142,101,110,81,29,327
"2011","Wandsworth 035A","E01004525",1497,162,22,140,351,152,143,73,146,117,120,93,27,233
"2011","Wandsworth 035B","E01004526",1298,201,39,162,321,107,106,92,127,102,112,82,30,130
"2011","Wandsworth 035C","E01004527",1260,145,29,116,332,117,143,51,120,87,100,76,24,165
"2011","Wandsworth 035D","E01004528",1147,124,18,106,280,127,125,42,131,78,118,98,20,122
"2011","Wandsworth 035E","E01004529",1666,234,55,179,481,203,168,85,172,95,95,77,18,133
"2011","Wandsworth 035F","E01004530",1511,205,35,170,438,151,148,61,125,93,106,71,35,184
"2011","Wandsworth 036A","E01004516",1324,156,18,138,359,135,117,45,86,59,63,45,18,304
"2011","Wandsworth 036B","E01004518",1284,203,49,154,372,138,150,45,106,73,93,59,34,104
"2011","Wandsworth 036C","E01004519",1271,172,40,132,312,122,155,57,131,100,88,60,28,134
"2011","Wandsworth 036D","E01004520",965,72,16,56,253,117,85,38,132,79,79,59,20,110
"2011","Wandsworth 036E","E01004523",1172,156,25,131,355,134,137,44,103,66,70,50,20,107
"2011","Wandsworth 037A","E01004517",1508,164,23,141,402,145,203,88,160,96,117,83,34,133
"2011","Wandsworth 037B","E01004521",1452,175,32,143,402,149,143,68,148,90,133,105,28,144
"2011","Wandsworth 037C","E01004522",1199,129,24,105,301,134,159,61,114,80,105,85,20,116
"2011","Wandsworth 037D","E01004524",1197,87,17,70,232,132,134,60,152,110,165,121,44,125
"2011","Westminster 001A","E01004647",1081,245,71,174,305,83,93,39,69,53,99,83,16,95
"2011","Westminster 001B","E01004649",1248,293,81,212,346,161,89,22,70,35,103,92,11,129
"2011","Westminster 001C","E01004724",1365,308,78,230,393,118,119,33,73,65,119,103,16,137
"2011","Westminster 001D","E01004730",1227,308,81,227,340,99,125,30,58,31,117,96,21,119
"2011","Westminster 002A","E01004646",1116,260,63,197,320,98,98,27,53,39,99,88,11,122
"2011","Westminster 002B","E01004648",1840,468,127,341,569,170,152,35,93,63,138,113,25,152
"2011","Westminster 002C","E01004650",1536,449,120,329,487,111,136,23,56,43,105,87,18,126
"2011","Westminster 002D","E01004710",1133,122,25,97,196,120,96,50,140,74,193,164,29,142
"2011","Westminster 002E","E01004711",1290,191,28,163,285,130,89,56,141,91,171,148,23,136
"2011","Westminster 003A","E01004651",1610,461,125,336,491,147,98,25,67,31,105,88,17,185
"2011","Westminster 003B","E01004725",1170,162,32,130,230,100,103,36,93,58,174,157,17,214
"2011","Westminster 003C","E01004726",1370,354,98,256,386,104,123,21,75,41,123,109,14,143
"2011","Westminster 003D","E01004728",1194,215,55,160,323,113,92,44,81,58,118,96,22,150
"2011","Westminster 003E","E01004729",1198,211,50,161,290,104,114,44,95,80,130,110,20,130
"2011","Westminster 004A","E01004718",1505,156,33,123,361,130,97,94,163,132,204,150,54,168
"2011","Westminster 004B","E01004719",1391,145,27,118,320,151,97,77,178,135,177,148,29,111
"2011","Westminster 004C","E01004720",1427,128,32,96,297,140,108,90,166,151,211,179,32,136
"2011","Westminster 004D","E01004721",1497,94,19,75,262,140,104,89,196,182,270,217,53,160
"2011","Westminster 004E","E01004722",1769,76,8,68,222,129,102,124,232,213,391,328,63,280
"2011","Westminster 005A","E01004674",1519,161,27,134,275,156,92,79,148,150,285,228,57,173
"2011","Westminster 005B","E01004675",1760,229,48,181,414,130,129,85,181,138,276,218,58,178
"2011","Westminster 005C","E01004677",1512,224,45,179,415,160,105,76,145,111,151,119,32,125
"2011","Westminster 005D","E01004678",1542,204,30,174,392,142,100,83,156,110,196,142,54,159
"2011","Westminster 005E","E01004679",1605,187,35,152,344,134,140,64,190,145,228,181,47,173
"2011","Westminster 005F","E01004723",1757,220,29,191,383,166,106,110,210,137,238,178,60,187
"2011","Westminster 006A","E01004676",1349,259,53,206,373,99,101,58,122,85,130,94,36,122
"2011","Westminster 006B","E01004706",1318,479,88,391,448,84,97,29,41,24,51,35,16,65
"2011","Westminster 006C","E01004707",1534,507,89,418,507,84,128,19,48,32,84,66,18,125
"2011","Westminster 006D","E01004708",1341,276,41,235,382,106,123,56,108,66,117,80,37,107
"2011","Westminster 006E","E01004756",1485,323,55,268,391,105,104,61,125,83,150,113,37,143
"2011","Westminster 007A","E01004701",1296,382,104,278,423,97,122,22,53,39,83,66,17,75
"2011","Westminster 007B","E01004703",1750,469,126,343,594,91,170,36,72,41,135,113,22,142
"2011","Westminster 007D","E01004705",1165,360,81,279,417,79,110,18,19,15,63,43,20,84
"2011","Westminster 007E","E01004709",1316,263,45,218,371,103,114,41,98,68,142,123,19,116
"2011","Westminster 007F","E01033600",1041,309,76,233,353,76,93,24,37,27,60,42,18,62
"2011","Westminster 007G","E01033608",1236,332,79,253,383,100,102,41,73,56,83,61,22,66
"2011","Westminster 008A","E01004659",1560,424,63,361,438,95,110,32,56,35,79,57,22,291
"2011","Westminster 008B","E01004660",1448,378,110,268,416,104,105,16,52,30,100,90,10,247
"2011","Westminster 008C","E01004712",1468,398,101,297,409,94,100,32,40,39,61,49,12,295
"2011","Westminster 008D","E01004727",1684,448,116,332,426,103,105,33,56,27,110,100,10,376
"2011","Westminster 009A","E01004670",1779,60,10,50,188,122,100,103,242,159,529,457,72,276
"2011","Westminster 009E","E01004702",1848,160,29,131,303,164,98,91,216,140,385,335,50,291
"2011","Westminster 009F","E01033598",887,68,14,54,133,66,36,36,113,95,222,204,18,118
"2011","Westminster 009G","E01033601",1095,60,12,48,208,97,73,77,140,115,189,161,28,136
"2011","Westminster 009H","E01033602",1116,70,8,62,149,75,54,54,160,113,267,234,33,174
"2011","Westminster 009I","E01033603",1108,181,27,154,222,91,68,45,108,69,165,127,38,159
"2011","Westminster 009J","E01033604",1010,79,16,63,155,84,72,87,110,100,161,127,34,162
"2011","Westminster 009K","E01033605",1452,105,17,88,231,115,102,89,165,164,312,268,44,169
"2011","Westminster 010A","E01004754",1067,83,13,70,155,76,66,66,154,116,212,186,26,139
"2011","Westminster 010B","E01004755",1733,241,49,192,398,150,103,86,171,105,305,270,35,174
"2011","Westminster 010C","E01004757",1140,114,15,99,177,95,67,46,128,105,235,208,27,173
"2011","Westminster 010F","E01032512",1746,141,28,113,285,135,109,104,212,159,397,336,61,204
"2011","Westminster 010G","E01032513",927,99,16,83,174,85,73,48,105,97,155,127,28,91
"2011","Westminster 011A","E01004713",1554,517,160,357,519,112,149,9,59,22,47,33,14,120
"2011","Westminster 011B","E01004714",1864,544,156,388,538,123,162,32,70,52,94,84,10,249
"2011","Westminster 011C","E01004716",1172,347,94,253,341,63,116,18,50,19,55,47,8,163
"2011","Westminster 011D","E01004717",1326,432,142,290,433,78,103,25,40,12,33,26,7,170
"2011","Westminster 011E","E01004762",1729,352,128,224,436,131,205,56,148,82,137,108,29,182
"2011","Westminster 012A","E01004657",1255,339,105,234,412,65,131,24,59,40,57,49,8,128
"2011","Westminster 012B","E01004658",1328,245,63,182,264,65,82,40,58,53,152,131,21,369
"2011","Westminster 012C","E01004661",1576,325,69,256,402,102,103,40,96,65,161,133,28,282
"2011","Westminster 012D","E01004662",1645,460,105,355,470,111,114,35,67,51,73,52,21,264
"2011","Westminster 012E","E01004663",1321,340,93,247,335,104,128,41,81,46,108,91,17,138
"2011","Westminster 013A","E01004715",1543,237,52,185,365,106,73,46,79,43,96,81,15,498
"2011","Westminster 013B","E01004763",2023,427,65,362,696,113,153,72,84,58,103,75,28,317
"2011","Westminster 013D","E01004765",1762,411,87,324,537,110,161,55,76,74,123,100,23,215
"2011","Westminster 013E","E01033595",1054,246,53,193,317,71,117,34,48,42,84,61,23,95
"2011","Westminster 013F","E01033596",1005,178,37,141,325,73,123,44,66,51,67,52,15,78
"2011","Westminster 014A","E01004653",1461,392,93,299,535,113,130,28,56,46,62,47,15,99
"2011","Westminster 014B","E01004654",1938,523,118,405,661,138,181,42,80,63,76,56,20,174
"2011","Westminster 014D","E01004656",1773,411,74,337,517,149,158,45,118,103,136,110,26,136
"2011","Westminster 014E","E01004760",1270,237,42,195,330,113,110,48,112,84,148,117,31,88
"2011","Westminster 014F","E01033606",949,251,59,192,309,82,68,31,41,38,64,49,15,65
"2011","Westminster 014G","E01033607",992,236,53,183,314,96,83,42,69,54,46,34,12,52
"2011","Westminster 015A","E01004680",1186,295,84,211,386,82,134,19,44,35,78,67,11,113
"2011","Westminster 015B","E01004683",1341,395,114,281,401,76,134,19,63,26,95,79,16,132
"2011","Westminster 015C","E01004684",1274,188,37,151,214,72,101,42,56,47,199,171,28,355
"2011","Westminster 015E","E01004686",1237,245,49,196,211,85,91,33,69,88,258,239,19,157
"2011","Westminster 015F","E01033593",910,165,37,128,212,47,49,20,51,34,147,125,22,185
"2011","Westminster 015G","E01033594",1176,201,43,158,276,94,102,37,65,78,126,94,32,197
"2011","Westminster 016A","E01004681",1862,569,114,455,549,116,135,53,90,31,123,100,23,196
"2011","Westminster 016B","E01004682",1386,352,60,292,345,72,89,30,55,41,81,60,21,321
"2011","Westminster 016C","E01004694",1565,406,106,300,482,102,104,34,87,54,73,55,18,223
"2011","Westminster 016D","E01004697",1280,355,61,294,367,89,113,31,69,34,84,66,18,138
"2011","Westminster 016E","E01004700",1489,391,84,307,476,104,111,43,53,63,72,51,21,176
"2011","Westminster 017A","E01004652",1585,406,62,344,405,118,93,53,72,62,120,85,35,256
"2011","Westminster 017B","E01004693",1140,330,100,230,387,72,106,20,50,21,52,41,11,102
"2011","Westminster 017C","E01004695",1132,280,43,237,327,58,90,24,44,21,56,49,7,232
"2011","Westminster 017D","E01004696",1171,173,25,148,240,104,88,50,118,84,172,146,26,142
"2011","Westminster 017E","E01004698",1362,335,60,275,333,98,119,45,89,64,60,43,17,219
"2011","Westminster 017F","E01004699",1997,556,114,442,581,123,134,53,94,81,125,91,34,250
"2011","Westminster 018A","E01004734",1735,285,67,218,476,108,154,102,98,104,127,77,50,281
"2011","Westminster 018B","E01004735",1640,320,70,250,404,133,117,51,106,78,86,63,23,345
"2011","Westminster 018C","E01004736",1589,357,121,236,433,229,113,54,50,40,47,30,17,266
"2011","Westminster 018D","E01004761",1678,427,138,289,522,79,192,45,96,49,95,82,13,173
"2011","Westminster 019A","E01004687",1316,333,140,193,394,83,148,19,98,65,77,73,4,99
"2011","Westminster 019B","E01004688",1778,198,63,135,210,39,85,18,42,17,56,47,9,1113
"2011","Westminster 019C","E01004689",974,236,104,132,242,156,89,21,16,23,72,65,7,119
"2011","Westminster 019D","E01004690",1089,271,125,146,314,73,103,30,75,48,71,64,7,104
"2011","Westminster 019E","E01004691",1256,291,116,175,334,74,139,37,77,42,112,101,11,150
"2011","Westminster 019F","E01004692",1266,267,101,166,301,70,97,29,51,38,119,115,4,294
"2011","Westminster 020A","E01004731",1575,486,151,335,480,126,88,67,77,54,79,62,17,118
"2011","Westminster 020B","E01004732",1153,129,30,99,225,104,66,76,153,121,173,124,49,106
"2011","Westminster 020C","E01004733",1664,432,149,283,515,134,79,29,63,58,95,66,29,259
"2011","Westminster 020D","E01004744",1049,179,52,127,348,128,46,39,97,70,59,37,22,83
"2011","Westminster 020E","E01004748",1183,329,107,222,342,82,83,26,66,21,49,37,12,185
"2011","Westminster 021A","E01004740",1140,190,21,169,265,127,83,57,137,79,115,95,20,87
"2011","Westminster 021B","E01004743",1106,216,49,167,287,98,65,60,86,76,102,70,32,116
"2011","Westminster 021C","E01004745",1729,469,145,324,526,170,105,46,117,57,106,75,31,133
"2011","Westminster 021D","E01004746",1076,163,39,124,230,128,84,57,124,104,103,81,22,83
"2011","Westminster 021E","E01004747",1819,464,110,354,576,148,87,63,99,60,153,125,28,169
"2011","Westminster 022A","E01004742",1233,365,86,279,446,106,70,32,51,34,48,37,11,81
"2011","Westminster 022B","E01004749",2043,514,123,391,603,158,165,42,95,66,107,81,26,293
"2011","Westminster 022C","E01004751",1475,483,130,353,495,104,107,32,51,48,63,42,21,92
"2011","Westminster 022D","E01004752",1386,320,66,254,363,143,91,55,102,93,101,69,32,118
"2011","Westminster 022E","E01004753",1605,419,92,327,468,189,110,48,129,74,69,42,27,99
"2011","Westminster 023B","E01004666",841,119,27,92,223,78,107,46,80,50,72,53,19,66
"2011","Westminster 023C","E01004667",1082,166,44,122,276,104,116,49,124,85,96,64,32,66
"2011","Westminster 023D","E01004668",1023,203,39,164,244,93,77,48,115,74,85,65,20,84
"2011","Westminster 023E","E01004750",1425,307,82,225,351,137,101,76,132,100,102,83,19,119
"2011","Westminster 023F","E01033597",833,156,46,110,240,77,70,34,69,35,60,43,17,92
"2011","Westminster 023G","E01033599",1062,124,18,106,206,97,60,48,121,118,144,120,24,144
"2011","Westminster 024A","E01004665",998,75,15,60,142,86,92,53,137,97,180,151,29,136
"2011","Westminster 024B","E01004669",1209,140,30,110,210,136,82,74,164,113,143,113,30,147
"2011","Westminster 024C","E01004737",980,216,71,145,239,104,66,58,97,63,70,51,19,67
"2011","Westminster 024D","E01004738",1117,320,77,243,377,87,90,22,50,44,46,35,11,81
"2011","Westminster 024E","E01004739",1166,359,88,271,427,102,84,20,33,16,17,9,8,108
"2011","Westminster 024F","E01004741",1018,209,44,165,279,92,72,42,96,65,64,52,12,99
"2011","Barking and Dagenham 001A","E01000027",1088,54,16,38,150,146,122,61,211,126,115,84,31,103
"2011","Barking and Dagenham 001B","E01000028",995,37,6,31,135,128,82,59,183,128,111,74,37,132
"2011","Barking and Dagenham 001C","E01000029",1068,72,13,59,215,171,125,70,164,89,76,63,13,86
"2011","Barking and Dagenham 001D","E01000030",1209,60,14,46,172,117,121,63,248,168,147,85,62,113
"2011","Barking and Dagenham 002A","E01000031",1157,104,20,84,245,175,108,78,159,91,93,60,33,104
"2011","Barking and Dagenham 002B","E01000032",1157,88,15,73,186,210,128,60,172,119,95,64,31,99
"2011","Barking and Dagenham 002C","E01000110",1026,88,19,69,227,180,118,56,119,71,70,52,18,97
"2011","Barking and Dagenham 002D","E01000111",1256,66,17,49,197,197,133,94,190,115,129,93,36,135
"2011","Barking and Dagenham 002E","E01000112",1357,96,19,77,265,218,137,89,176,128,121,82,39,127
"2011","Barking and Dagenham 002F","E01000113",1196,88,22,66,226,203,93,81,189,102,110,69,41,104
"2011","Barking and Dagenham 003A","E01000034",944,54,8,46,143,146,88,61,138,136,75,49,26,103
"2011","Barking and Dagenham 003B","E01000037",1329,75,13,62,263,243,134,119,152,127,105,46,59,111
"2011","Barking and Dagenham 003C","E01000038",1021,57,14,43,188,182,99,64,170,125,36,24,12,100
"2011","Barking and Dagenham 003D","E01000039",1144,88,28,60,240,200,105,94,149,103,82,60,22,83
"2011","Barking and Dagenham 004A","E01000063",1101,43,9,34,151,143,103,84,213,176,109,72,37,79
"2011","Barking and Dagenham 004B","E01000100",1114,44,8,36,158,160,98,105,188,137,109,63,46,115
"2011","Barking and Dagenham 004C","E01000101",1078,41,8,33,167,134,80,92,214,160,90,63,27,100
"2011","Barking and Dagenham 004D","E01000109",1190,56,13,43,210,171,116,79,191,134,106,72,34,127
"2011","Barking and Dagenham 004E","E01000114",1450,81,26,55,207,232,162,109,227,169,119,93,26,144
"2011","Barking and Dagenham 006A","E01000033",919,31,5,26,113,107,92,71,156,146,109,70,39,94
"2011","Barking and Dagenham 006B","E01000060",1174,60,5,55,176,163,112,87,182,168,117,79,38,109
"2011","Barking and Dagenham 006C","E01000061",1154,41,5,36,155,103,57,63,209,174,192,128,64,160
"2011","Barking and Dagenham 006D","E01000062",1299,92,17,75,208,158,96,108,210,159,134,88,46,134
"2011","Barking and Dagenham 006E","E01000064",1252,67,15,52,187,171,128,82,188,160,126,84,42,143
"2011","Barking and Dagenham 007A","E01000065",1157,50,11,39,171,177,124,68,170,175,103,73,30,119
"2011","Barking and Dagenham 007B","E01000078",1144,40,6,34,154,159,93,84,182,158,150,112,38,124
"2011","Barking and Dagenham 007C","E01000080",1062,34,7,27,136,127,97,79,193,156,127,78,49,113
"2011","Barking and Dagenham 007D","E01000081",1173,38,12,26,159,149,99,98,204,191,121,90,31,114
"2011","Barking and Dagenham 007E","E01000082",1158,41,10,31,178,166,102,84,220,151,112,80,32,104
"2011","Barking and Dagenham 007F","E01000083",1155,42,13,29,161,165,114,80,199,150,147,112,35,97
"2011","Barking and Dagenham 007G","E01000102",1057,55,9,46,174,163,88,77,187,124,106,70,36,83
"2011","Barking and Dagenham 008A","E01000021",1141,52,14,38,145,127,114,75,167,143,137,90,47,181
"2011","Barking and Dagenham 008B","E01000022",899,36,10,26,138,117,91,78,144,97,95,64,31,103
"2011","Barking and Dagenham 008C","E01000023",825,60,7,53,159,93,90,49,136,83,82,59,23,73
"2011","Barking and Dagenham 008D","E01000024",912,32,6,26,134,109,90,63,181,100,103,84,19,100
"2011","Barking and Dagenham 008E","E01000025",1139,54,8,46,171,147,110,78,206,148,121,86,35,104
"2011","Barking and Dagenham 008F","E01000077",1031,40,9,31,143,127,99,72,189,132,122,84,38,107
"2011","Barking and Dagenham 009A","E01000015",1493,45,11,34,219,168,164,108,234,189,198,138,60,168
"2011","Barking and Dagenham 009B","E01000016",1120,43,11,32,170,145,95,89,195,163,107,76,31,113
"2011","Barking and Dagenham 009C","E01000017",1108,48,6,42,177,147,104,76,172,151,120,89,31,113
"2011","Barking and Dagenham 009D","E01000018",1085,61,14,47,148,155,92,80,200,141,101,68,33,107
"2011","Barking and Dagenham 009E","E01000079",1026,39,4,35,166,157,92,69,171,137,107,82,25,88
"2011","Barking and Dagenham 010A","E01000035",1119,53,14,39,192,161,127,76,148,127,98,66,32,137
"2011","Barking and Dagenham 010B","E01000036",980,46,12,34,174,147,131,73,145,86,62,50,12,116
"2011","Barking and Dagenham 010C","E01000107",1117,62,15,47,181,184,123,80,158,128,95,68,27,106
"2011","Barking and Dagenham 010D","E01000108",1156,58,10,48,177,196,99,97,179,163,78,52,26,109
"2011","Barking and Dagenham 011A","E01000066",1323,90,17,73,239,167,150,71,193,117,162,140,22,134
"2011","Barking and Dagenham 011B","E01000067",1394,105,18,87,241,201,155,60,180,102,151,120,31,199
"2011","Barking and Dagenham 011C","E01000069",1267,105,22,83,231,202,132,73,127,89,115,101,14,193
"2011","Barking and Dagenham 011D","E01000070",1410,106,22,84,266,184,185,77,154,111,137,102,35,190
"2011","Barking and Dagenham 011E","E01000071",1571,142,27,115,280,237,157,81,190,112,179,145,34,193
"2011","Barking and Dagenham 012A","E01000057",987,34,9,25,153,138,85,71,167,142,89,62,27,108
"2011","Barking and Dagenham 012B","E01000073",1074,43,10,33,154,142,95,77,198,154,114,77,37,97
"2011","Barking and Dagenham 012C","E01000074",1052,44,5,39,133,155,108,87,177,149,95,56,39,104
"2011","Barking and Dagenham 012D","E01000075",1204,51,12,39,189,184,116,90,192,150,107,77,30,125
"2011","Barking and Dagenham 012E","E01000076",1296,48,9,39,178,142,112,97,221,193,170,123,47,135
"2011","Barking and Dagenham 013A","E01000013",1134,42,6,36,165,138,115,84,211,151,114,79,35,114
"2011","Barking and Dagenham 013B","E01000014",1170,51,10,41,173,160,113,75,180,189,138,96,42,91
"2011","Barking and Dagenham 013C","E01000059",1050,51,7,44,148,144,74,82,196,149,104,72,32,102
"2011","Barking and Dagenham 013D","E01000084",920,35,11,24,117,115,80,74,172,137,99,69,30,91
"2011","Barking and Dagenham 013E","E01000085",1162,31,4,27,123,134,121,88,228,192,152,93,59,93
"2011","Barking and Dagenham 013F","E01000086",985,33,5,28,144,101,78,82,173,176,94,66,28,104
"2011","Barking and Dagenham 014A","E01000103",1179,45,7,38,161,141,107,76,174,167,139,97,42,169
"2011","Barking and Dagenham 014B","E01000104",1216,38,6,32,178,128,95,96,208,159,173,109,64,141
"2011","Barking and Dagenham 014C","E01000105",1441,58,9,49,187,184,121,97,281,211,184,119,65,118
"2011","Barking and Dagenham 014D","E01000106",1355,63,13,50,191,169,129,121,217,168,171,120,51,126
"2011","Barking and Dagenham 015A","E01000007",1034,71,4,67,159,94,85,57,148,83,141,120,21,196
"2011","Barking and Dagenham 015B","E01000008",1023,41,7,34,109,69,84,56,159,116,193,149,44,196
"2011","Barking and Dagenham 015C","E01000010",2159,267,26,241,405,189,155,110,210,156,280,227,53,387
"2011","Barking and Dagenham 015D","E01000012",1324,72,12,60,217,106,141,70,182,141,197,159,38,198
"2011","Barking and Dagenham 016A","E01000006",1251,109,10,99,218,117,164,63,153,97,163,130,33,167
"2011","Barking and Dagenham 016B","E01000009",1377,109,11,98,218,147,95,74,176,120,209,171,38,229
"2011","Barking and Dagenham 016C","E01000011",1239,76,10,66,171,100,109,57,154,126,200,166,34,246
"2011","Barking and Dagenham 016D","E01000044",1253,66,12,54,186,151,144,68,190,135,145,114,31,168
"2011","Barking and Dagenham 016E","E01000068",1171,93,10,83,197,139,120,65,153,84,145,131,14,175
"2011","Barking and Dagenham 017A","E01000041",1150,48,9,39,172,143,115,96,206,157,120,82,38,93
"2011","Barking and Dagenham 017B","E01000042",1189,57,6,51,170,118,93,85,196,140,191,155,36,139
"2011","Barking and Dagenham 017C","E01000045",1130,60,16,44,159,137,109,89,188,151,118,85,33,119
"2011","Barking and Dagenham 017D","E01000046",1188,47,6,41,164,175,122,103,210,135,108,67,41,124
"2011","Barking and Dagenham 017E","E01000072",1331,39,2,37,183,157,113,112,221,188,161,122,39,157
"2011","Barking and Dagenham 018A","E01000054",1150,44,8,36,177,163,97,95,191,154,113,77,36,116
"2011","Barking and Dagenham 018B","E01000055",1093,44,12,32,152,142,115,88,186,147,101,71,30,118
"2011","Barking and Dagenham 018C","E01000056",1048,42,7,35,147,127,77,58,179,177,119,79,40,122
"2011","Barking and Dagenham 018D","E01000058",1284,43,4,39,226,166,124,80,210,180,119,86,33,136
"2011","Barking and Dagenham 018E","E01000095",1061,81,19,62,176,142,98,61,158,141,89,50,39,115
"2011","Barking and Dagenham 019A","E01000040",1096,41,4,37,164,132,102,89,170,131,148,117,31,119
"2011","Barking and Dagenham 019B","E01000043",913,46,11,35,111,127,82,54,136,136,107,81,26,114
"2011","Barking and Dagenham 019C","E01000050",1112,71,11,60,153,110,97,64,153,122,161,139,22,181
"2011","Barking and Dagenham 019D","E01000052",1385,62,4,58,214,178,147,97,193,165,146,107,39,183
"2011","Barking and Dagenham 019E","E01000092",1773,102,24,78,308,199,169,104,263,182,237,173,64,209
"2011","Barking and Dagenham 020A","E01000053",1029,51,15,36,164,143,109,70,159,142,97,68,29,94
"2011","Barking and Dagenham 020B","E01000087",942,40,7,33,119,103,95,70,191,135,92,61,31,97
"2011","Barking and Dagenham 020C","E01000088",1216,56,9,47,216,138,127,73,182,136,148,114,34,140
"2011","Barking and Dagenham 020D","E01000089",1143,43,8,35,176,161,105,95,187,131,106,80,26,139
"2011","Barking and Dagenham 020E","E01000090",1068,39,9,30,179,142,109,76,156,116,106,75,31,145
"2011","Barking and Dagenham 021B","E01000048",1096,25,5,20,95,118,85,51,158,150,233,172,61,181
"2011","Barking and Dagenham 021C","E01000049",1112,43,7,36,114,94,79,61,178,146,223,152,71,174
"2011","Barking and Dagenham 021D","E01000051",1252,40,13,27,130,109,83,62,177,177,269,213,56,205
"2011","Barking and Dagenham 021E","E01033587",1140,95,13,82,196,123,115,67,142,142,155,111,44,105
"2011","Barking and Dagenham 021F","E01033588",1061,55,6,49,159,113,122,74,147,106,178,148,30,107
"2011","Barking and Dagenham 022A","E01000091",1069,45,14,31,125,118,87,80,180,149,148,112,36,137
"2011","Barking and Dagenham 022B","E01000093",1048,37,7,30,123,122,98,65,187,135,154,107,47,127
"2011","Barking and Dagenham 022C","E01000094",922,62,9,53,192,119,84,56,118,78,101,74,27,112
"2011","Barking and Dagenham 022D","E01000096",1188,33,6,27,124,118,80,75,214,146,215,162,53,183
"2011","Barking and Dagenham 023A","E01000019",970,35,6,29,138,155,104,59,147,119,119,77,42,94
"2011","Barking and Dagenham 023B","E01000020",1226,47,7,40,205,163,122,78,163,157,134,99,35,157
"2011","Barking and Dagenham 023C","E01000097",1089,53,14,39,191,158,105,69,169,151,104,79,25,89
"2011","Barking and Dagenham 023D","E01000098",1186,43,9,34,180,154,104,80,191,138,161,109,52,135
"2011","Barking and Dagenham 023E","E01000099",1191,61,17,44,192,161,109,96,177,189,108,68,40,98
"2011","Barking and Dagenham 023F","E01032580",961,48,10,38,116,106,113,61,169,88,116,94,22,144
"2011","Barnet 001A","E01000248",1183,231,45,186,361,140,145,47,80,32,46,22,24,101
"2011","Barnet 001B","E01000249",1099,214,35,179,321,155,125,37,64,36,37,24,13,110
"2011","Barnet 001C","E01000250",1634,246,46,200,449,235,193,80,137,73,79,59,20,142
"2011","Barnet 001D","E01000254",1082,218,46,172,360,146,124,37,69,40,33,21,12,55
"2011","Barnet 001E","E01000292",1049,155,26,129,295,146,130,44,78,56,58,41,17,87
"2011","Barnet 001F","E01000293",1283,242,33,209,381,151,143,55,86,41,44,26,18,140
"2011","Barnet 002A","E01000167",977,93,12,81,171,127,113,71,136,87,72,54,18,107
"2011","Barnet 002B","E01000246",1093,199,33,166,319,161,135,36,72,43,52,37,15,76
"2011","Barnet 002C","E01000247",1293,213,37,176,391,194,130,45,99,65,55,26,29,101
"2011","Barnet 002D","E01000251",1422,212,33,179,378,187,120,77,155,85,96,72,24,112
"2011","Barnet 002E","E01000252",1180,192,25,167,338,153,123,38,100,64,60,41,19,112
"2011","Barnet 003A","E01000166",1144,183,36,147,263,161,154,52,101,75,64,43,21,91
"2011","Barnet 003B","E01000168",1140,207,36,171,275,190,153,42,65,45,62,50,12,101
"2011","Barnet 003C","E01000169",1121,180,33,147,310,154,152,42,93,64,53,38,15,73
"2011","Barnet 003D","E01000172",1185,162,33,129,296,206,148,36,78,51,57,42,15,151
"2011","Barnet 004A","E01000285",1105,120,23,97,256,142,109,58,137,82,82,61,21,119
"2011","Barnet 004B","E01000287",1146,97,17,80,240,150,129,56,156,100,100,77,23,118
"2011","Barnet 004C","E01000288",1124,136,33,103,258,183,118,54,142,77,52,40,12,104
"2011","Barnet 004D","E01000289",1264,66,10,56,172,134,110,67,209,167,160,118,42,179
"2011","Barnet 004E","E01000291",1068,67,9,58,166,134,118,65,158,102,139,95,44,119
"2011","Barnet 004F","E01000294",1132,167,28,139,321,157,106,58,97,61,72,45,27,93
"2011","Barnet 005A","E01000267",1152,208,46,162,295,159,124,52,99,46,50,34,16,119
"2011","Barnet 005B","E01000268",1265,203,41,162,335,185,146,52,96,55,93,72,21,100
"2011","Barnet 005C","E01000269",1034,148,29,119,281,152,126,49,84,63,45,32,13,86
"2011","Barnet 005D","E01000270",1089,208,31,177,317,162,117,34,71,52,46,37,9,82
"2011","Barnet 006A","E01000170",1172,151,35,116,258,158,139,61,135,88,75,51,24,107
"2011","Barnet 006B","E01000171",1379,167,34,133,363,187,142,73,153,86,102,64,38,106
"2011","Barnet 006C","E01000173",1256,166,33,133,329,203,153,41,112,79,49,41,8,124
"2011","Barnet 006D","E01000174",1265,137,27,110,311,176,151,68,142,78,87,55,32,115
"2011","Barnet 006E","E01000175",1138,186,30,156,306,192,124,49,95,49,60,40,20,77
"2011","Barnet 007A","E01000228",1011,157,42,115,264,117,149,32,83,42,47,38,9,120
"2011","Barnet 007B","E01000253",1183,225,58,167,319,128,216,20,76,29,68,53,15,102
"2011","Barnet 007C","E01000279",1039,246,61,185,282,111,156,11,53,21,50,45,5,109
"2011","Barnet 007D","E01000280",1022,254,61,193,298,115,138,17,50,30,32,26,6,88
"2011","Barnet 007E","E01000286",1109,118,20,98,223,160,114,68,145,107,77,47,30,97
"2011","Barnet 007F","E01000290",1113,110,26,84,277,164,122,64,134,78,68,45,23,96
"2011","Barnet 008A","E01000271",1033,214,40,174,277,131,153,26,66,43,44,30,14,79
"2011","Barnet 008B","E01000272",957,219,32,187,281,116,133,12,56,17,26,22,4,97
"2011","Barnet 008C","E01000273",1104,198,37,161,273,143,112,46,91,69,82,69,13,90
"2011","Barnet 008D","E01000281",835,93,23,70,207,100,91,48,96,53,67,52,15,80
"2011","Barnet 008E","E01000282",1218,246,44,202,336,177,120,42,79,40,68,49,19,110
"2011","Barnet 009A","E01000115",1066,187,33,154,246,156,169,33,72,39,45,36,9,119
"2011","Barnet 009B","E01000116",1228,152,24,128,300,212,175,52,124,74,45,31,14,94
"2011","Barnet 009C","E01000119",1241,195,26,169,325,158,180,42,77,71,78,59,19,115
"2011","Barnet 009D","E01000120",1081,177,23,154,270,152,141,41,85,44,45,37,8,126
"2011","Barnet 009E","E01000122",1088,171,26,145,275,132,149,47,94,56,58,41,17,106
"2011","Barnet 010A","E01000117",1314,160,31,129,320,233,187,66,93,80,68,40,28,107
"2011","Barnet 010B","E01000118",1390,169,34,135,345,227,175,55,127,76,98,66,32,118
"2011","Barnet 010C","E01000121",988,61,11,50,166,137,101,46,137,73,147,107,40,120
"2011","Barnet 010D","E01000123",1283,151,27,124,319,182,183,75,116,74,87,53,34,96
"2011","Barnet 010E","E01000124",1206,129,32,97,243,144,138,67,146,107,112,77,35,120
"2011","Barnet 011A","E01000265",1392,161,32,129,326,165,186,75,171,84,98,67,31,126
"2011","Barnet 011B","E01000266",1124,209,45,164,296,168,157,34,69,40,39,26,13,112
"2011","Barnet 011C","E01000274",1333,147,36,111,326,193,154,63,148,86,87,69,18,129
"2011","Barnet 011D","E01000320",1052,184,37,147,293,125,129,45,88,45,51,36,15,92
"2011","Barnet 011E","E01000322",1321,182,39,143,361,160,167,56,114,62,92,76,16,127
"2011","Barnet 012A","E01000275",1184,261,42,219,321,156,127,30,75,45,73,61,12,96
"2011","Barnet 012B","E01000277",1167,193,31,162,277,127,127,47,95,49,115,81,34,137
"2011","Barnet 012C","E01000283",999,233,45,188,300,118,120,14,62,26,37,33,4,89
"2011","Barnet 012D","E01000284",1241,201,34,167,308,151,119,56,138,74,88,64,24,106
"2011","Barnet 012E","E01000321",1289,197,33,164,332,149,146,65,126,72,94,74,20,108
"2011","Barnet 013A","E01000195",1276,113,22,91,216,137,144,74,169,121,158,130,28,144
"2011","Barnet 013B","E01000229",1191,93,16,77,225,175,163,71,142,83,117,86,31,122
"2011","Barnet 013C","E01000230",1206,185,30,155,293,184,179,33,110,40,70,56,14,112
"2011","Barnet 013D","E01000231",1294,187,27,160,294,179,177,47,116,73,75,55,20,146
"2011","Barnet 013E","E01000232",1304,207,47,160,334,176,191,36,93,44,110,91,19,113
"2011","Barnet 013F","E01000233",1312,240,47,193,333,151,166,57,103,62,65,47,18,135
"2011","Barnet 014A","E01000186",1080,190,31,159,296,163,156,26,69,31,45,32,13,104
"2011","Barnet 014B","E01000187",1084,169,26,143,258,165,133,29,99,60,74,57,17,97
"2011","Barnet 014C","E01000188",1127,240,40,200,285,148,197,19,67,32,39,30,9,100
"2011","Barnet 014D","E01000189",1248,70,12,58,169,128,90,63,191,138,208,155,53,191
"2011","Barnet 014E","E01000190",1083,205,31,174,271,132,152,19,72,41,72,57,15,119
"2011","Barnet 014F","E01000191",1056,220,33,187,280,158,135,23,54,35,55,43,12,96
"2011","Barnet 015A","E01000158",1098,109,25,84,298,128,114,45,124,81,84,70,14,115
"2011","Barnet 015B","E01000159",1271,166,35,131,332,165,149,50,98,72,81,58,23,158
"2011","Barnet 015C","E01000160",1654,340,67,273,490,158,193,54,95,76,108,87,21,140
"2011","Barnet 015D","E01000161",1413,188,21,167,359,144,267,42,109,69,81,56,25,154
"2011","Barnet 015E","E01000162",1146,110,25,85,273,139,144,51,120,89,106,75,31,114
"2011","Barnet 015F","E01000324",1284,168,24,144,316,159,193,54,110,81,81,62,19,122
"2011","Barnet 016A","E01000256",1306,261,52,209,332,127,183,41,107,54,71,51,20,130
"2011","Barnet 016B","E01000258",1192,234,46,188,356,124,170,41,87,34,35,24,11,111
"2011","Barnet 016C","E01000263",1064,244,54,190,336,120,137,16,51,24,28,23,5,108
"2011","Barnet 016D","E01000264",1228,182,24,158,278,132,187,45,89,78,106,84,22,131
"2011","Barnet 017A","E01000255",1081,124,18,106,244,111,141,42,114,70,95,73,22,140
"2011","Barnet 017B","E01000257",1252,123,18,105,230,124,186,50,150,76,158,108,50,155
"2011","Barnet 017C","E01000261",1069,219,51,168,300,126,135,33,71,27,31,19,12,127
"2011","Barnet 017D","E01000262",1561,237,42,195,362,150,234,60,131,72,140,116,24,175
"2011","Barnet 018A","E01000192",1292,213,48,165,272,165,191,55,120,56,85,66,19,135
"2011","Barnet 018B","E01000193",1235,195,32,163,276,154,176,31,94,67,71,54,17,171
"2011","Barnet 018C","E01000194",1230,127,22,105,249,139,183,49,133,95,115,82,33,140
"2011","Barnet 018D","E01000226",1212,74,18,56,156,120,165,72,188,148,137,110,27,152
"2011","Barnet 018E","E01000227",1285,183,28,155,326,176,179,49,114,67,65,50,15,126
"2011","Barnet 019A","E01000299",1383,214,36,178,324,158,158,66,123,93,97,70,27,150
"2011","Barnet 019B","E01000300",1241,217,36,181,363,146,146,46,100,64,55,42,13,104
"2011","Barnet 019C","E01000302",1359,234,32,202,345,156,136,70,107,76,108,76,32,127
"2011","Barnet 019D","E01000317",1198,214,32,182,321,132,136,51,88,63,85,63,22,108
"2011","Barnet 019E","E01000318",1345,175,23,152,305,158,185,45,140,90,99,70,29,148
"2011","Barnet 019F","E01000323",1505,206,25,181,370,148,203,65,153,79,145,117,28,136
"2011","Barnet 020A","E01000276",1050,252,45,207,290,133,121,24,60,21,49,41,8,100
"2011","Barnet 020B","E01000278",1021,257,50,207,303,132,114,15,48,24,57,46,11,71
"2011","Barnet 020C","E01000301",1054,241,40,201,277,131,121,30,68,39,53,44,9,94
"2011","Barnet 020D","E01000303",1078,252,45,207,327,137,111,31,41,35,36,27,9,108
"2011","Barnet 020E","E01000304",1230,259,37,222,336,135,142,44,87,43,82,60,22,102
"2011","Barnet 021A","E01000130",1183,80,12,68,212,157,138,52,170,109,125,87,38,140
"2011","Barnet 021B","E01000132",1027,53,9,44,151,108,126,65,165,106,124,100,24,129
"2011","Barnet 021C","E01000133",1125,57,14,43,177,130,124,71,186,134,113,89,24,133
"2011","Barnet 021D","E01000234",1239,220,32,188,335,157,152,34,100,61,84,64,20,96
"2011","Barnet 021E","E01000235",1192,118,22,96,222,138,127,52,138,111,123,95,28,163
"2011","Barnet 022A","E01000156",1418,230,38,192,424,128,183,60,96,73,72,52,20,152
"2011","Barnet 022B","E01000157",1172,151,27,124,353,159,128,55,106,65,74,42,32,81
"2011","Barnet 022C","E01000163",1211,94,13,81,249,159,135,92,144,113,129,94,35,96
"2011","Barnet 022D","E01000164",1225,113,16,97,248,129,146,55,165,116,116,92,24,137
"2011","Barnet 022E","E01000165",1427,226,33,193,360,164,245,47,115,73,92,60,32,105
"2011","Barnet 022F","E01000315",1212,81,18,63,192,146,149,61,192,115,125,95,30,151
"2011","Barnet 023A","E01000197",1428,231,29,202,355,175,187,44,130,86,81,55,26,139
"2011","Barnet 023B","E01000295",1330,279,45,234,370,173,126,31,84,53,75,64,11,139
"2011","Barnet 023C","E01000296",1338,261,30,231,375,156,157,37,89,59,76,51,25,128
"2011","Barnet 023D","E01000298",1382,246,39,207,384,144,169,58,83,74,82,62,20,142
"2011","Barnet 024A","E01000125",1957,128,14,114,330,199,202,106,272,210,262,207,55,248
"2011","Barnet 024B","E01000127",1074,49,10,39,168,126,126,71,180,100,123,97,26,131
"2011","Barnet 024C","E01000128",1283,68,10,58,194,155,179,90,178,123,129,107,22,167
"2011","Barnet 024D","E01000129",1252,53,10,43,179,112,146,64,214,128,191,165,26,165
"2011","Barnet 024E","E01000131",1342,123,22,101,220,162,200,79,160,99,135,120,15,164
"2011","Barnet 024F","E01000134",1181,80,13,67,207,122,155,78,166,122,121,85,36,130
"2011","Barnet 025A","E01000198",1313,262,40,222,341,127,212,25,91,43,72,61,11,140
"2011","Barnet 025B","E01000199",1114,258,44,214,330,129,136,18,70,29,48,41,7,96
"2011","Barnet 025C","E01000204",1311,296,41,255,355,128,147,48,100,52,68,58,10,117
"2011","Barnet 025D","E01000259",1871,311,58,253,480,245,230,65,145,73,119,81,38,203
"2011","Barnet 025E","E01000260",1445,218,50,168,336,167,195,58,127,73,114,95,19,157
"2011","Barnet 026A","E01000126",1485,84,15,69,242,153,156,84,168,129,229,182,47,240
"2011","Barnet 026B","E01000151",1127,51,5,46,135,101,123,70,161,144,187,151,36,155
"2011","Barnet 026C","E01000152",1116,45,3,42,156,123,104,55,174,124,149,117,32,186
"2011","Barnet 026D","E01000153",1107,55,10,45,162,126,110,66,177,124,140,111,29,147
"2011","Barnet 026E","E01000154",979,63,7,56,128,86,135,67,165,96,118,96,22,121
"2011","Barnet 027A","E01000176",1187,112,19,93,278,117,131,54,155,109,122,89,33,109
"2011","Barnet 027B","E01000178",1267,241,42,199,406,109,136,41,94,50,59,48,11,131
"2011","Barnet 027C","E01000184",1005,85,16,69,186,110,108,62,135,101,100,73,27,118
"2011","Barnet 027D","E01000297",1144,180,28,152,275,123,152,53,121,77,63,45,18,100
"2011","Barnet 027E","E01000316",1764,250,36,214,405,196,177,84,211,107,123,91,32,211
"2011","Barnet 027F","E01000319",1105,197,31,166,300,124,135,34,91,60,58,42,16,106
"2011","Barnet 028A","E01000196",1423,218,27,191,409,141,184,46,120,72,95,65,30,138
"2011","Barnet 028B","E01000200",1292,297,55,242,319,147,164,24,90,32,72,49,23,147
"2011","Barnet 028C","E01000201",1103,235,52,183,271,87,184,7,57,19,87,73,14,156
"2011","Barnet 028D","E01000202",1265,290,42,248,366,103,148,38,86,47,46,36,10,141
"2011","Barnet 028E","E01000203",1227,172,34,138,246,111,145,40,107,63,116,86,30,227
"2011","Barnet 029A","E01000177",1287,265,39,226,442,142,140,44,73,47,48,29,19,86
"2011","Barnet 029B","E01000179",1294,253,43,210,457,151,138,47,76,54,41,25,16,77
"2011","Barnet 029C","E01000180",1188,205,43,162,333,140,107,43,111,67,64,46,18,118
"2011","Barnet 029D","E01000181",1319,299,40,259,447,128,126,43,69,51,51,35,16,105
"2011","Barnet 029E","E01000182",1320,314,53,261,480,145,99,38,64,39,34,21,13,107
"2011","Barnet 029F","E01000185",1092,85,20,65,218,113,111,57,119,91,149,116,33,149
"2011","Barnet 030A","E01000147",1335,130,14,116,211,162,217,77,179,90,117,100,17,152
"2011","Barnet 030B","E01000148",1421,105,14,91,242,143,147,74,199,133,169,148,21,209
"2011","Barnet 030D","E01000155",1452,157,20,137,262,123,233,87,161,122,121,92,29,186
"2011","Barnet 030E","E01033572",1235,123,20,103,207,147,218,77,120,84,104,88,16,155
"2011","Barnet 030F","E01033573",1401,159,23,136,232,78,67,39,63,44,87,67,20,632
"2011","Barnet 031A","E01000239",1572,220,30,190,333,163,216,62,124,98,124,97,27,232
"2011","Barnet 031B","E01000240",1254,151,24,127,248,128,212,48,118,63,102,75,27,184
"2011","Barnet 031C","E01000241",1339,242,35,207,311,134,203,41,79,55,85,65,20,189
"2011","Barnet 031D","E01000309",1386,202,27,175,271,144,188,43,128,71,108,92,16,231
"2011","Barnet 032A","E01000237",1554,226,45,181,332,151,230,57,95,77,77,65,12,309
"2011","Barnet 032B","E01000242",1075,171,34,137,272,104,134,28,95,59,68,55,13,144
"2011","Barnet 032C","E01000243",1443,175,30,145,314,136,190,41,131,58,82,65,17,316
"2011","Barnet 032D","E01000244",1332,151,25,126,228,112,155,46,99,84,70,59,11,387
"2011","Barnet 032E","E01000245",1460,140,21,119,252,105,168,60,208,158,128,109,19,241
"2011","Barnet 032F","E01000314",1426,225,48,177,313,127,209,50,99,77,90,73,17,236
"2011","Barnet 033A","E01000183",1025,252,41,211,322,133,79,24,52,39,45,37,8,79
"2011","Barnet 033B","E01000206",1069,260,89,171,273,76,134,10,83,45,68,56,12,120
"2011","Barnet 033C","E01000207",1107,282,63,219,303,85,149,31,64,41,44,30,14,108
"2011","Barnet 033D","E01000208",1141,305,46,259,341,109,131,19,53,32,54,41,13,97
"2011","Barnet 033E","E01000210",1071,279,48,231,332,104,131,20,45,35,43,29,14,82
"2011","Barnet 033F","E01000213",957,259,61,198,280,89,104,11,38,30,45,38,7,101
"2011","Barnet 034A","E01000236",1213,222,37,185,298,147,138,28,77,38,89,68,21,176
"2011","Barnet 034B","E01000238",1319,149,25,124,295,169,194,34,111,72,101,77,24,194
"2011","Barnet 034C","E01000310",1577,200,34,166,282,166,245,64,168,109,118,99,19,225
"2011","Barnet 034D","E01000311",1014,213,44,169,244,92,157,22,53,20,73,58,15,140
"2011","Barnet 035A","E01000205",1064,274,50,224,353,97,138,16,51,29,30,18,12,76
"2011","Barnet 035B","E01000209",1064,287,49,238,376,96,133,13,40,18,32,21,11,69
"2011","Barnet 035C","E01000211",1568,225,45,180,406,164,184,73,146,88,101,64,37,181
"2011","Barnet 035D","E01000212",1041,249,48,201,324,97,130,26,47,31,47,41,6,90
"2011","Barnet 035E","E01000216",1294,257,41,216,368,130,143,37,90,57,93,72,21,119
"2011","Barnet 035F","E01000217",1150,199,34,165,260,130,182,29,82,36,105,88,17,127
"2011","Barnet 036A","E01000150",1532,144,26,118,298,200,200,77,196,124,130,103,27,163
"2011","Barnet 036B","E01000305",1254,80,11,69,178,138,177,77,175,115,143,109,34,171
"2011","Barnet 036C","E01000306",1320,129,17,112,221,157,180,68,150,128,99,86,13,188
"2011","Barnet 036D","E01000308",1107,56,13,43,146,131,96,75,183,151,131,90,41,138
"2011","Barnet 036E","E01000312",1244,104,12,92,201,133,168,84,161,131,122,97,25,140
"2011","Barnet 036F","E01000313",1422,135,18,117,232,127,174,77,198,128,126,99,27,225
"2011","Barnet 037A","E01000145",992,164,31,133,218,120,156,17,56,32,90,69,21,139
"2011","Barnet 037B","E01000215",1251,214,40,174,271,145,181,35,102,42,108,98,10,153
"2011","Barnet 037C","E01000218",1203,181,35,146,304,152,137,35,88,45,106,95,11,155
"2011","Barnet 037D","E01000219",1279,143,29,114,277,140,192,75,105,83,103,76,27,161
"2011","Barnet 037E","E01000220",1235,157,24,133,290,119,167,52,114,72,123,106,17,141
"2011","Barnet 037F","E01000225",980,170,42,128,264,135,116,20,50,21,79,71,8,125
"2011","Barnet 038A","E01000135",1123,228,45,183,249,96,155,30,71,40,87,72,15,167
"2011","Barnet 038B","E01000136",1040,267,51,216,299,101,126,12,49,33,47,40,7,106
"2011","Barnet 038C","E01000144",1201,226,38,188,302,124,141,43,75,51,65,52,13,174
"2011","Barnet 038D","E01000146",1352,253,48,205,317,140,163,56,92,67,92,65,27,172
"2011","Barnet 038E","E01000214",1294,355,53,302,405,116,117,34,53,25,43,30,13,146
"2011","Barnet 039A","E01000141",1656,167,29,138,319,137,231,82,191,168,130,96,34,231
"2011","Barnet 039B","E01000221",878,60,15,45,144,95,104,40,104,85,125,105,20,121
"2011","Barnet 039C","E01000223",922,63,11,52,162,90,126,52,129,82,114,95,19,104
"2011","Barnet 039D","E01000307",1224,83,18,65,191,130,170,76,169,111,120,94,26,174
"2011","Barnet 040A","E01000138",1063,118,21,97,216,104,171,48,91,81,95,80,15,139
"2011","Barnet 040B","E01000142",1770,262,40,222,381,199,222,75,142,151,172,131,41,166
"2011","Barnet 040C","E01000222",1128,85,14,71,207,112,156,63,123,91,142,118,24,149
"2011","Barnet 040D","E01000224",1130,93,24,69,219,110,175,53,113,87,131,108,23,149
"2011","Barnet 041A","E01000137",1177,134,26,108,215,136,110,57,153,107,141,118,23,124
"2011","Barnet 041B","E01000139",1103,186,41,145,280,102,142,27,81,73,90,69,21,122
"2011","Barnet 041C","E01000140",1296,187,30,157,312,89,163,55,115,84,93,64,29,198
"2011","Barnet 041D","E01000143",1077,75,17,58,152,97,115,51,126,129,123,86,37,209
"2011","Bexley 001A","E01000466",1170,72,20,52,168,114,95,70,201,133,146,92,54,171
"2011","Bexley 001B","E01000467",1145,78,8,70,216,154,88,69,152,110,119,78,41,159
"2011","Bexley 001C","E01000468",1798,153,28,125,349,194,159,106,253,142,143,93,50,299
"2011","Bexley 001D","E01000469",1214,85,14,71,230,173,115,86,167,111,101,72,29,146
"2011","Bexley 002A","E01000416",1079,51,11,40,197,139,92,72,165,116,109,84,25,138
"2011","Bexley 002B","E01000418",1388,105,13,92,251,222,137,102,215,122,94,70,24,140
"2011","Bexley 002C","E01000422",1190,48,9,39,162,145,80,76,199,138,180,122,58,162
"2011","Bexley 002D","E01000464",1034,46,10,36,149,124,76,61,191,156,104,65,39,127
"2011","Bexley 002E","E01000465",1135,49,19,30,156,165,69,84,228,151,127,67,60,106
"2011","Bexley 002F","E01000470",1004,30,5,25,118,131,59,73,198,143,121,79,42,131
"2011","Bexley 003A","E01000333",1169,84,28,56,253,188,118,86,158,116,87,70,17,79
"2011","Bexley 003B","E01000335",1214,65,8,57,201,158,138,82,158,169,123,88,35,120
"2011","Bexley 003C","E01000336",1342,83,19,64,222,172,114,92,204,149,148,112,36,158
"2011","Bexley 003D","E01000337",1212,81,22,59,254,172,121,80,183,141,76,46,30,104
"2011","Bexley 003E","E01000338",1302,92,21,71,256,222,118,90,184,135,60,42,18,145
"2011","Bexley 004A","E01000403",1435,97,28,69,260,242,120,100,241,164,115,69,46,96
"2011","Bexley 004B","E01000404",1585,123,19,104,267,242,120,86,248,168,161,111,50,170
"2011","Bexley 004C","E01000405",983,53,13,40,197,144,79,74,168,121,68,38,30,79
"2011","Bexley 004D","E01000408",1185,49,10,39,207,186,109,79,172,159,93,64,29,131
"2011","Bexley 005A","E01000332",1101,91,22,69,207,196,106,80,136,128,52,42,10,105
"2011","Bexley 005B","E01000402",1105,78,12,66,230,199,98,68,155,115,74,50,24,88
"2011","Bexley 005C","E01000406",1170,79,19,60,198,165,118,75,183,136,78,60,18,138
"2011","Bexley 005D","E01000407",1065,88,18,70,202,197,110,74,146,118,71,54,17,59
"2011","Bexley 006A","E01000334",1175,88,20,68,246,211,113,98,168,115,38,28,10,98
"2011","Bexley 006B","E01000417",1238,112,21,91,252,235,133,83,176,102,66,40,26,79
"2011","Bexley 006C","E01000419",1030,82,27,55,203,215,114,94,122,99,26,20,6,75
"2011","Bexley 006D","E01000420",1146,100,25,75,252,203,117,84,152,98,32,22,10,108
"2011","Bexley 006E","E01000442",1132,91,30,61,208,240,127,92,157,102,34,24,10,81
"2011","Bexley 007A","E01000437",948,69,23,46,179,195,83,63,147,80,39,23,16,93
"2011","Bexley 007B","E01000438",1167,74,25,49,221,219,115,103,166,100,72,51,21,97
"2011","Bexley 007C","E01000439",980,58,21,37,156,185,90,78,156,118,61,44,17,78
"2011","Bexley 007D","E01000440",1051,85,19,66,225,218,119,84,112,97,26,17,9,85
"2011","Bexley 007E","E01000441",1149,80,24,56,214,185,110,81,166,133,94,57,37,86
"2011","Bexley 008A","E01000373",1034,27,5,22,124,134,58,67,205,175,150,83,67,94
"2011","Bexley 008B","E01000429",1161,52,9,43,183,139,87,98,189,155,138,94,44,120
"2011","Bexley 008C","E01000430",1204,97,13,84,252,199,92,67,158,136,93,57,36,110
"2011","Bexley 008D","E01000431",1177,52,15,37,145,145,79,85,214,171,145,90,55,141
"2011","Bexley 008E","E01000432",1106,58,9,49,172,177,89,103,189,142,81,53,28,95
"2011","Bexley 008F","E01000433",1218,54,17,37,162,163,94,106,214,176,124,74,50,125
"2011","Bexley 008G","E01000434",1029,39,13,26,121,117,56,83,223,176,99,72,27,115
"2011","Bexley 009A","E01000356",1077,110,23,87,232,239,121,66,136,76,32,21,11,65
"2011","Bexley 009B","E01000357",1041,107,21,86,262,215,103,68,104,61,32,21,11,89
"2011","Bexley 009C","E01000359",953,95,24,71,242,230,79,57,89,71,16,9,7,74
"2011","Bexley 009D","E01000421",1028,105,29,76,205,223,105,59,138,84,23,13,10,86
"2011","Bexley 009E","E01000450",1257,94,27,67,234,234,128,86,192,118,72,50,22,99
"2011","Bexley 009F","E01000451",1245,121,32,89,235,242,136,100,169,99,37,18,19,106
"2011","Bexley 009G","E01000452",1014,81,27,54,204,223,122,66,124,73,38,22,16,83
"2011","Bexley 010A","E01000367",1126,52,18,34,179,163,92,86,204,171,86,49,37,93
"2011","Bexley 010B","E01000368",1056,57,17,40,177,148,74,81,202,170,64,40,24,83
"2011","Bexley 010C","E01000372",1173,54,11,43,193,161,95,97,201,161,103,60,43,108
"2011","Bexley 010D","E01000380",1055,70,17,53,166,195,102,75,188,144,51,30,21,64
"2011","Bexley 010E","E01000435",982,58,8,50,161,164,81,83,159,125,66,42,24,85
"2011","Bexley 011A","E01000353",1225,128,28,100,288,277,129,74,133,81,24,18,6,91
"2011","Bexley 011B","E01000354",1085,83,22,61,216,239,97,84,151,94,46,27,19,75
"2011","Bexley 011C","E01000355",1067,82,21,61,229,219,127,89,119,79,40,34,6,83
"2011","Bexley 011D","E01000358",1179,145,24,121,237,263,143,89,128,79,25,13,12,70
"2011","Bexley 011E","E01000436",1224,151,40,111,268,259,119,82,146,82,33,24,9,84
"2011","Bexley 013A","E01000401",1164,76,14,62,187,202,113,92,203,127,64,48,16,100
"2011","Bexley 013B","E01000453",1063,98,27,71,199,194,134,84,143,94,40,31,9,77
"2011","Bexley 013C","E01000454",1143,61,23,38,220,234,102,103,172,111,50,34,16,90
"2011","Bexley 013D","E01000455",1212,97,24,73,278,224,120,84,157,100,42,20,22,110
"2011","Bexley 013E","E01000456",1026,101,22,79,199,232,97,62,136,88,25,18,7,86
"2011","Bexley 014A","E01000325",1187,119,32,87,267,282,95,86,147,79,28,17,11,84
"2011","Bexley 014B","E01000326",963,89,15,74,234,211,85,92,108,83,21,12,9,40
"2011","Bexley 014C","E01000369",1241,96,20,76,227,257,106,99,183,139,40,26,14,94
"2011","Bexley 014D","E01000370",1136,95,19,76,269,246,107,87,149,82,31,15,16,70
"2011","Bexley 014E","E01000371",1152,98,24,74,272,240,123,93,145,86,26,12,14,69
"2011","Bexley 015A","E01000360",1192,144,20,124,279,214,133,76,131,61,67,52,15,87
"2011","Bexley 015B","E01000362",1039,121,25,96,247,198,125,72,110,64,30,16,14,72
"2011","Bexley 015C","E01000365",1136,116,27,89,252,221,118,86,145,79,29,15,14,90
"2011","Bexley 015D","E01000366",1180,144,35,109,298,242,123,73,109,80,39,20,19,72
"2011","Bexley 015E","E01000394",1020,118,34,84,225,230,117,57,119,65,25,13,12,64
"2011","Bexley 016A","E01000388",1101,108,26,82,234,227,128,68,148,65,36,26,10,87
"2011","Bexley 016B","E01000392",1165,81,23,58,208,196,85,76,188,125,86,50,36,120
"2011","Bexley 016C","E01000409",1210,113,26,87,233,256,110,101,192,99,30,14,16,76
"2011","Bexley 016D","E01000411",1028,58,16,42,212,242,113,77,137,81,31,18,13,77
"2011","Bexley 016E","E01000414",1209,109,30,79,237,213,130,106,150,93,62,45,17,109
"2011","Bexley 016F","E01000415",1114,101,22,79,227,236,128,94,113,78,40,29,11,97
"2011","Bexley 017A","E01000327",1105,137,40,97,254,251,118,65,111,62,20,13,7,87
"2011","Bexley 017B","E01000328",1100,101,32,69,235,224,121,86,143,76,49,30,19,65
"2011","Bexley 017C","E01000329",950,80,18,62,209,170,68,71,148,84,43,28,15,77
"2011","Bexley 017D","E01000330",1086,96,27,69,228,223,81,90,153,98,47,26,21,70
"2011","Bexley 017E","E01000331",1117,65,27,38,198,178,115,81,193,132,64,48,16,91
"2011","Bexley 018A","E01000340",1077,76,22,54,213,222,144,88,145,92,33,19,14,64
"2011","Bexley 018B","E01000395",1067,95,25,70,249,226,114,63,112,68,31,20,11,109
"2011","Bexley 018C","E01000396",1026,107,21,86,222,193,104,77,145,72,26,18,8,80
"2011","Bexley 018D","E01000410",1152,106,20,86,233,249,114,101,144,88,38,23,15,79
"2011","Bexley 018E","E01000412",1194,93,21,72,282,258,140,74,130,93,30,21,9,94
"2011","Bexley 018F","E01000413",966,61,18,43,170,191,137,78,132,80,38,22,16,79
"2011","Bexley 019A","E01000374",997,36,6,30,146,128,85,83,180,154,94,78,16,91
"2011","Bexley 019B","E01000375",1078,65,17,48,205,159,98,84,172,117,63,34,29,115
"2011","Bexley 019C","E01000376",1085,84,24,60,218,209,116,95,149,104,42,26,16,68
"2011","Bexley 019D","E01000377",1052,100,21,79,245,215,111,77,137,85,22,11,11,60
"2011","Bexley 019E","E01000378",1535,153,36,117,338,275,147,119,205,134,71,48,23,93
"2011","Bexley 019F","E01000379",1184,95,21,74,264,224,97,108,141,103,60,33,27,92
"2011","Bexley 020A","E01000348",1085,116,25,91,289,213,155,66,99,38,23,14,9,86
"2011","Bexley 020B","E01000349",1144,146,33,113,288,225,155,67,112,61,32,23,9,58
"2011","Bexley 020C","E01000361",1145,111,31,80,279,216,141,74,113,81,41,24,17,89
"2011","Bexley 020D","E01000363",1091,106,26,80,274,222,138,65,100,59,39,29,10,88
"2011","Bexley 020E","E01000389",1216,136,25,111,291,251,149,78,129,64,42,25,17,76
"2011","Bexley 020F","E01000390",935,82,14,68,199,187,123,60,96,82,37,27,10,69
"2011","Bexley 020G","E01000393",1199,106,31,75,254,246,131,84,150,93,34,18,16,101
"2011","Bexley 021A","E01000346",1154,107,26,81,235,265,148,91,141,70,25,16,9,72
"2011","Bexley 021B","E01000347",1076,82,20,62,210,224,125,68,137,91,37,27,10,102
"2011","Bexley 021C","E01000350",1109,95,18,77,233,237,156,74,125,61,27,15,12,101
"2011","Bexley 021D","E01000352",1130,97,26,71,234,233,113,92,154,91,35,19,16,81
"2011","Bexley 021E","E01000391",1249,77,16,61,231,237,152,112,158,112,57,34,23,113
"2011","Bexley 022A","E01000341",1047,86,24,62,236,225,111,73,142,89,32,16,16,53
"2011","Bexley 022B","E01000342",1191,86,17,69,274,249,119,97,159,88,28,13,15,91
"2011","Bexley 022C","E01000343",1098,94,23,71,218,213,125,75,140,92,44,27,17,97
"2011","Bexley 022D","E01000345",1001,107,29,78,223,226,124,65,93,56,20,16,4,87
"2011","Bexley 022E","E01000460",1075,159,39,120,301,217,118,42,73,32,21,12,9,112
"2011","Bexley 023A","E01000364",1134,126,33,93,248,231,149,76,116,71,38,21,17,79
"2011","Bexley 023B","E01000444",1190,176,40,136,312,245,147,37,99,44,32,24,8,98
"2011","Bexley 023C","E01000447",1102,156,33,123,301,212,130,60,96,57,25,12,13,65
"2011","Bexley 023D","E01000448",939,162,41,121,260,182,93,41,80,27,17,11,6,77
"2011","Bexley 023E","E01000449",1002,181,34,147,302,187,90,48,77,33,15,10,5,69
"2011","Bexley 024A","E01000351",1176,91,20,71,234,285,143,80,133,98,28,23,5,84
"2011","Bexley 024B","E01000443",908,73,16,57,198,182,102,57,121,60,38,20,18,77
"2011","Bexley 024C","E01000445",1169,131,27,104,302,259,133,66,114,62,24,15,9,78
"2011","Bexley 024D","E01000446",1174,112,26,86,267,252,138,67,147,89,29,21,8,73
"2011","Bexley 024E","E01000461",1255,136,40,96,289,235,137,91,144,65,16,8,8,142
"2011","Bexley 025A","E01000339",1085,103,26,77,206,237,124,87,132,89,33,18,15,74
"2011","Bexley 025B","E01000344",1132,101,19,82,295,230,132,81,115,65,20,13,7,93
"2011","Bexley 025C","E01000423",1154,134,21,113,320,225,126,56,133,63,22,13,9,75
"2011","Bexley 025D","E01000425",1201,131,33,98,307,255,138,71,107,58,50,42,8,84
"2011","Bexley 025E","E01000463",920,105,18,87,206,203,100,65,96,41,19,11,8,85
"2011","Bexley 026A","E01000424",1280,186,49,137,389,255,107,62,96,55,37,23,14,93
"2011","Bexley 026B","E01000426",1233,154,34,120,334,236,126,68,127,61,44,25,19,83
"2011","Bexley 026C","E01000427",1350,152,34,118,313,267,123,83,173,96,42,15,27,101
"2011","Bexley 026D","E01000457",1311,149,33,116,306,250,103,65,117,67,55,38,17,199
"2011","Bexley 026E","E01000462",1135,118,21,97,264,224,98,59,108,63,34,23,11,167
"2011","Bexley 027A","E01000382",1096,132,31,101,284,225,130,63,121,44,24,18,6,73
"2011","Bexley 027B","E01000384",1222,142,32,110,292,223,125,69,132,85,37,19,18,117
"2011","Bexley 027C","E01000387",1095,114,28,86,255,208,113,82,126,76,36,22,14,85
"2011","Bexley 027D","E01000428",1248,143,26,117,290,183,101,49,147,77,47,31,16,211
"2011","Bexley 027E","E01000458",1046,159,26,133,307,206,113,43,68,33,23,13,10,94
"2011","Bexley 027F","E01000459",1168,163,30,133,260,183,115,55,143,66,53,42,11,130
"2011","Bexley 028A","E01000381",1104,93,21,72,228,200,112,61,157,118,58,46,12,77
"2011","Bexley 028B","E01000383",1088,113,25,88,231,195,149,68,139,86,45,37,8,62
"2011","Bexley 028C","E01000385",1270,65,17,48,242,213,113,94,189,147,103,63,40,104
"2011","Bexley 028D","E01000386",984,46,9,37,176,132,91,70,167,117,96,60,36,89
"2011","Bexley 029A","E01000398",1132,66,22,44,205,216,107,89,167,119,73,40,33,90
"2011","Bexley 029B","E01000399",1136,109,28,81,231,228,126,62,142,101,50,33,17,87
"2011","Bexley 029C","E01000400",1109,86,24,62,203,234,127,74,145,106,37,23,14,97
"2011","Bexley 029D","E01032566",1212,77,21,56,241,228,118,75,170,124,87,59,28,92
"2011","Brent 001A","E01000587",1231,115,19,96,176,170,242,47,136,82,140,128,12,123
"2011","Brent 001B","E01000589",1466,141,29,112,267,194,168,63,185,158,134,117,17,156
"2011","Brent 001C","E01000590",1329,133,25,108,272,165,206,58,158,103,103,81,22,131
"2011","Brent 001D","E01000592",1244,111,14,97,234,154,191,52,153,108,114,94,20,127
"2011","Brent 001E","E01000593",1590,154,18,136,289,210,199,84,182,122,159,129,30,191
"2011","Brent 001F","E01000594",1266,124,28,96,198,166,209,61,152,100,111,91,20,145
"2011","Brent 002A","E01000513",1212,106,16,90,196,141,223,52,126,92,105,98,7,171
"2011","Brent 002B","E01000514",1130,99,14,85,215,116,192,64,133,91,94,80,14,126
"2011","Brent 002C","E01000516",1304,92,15,77,190,154,236,66,165,100,143,130,13,158
"2011","Brent 002D","E01000520",1196,118,13,105,177,123,187,68,148,92,147,119,28,136
"2011","Brent 002E","E01000588",1568,105,10,95,256,183,221,95,161,131,196,159,37,220
"2011","Brent 003A","E01000515",1252,74,12,62,183,152,168,64,162,105,177,142,35,167
"2011","Brent 003B","E01000517",1208,153,21,132,202,140,210,53,110,80,122,106,16,138
"2011","Brent 003E","E01000543",1213,143,24,119,231,151,133,54,114,77,128,100,28,182
"2011","Brent 003F","E01000591",1582,133,20,113,238,194,189,77,209,122,170,152,18,250
"2011","Brent 003G","E01033463",2168,256,40,216,353,278,313,97,228,151,183,140,43,309
"2011","Brent 004A","E01000536",1219,237,32,205,271,165,131,28,77,50,94,75,19,166
"2011","Brent 004B","E01000538",1168,228,28,200,267,183,161,26,76,35,53,42,11,139
"2011","Brent 004C","E01000539",1153,216,26,190,257,171,150,32,105,52,69,55,14,101
"2011","Brent 004D","E01000540",1138,250,32,218,244,158,137,31,86,27,83,64,19,122
"2011","Brent 004E","E01000541",1043,163,18,145,183,142,140,61,132,54,68,60,8,100
"2011","Brent 005A","E01000518",1202,96,13,83,202,135,172,54,141,97,127,100,27,178
"2011","Brent 005B","E01000519",1387,93,20,73,206,138,192,73,180,113,147,130,17,245
"2011","Brent 005C","E01000623",1304,113,19,94,229,155,203,73,149,101,129,106,23,152
"2011","Brent 005D","E01000624",1205,91,21,70,196,169,199,70,138,105,98,76,22,139
"2011","Brent 005E","E01000629",1466,110,20,90,192,176,253,97,169,164,133,108,25,172
"2011","Brent 006A","E01000480",1332,223,36,187,264,140,219,41,102,62,115,99,16,166
"2011","Brent 006B","E01000484",886,64,6,58,143,119,97,29,124,88,112,92,20,110
"2011","Brent 006C","E01000485",1026,103,17,86,167,109,143,45,138,83,113,98,15,125
"2011","Brent 006D","E01000486",1259,158,19,139,249,143,198,52,104,62,121,96,25,172
"2011","Brent 006E","E01000487",1398,197,26,171,268,148,202,60,123,70,169,143,26,161
"2011","Brent 007A","E01000572",1090,141,23,118,238,139,137,40,109,70,86,63,23,130
"2011","Brent 007B","E01000573",1151,124,11,113,218,131,187,39,119,76,105,90,15,152
"2011","Brent 007C","E01000574",991,120,16,104,190,138,163,38,85,60,73,61,12,124
"2011","Brent 007D","E01000575",1416,175,23,152,261,162,234,69,145,78,124,100,24,168
"2011","Brent 007E","E01000577",1681,142,22,120,275,175,149,91,222,143,254,210,44,230
"2011","Brent 008A","E01000562",1175,232,30,202,257,155,168,27,88,37,74,57,17,137
"2011","Brent 008B","E01000563",1142,176,25,151,227,155,176,41,95,54,71,59,12,147
"2011","Brent 008C","E01000566",1170,160,26,134,227,165,142,41,131,66,97,80,17,141
"2011","Brent 008D","E01000568",1962,192,14,178,586,142,84,48,85,52,58,47,11,715
"2011","Brent 008E","E01000569",1203,173,29,144,271,182,160,44,96,53,68,57,11,156
"2011","Brent 009A","E01000479",1231,154,28,126,221,157,212,39,91,73,136,119,17,148
"2011","Brent 009B","E01000481",1154,139,14,125,197,100,136,60,140,95,129,97,32,158
"2011","Brent 009C","E01000482",2030,167,19,148,304,216,181,99,280,175,289,235,54,319
"2011","Brent 009D","E01000483",1226,77,12,65,169,126,125,79,173,124,210,159,51,143
"2011","Brent 009E","E01000625",1091,122,23,99,189,129,160,48,101,85,123,106,17,134
"2011","Brent 010B","E01000498",1130,61,7,54,130,114,149,62,150,130,167,141,26,167
"2011","Brent 010D","E01000622",1204,71,10,61,164,112,228,94,153,134,141,104,37,107
"2011","Brent 010E","E01000626",1053,37,7,30,134,124,120,63,155,128,152,131,21,140
"2011","Brent 010F","E01033464",2045,99,16,83,280,201,289,106,255,267,280,236,44,268
"2011","Brent 011A","E01000497",1307,87,15,72,200,133,183,71,146,136,149,126,23,202
"2011","Brent 011B","E01000499",1189,74,10,64,152,106,170,61,153,116,185,157,28,172
"2011","Brent 011C","E01000501",1286,91,9,82,190,165,140,59,161,137,181,136,45,162
"2011","Brent 011D","E01000502",972,78,18,60,158,87,164,60,114,82,120,105,15,109
"2011","Brent 011E","E01000503",1452,127,19,108,243,142,210,72,194,136,145,117,28,183
"2011","Brent 012A","E01000570",1181,93,25,68,162,140,132,62,186,120,134,111,23,152
"2011","Brent 012B","E01000571",1269,130,22,108,222,140,192,51,121,79,160,137,23,174
"2011","Brent 012C","E01000576",1244,149,24,125,231,152,160,50,135,76,99,82,17,192
"2011","Brent 012D","E01000578",1323,160,27,133,225,156,181,72,128,109,132,108,24,160
"2011","Brent 013A","E01000564",1195,113,19,94,164,142,207,55,121,91,137,117,20,165
"2011","Brent 013B","E01000565",1109,130,23,107,226,124,125,52,133,80,115,98,17,124
"2011","Brent 013C","E01000607",1661,132,30,102,252,181,159,80,257,145,177,148,29,278
"2011","Brent 013D","E01000608",1659,120,20,100,268,159,164,70,282,153,175,150,25,268
"2011","Brent 013E","E01000613",1278,120,29,91,232,152,128,60,160,112,156,138,18,158
"2011","Brent 014A","E01000506",1248,73,16,57,190,119,179,66,144,139,192,150,42,146
"2011","Brent 014B","E01000509",1080,60,13,47,145,92,168,63,115,162,129,104,25,146
"2011","Brent 014C","E01000510",1226,70,8,62,160,122,212,74,148,124,144,121,23,172
"2011","Brent 014D","E01000511",1161,105,21,84,178,93,180,55,133,124,149,127,22,144
"2011","Brent 014E","E01000627",1372,73,25,48,161,142,199,99,191,167,175,127,48,165
"2011","Brent 014F","E01000628",1387,82,18,64,189,126,218,83,176,140,185,146,39,188
"2011","Brent 015A","E01000553",1649,116,16,100,272,153,218,95,179,210,176,139,37,230
"2011","Brent 015B","E01000554",1391,132,22,110,272,133,203,81,164,127,121,97,24,158
"2011","Brent 015C","E01000555",1132,151,27,124,263,121,151,47,96,58,87,66,21,158
"2011","Brent 015D","E01000556",1544,105,18,87,281,148,176,113,172,167,150,112,38,232
"2011","Brent 015E","E01000557",1535,178,28,150,330,140,161,100,181,128,102,76,26,215
"2011","Brent 015F","E01000558",1235,203,24,179,357,109,114,48,93,82,109,74,35,120
"2011","Brent 016A","E01000567",1008,119,16,103,211,122,120,51,111,68,97,84,13,109
"2011","Brent 016B","E01000606",1250,80,11,69,192,148,158,74,187,143,124,103,21,144
"2011","Brent 016C","E01000609",1530,87,19,68,263,173,140,108,227,160,168,137,31,204
"2011","Brent 016D","E01000611",1100,67,14,53,192,116,78,57,164,148,128,100,28,150
"2011","Brent 017B","E01000615",1224,128,14,114,201,140,116,89,149,125,116,94,22,160
"2011","Brent 017C","E01000617",1343,90,13,77,190,141,140,70,222,160,131,108,23,199
"2011","Brent 017D","E01000618",1169,88,14,74,166,137,122,58,180,154,115,96,19,149
"2011","Brent 017E","E01000619",1243,80,9,71,186,144,138,68,187,175,106,88,18,159
"2011","Brent 017F","E01033424",1207,177,26,151,230,104,72,68,103,95,181,141,40,177
"2011","Brent 017G","E01033457",1327,183,26,157,260,128,176,73,136,119,95,80,15,157
"2011","Brent 018A","E01000504",1362,147,23,124,393,139,159,69,104,105,104,87,17,142
"2011","Brent 018B","E01000505",1260,134,14,120,224,138,146,60,122,125,139,117,22,172
"2011","Brent 018C","E01000507",1255,128,13,115,245,124,168,67,128,100,124,103,21,171
"2011","Brent 018D","E01000512",1372,153,27,126,365,143,171,73,132,95,95,74,21,145
"2011","Brent 018E","E01000559",1212,138,23,115,362,143,128,53,109,69,69,38,31,141
"2011","Brent 019A","E01000610",1410,138,22,116,226,156,149,83,208,112,160,130,30,178
"2011","Brent 019B","E01000612",1259,75,14,61,197,163,117,74,211,111,135,111,24,176
"2011","Brent 019C","E01000631",1466,112,9,103,221,152,140,78,261,146,148,121,27,208
"2011","Brent 019D","E01000633",1548,105,19,86,178,126,110,106,314,190,186,157,29,233
"2011","Brent 019E","E01000634",1751,100,19,81,229,152,124,120,320,225,204,173,31,277
"2011","Brent 020A","E01000616",1372,112,18,94,191,135,152,88,216,166,119,96,23,193
"2011","Brent 020B","E01000620",1315,96,17,79,172,149,120,83,204,165,136,116,20,190
"2011","Brent 020C","E01000621",1362,75,17,58,187,128,163,62,225,198,127,106,21,197
"2011","Brent 020D","E01000635",1879,117,18,99,248,172,145,105,302,220,225,180,45,345
"2011","Brent 020E","E01000636",1415,76,10,66,179,142,146,84,226,202,129,104,25,231
"2011","Brent 021A","E01000596",1139,25,2,23,120,117,85,60,178,150,248,192,56,156
"2011","Brent 021B","E01000601",969,41,6,35,113,91,96,62,155,96,164,134,30,151
"2011","Brent 021C","E01000602",1064,30,8,22,121,116,90,51,182,149,159,121,38,166
"2011","Brent 021D","E01000603",1041,50,8,42,141,128,76,84,170,127,154,114,40,111
"2011","Brent 021E","E01000604",1224,44,11,33,133,120,70,62,203,134,211,179,32,247
"2011","Brent 021F","E01000605",1131,30,9,21,117,115,89,63,182,153,196,158,38,186
"2011","Brent 022A","E01000488",1177,106,12,94,268,95,140,64,98,102,137,119,18,167
"2011","Brent 022B","E01000637",1308,121,23,98,266,122,132,86,136,157,116,89,27,172
"2011","Brent 022C","E01000639",1462,165,21,144,341,159,166,100,159,127,85,57,28,160
"2011","Brent 022D","E01000642",1734,190,31,159,411,170,174,121,154,176,128,98,30,210
"2011","Brent 022E","E01000644",1482,128,23,105,316,144,157,88,183,160,140,103,37,166
"2011","Brent 023A","E01000490",1346,280,36,244,438,124,114,50,87,60,89,69,20,104
"2011","Brent 023B","E01000494",1379,215,38,177,374,135,135,48,92,85,137,96,41,158
"2011","Brent 023C","E01000495",1287,199,32,167,326,115,137,66,119,97,111,87,24,117
"2011","Brent 023D","E01000560",1349,261,28,233,406,128,117,41,85,72,82,48,34,157
"2011","Brent 023E","E01000561",1423,251,43,208,358,148,111,60,143,108,101,74,27,143
"2011","Brent 024A","E01000638",1469,72,10,62,200,120,223,92,186,236,167,116,51,173
"2011","Brent 024B","E01000640",1631,89,19,70,231,115,229,112,247,218,186,142,44,204
"2011","Brent 024C","E01000641",1465,83,19,64,257,146,193,103,186,169,144,113,31,184
"2011","Brent 024D","E01000643",1523,101,14,87,248,149,150,87,197,167,223,181,42,201
"2011","Brent 025A","E01000508",1375,51,10,41,164,126,168,96,193,193,222,174,48,162
"2011","Brent 025B","E01000521",1579,64,19,45,203,132,176,77,205,230,292,220,72,200
"2011","Brent 025C","E01000522",1317,66,14,52,192,135,157,83,180,174,159,118,41,171
"2011","Brent 025D","E01000526",1580,38,10,28,199,166,115,101,255,205,257,198,59,244
"2011","Brent 025E","E01000527",1495,56,9,47,208,133,186,97,215,212,213,155,58,175
"2011","Brent 025F","E01000528",1069,30,10,20,149,130,100,48,191,116,159,118,41,146
"2011","Brent 026A","E01000471",1251,61,9,52,155,125,121,82,197,206,123,104,19,181
"2011","Brent 026B","E01000474",1496,61,12,49,137,147,118,95,279,238,193,162,31,228
"2011","Brent 026C","E01000476",1263,64,7,57,153,122,137,90,212,189,115,88,27,181
"2011","Brent 026D","E01000477",1422,73,11,62,178,130,163,94,237,218,170,139,31,159
"2011","Brent 026E","E01000630",1727,89,23,66,222,190,143,97,265,224,231,196,35,266
"2011","Brent 027A","E01000595",1128,42,5,37,146,106,110,69,165,122,191,151,40,177
"2011","Brent 027D","E01000599",926,41,6,35,166,113,57,63,134,92,121,94,27,139
"2011","Brent 027E","E01000600",1429,83,13,70,205,147,110,89,195,174,230,182,48,196
"2011","Brent 027F","E01033456",1491,53,12,41,180,130,97,101,221,190,269,217,52,250
"2011","Brent 028A","E01000545",1547,225,39,186,429,145,123,93,159,121,104,68,36,148
"2011","Brent 028B","E01000546",1329,214,38,176,386,121,125,64,124,103,82,65,17,110
"2011","Brent 028C","E01000547",1412,199,47,152,358,123,123,71,121,136,122,89,33,159
"2011","Brent 028D","E01000548",1739,254,39,215,458,153,174,84,155,178,138,94,44,145
"2011","Brent 028E","E01000549",1564,319,58,261,519,134,155,69,115,80,71,44,27,102
"2011","Brent 029A","E01000472",1078,97,17,80,207,121,130,70,150,107,87,69,18,109
"2011","Brent 029B","E01000473",1491,77,19,58,158,116,109,98,285,230,189,166,23,229
"2011","Brent 029C","E01000475",1518,93,13,80,207,171,142,99,256,178,163,136,27,209
"2011","Brent 029D","E01000478",1279,55,6,49,149,113,132,94,244,207,121,100,21,164
"2011","Brent 029E","E01000632",1606,96,14,82,181,179,152,79,301,205,176,153,23,237
"2011","Brent 030A","E01000489",1160,178,25,153,291,106,125,43,108,69,74,68,6,166
"2011","Brent 030B","E01000491",1465,236,39,197,368,120,186,68,114,93,145,115,30,135
"2011","Brent 030C","E01000492",1001,134,27,107,264,85,146,43,96,71,61,48,13,101
"2011","Brent 030D","E01000493",1241,162,30,132,327,138,174,55,103,83,90,62,28,109
"2011","Brent 030E","E01000581",1172,154,42,112,414,106,110,70,99,72,60,42,18,87
"2011","Brent 031A","E01000523",1887,88,19,69,302,166,241,134,228,287,228,172,56,213
"2011","Brent 031B","E01000524",1796,77,14,63,258,160,194,95,235,253,274,199,75,250
"2011","Brent 031C","E01000525",1447,75,12,63,202,144,178,103,203,207,174,117,57,161
"2011","Brent 031E","E01000533",1676,88,15,73,288,139,201,97,235,251,215,166,49,162
"2011","Brent 031F","E01000535",1675,135,31,104,377,171,195,97,196,163,134,105,29,207
"2011","Brent 031G","E01033455",902,40,3,37,124,76,120,69,130,125,139,109,30,79
"2011","Brent 031H","E01033485",1481,85,10,75,236,131,150,87,173,196,216,166,50,207
"2011","Brent 032A","E01000579",1338,151,32,119,364,134,137,58,148,127,89,69,20,130
"2011","Brent 032B","E01000580",1500,283,65,218,468,135,183,64,106,70,72,46,26,119
"2011","Brent 032C","E01000582",1392,254,62,192,475,123,171,42,84,82,66,49,17,95
"2011","Brent 032D","E01000583",1856,320,53,267,554,163,175,75,145,124,117,80,37,183
"2011","Brent 032E","E01000586",2012,280,62,218,544,202,213,119,167,153,155,115,40,179
"2011","Brent 033A","E01000530",1438,192,32,160,384,153,170,66,144,118,84,61,23,127
"2011","Brent 033B","E01000531",1619,155,25,130,396,136,183,107,160,191,130,93,37,161
"2011","Brent 033C","E01000532",1313,161,27,134,368,134,135,71,157,122,78,53,25,87
"2011","Brent 033D","E01000534",1325,130,24,106,323,118,194,55,141,104,89,68,21,171
"2011","Brent 033E","E01000584",1282,146,33,113,346,122,140,64,117,135,76,56,20,136
"2011","Brent 033F","E01000585",1379,183,34,149,422,133,173,63,105,115,88,53,35,97
"2011","Brent 034A","E01000544",1329,99,10,89,245,115,129,55,191,145,186,149,37,164
"2011","Brent 034B","E01000550",1529,153,19,134,345,152,116,79,199,172,164,115,49,149
"2011","Brent 034C","E01000551",1520,79,19,60,248,150,110,91,221,159,273,196,77,189
"2011","Brent 034D","E01000552",1263,50,11,39,163,142,91,87,205,141,222,156,66,162
"2011","Bromley 001A","E01000779",929,133,31,102,273,144,116,42,81,38,43,27,16,59
"2011","Bromley 001B","E01000780",1058,84,21,63,220,175,104,74,148,102,74,49,25,77
"2011","Bromley 001C","E01000781",998,68,11,57,171,141,103,70,175,120,73,44,29,77
"2011","Bromley 001D","E01000782",979,56,15,41,151,125,105,77,167,115,94,67,27,89
"2011","Bromley 001E","E01000783",1019,58,8,50,181,131,104,63,168,131,89,57,32,94
"2011","Bromley 001F","E01000785",974,73,22,51,174,148,94,76,160,108,61,38,23,80
"2011","Bromley 002A","E01000689",974,126,25,101,184,177,127,52,101,89,55,38,17,63
"2011","Bromley 002B","E01000690",1014,163,40,123,290,180,114,48,91,37,30,19,11,61
"2011","Bromley 002C","E01000691",1043,132,31,101,234,172,114,62,133,86,37,21,16,73
"2011","Bromley 002D","E01000692",1162,176,41,135,341,211,130,61,98,48,33,18,15,64
"2011","Bromley 002E","E01000784",1095,142,36,106,275,190,112,73,128,65,33,20,13,77
"2011","Bromley 004A","E01000799",1255,155,40,115,311,170,126,69,145,70,85,53,32,124
"2011","Bromley 004B","E01000802",1326,177,32,145,374,166,130,80,128,78,90,61,29,103
"2011","Bromley 004C","E01000803",1200,166,36,130,368,155,108,64,96,68,72,53,19,103
"2011","Bromley 004D","E01000804",1055,191,30,161,306,154,132,41,85,43,31,12,19,72
"2011","Bromley 004E","E01000805",1156,148,38,110,297,174,104,58,118,96,71,46,25,90
"2011","Bromley 005A","E01000740",1339,126,24,102,306,183,134,97,157,113,86,54,32,137
"2011","Bromley 005B","E01000741",1289,194,31,163,326,149,108,72,124,122,94,63,31,100
"2011","Bromley 005C","E01000742",1608,199,32,167,472,220,149,75,162,112,109,70,39,110
"2011","Bromley 005D","E01000745",1370,204,33,171,423,163,133,65,123,84,91,61,30,84
"2011","Bromley 005E","E01000746",1466,249,56,193,466,173,135,63,135,81,90,54,36,74
"2011","Bromley 006A","E01000709",988,170,34,136,318,165,99,41,81,39,40,23,17,35
"2011","Bromley 006B","E01000710",1296,278,53,225,442,240,106,44,54,43,40,24,16,49
"2011","Bromley 006C","E01000711",1390,323,54,269,449,222,97,50,99,48,44,28,16,58
"2011","Bromley 006D","E01000714",1500,299,59,240,516,236,123,83,86,50,44,10,34,63
"2011","Bromley 006E","E01000718",1514,194,44,150,389,230,123,79,161,107,117,70,47,114
"2011","Bromley 007A","E01000645",996,283,72,211,306,140,106,13,37,14,14,8,6,83
"2011","Bromley 007B","E01000649",1387,358,85,273,376,194,138,35,97,45,34,26,8,110
"2011","Bromley 007C","E01000694",1069,294,70,224,319,157,112,25,54,18,25,16,9,65
"2011","Bromley 007D","E01000695",1047,210,48,162,338,182,90,36,67,30,19,13,6,75
"2011","Bromley 007E","E01000696",1000,274,63,211,306,134,110,15,42,25,21,14,7,73
"2011","Bromley 007F","E01000697",1211,297,51,246,413,161,130,44,55,22,25,12,13,64
"2011","Bromley 008A","E01000674",1174,215,42,173,357,164,121,48,90,62,52,38,14,65
"2011","Bromley 008B","E01000676",1293,209,50,159,345,193,106,91,130,65,84,51,33,70
"2011","Bromley 008C","E01000820",1017,193,48,145,299,143,99,42,88,51,49,34,15,53
"2011","Bromley 008D","E01000822",1196,191,30,161,345,184,116,48,122,61,53,27,26,76
"2011","Bromley 008E","E01000823",1295,253,57,196,409,208,118,45,84,50,48,25,23,80
"2011","Bromley 008F","E01000824",900,131,27,104,271,116,88,47,91,66,37,19,18,53
"2011","Bromley 008G","E01000825",1189,204,38,166,341,205,95,53,99,54,79,52,27,59
"2011","Bromley 009A","E01000743",1300,107,19,88,256,171,125,80,200,102,143,109,34,116
"2011","Bromley 009B","E01000744",1072,55,12,43,155,136,82,74,165,139,139,94,45,127
"2011","Bromley 009C","E01000796",1157,54,15,39,195,125,85,72,189,126,142,97,45,169
"2011","Bromley 009D","E01000798",1112,47,7,40,173,116,115,73,195,120,163,104,59,110
"2011","Bromley 009E","E01000800",1238,101,17,84,281,163,115,89,138,122,111,58,53,118
"2011","Bromley 009F","E01000806",1262,98,17,81,283,159,109,74,170,105,118,78,40,146
"2011","Bromley 010A","E01000693",1019,171,46,125,280,141,112,39,80,27,28,16,12,141
"2011","Bromley 010B","E01000698",875,161,35,126,238,137,126,30,60,33,25,18,7,65
"2011","Bromley 010C","E01000736",1068,76,16,60,198,180,136,62,154,110,53,38,15,99
"2011","Bromley 010D","E01000737",925,86,31,55,157,173,80,63,150,94,69,50,19,53
"2011","Bromley 011A","E01000672",1093,189,45,144,333,167,128,59,100,43,23,15,8,51
"2011","Bromley 011B","E01000673",1118,184,42,142,337,193,126,49,89,48,34,22,12,58
"2011","Bromley 011C","E01000716",1104,257,52,205,327,189,105,35,67,22,37,25,12,65
"2011","Bromley 011D","E01000717",1295,227,57,170,436,236,123,56,72,53,33,20,13,59
"2011","Bromley 011E","E01000828",1131,229,55,174,335,182,104,43,92,53,28,18,10,65
"2011","Bromley 012A","E01000712",1297,270,65,205,414,230,135,52,72,38,25,17,8,61
"2011","Bromley 012B","E01000713",1338,264,52,212,452,211,137,37,95,49,35,22,13,58
"2011","Bromley 012C","E01000715",1236,268,44,224,423,209,110,42,79,45,21,10,11,39
"2011","Bromley 012D","E01000770",998,252,58,194,313,145,99,26,55,28,26,16,10,54
"2011","Bromley 012E","E01000772",1016,200,47,153,336,158,122,32,61,25,27,21,6,55
"2011","Bromley 013A","E01000700",1147,189,46,143,332,181,99,53,128,63,42,22,20,60
"2011","Bromley 013B","E01000702",1031,171,41,130,306,173,99,53,74,55,36,19,17,64
"2011","Bromley 013C","E01000703",1193,234,43,191,371,183,119,41,92,51,26,14,12,76
"2011","Bromley 013D","E01000706",968,96,18,78,264,169,108,68,106,65,32,18,14,60
"2011","Bromley 013E","E01000797",1210,256,54,202,349,182,112,50,80,53,52,32,20,76
"2011","Bromley 014A","E01000729",1238,58,8,50,180,175,95,79,256,167,146,89,57,82
"2011","Bromley 014B","E01000730",1143,47,10,37,174,150,96,87,178,152,115,82,33,144
"2011","Bromley 014C","E01000735",1034,65,16,49,161,160,100,76,155,123,95,62,33,99
"2011","Bromley 014D","E01000738",1055,97,21,76,192,176,144,74,147,112,41,20,21,72
"2011","Bromley 014E","E01000739",995,56,16,40,139,146,62,74,195,143,95,63,32,85
"2011","Bromley 015A","E01000699",1096,106,35,71,293,134,113,62,126,71,90,51,39,101
"2011","Bromley 015B","E01000701",1028,146,24,122,314,171,96,49,105,54,45,31,14,48
"2011","Bromley 015C","E01000704",1039,124,25,99,269,187,114,53,103,60,40,18,22,89
"2011","Bromley 015D","E01000705",982,133,33,100,288,139,87,48,95,53,64,41,23,75
"2011","Bromley 015E","E01000801",1052,83,23,60,279,149,121,66,106,108,65,36,29,75
"2011","Bromley 016A","E01000646",1163,239,44,195,355,175,98,67,84,39,44,29,15,62
"2011","Bromley 016B","E01000647",1154,179,39,140,323,198,142,46,99,54,37,19,18,76
"2011","Bromley 016C","E01000648",1245,224,49,175,343,198,157,56,88,53,38,23,15,88
"2011","Bromley 016D","E01000653",1093,218,50,168,326,147,125,31,81,38,38,29,9,89
"2011","Bromley 016E","E01000678",1239,216,37,179,355,195,124,55,96,55,42,27,15,101
"2011","Bromley 018A","E01000670",1461,379,57,322,442,189,137,50,86,38,51,22,29,89
"2011","Bromley 018B","E01000675",1226,244,45,199,345,189,106,39,104,58,44,25,19,97
"2011","Bromley 018C","E01000677",1325,205,40,165,445,177,148,51,117,63,52,23,29,67
"2011","Bromley 018D","E01000762",1156,188,31,157,332,214,122,45,105,43,43,21,22,64
"2011","Bromley 018E","E01000829",1264,242,46,196,388,203,106,57,108,55,36,24,12,69
"2011","Bromley 019A","E01000719",1330,97,22,75,279,204,109,117,214,141,92,59,33,77
"2011","Bromley 019B","E01000720",1143,67,18,49,192,156,124,82,194,118,121,88,33,89
"2011","Bromley 019C","E01000721",897,25,5,20,136,111,62,71,185,111,107,79,28,89
"2011","Bromley 019D","E01000724",1130,54,4,50,149,134,110,86,214,131,131,85,46,121
"2011","Bromley 019E","E01000728",1071,90,21,69,205,170,115,101,155,106,67,42,25,62
"2011","Bromley 020A","E01000651",1079,214,51,163,309,178,114,36,80,49,27,16,11,72
"2011","Bromley 020B","E01000668",1193,188,40,148,326,185,129,58,117,69,39,27,12,82
"2011","Bromley 020C","E01000669",1194,152,32,120,348,197,130,58,131,57,47,22,25,74
"2011","Bromley 020D","E01000671",1264,200,37,163,348,200,130,64,123,66,46,26,20,87
"2011","Bromley 020E","E01000679",1188,149,39,110,350,202,132,63,130,67,27,15,12,68
"2011","Bromley 021A","E01000826",1163,246,43,203,343,192,132,31,69,22,17,11,6,111
"2011","Bromley 021B","E01000827",1196,218,50,168,373,179,131,51,94,46,34,18,16,70
"2011","Bromley 021C","E01000830",1089,232,52,180,364,145,135,24,48,15,28,19,9,98
"2011","Bromley 021D","E01000831",1158,257,59,198,350,188,106,36,71,43,37,21,16,70
"2011","Bromley 021E","E01000833",998,170,37,133,289,177,124,28,88,23,20,14,6,79
"2011","Bromley 022A","E01000650",1315,321,71,250,368,192,116,28,86,54,44,30,14,106
"2011","Bromley 022B","E01000652",1158,179,47,132,318,224,146,45,94,50,19,14,5,83
"2011","Bromley 022C","E01000807",1098,210,52,158,303,199,98,40,82,36,36,19,17,94
"2011","Bromley 022D","E01000809",1053,164,37,127,295,212,105,45,96,54,25,8,17,57
"2011","Bromley 023A","E01000722",1173,87,20,67,246,190,117,84,213,110,60,31,29,66
"2011","Bromley 023B","E01000725",1174,100,22,78,259,174,115,99,172,116,67,36,31,72
"2011","Bromley 023C","E01000731",940,77,16,61,177,166,94,58,141,94,61,42,19,72
"2011","Bromley 023D","E01000732",1052,140,32,108,236,171,130,65,114,74,50,31,19,72
"2011","Bromley 023E","E01000733",1138,86,19,67,229,204,126,92,169,96,52,27,25,84
"2011","Bromley 024A","E01000769",1063,119,28,91,267,172,105,50,110,59,95,82,13,86
"2011","Bromley 024B","E01000773",1006,145,35,110,280,197,106,49,78,51,27,15,12,73
"2011","Bromley 024C","E01000775",1547,273,71,202,487,228,170,52,117,55,39,28,11,126
"2011","Bromley 024D","E01000777",1098,150,34,116,275,206,138,50,113,49,28,13,15,89
"2011","Bromley 024E","E01000778",1122,101,18,83,240,224,132,63,131,90,48,34,14,93
"2011","Bromley 025A","E01000808",1115,219,54,165,312,189,110,43,104,42,29,21,8,67
"2011","Bromley 025B","E01000810",1078,227,55,172,323,205,100,40,77,23,25,12,13,58
"2011","Bromley 025C","E01000811",979,172,31,141,258,191,96,47,88,54,19,12,7,54
"2011","Bromley 025D","E01000813",1118,171,36,135,304,212,98,55,117,57,39,28,11,65
"2011","Bromley 025E","E01000815",1105,230,44,186,345,209,113,32,53,22,15,11,4,86
"2011","Bromley 026A","E01000661",1108,58,15,43,194,148,102,84,192,126,108,74,34,96
"2011","Bromley 026B","E01000662",1220,116,27,89,268,183,151,57,157,99,86,54,32,103
"2011","Bromley 026C","E01000663",1104,103,15,88,233,197,138,62,150,103,52,27,25,66
"2011","Bromley 026D","E01000664",1136,97,18,79,232,207,128,66,128,107,64,35,29,107
"2011","Bromley 027A","E01000763",1047,146,34,112,274,208,130,41,107,44,20,15,5,77
"2011","Bromley 027B","E01000764",1122,142,36,106,244,202,117,66,139,85,28,18,10,99
"2011","Bromley 027C","E01000766",1213,193,46,147,323,264,129,63,100,43,21,13,8,77
"2011","Bromley 027D","E01000767",1144,181,38,143,332,224,117,50,106,37,20,12,8,77
"2011","Bromley 027E","E01000834",956,119,28,91,265,164,123,41,88,48,17,9,8,91
"2011","Bromley 028A","E01000727",1114,130,29,101,269,189,121,65,148,84,44,23,21,64
"2011","Bromley 028B","E01000734",945,125,28,97,211,163,110,55,117,63,36,23,13,65
"2011","Bromley 028C","E01000790",1481,263,49,214,377,213,129,77,165,84,68,39,29,105
"2011","Bromley 028D","E01000812",1136,186,36,150,303,190,103,62,124,60,45,32,13,63
"2011","Bromley 028E","E01000814",1156,255,60,195,328,205,96,39,77,36,21,13,8,99
"2011","Bromley 029A","E01000723",914,60,17,43,189,211,109,57,126,87,30,15,15,45
"2011","Bromley 029B","E01000726",947,90,16,74,265,166,85,73,117,70,29,19,10,52
"2011","Bromley 029C","E01000787",1000,94,27,67,204,184,92,89,143,95,44,25,19,55
"2011","Bromley 029D","E01000788",1122,121,26,95,260,197,98,84,145,77,57,32,25,83
"2011","Bromley 029E","E01000791",991,104,18,86,234,197,98,62,133,73,28,22,6,62
"2011","Bromley 030A","E01000832",1056,166,37,129,298,188,128,40,76,34,33,20,13,93
"2011","Bromley 030B","E01000835",1119,140,28,112,296,237,107,55,112,57,24,13,11,91
"2011","Bromley 030C","E01000836",983,151,38,113,282,163,106,55,76,33,19,9,10,98
"2011","Bromley 030D","E01000837",1017,160,37,123,273,177,101,58,102,58,25,17,8,63
"2011","Bromley 030E","E01000838",982,130,18,112,269,183,109,43,95,46,18,9,9,89
"2011","Bromley 030F","E01000839",1106,182,38,144,344,210,111,43,89,26,21,9,12,80
"2011","Bromley 030G","E01000840",1048,164,40,124,286,226,107,41,109,35,21,8,13,59
"2011","Bromley 030H","E01000841",1108,154,43,111,304,223,112,43,121,51,24,13,11,76
"2011","Bromley 031A","E01000753",1186,194,44,150,337,272,95,50,86,42,21,10,11,89
"2011","Bromley 031B","E01000754",1165,150,30,120,315,243,118,57,107,59,33,20,13,83
"2011","Bromley 031C","E01000755",1027,162,46,116,286,196,98,51,89,33,20,11,9,92
"2011","Bromley 031D","E01000757",1097,189,40,149,333,227,88,50,87,33,13,6,7,77
"2011","Bromley 031E","E01000758",1037,187,33,154,314,197,81,35,79,28,18,11,7,98
"2011","Bromley 032A","E01000786",986,137,29,108,265,185,126,53,87,51,27,17,10,55
"2011","Bromley 032B","E01000789",1121,53,12,41,160,132,77,79,219,160,142,94,48,99
"2011","Bromley 032C","E01000792",773,83,12,71,171,152,72,52,94,57,33,21,12,59
"2011","Bromley 032D","E01000793",1131,202,43,159,320,215,100,46,99,48,28,19,9,73
"2011","Bromley 032E","E01000795",984,134,31,103,214,170,88,50,123,82,44,29,15,79
"2011","Bromley 033A","E01000665",1296,132,32,100,338,244,196,68,130,59,43,26,17,86
"2011","Bromley 033B","E01000666",1304,238,72,166,387,203,169,46,117,42,24,14,10,78
"2011","Bromley 033C","E01000667",1118,206,58,148,278,178,187,49,77,27,28,17,11,88
"2011","Bromley 033D","E01000756",1094,187,32,155,298,192,145,42,83,44,21,17,4,82
"2011","Bromley 034A","E01000759",1113,155,38,117,312,201,160,47,89,38,19,13,6,92
"2011","Bromley 034B","E01000760",1029,130,33,97,244,207,125,55,95,64,28,19,9,81
"2011","Bromley 034C","E01000761",1131,134,39,95,287,243,146,58,104,55,24,12,12,80
"2011","Bromley 034D","E01000765",1221,161,40,121,334,225,151,67,104,60,29,18,11,90
"2011","Bromley 034E","E01000768",1116,190,35,155,335,194,91,45,72,42,30,13,17,117
"2011","Bromley 035A","E01000681",1221,195,41,154,338,264,97,57,118,54,19,10,9,79
"2011","Bromley 035B","E01000682",1035,156,29,127,281,193,97,50,108,41,20,11,9,89
"2011","Bromley 035C","E01000683",1170,161,28,133,292,231,100,56,122,72,60,44,16,76
"2011","Bromley 035D","E01000684",1456,262,44,218,402,255,128,73,121,61,42,23,19,112
"2011","Bromley 035E","E01000794",1124,148,31,117,318,210,128,60,121,46,25,18,7,68
"2011","Bromley 036A","E01000749",1132,127,36,91,301,173,157,72,125,83,24,19,5,70
"2011","Bromley 036B","E01000750",1088,89,26,63,203,168,111,72,166,124,61,43,18,94
"2011","Bromley 036C","E01000751",1368,216,46,170,334,240,141,64,132,65,76,64,12,100
"2011","Bromley 036D","E01000752",1050,142,39,103,283,196,99,64,120,59,35,16,19,52
"2011","Bromley 037A","E01000680",1192,218,60,158,335,182,182,48,94,49,22,15,7,62
"2011","Bromley 037B","E01000685",1107,142,22,120,297,167,116,73,136,68,39,24,15,69
"2011","Bromley 037C","E01000686",1069,172,45,127,304,186,122,43,113,43,27,16,11,59
"2011","Bromley 037D","E01000687",1161,151,35,116,348,220,118,52,111,57,33,22,11,71
"2011","Bromley 037E","E01000688",985,209,49,160,272,160,101,35,83,44,24,16,8,57
"2011","Bromley 039A","E01000654",959,75,21,54,226,191,130,77,142,60,21,9,12,37
"2011","Bromley 039B","E01000655",979,92,28,64,241,181,123,78,122,57,29,16,13,56
"2011","Bromley 039C","E01000656",1070,119,33,86,266,233,141,59,108,60,25,18,7,59
"2011","Bromley 039D","E01000657",1171,102,33,69,281,224,170,86,122,93,30,18,12,63
"2011","Bromley 039E","E01000659",1112,94,26,68,255,227,136,98,116,91,21,11,10,74
"2011","Bromley 040A","E01000816",1102,112,27,85,281,188,114,73,134,80,51,32,19,69
"2011","Bromley 040B","E01000818",1072,146,39,107,265,183,139,56,116,55,32,24,8,80
"2011","Bromley 040C","E01000819",1183,115,16,99,251,181,135,52,144,103,101,67,34,101
"2011","Bromley 040D","E01032562",1021,63,10,53,175,161,86,72,175,108,92,64,28,89
"2011","Bromley 040E","E01032563",1002,177,36,141,273,145,165,37,69,48,39,28,11,49
"2011","Bromley 041A","E01000707",1009,203,30,173,359,158,91,38,60,32,15,5,10,53
"2011","Bromley 041B","E01000708",1107,183,44,139,325,193,104,57,93,52,47,34,13,53
"2011","Bromley 041C","E01000771",1188,200,44,156,378,169,128,29,103,54,39,19,20,88
"2011","Bromley 041D","E01000774",1062,171,51,120,277,189,116,61,93,55,30,19,11,70
"2011","Bromley 041E","E01032568",1059,106,14,92,228,195,102,54,148,104,50,24,26,72
"2011","Bromley 042A","E01000658",1006,99,24,75,254,213,121,78,105,56,18,9,9,62
"2011","Bromley 042B","E01000747",1374,186,75,111,333,213,224,68,120,97,60,43,17,73
"2011","Bromley 042C","E01000748",1190,147,31,116,297,208,196,60,121,66,40,30,10,55
"2011","Bromley 042D","E01032570",1124,138,39,99,277,202,146,69,123,55,33,25,8,81
"2011","Croydon 001A","E01001137",1340,187,39,148,404,165,127,68,116,72,100,59,41,101
"2011","Croydon 001B","E01001138",1180,217,43,174,375,162,92,50,95,56,49,29,20,84
"2011","Croydon 001C","E01001156",1183,143,30,113,278,147,122,61,122,78,100,64,36,132
"2011","Croydon 001D","E01001162",1261,135,28,107,314,148,126,49,139,124,112,68,44,114
"2011","Croydon 001E","E01001164",1550,229,39,190,486,210,163,68,144,70,93,65,28,87
"2011","Croydon 002A","E01001084",1314,218,33,185,317,183,181,51,108,61,89,67,22,106
"2011","Croydon 002B","E01001157",1259,142,26,116,268,167,175,56,135,87,91,70,21,138
"2011","Croydon 002C","E01001159",1339,154,36,118,338,191,194,66,116,85,81,53,28,114
"2011","Croydon 002D","E01001160",1437,149,30,119,285,203,206,73,144,71,122,97,25,184
"2011","Croydon 002E","E01001163",1417,174,42,132,367,187,171,78,133,109,77,47,30,121
"2011","Croydon 003A","E01001083",1158,154,21,133,268,165,152,37,108,63,79,57,22,132
"2011","Croydon 003B","E01001086",1317,134,22,112,297,195,162,60,123,78,114,88,26,154
"2011","Croydon 003C","E01001087",1692,145,21,124,356,232,209,72,173,135,160,118,42,210
"2011","Croydon 003D","E01001161",1327,61,11,50,194,162,112,70,193,126,200,156,44,209
"2011","Croydon 004A","E01001085",1138,115,18,97,222,152,180,63,130,66,88,73,15,122
"2011","Croydon 004B","E01001088",1205,98,31,67,240,187,148,67,138,99,90,60,30,138
"2011","Croydon 004C","E01001089",1293,87,11,76,228,167,163,59,160,120,137,97,40,172
"2011","Croydon 004D","E01001090",1629,167,27,140,329,215,150,92,201,129,140,109,31,206
"2011","Croydon 004E","E01001091",1187,126,16,110,283,186,168,50,114,54,93,57,36,113
"2011","Croydon 005A","E01001147",1105,70,15,55,191,138,91,58,156,105,133,79,54,163
"2011","Croydon 005B","E01001148",1158,90,22,68,242,185,93,57,156,103,106,68,38,126
"2011","Croydon 005C","E01001151",1138,55,9,46,186,151,121,63,160,117,140,105,35,145
"2011","Croydon 005D","E01001152",1176,82,25,57,210,156,117,75,148,117,131,96,35,140
"2011","Croydon 005E","E01001158",1141,99,18,81,255,191,116,65,119,96,80,45,35,120
"2011","Croydon 006A","E01001146",1190,81,18,63,265,190,102,50,153,111,89,57,32,149
"2011","Croydon 006B","E01001149",1102,88,23,65,284,179,103,59,111,67,92,59,33,119
"2011","Croydon 006C","E01001150",1186,127,37,90,328,164,97,56,103,86,76,46,30,149
"2011","Croydon 006D","E01001153",1160,78,28,50,250,191,112,59,158,70,81,54,27,161
"2011","Croydon 006E","E01001154",1353,70,13,57,237,154,141,90,206,120,158,109,49,177
"2011","Croydon 007A","E01001136",1401,101,21,80,287,221,144,69,174,129,160,98,62,116
"2011","Croydon 007B","E01001139",1196,119,32,87,307,203,94,62,139,77,75,43,32,120
"2011","Croydon 007C","E01001140",1211,146,34,112,351,181,111,56,122,62,81,45,36,101
"2011","Croydon 007D","E01001142",1119,149,28,121,300,173,118,45,116,56,62,38,24,100
"2011","Croydon 007E","E01001144",1250,91,25,66,265,168,105,72,146,98,143,101,42,162
"2011","Croydon 008A","E01001141",909,68,23,45,188,150,100,57,113,75,66,44,22,92
"2011","Croydon 008B","E01001143",1371,107,19,88,283,178,103,104,183,129,133,82,51,151
"2011","Croydon 008C","E01001145",1210,52,9,43,226,170,122,75,173,130,110,73,37,152
"2011","Croydon 008D","E01001191",1319,90,23,67,286,202,114,79,182,95,144,80,64,127
"2011","Croydon 008E","E01001192",1155,84,16,68,251,189,91,79,172,74,113,63,50,102
"2011","Croydon 009A","E01000994",1153,97,12,85,213,188,118,53,127,69,119,94,25,169
"2011","Croydon 009B","E01000995",1137,97,23,74,184,145,108,63,161,95,120,85,35,164
"2011","Croydon 009C","E01000996",949,80,12,68,202,158,80,46,135,50,66,52,14,132
"2011","Croydon 009D","E01000997",1005,78,21,57,169,163,84,38,132,76,121,92,29,144
"2011","Croydon 009E","E01000999",1016,70,9,61,179,165,103,48,140,91,90,71,19,130
"2011","Croydon 009F","E01001002",969,69,17,52,175,123,81,81,139,79,74,58,16,148
"2011","Croydon 010A","E01000998",1170,97,20,77,233,159,111,61,165,73,119,92,27,152
"2011","Croydon 010B","E01001000",945,76,17,59,191,131,98,52,117,72,85,59,26,123
"2011","Croydon 010C","E01001003",1081,89,15,74,209,151,90,63,180,108,94,64,30,97
"2011","Croydon 010D","E01001111",1166,81,27,54,249,149,97,80,167,89,85,54,31,169
"2011","Croydon 010E","E01001155",1169,62,13,49,213,151,79,81,158,113,158,130,28,154
"2011","Croydon 011A","E01001174",1146,71,13,58,210,169,115,55,194,76,96,72,24,160
"2011","Croydon 011B","E01001175",1093,78,15,63,169,159,114,50,153,94,124,85,39,152
"2011","Croydon 011C","E01001176",1321,93,16,77,228,190,126,60,203,101,145,120,25,175
"2011","Croydon 011D","E01001182",1009,89,13,76,188,134,104,46,122,80,98,82,16,148
"2011","Croydon 011E","E01001183",1168,80,17,63,199,164,99,52,178,117,116,88,28,163
"2011","Croydon 011F","E01001184",995,76,12,64,197,157,87,59,136,73,64,50,14,146
"2011","Croydon 013A","E01001001",861,62,18,44,165,129,78,45,116,75,101,72,29,90
"2011","Croydon 013B","E01001109",1367,113,19,94,254,175,122,71,203,120,158,120,38,151
"2011","Croydon 013C","E01001112",1215,85,12,73,261,169,99,70,164,116,114,71,43,137
"2011","Croydon 013D","E01001113",1299,108,27,81,296,200,124,80,163,94,104,62,42,130
"2011","Croydon 013E","E01001114",961,53,10,43,177,128,72,63,151,84,120,83,37,113
"2011","Croydon 013F","E01001116",973,60,10,50,203,132,68,47,135,95,94,68,26,139
"2011","Croydon 014A","E01000992",1370,81,14,67,263,223,109,88,199,126,127,87,40,154
"2011","Croydon 014B","E01001185",1231,121,28,93,297,204,129,64,146,87,74,47,27,109
"2011","Croydon 014C","E01001186",1280,113,26,87,270,194,130,84,154,89,137,91,46,109
"2011","Croydon 014D","E01001188",1306,106,28,78,265,207,126,76,166,86,134,89,45,140
"2011","Croydon 014E","E01001193",1225,75,14,61,227,176,76,67,189,88,115,83,32,212
"2011","Croydon 015A","E01001004",1470,105,22,83,272,232,94,83,224,100,156,121,35,204
"2011","Croydon 015B","E01001115",1172,50,10,40,180,150,82,65,187,114,161,120,41,183
"2011","Croydon 015C","E01001117",2028,148,28,120,426,240,177,94,291,156,235,190,45,261
"2011","Croydon 015D","E01001178",959,52,6,46,139,94,64,49,146,99,154,109,45,162
"2011","Croydon 015E","E01001181",1290,64,15,49,228,160,103,78,230,121,136,105,31,170
"2011","Croydon 016A","E01001006",1045,74,13,61,175,149,100,72,181,87,87,62,25,120
"2011","Croydon 016B","E01001007",1396,80,9,71,199,177,118,92,210,122,176,141,35,222
"2011","Croydon 016C","E01001177",1132,57,16,41,199,143,79,70,173,103,111,87,24,197
"2011","Croydon 016D","E01001179",1071,63,12,51,212,169,86,58,184,76,79,60,19,144
"2011","Croydon 016E","E01001180",1205,49,7,42,216,172,97,88,183,112,133,102,31,155
"2011","Croydon 017A","E01000980",1045,114,20,94,251,178,80,50,141,67,66,45,21,98
"2011","Croydon 017B","E01000981",1187,135,30,105,299,205,88,72,131,89,73,53,20,95
"2011","Croydon 017C","E01000982",1213,161,27,134,283,186,93,66,138,95,94,57,37,97
"2011","Croydon 017D","E01000983",1311,145,30,115,365,217,106,82,138,83,60,36,24,115
"2011","Croydon 017E","E01001187",1430,129,32,97,322,223,108,100,188,91,115,71,44,154
"2011","Croydon 018A","E01000989",1235,144,33,111,292,238,141,76,118,83,35,22,13,108
"2011","Croydon 018B","E01000991",1212,149,29,120,294,238,166,49,120,63,44,32,12,89
"2011","Croydon 018C","E01001131",1127,96,25,71,270,233,133,76,143,61,39,18,21,76
"2011","Croydon 018D","E01001132",1111,138,31,107,258,229,114,73,107,48,43,28,15,101
"2011","Croydon 018E","E01001134",1234,148,33,115,340,210,136,69,126,66,48,32,16,91
"2011","Croydon 019A","E01001005",1172,56,11,45,191,142,99,82,191,117,136,106,30,158
"2011","Croydon 019B","E01001008",1110,53,13,40,139,127,87,85,187,144,130,100,30,158
"2011","Croydon 019C","E01001009",1262,82,18,64,206,167,67,66,211,104,139,119,20,220
"2011","Croydon 019D","E01001010",1040,37,6,31,134,149,77,67,191,151,118,91,27,116
"2011","Croydon 019E","E01001011",1409,66,10,56,257,184,81,87,234,131,167,123,44,202
"2011","Croydon 020A","E01001012",1440,108,20,88,225,159,109,70,235,128,207,152,55,199
"2011","Croydon 020B","E01001013",1445,63,11,52,215,183,96,97,221,164,203,146,57,203
"2011","Croydon 020C","E01001048",1471,253,23,230,336,203,76,76,195,89,122,75,47,121
"2011","Croydon 020D","E01001110",1335,138,14,124,257,206,95,74,162,113,142,100,42,148
"2011","Croydon 020E","E01001118",1354,80,14,66,228,175,123,73,200,135,165,118,47,175
"2011","Croydon 021A","E01000985",1085,122,20,102,263,184,142,70,106,54,49,30,19,95
"2011","Croydon 021B","E01000986",1262,191,32,159,365,223,127,52,92,50,58,46,12,104
"2011","Croydon 021C","E01000987",1088,116,17,99,276,237,122,61,90,58,35,23,12,93
"2011","Croydon 021D","E01000993",1194,124,24,100,294,225,129,56,128,71,54,36,18,113
"2011","Croydon 022A","E01000975",1287,232,34,198,330,190,102,59,118,55,92,64,28,109
"2011","Croydon 022B","E01000976",1452,171,24,147,326,190,153,84,173,107,104,71,33,144
"2011","Croydon 022C","E01000977",1350,192,35,157,326,199,93,81,153,101,125,77,48,80
"2011","Croydon 022D","E01000978",1424,259,30,229,374,218,84,76,136,95,89,57,32,93
"2011","Croydon 022E","E01000979",1348,258,35,223,389,207,103,79,123,64,50,40,10,75
"2011","Croydon 022F","E01000984",1325,157,23,134,347,204,93,57,139,108,101,67,34,119
"2011","Croydon 023A","E01001044",1392,328,60,268,439,212,94,54,70,37,83,67,16,75
"2011","Croydon 023B","E01001046",1310,375,39,336,386,179,81,31,68,29,77,57,20,84
"2011","Croydon 023C","E01001049",1058,280,46,234,261,142,100,18,57,25,68,50,18,107
"2011","Croydon 023D","E01001050",1123,289,29,260,276,138,54,34,103,73,87,63,24,69
"2011","Croydon 024A","E01001014",1952,203,34,169,436,284,136,139,288,161,155,114,41,150
"2011","Croydon 024B","E01001042",1417,186,40,146,315,192,104,88,167,103,133,94,39,129
"2011","Croydon 024C","E01001165",1238,119,23,96,298,188,122,92,135,108,68,42,26,108
"2011","Croydon 024D","E01001166",1328,123,26,97,249,208,118,80,186,126,101,61,40,137
"2011","Croydon 024E","E01001168",1318,149,31,118,338,231,115,65,148,90,63,43,20,119
"2011","Croydon 025A","E01001127",1210,152,41,111,311,269,115,59,120,54,40,21,19,90
"2011","Croydon 025B","E01001128",1071,62,18,44,179,160,72,60,173,117,119,79,40,129
"2011","Croydon 025C","E01001130",1053,35,10,25,150,110,67,60,177,126,166,120,46,162
"2011","Croydon 025D","E01001135",1211,171,36,135,283,239,143,54,121,56,41,24,17,103
"2011","Croydon 026A","E01001062",1156,174,40,134,325,193,124,50,94,45,36,28,8,115
"2011","Croydon 026B","E01001063",1167,179,28,151,308,199,124,61,111,47,34,22,12,104
"2011","Croydon 026C","E01001064",1173,201,44,157,292,211,138,45,100,49,34,21,13,103
"2011","Croydon 026D","E01001129",1092,150,39,111,303,200,115,54,107,45,20,16,4,98
"2011","Croydon 026E","E01001133",1053,143,31,112,245,199,138,51,93,63,55,37,18,66
"2011","Croydon 027A","E01001035",1399,238,35,203,388,215,105,67,113,73,96,63,33,104
"2011","Croydon 027B","E01001043",2052,243,26,217,511,264,193,130,228,135,170,109,61,178
"2011","Croydon 027C","E01001045",1457,264,34,230,372,200,98,77,130,102,125,77,48,89
"2011","Croydon 027D","E01001047",1352,218,33,185,347,208,128,54,137,85,64,49,15,111
"2011","Croydon 027E","E01001170",1496,200,23,177,331,241,127,96,166,104,104,74,30,127
"2011","Croydon 028A","E01001167",1599,184,34,150,364,242,130,111,177,113,122,83,39,156
"2011","Croydon 028B","E01001169",1142,83,9,74,192,153,86,83,180,146,95,74,21,124
"2011","Croydon 028C","E01001171",1124,130,17,113,231,159,103,75,145,90,79,61,18,112
"2011","Croydon 028D","E01001172",1198,48,7,41,188,141,106,87,178,149,149,115,34,152
"2011","Croydon 028E","E01001173",1856,223,37,186,482,273,174,89,209,117,120,84,36,169
"2011","Croydon 029A","E01001036",1114,246,34,212,343,133,91,43,51,32,85,65,20,90
"2011","Croydon 029B","E01001037",1033,129,22,107,261,188,76,49,116,83,67,44,23,64
"2011","Croydon 029C","E01001038",1488,272,48,224,419,236,117,73,138,76,72,47,25,85
"2011","Croydon 029D","E01001039",1091,224,41,183,345,179,89,37,74,29,39,25,14,75
"2011","Croydon 029E","E01001040",1287,170,34,136,354,247,100,61,120,100,69,52,17,66
"2011","Croydon 030A","E01001051",996,31,9,22,127,118,90,75,204,161,104,73,31,86
"2011","Croydon 030B","E01001052",918,27,2,25,126,91,59,68,185,152,104,74,30,106
"2011","Croydon 030C","E01001054",1171,29,6,23,156,166,92,85,196,184,131,103,28,132
"2011","Croydon 030D","E01001056",1093,31,3,28,150,115,69,68,196,180,147,112,35,137
"2011","Croydon 030E","E01001057",1085,27,6,21,120,116,55,51,217,156,182,130,52,161
"2011","Croydon 031A","E01001033",1180,195,33,162,312,178,104,47,110,77,66,33,33,91
"2011","Croydon 031B","E01001034",1184,149,26,123,353,175,124,66,124,79,43,26,17,71
"2011","Croydon 031C","E01001041",1203,156,24,132,308,201,115,59,123,88,74,42,32,79
"2011","Croydon 031D","E01001095",1112,126,21,105,323,193,103,52,115,55,49,25,24,96
"2011","Croydon 031E","E01001100",1093,179,40,139,306,210,113,42,99,63,22,14,8,59
"2011","Croydon 032A","E01001053",1022,34,8,26,151,143,89,93,181,157,92,76,16,82
"2011","Croydon 032B","E01001055",1098,31,13,18,134,130,106,90,197,201,110,80,30,99
"2011","Croydon 032C","E01001077",1032,66,12,54,180,183,127,76,160,120,46,21,25,74
"2011","Croydon 032D","E01001078",966,52,17,35,128,137,85,87,189,122,79,53,26,87
"2011","Croydon 032E","E01001082",1102,47,16,31,148,150,105,81,213,163,107,75,32,88
"2011","Croydon 033A","E01001120",931,105,16,89,201,199,98,67,112,57,22,13,9,70
"2011","Croydon 033B","E01001122",1205,202,43,159,327,178,114,48,91,46,37,28,9,162
"2011","Croydon 033C","E01001123",1068,155,37,118,293,224,108,52,84,37,27,20,7,88
"2011","Croydon 033D","E01001124",1159,212,38,174,325,217,127,38,91,34,32,19,13,83
"2011","Croydon 033E","E01001125",1254,141,30,111,307,240,135,70,114,65,77,55,22,105
"2011","Croydon 034A","E01001058",941,118,23,95,245,181,87,53,99,58,34,20,14,66
"2011","Croydon 034B","E01001059",1086,105,22,83,270,233,100,80,112,77,37,32,5,72
"2011","Croydon 034C","E01001060",1152,107,20,87,274,233,107,91,123,84,51,32,19,82
"2011","Croydon 034D","E01001061",1124,83,21,62,223,193,109,101,158,102,62,36,26,93
"2011","Croydon 034E","E01001065",1026,106,24,82,280,211,109,68,102,58,38,18,20,54
"2011","Croydon 034F","E01001066",910,40,6,34,135,127,94,63,158,106,101,72,29,86
"2011","Croydon 034G","E01001119",1135,149,34,115,249,261,126,75,120,66,22,14,8,67
"2011","Croydon 034H","E01001126",1061,126,25,101,274,225,103,56,115,70,27,20,7,65
"2011","Croydon 035A","E01001032",968,202,41,161,289,164,114,28,51,37,19,13,6,64
"2011","Croydon 035B","E01001101",1035,170,44,126,302,201,98,33,80,29,27,17,10,95
"2011","Croydon 035C","E01001102",996,177,42,135,261,159,131,36,82,39,27,24,3,84
"2011","Croydon 035D","E01001107",1213,256,45,211,388,213,104,23,75,35,34,21,13,85
"2011","Croydon 035E","E01001108",1235,232,38,194,410,201,108,36,96,31,31,16,15,90
"2011","Croydon 036A","E01001076",1086,46,9,37,142,152,92,94,207,162,104,70,34,87
"2011","Croydon 036B","E01001079",1113,52,14,38,118,153,118,107,199,153,98,65,33,115
"2011","Croydon 036C","E01001080",1062,36,11,25,110,141,78,83,212,168,141,109,32,93
"2011","Croydon 036D","E01001081",957,34,8,26,101,140,91,83,178,147,96,71,25,87
"2011","Croydon 037A","E01001073",1109,199,45,154,315,172,93,47,105,47,56,37,19,75
"2011","Croydon 037B","E01001092",1221,252,61,191,305,156,125,40,76,42,125,101,24,100
"2011","Croydon 037C","E01001093",1233,177,41,136,329,196,114,59,126,59,75,53,22,98
"2011","Croydon 037D","E01001096",1145,251,48,203,304,193,107,33,76,34,39,30,9,108
"2011","Croydon 037E","E01001097",1594,254,37,217,445,246,134,51,160,99,98,73,25,107
"2011","Croydon 037F","E01001098",1063,254,41,213,322,164,91,26,68,20,45,32,13,73
"2011","Croydon 038A","E01001028",1188,250,45,205,296,189,160,32,58,32,56,38,18,115
"2011","Croydon 038B","E01001029",1183,213,38,175,314,171,134,46,70,41,97,81,16,97
"2011","Croydon 038C","E01001030",1020,209,36,173,276,136,123,33,73,20,46,42,4,104
"2011","Croydon 038D","E01001031",1087,190,35,155,312,172,117,33,81,43,37,20,17,102
"2011","Croydon 038E","E01001094",1142,259,65,194,307,146,160,21,55,18,70,57,13,106
"2011","Croydon 039A","E01001103",1127,143,33,110,300,209,127,66,100,51,46,25,21,85
"2011","Croydon 039B","E01001105",1194,102,26,76,235,206,127,87,177,108,53,33,20,99
"2011","Croydon 039C","E01001106",1051,111,25,86,210,198,129,85,114,79,46,34,12,79
"2011","Croydon 039D","E01001121",1030,162,31,131,308,176,128,52,76,42,26,21,5,60
"2011","Croydon 040A","E01001069",969,163,33,130,287,161,101,39,85,37,32,26,6,64
"2011","Croydon 040B","E01001070",1164,152,36,116,281,195,126,67,122,59,71,50,21,91
"2011","Croydon 040C","E01001075",1084,162,30,132,304,189,101,52,118,48,49,25,24,61
"2011","Croydon 040D","E01001099",1084,176,43,133,273,162,80,54,109,55,80,52,28,95
"2011","Croydon 041A","E01001015",1036,119,28,91,264,160,98,47,120,86,53,31,22,89
"2011","Croydon 041B","E01001016",1227,162,40,122,332,222,124,65,121,50,56,39,17,95
"2011","Croydon 041C","E01001023",957,104,21,83,228,142,113,64,96,79,56,27,29,75
"2011","Croydon 041D","E01001067",1174,255,42,213,365,180,128,37,68,34,38,26,12,69
"2011","Croydon 041E","E01001074",1464,192,38,154,395,240,131,85,140,85,86,55,31,110
"2011","Croydon 042A","E01001068",1379,209,38,171,365,204,148,57,145,70,60,30,30,121
"2011","Croydon 042B","E01001071",1374,179,43,136,359,246,133,79,158,86,48,35,13,86
"2011","Croydon 042C","E01001072",1035,215,67,148,299,156,140,33,71,24,26,17,9,71
"2011","Croydon 042D","E01001104",1224,230,50,180,349,237,107,36,98,46,31,15,16,90
"2011","Croydon 043A","E01001017",1208,230,53,177,380,194,142,41,76,29,50,34,16,66
"2011","Croydon 043B","E01001024",1062,153,35,118,291,179,80,55,101,69,34,16,18,100
"2011","Croydon 043C","E01001025",940,110,19,91,243,188,101,55,92,57,31,20,11,63
"2011","Croydon 043D","E01001026",1245,126,23,103,295,224,129,101,146,91,34,23,11,99
"2011","Croydon 043E","E01001027",1140,146,38,108,314,171,149,58,102,65,51,36,15,84
"2011","Croydon 044A","E01001018",1113,135,39,96,338,217,121,57,97,71,25,13,12,52
"2011","Croydon 044B","E01001019",1088,195,39,156,292,198,102,44,93,47,33,21,12,84
"2011","Croydon 044C","E01001020",1159,137,33,104,303,207,112,73,131,86,35,23,12,75
"2011","Croydon 044D","E01001021",858,57,15,42,149,125,78,68,139,94,65,42,23,83
"2011","Croydon 044E","E01001022",1001,114,23,91,268,201,119,59,87,45,42,26,16,66
"2011","Croydon 045A","E01000990",1000,45,15,30,141,146,90,54,158,118,123,89,34,125
"2011","Croydon 045B","E01001189",879,73,17,56,198,152,60,44,119,75,52,37,15,106
"2011","Croydon 045C","E01001190",1112,93,24,69,240,199,76,52,154,94,62,43,19,142
"2011","Croydon 045D","E01001194",1141,110,40,70,299,167,89,68,143,86,64,37,27,115
"2011","Croydon 045E","E01032569",1180,51,11,40,173,151,99,81,203,140,126,90,36,156
"2011","Ealing 001A","E01001269",1465,135,20,115,253,192,253,81,195,132,83,60,23,141
"2011","Ealing 001B","E01001271",1345,102,19,83,249,154,181,79,192,132,135,100,35,121
"2011","Ealing 001C","E01001309",1366,99,19,80,269,190,172,85,163,140,109,89,20,139
"2011","Ealing 001D","E01001310",1346,115,25,90,236,195,135,104,167,128,120,92,28,146
"2011","Ealing 001E","E01001311",1494,88,18,70,187,159,202,99,224,215,173,131,42,147
"2011","Ealing 002A","E01001307",1400,141,39,102,239,202,242,83,139,122,103,65,38,129
"2011","Ealing 002B","E01001308",1541,180,30,150,298,228,184,90,178,125,108,91,17,150
"2011","Ealing 002C","E01001312",1360,136,26,110,225,168,213,95,154,124,107,89,18,138
"2011","Ealing 002D","E01001313",1295,133,28,105,226,174,166,83,169,115,95,73,22,134
"2011","Ealing 002E","E01001314",1194,109,19,90,227,142,187,67,171,115,71,52,19,105
"2011","Ealing 003A","E01001315",1091,64,16,48,204,161,112,98,159,113,82,66,16,98
"2011","Ealing 003B","E01001316",1105,55,9,46,176,151,76,78,194,140,136,99,37,99
"2011","Ealing 003C","E01001317",1302,100,26,74,235,145,144,77,184,135,146,112,34,136
"2011","Ealing 003D","E01001318",1217,79,11,68,180,139,131,81,172,165,145,115,30,125
"2011","Ealing 003E","E01001320",1021,47,12,35,131,119,87,70,175,119,123,87,36,150
"2011","Ealing 003F","E01001321",1449,109,10,99,247,205,171,103,185,159,133,93,40,137
"2011","Ealing 004A","E01001270",1281,124,29,95,255,179,141,70,144,114,106,81,25,148
"2011","Ealing 004B","E01001319",1071,84,17,67,166,174,116,75,162,92,94,74,20,108
"2011","Ealing 004C","E01001322",1289,112,20,92,221,174,166,71,183,107,119,89,30,136
"2011","Ealing 004D","E01001323",1304,135,14,121,249,170,136,87,198,99,106,85,21,124
"2011","Ealing 005A","E01001341",1283,101,17,84,194,134,199,88,192,120,115,91,24,140
"2011","Ealing 005B","E01001342",1410,145,11,134,233,181,208,61,166,133,126,103,23,157
"2011","Ealing 005C","E01001343",1135,93,15,78,207,144,175,82,133,95,106,86,20,100
"2011","Ealing 005D","E01001345",1225,75,18,57,152,112,151,81,175,173,147,125,22,159
"2011","Ealing 006A","E01001265",1264,106,17,89,218,162,189,84,145,163,114,89,25,83
"2011","Ealing 006B","E01001266",1404,115,14,101,245,166,192,103,166,128,116,88,28,173
"2011","Ealing 006C","E01001267",1388,102,22,80,260,178,157,93,172,155,158,126,32,113
"2011","Ealing 006D","E01001272",1213,124,24,100,212,156,194,64,130,119,94,70,24,120
"2011","Ealing 006E","E01001349",1057,106,29,77,179,104,133,69,120,117,126,104,22,103
"2011","Ealing 007A","E01001344",1639,193,30,163,327,212,232,94,162,153,135,113,22,131
"2011","Ealing 007B","E01001346",1388,138,25,113,265,166,250,92,139,128,99,79,20,111
"2011","Ealing 007C","E01001347",1189,99,16,83,189,134,230,74,133,135,90,69,21,105
"2011","Ealing 007D","E01001348",1207,134,23,111,284,135,172,68,137,123,76,68,8,78
"2011","Ealing 008A","E01001257",1186,47,7,40,135,131,118,78,149,170,207,160,47,151
"2011","Ealing 008B","E01001324",1133,87,16,71,206,173,115,76,121,114,135,99,36,106
"2011","Ealing 008C","E01001326",1169,71,13,58,191,123,119,77,162,147,151,124,27,128
"2011","Ealing 008D","E01001330",1127,49,8,41,138,121,99,101,198,158,165,132,33,98
"2011","Ealing 008E","E01001332",1091,44,5,39,156,157,73,59,184,119,164,125,39,135
"2011","Ealing 009A","E01001325",1225,58,20,38,193,161,123,99,183,129,133,110,23,146
"2011","Ealing 009B","E01001327",1288,71,15,56,181,152,137,97,170,136,171,145,26,173
"2011","Ealing 009C","E01001328",1184,63,12,51,160,138,114,75,179,151,170,133,37,134
"2011","Ealing 009D","E01001329",1208,76,20,56,215,157,112,77,161,115,122,88,34,173
"2011","Ealing 009E","E01001331",1118,40,7,33,150,108,91,81,169,142,202,151,51,135
"2011","Ealing 010B","E01001258",1242,101,18,83,224,154,150,76,161,144,109,75,34,123
"2011","Ealing 010C","E01001262",1107,41,7,34,186,136,125,66,151,143,127,94,33,132
"2011","Ealing 010D","E01001263",1219,63,20,43,205,182,121,80,161,145,139,111,28,123
"2011","Ealing 010E","E01001264",1131,78,13,65,190,141,150,59,144,124,128,93,35,117
"2011","Ealing 010F","E01032743",1473,147,28,119,289,166,144,85,161,126,180,147,33,175
"2011","Ealing 010G","E01032744",1013,65,10,55,167,111,90,67,149,116,131,118,13,117
"2011","Ealing 011A","E01001276",1372,148,28,120,267,143,220,66,143,142,120,91,29,123
"2011","Ealing 011B","E01001277",1438,191,35,156,293,137,217,70,126,142,108,85,23,154
"2011","Ealing 011C","E01001278",1461,226,42,184,306,138,236,60,112,88,155,113,42,140
"2011","Ealing 011D","E01001280",1315,282,41,241,354,163,135,44,83,51,99,82,17,104
"2011","Ealing 012A","E01001218",1350,66,9,57,197,152,145,74,197,171,195,164,31,153
"2011","Ealing 012B","E01001260",1406,102,22,80,259,179,199,83,158,151,124,101,23,151
"2011","Ealing 012C","E01001261",1667,82,12,70,260,191,178,132,205,188,184,144,40,247
"2011","Ealing 012D","E01001268",1220,143,23,120,245,187,185,68,119,105,86,67,19,82
"2011","Ealing 013A","E01001209",1235,302,58,244,413,116,125,29,65,40,42,25,17,103
"2011","Ealing 013B","E01001211",1270,293,61,232,381,141,119,38,75,43,85,68,17,95
"2011","Ealing 013C","E01001279",1092,291,46,245,337,137,105,26,41,23,41,27,14,91
"2011","Ealing 013D","E01001281",1091,289,47,242,397,112,84,24,51,28,21,12,9,85
"2011","Ealing 014A","E01001217",1147,69,12,57,209,163,120,77,146,115,100,85,15,148
"2011","Ealing 014B","E01001259",1094,73,16,57,182,118,175,61,151,124,106,83,23,104
"2011","Ealing 014C","E01001291",1210,82,16,66,196,151,130,73,168,129,127,96,31,154
"2011","Ealing 014D","E01001292",1289,106,25,81,224,169,148,81,165,118,100,84,16,178
"2011","Ealing 014E","E01001293",1191,75,13,62,179,137,124,72,186,111,127,108,19,180
"2011","Ealing 015A","E01001196",1276,87,12,75,233,145,149,66,149,132,157,124,33,158
"2011","Ealing 015B","E01001238",2385,254,33,221,549,241,201,127,210,160,243,181,62,400
"2011","Ealing 015C","E01001239",1203,82,14,68,236,141,140,53,125,119,147,107,40,160
"2011","Ealing 015D","E01001246",1000,73,17,56,203,86,129,95,98,112,104,71,33,100
"2011","Ealing 015E","E01001247",1688,175,26,149,317,206,195,98,161,158,166,129,37,212
"2011","Ealing 016A","E01001210",1174,83,18,65,208,118,90,56,125,144,219,174,45,131
"2011","Ealing 016B","E01001282",1095,73,20,53,169,120,166,77,149,111,116,89,27,114
"2011","Ealing 016C","E01001283",1120,90,28,62,211,134,123,57,156,118,125,97,28,106
"2011","Ealing 016D","E01001285",1221,106,22,84,233,136,187,71,143,111,105,86,19,129
"2011","Ealing 016E","E01001286",1171,88,24,64,243,142,178,62,123,108,92,79,13,135
"2011","Ealing 016F","E01001287",1014,63,14,49,156,126,114,62,120,96,135,102,33,142
"2011","Ealing 017A","E01001294",1457,88,20,68,210,165,121,112,225,191,154,127,27,191
"2011","Ealing 017B","E01001295",1376,96,19,77,206,172,92,79,227,173,156,132,24,175
"2011","Ealing 017C","E01001296",1115,61,15,46,146,133,89,78,192,134,123,99,24,159
"2011","Ealing 017D","E01001297",1366,76,20,56,185,130,135,74,222,179,167,148,19,198
"2011","Ealing 017E","E01001298",1400,77,18,59,161,153,101,97,236,188,202,160,42,185
"2011","Ealing 018A","E01001204",1191,213,38,175,343,131,131,41,81,50,77,63,14,124
"2011","Ealing 018B","E01001205",1151,131,25,106,252,116,129,55,98,78,136,101,35,156
"2011","Ealing 018C","E01001206",1133,80,14,66,164,103,117,47,108,87,227,186,41,200
"2011","Ealing 018D","E01001207",1258,251,56,195,361,135,129,64,74,63,78,53,25,103
"2011","Ealing 018E","E01001208",937,190,47,143,310,99,111,17,62,30,40,25,15,78
"2011","Ealing 018F","E01001212",1207,263,55,208,367,137,121,43,73,44,83,68,15,76
"2011","Ealing 019A","E01001222",1951,402,65,337,539,185,169,92,132,107,153,109,44,172
"2011","Ealing 019B","E01001224",1210,295,55,240,382,127,125,23,65,35,37,27,10,121
"2011","Ealing 019C","E01001226",1166,281,43,238,363,127,109,31,71,44,54,44,10,86
"2011","Ealing 019D","E01001227",1137,302,70,232,329,132,113,25,60,28,55,45,10,93
"2011","Ealing 019E","E01001228",1446,302,42,260,398,155,164,41,100,67,86,67,19,133
"2011","Ealing 020A","E01001221",1625,349,50,299,554,169,119,64,102,75,65,38,27,128
"2011","Ealing 020B","E01001223",1220,348,48,300,351,111,111,34,56,30,73,44,29,106
"2011","Ealing 020C","E01001225",1385,339,43,296,413,148,100,44,88,54,62,39,23,137
"2011","Ealing 020D","E01001235",1333,346,49,297,430,153,91,42,79,47,52,38,14,93
"2011","Ealing 020E","E01001236",1251,308,37,271,384,162,84,45,62,44,67,49,18,95
"2011","Ealing 020F","E01001273",1208,291,65,226,316,120,141,26,82,32,83,74,9,117
"2011","Ealing 020G","E01001274",1140,245,39,206,291,130,83,36,70,30,124,116,8,131
"2011","Ealing 020H","E01001275",1508,387,63,324,454,149,122,62,71,48,124,98,26,91
"2011","Ealing 021A","E01001195",1372,165,24,141,261,150,147,68,102,88,120,98,22,271
"2011","Ealing 021B","E01001197",1228,157,23,134,312,123,135,57,124,81,116,89,27,123
"2011","Ealing 021C","E01001198",1130,137,35,102,309,113,148,64,104,68,61,35,26,126
"2011","Ealing 021D","E01001199",1311,161,23,138,366,142,157,67,130,68,100,66,34,120
"2011","Ealing 022A","E01001284",1139,119,19,100,270,163,136,69,117,93,54,38,16,118
"2011","Ealing 022B","E01001288",1091,143,30,113,287,122,157,48,103,84,52,35,17,95
"2011","Ealing 022C","E01001289",1002,152,23,129,274,115,147,37,71,63,57,42,15,86
"2011","Ealing 022D","E01001290",1423,210,35,175,402,162,201,58,109,77,61,40,21,143
"2011","Ealing 023A","E01001213",1407,71,6,65,177,156,106,97,213,178,213,176,37,196
"2011","Ealing 023B","E01001214",1350,99,15,84,203,152,86,104,207,164,129,107,22,206
"2011","Ealing 023C","E01001215",1285,80,9,71,156,128,72,84,209,158,208,176,32,190
"2011","Ealing 023D","E01001216",1158,104,13,91,197,125,83,71,141,145,146,127,19,146
"2011","Ealing 023E","E01001361",1334,45,7,38,143,108,110,94,180,220,238,205,33,196
"2011","Ealing 024A","E01001240",1230,92,23,69,231,124,125,76,128,115,130,104,26,209
"2011","Ealing 024B","E01001241",1157,114,19,95,206,109,142,73,130,109,111,95,16,163
"2011","Ealing 024C","E01001242",1043,109,29,80,215,102,137,34,86,82,113,91,22,165
"2011","Ealing 024D","E01001243",1230,134,28,106,258,142,129,48,104,101,137,114,23,177
"2011","Ealing 024E","E01001244",1934,283,46,237,392,179,145,96,186,140,193,151,42,320
"2011","Ealing 024F","E01001245",1520,233,41,192,473,155,146,78,137,85,66,44,22,147
"2011","Ealing 025A","E01001200",1177,150,28,122,359,109,155,64,84,76,84,64,20,96
"2011","Ealing 025B","E01001201",1211,165,29,136,365,146,128,54,80,91,78,50,28,104
"2011","Ealing 025C","E01001202",1552,139,22,117,359,119,165,100,166,134,167,132,35,203
"2011","Ealing 025D","E01001203",1424,158,29,129,348,146,172,72,139,150,135,99,36,104
"2011","Ealing 025E","E01001351",1486,180,32,148,347,157,169,91,130,125,129,102,27,158
"2011","Ealing 026A","E01001359",1594,54,10,44,162,128,95,118,284,223,271,235,36,259
"2011","Ealing 026B","E01001360",1437,84,11,73,150,118,87,123,210,215,200,166,34,250
"2011","Ealing 026C","E01001362",1511,66,13,53,154,117,96,94,270,235,234,200,34,245
"2011","Ealing 026D","E01001363",1198,47,10,37,115,92,78,80,215,199,203,171,32,169
"2011","Ealing 026E","E01001364",1253,51,5,46,134,107,77,91,189,155,223,210,13,226
"2011","Ealing 026F","E01001365",1652,61,7,54,194,126,128,110,259,257,276,236,40,241
"2011","Ealing 027A","E01001231",1444,290,59,231,423,148,157,69,85,39,73,59,14,160
"2011","Ealing 027B","E01001234",1156,221,29,192,382,128,94,53,82,51,58,40,18,87
"2011","Ealing 027C","E01001350",1131,207,51,156,336,121,120,45,80,34,87,65,22,101
"2011","Ealing 027D","E01001352",1171,226,47,179,349,120,138,40,69,48,67,51,16,114
"2011","Ealing 027E","E01001354",1398,256,46,210,389,140,164,50,67,89,94,75,19,149
"2011","Ealing 028A","E01001249",1776,196,27,169,393,165,209,102,204,121,211,151,60,175
"2011","Ealing 028B","E01001250",1619,203,34,169,353,194,177,96,162,159,170,119,51,105
"2011","Ealing 028C","E01001255",1200,215,45,170,355,148,109,58,79,70,67,38,29,99
"2011","Ealing 028D","E01001383",1424,239,35,204,417,152,137,62,122,80,71,53,18,144
"2011","Ealing 028E","E01001388",1249,175,30,145,315,130,132,54,124,83,115,92,23,121
"2011","Ealing 028F","E01001389",1348,227,32,195,366,151,155,57,102,85,102,77,25,103
"2011","Ealing 029A","E01001219",1380,52,7,45,148,133,93,82,199,185,269,238,31,219
"2011","Ealing 029B","E01001220",996,47,10,37,114,99,65,62,135,121,224,192,32,129
"2011","Ealing 029C","E01001334",1145,47,7,40,118,113,80,79,179,160,194,163,31,175
"2011","Ealing 029D","E01001337",1129,75,12,63,199,148,108,49,153,104,124,95,29,169
"2011","Ealing 029E","E01001338",1417,86,23,63,208,139,107,83,179,154,289,251,38,172
"2011","Ealing 029F","E01001339",1295,70,12,58,202,143,108,68,178,122,224,185,39,180
"2011","Ealing 029G","E01001340",1521,98,17,81,308,144,100,80,195,149,317,287,30,130
"2011","Ealing 030A","E01001251",1266,163,31,132,387,147,163,52,83,92,69,52,17,110
"2011","Ealing 030B","E01001252",1474,163,21,142,347,169,192,88,143,125,98,56,42,149
"2011","Ealing 030C","E01001253",1250,150,32,118,336,148,141,62,121,95,79,56,23,118
"2011","Ealing 030D","E01001254",1257,198,53,145,424,123,151,59,91,67,64,41,23,80
"2011","Ealing 031A","E01001229",1126,108,26,82,243,125,128,80,121,101,114,84,30,106
"2011","Ealing 031B","E01001230",1233,282,45,237,375,121,127,32,76,45,85,49,36,90
"2011","Ealing 031C","E01001232",1182,235,34,201,252,143,107,49,113,76,94,71,23,113
"2011","Ealing 031D","E01001233",1123,186,29,157,323,134,110,52,81,65,58,48,10,114
"2011","Ealing 031E","E01001237",1271,329,56,273,388,138,122,44,51,37,62,52,10,100
"2011","Ealing 031F","E01001386",1366,362,64,298,469,124,121,35,44,55,45,26,19,111
"2011","Ealing 032A","E01001303",1243,281,49,232,425,139,115,41,69,37,41,29,12,95
"2011","Ealing 032B","E01001382",1106,283,68,215,330,123,103,46,62,29,36,27,9,94
"2011","Ealing 032C","E01001384",1316,276,57,219,381,156,155,47,89,63,49,32,17,100
"2011","Ealing 032D","E01001385",1292,257,59,198,433,144,107,47,86,61,44,31,13,113
"2011","Ealing 032E","E01001387",1223,301,49,252,371,139,107,39,60,50,73,42,31,83
"2011","Ealing 033A","E01001353",1296,166,20,146,317,139,141,74,108,114,107,83,24,130
"2011","Ealing 033B","E01001355",1327,166,22,144,381,131,123,70,107,118,100,71,29,131
"2011","Ealing 033C","E01001356",1334,60,13,47,188,135,139,74,199,164,253,213,40,122
"2011","Ealing 033D","E01001357",787,59,8,51,135,82,100,35,95,70,103,85,18,108
"2011","Ealing 033E","E01001358",1065,51,11,40,139,89,100,56,133,123,212,165,47,162
"2011","Ealing 034A","E01001375",1276,401,90,311,455,104,113,26,42,29,24,15,9,82
"2011","Ealing 034B","E01001377",1299,343,84,259,454,100,118,29,64,40,45,32,13,106
"2011","Ealing 034C","E01001379",1278,387,81,306,455,100,119,25,52,25,22,13,9,93
"2011","Ealing 034D","E01001381",1346,214,45,169,356,127,144,75,108,84,77,47,30,161
"2011","Ealing 035A","E01001248",1172,139,24,115,284,143,141,53,120,106,87,61,26,99
"2011","Ealing 035B","E01001299",1341,234,38,196,372,191,152,51,83,58,55,31,24,145
"2011","Ealing 035C","E01001305",1292,234,55,179,420,146,144,50,102,55,42,28,14,99
"2011","Ealing 035D","E01001306",1223,262,33,229,430,138,130,40,81,31,38,22,16,73
"2011","Ealing 037A","E01001366",1434,53,11,42,141,128,127,106,243,190,223,188,35,223
"2011","Ealing 037B","E01001367",1327,40,7,33,95,89,115,80,221,220,210,188,22,257
"2011","Ealing 037C","E01001368",1266,42,10,32,153,94,104,108,198,164,186,159,27,217
"2011","Ealing 037D","E01001370",1503,57,8,49,169,132,118,114,234,212,223,178,45,244
"2011","Ealing 037E","E01001371",1480,69,15,54,165,130,107,96,275,207,224,176,48,207
"2011","Ealing 037F","E01001372",1341,51,10,41,143,128,106,74,186,202,227,196,31,224
"2011","Ealing 037G","E01001373",1096,43,4,39,115,83,87,70,183,183,158,132,26,174
"2011","Ealing 038A","E01001333",1382,54,5,49,146,122,105,90,202,189,247,201,46,227
"2011","Ealing 038B","E01001335",1308,146,26,120,258,168,147,64,160,96,110,84,26,159
"2011","Ealing 038C","E01001336",1183,100,17,83,179,152,121,59,162,126,146,126,20,138
"2011","Ealing 038D","E01001369",1405,70,10,60,203,120,114,85,211,189,222,187,35,191
"2011","Ealing 039A","E01001300",1227,295,46,249,402,123,112,39,79,61,29,22,7,87
"2011","Ealing 039B","E01001301",1481,218,37,181,395,129,136,64,80,65,54,36,18,340
"2011","Ealing 039C","E01001302",1220,227,33,194,372,151,145,52,89,57,50,26,24,77
"2011","Ealing 039D","E01001304",1283,253,43,210,428,153,115,49,76,78,38,26,12,93
"2011","Ealing 040A","E01001374",1424,330,71,259,461,134,111,55,85,67,75,58,17,106
"2011","Ealing 040B","E01001376",1283,220,46,174,384,139,113,57,101,98,83,63,20,88
"2011","Ealing 040C","E01001380",1401,332,60,272,481,128,128,46,68,48,47,26,21,123
"2011","Ealing 040D","E01032572",1300,322,67,255,447,126,108,43,87,56,47,27,20,64
"2011","Enfield 001A","E01001444",1215,79,18,61,196,185,122,79,177,124,112,81,31,141
"2011","Enfield 001B","E01001446",1291,77,6,71,217,187,111,74,184,170,147,106,41,124
"2011","Enfield 001C","E01001546",1263,76,15,61,202,175,133,84,180,147,137,92,45,129
"2011","Enfield 001D","E01001552",1266,95,22,73,229,186,136,85,161,148,96,76,20,130
"2011","Enfield 002A","E01001442",1047,33,11,22,110,105,78,82,176,138,185,131,54,140
"2011","Enfield 002B","E01001545",1233,50,15,35,160,128,99,86,184,158,187,153,34,181
"2011","Enfield 002C","E01001547",1255,81,19,62,201,145,135,79,189,140,167,131,36,118
"2011","Enfield 002D","E01001548",1264,78,13,65,188,139,121,90,207,135,171,144,27,135
"2011","Enfield 002E","E01001551",1177,66,21,45,156,140,106,76,160,145,185,145,40,143
"2011","Enfield 003B","E01001445",1631,132,21,111,336,202,153,110,190,152,208,161,47,148
"2011","Enfield 003C","E01001447",1373,46,11,35,183,150,130,94,209,181,235,178,57,145
"2011","Enfield 003D","E01001448",1292,72,11,61,229,146,91,78,169,147,185,132,53,175
"2011","Enfield 003E","E01001449",1108,55,15,40,193,134,109,63,153,149,138,98,40,114
"2011","Enfield 003F","E01033148",1295,115,21,94,210,135,120,67,151,115,205,172,33,177
"2011","Enfield 003G","E01033150",1145,115,24,91,252,130,91,63,145,97,145,105,40,107
"2011","Enfield 004A","E01001408",1235,145,36,109,362,177,148,64,132,82,60,38,22,65
"2011","Enfield 004B","E01001411",1319,165,47,118,384,204,122,68,113,91,78,50,28,94
"2011","Enfield 004C","E01001412",1336,100,26,74,268,196,218,83,159,116,87,66,21,109
"2011","Enfield 004D","E01001413",1153,133,48,85,342,186,152,61,111,56,37,26,11,75
"2011","Enfield 004E","E01001414",1077,59,13,46,214,111,89,71,156,143,118,87,31,116
"2011","Enfield 005A","E01001407",1174,116,29,87,257,185,142,77,129,98,76,52,24,94
"2011","Enfield 005B","E01001409",1355,85,10,75,246,193,133,81,189,129,175,129,46,124
"2011","Enfield 005C","E01001410",1191,80,11,69,202,155,89,65,183,127,169,117,52,121
"2011","Enfield 005D","E01001516",1286,62,13,49,220,180,144,91,179,135,139,111,28,136
"2011","Enfield 005E","E01001537",1225,130,32,98,338,204,136,79,115,74,68,45,23,81
"2011","Enfield 006A","E01001439",1367,58,15,43,177,137,138,69,238,171,233,194,39,146
"2011","Enfield 006B","E01001441",1093,54,16,38,148,118,107,81,176,133,165,127,38,111
"2011","Enfield 006C","E01001517",1271,37,5,32,150,128,85,82,197,188,240,189,51,164
"2011","Enfield 006D","E01001549",1317,60,16,44,173,121,92,93,228,175,243,199,44,132
"2011","Enfield 006E","E01001550",1147,64,17,47,170,139,117,67,162,143,140,107,33,145
"2011","Enfield 007A","E01001433",1240,36,10,26,174,129,101,92,192,173,173,121,52,170
"2011","Enfield 007B","E01001434",1109,58,17,41,160,153,134,90,144,141,108,84,24,121
"2011","Enfield 007C","E01001435",1042,59,12,47,173,135,114,73,140,126,93,66,27,129
"2011","Enfield 007D","E01001436",1314,59,16,43,220,177,149,82,200,129,148,113,35,150
"2011","Enfield 007E","E01001438",1183,69,15,54,171,138,103,65,173,136,157,126,31,171
"2011","Enfield 008A","E01001469",1186,162,34,128,270,147,137,67,129,88,90,66,24,96
"2011","Enfield 008B","E01001536",1280,197,33,164,411,175,131,52,120,59,66,43,23,69
"2011","Enfield 008C","E01001540",1328,183,34,149,386,239,131,54,117,70,67,38,29,81
"2011","Enfield 008D","E01001541",1104,184,48,136,355,170,111,58,71,64,37,32,5,54
"2011","Enfield 008E","E01001542",1102,85,22,63,274,191,109,51,116,97,97,75,22,82
"2011","Enfield 009A","E01001538",1221,130,35,95,304,247,124,69,130,81,46,31,15,90
"2011","Enfield 009B","E01001539",1216,136,28,108,300,211,137,70,133,71,58,42,16,100
"2011","Enfield 009C","E01001543",1176,157,42,115,264,216,132,60,99,90,57,39,18,101
"2011","Enfield 009D","E01001544",1144,152,27,125,278,192,117,57,107,81,69,48,21,91
"2011","Enfield 010A","E01001457",1209,238,54,184,322,202,117,50,102,53,47,29,18,78
"2011","Enfield 010B","E01001468",995,161,32,129,236,126,118,44,90,69,92,84,8,59
"2011","Enfield 010C","E01001471",1333,218,38,180,371,227,137,46,119,71,75,49,26,69
"2011","Enfield 010D","E01001472",1253,187,34,153,343,195,119,58,116,71,59,38,21,105
"2011","Enfield 010E","E01001474",1377,307,66,241,409,196,146,58,90,46,40,25,15,85
"2011","Enfield 011A","E01001415",1110,135,30,105,246,163,142,57,102,65,69,56,13,131
"2011","Enfield 011B","E01001417",1433,267,68,199,288,153,202,32,64,32,47,41,6,348
"2011","Enfield 011C","E01001418",1218,149,31,118,272,183,164,47,107,79,77,46,31,140
"2011","Enfield 011D","E01001422",1196,293,75,218,308,130,189,23,59,24,43,34,9,127
"2011","Enfield 012A","E01001440",1152,70,20,50,178,130,112,79,177,130,136,105,31,140
"2011","Enfield 012B","E01001504",1084,59,16,43,140,132,116,70,149,112,144,116,28,162
"2011","Enfield 012C","E01001505",1241,67,13,54,179,143,96,71,173,145,178,138,40,189
"2011","Enfield 012D","E01001507",1336,67,16,51,165,153,121,96,191,147,219,173,46,177
"2011","Enfield 012E","E01001508",1396,68,18,50,207,194,99,96,183,129,219,177,42,201
"2011","Enfield 012F","E01001513",1208,67,12,55,204,131,102,84,189,145,129,93,36,157
"2011","Enfield 013A","E01001416",1278,228,40,188,314,199,159,47,89,51,59,39,20,132
"2011","Enfield 013B","E01001470",1126,134,32,102,301,189,153,27,84,57,48,34,14,133
"2011","Enfield 013C","E01001473",1099,95,21,74,226,181,129,52,123,89,80,54,26,124
"2011","Enfield 013D","E01001475",1218,201,43,158,295,201,160,42,93,58,64,45,19,104
"2011","Enfield 014A","E01001437",1598,82,17,65,232,200,140,93,252,200,227,176,51,172
"2011","Enfield 014B","E01001506",1113,42,8,34,145,113,90,71,164,141,188,151,37,159
"2011","Enfield 014C","E01001509",1236,52,7,45,175,131,95,78,207,146,180,148,32,172
"2011","Enfield 014D","E01001510",960,25,9,16,94,75,48,62,195,133,211,162,49,117
"2011","Enfield 015A","E01001405",1238,182,44,138,369,176,152,61,105,60,71,46,25,62
"2011","Enfield 015B","E01001406",1190,125,21,104,290,148,142,59,127,93,92,72,20,114
"2011","Enfield 015C","E01001450",1403,191,32,159,353,178,147,85,156,85,96,71,25,112
"2011","Enfield 015D","E01001512",1275,144,42,102,323,201,106,79,155,93,80,53,27,94
"2011","Enfield 015E","E01001515",1350,78,19,59,208,163,96,65,182,165,210,151,59,183
"2011","Enfield 016A","E01001401",939,93,19,74,234,163,113,49,101,49,51,31,20,86
"2011","Enfield 016B","E01001478",1103,64,15,49,180,164,124,67,167,105,105,83,22,127
"2011","Enfield 016C","E01001484",931,66,18,48,166,127,112,56,122,88,89,76,13,105
"2011","Enfield 016D","E01001511",1227,111,24,87,261,188,122,74,137,113,104,87,17,117
"2011","Enfield 016E","E01001514",1317,124,24,100,313,172,124,61,162,112,106,73,33,143
"2011","Enfield 016F","E01001518",1330,152,26,126,323,205,137,67,129,101,80,53,27,136
"2011","Enfield 017A","E01001451",1148,167,35,132,306,191,150,59,87,52,43,28,15,93
"2011","Enfield 017B","E01001452",997,181,41,140,266,136,140,28,74,42,42,34,8,88
"2011","Enfield 017C","E01001453",1200,230,52,178,300,189,167,31,82,49,54,33,21,98
"2011","Enfield 017D","E01001454",1125,205,50,155,324,129,160,41,76,38,52,35,17,100
"2011","Enfield 018A","E01001476",1173,59,10,49,191,166,104,75,174,109,145,122,23,150
"2011","Enfield 018B","E01001477",1254,49,10,39,168,119,109,80,206,176,168,136,32,179
"2011","Enfield 018C","E01001481",1172,46,14,32,181,159,108,87,150,143,153,118,35,145
"2011","Enfield 018D","E01001502",1388,62,17,45,181,114,101,96,193,147,162,133,29,332
"2011","Enfield 018E","E01001503",1289,63,10,53,204,172,143,86,163,154,167,130,37,137
"2011","Enfield 019A","E01001520",1258,201,46,155,287,167,152,63,114,76,89,63,26,109
"2011","Enfield 019B","E01001522",1278,228,47,181,338,160,121,38,113,74,91,57,34,115
"2011","Enfield 019C","E01001523",1215,204,36,168,323,162,159,45,94,54,78,52,26,96
"2011","Enfield 019D","E01001524",1124,136,21,115,234,130,137,41,111,68,113,88,25,154
"2011","Enfield 019E","E01001526",1165,167,33,134,335,157,150,37,98,49,54,33,21,118
"2011","Enfield 020A","E01001419",1481,207,34,173,320,199,184,58,120,65,93,70,23,235
"2011","Enfield 020B","E01001420",1142,105,25,80,209,135,136,58,129,91,123,96,27,156
"2011","Enfield 020C","E01001421",1181,124,30,94,225,125,138,48,139,98,131,104,27,153
"2011","Enfield 020D","E01001519",1941,305,36,269,498,208,191,87,183,102,116,66,50,251
"2011","Enfield 020E","E01001525",1352,187,33,154,302,153,176,57,116,84,91,74,17,186
"2011","Enfield 021A","E01001398",1036,145,32,113,317,155,139,40,70,39,41,29,12,90
"2011","Enfield 021B","E01001399",1080,143,29,114,246,185,158,42,98,74,32,20,12,102
"2011","Enfield 021C","E01001400",1109,138,38,100,271,212,128,42,111,60,54,41,13,93
"2011","Enfield 021D","E01001402",1408,231,55,176,356,179,192,62,116,69,101,83,18,102
"2011","Enfield 021E","E01001403",1131,116,21,95,281,147,137,78,113,83,67,46,21,109
"2011","Enfield 021F","E01001455",1143,143,30,113,276,180,154,58,116,77,41,30,11,98
"2011","Enfield 022A","E01001456",997,192,34,158,300,123,131,28,64,39,25,19,6,95
"2011","Enfield 022B","E01001564",1203,248,53,195,374,155,145,31,83,36,49,36,13,82
"2011","Enfield 022C","E01001567",1119,244,66,178,308,148,148,39,73,52,27,19,8,80
"2011","Enfield 022D","E01001568",1185,194,37,157,284,161,201,35,81,48,71,55,16,110
"2011","Enfield 022E","E01001569",1344,260,46,214,394,151,160,45,91,69,67,54,13,107
"2011","Enfield 023A","E01001479",1188,58,13,45,202,130,117,86,173,123,151,123,28,148
"2011","Enfield 023B","E01001482",1296,56,11,45,200,134,106,90,183,166,197,148,49,164
"2011","Enfield 023C","E01001487",1309,56,13,43,185,153,127,70,215,146,190,144,46,167
"2011","Enfield 023D","E01001489",1249,65,22,43,181,144,130,78,173,156,158,131,27,164
"2011","Enfield 023E","E01001491",1378,75,16,59,189,155,128,87,220,157,199,164,35,168
"2011","Enfield 024A","E01001459",1208,55,9,46,229,156,123,69,172,120,134,113,21,150
"2011","Enfield 024B","E01001460",1164,64,15,49,136,129,111,56,174,151,216,177,39,127
"2011","Enfield 024C","E01001462",979,71,20,51,165,129,73,53,136,85,147,119,28,120
"2011","Enfield 024D","E01001480",1133,72,16,56,199,145,112,74,154,120,126,95,31,131
"2011","Enfield 024E","E01001488",1292,78,22,56,214,140,126,59,194,126,181,148,33,174
"2011","Enfield 025A","E01001483",871,44,10,34,109,122,72,69,140,91,148,114,34,76
"2011","Enfield 025B","E01001485",1229,48,16,32,185,132,114,76,207,142,170,145,25,155
"2011","Enfield 025C","E01001486",1434,56,13,43,176,144,127,96,205,186,258,218,40,186
"2011","Enfield 025E","E01001492",1354,90,26,64,197,142,126,65,202,156,189,146,43,187
"2011","Enfield 025F","E01033146",1083,37,12,25,134,111,80,81,172,116,202,168,34,150
"2011","Enfield 025G","E01033151",997,32,10,22,114,82,78,57,157,116,203,168,35,158
"2011","Enfield 026A","E01001404",1068,110,25,85,231,138,146,62,114,71,82,65,17,114
"2011","Enfield 026B","E01001493",1314,106,17,89,255,165,156,68,158,119,157,123,34,130
"2011","Enfield 026C","E01001494",1130,88,17,71,200,161,165,58,143,102,95,77,18,118
"2011","Enfield 026D","E01001496",1267,124,18,106,311,162,177,69,110,86,79,65,14,149
"2011","Enfield 026E","E01001570",1324,149,39,110,345,150,154,68,140,93,85,56,29,140
"2011","Enfield 027A","E01001423",1236,88,15,73,181,134,114,74,165,128,196,159,37,156
"2011","Enfield 027B","E01001425",1255,51,10,41,148,120,105,81,186,150,237,195,42,177
"2011","Enfield 027C","E01001428",1145,59,8,51,172,107,88,57,154,139,194,159,35,175
"2011","Enfield 027D","E01001461",1204,52,9,43,160,124,100,76,195,139,193,158,35,165
"2011","Enfield 027E","E01001464",926,36,2,34,140,93,90,51,122,132,122,100,22,140
"2011","Enfield 028A","E01001521",1311,244,41,203,359,162,169,46,72,55,63,42,21,141
"2011","Enfield 028B","E01001531",1113,240,60,180,324,123,141,24,54,35,59,49,10,113
"2011","Enfield 028C","E01001532",1340,298,61,237,442,148,154,28,66,31,50,37,13,123
"2011","Enfield 028D","E01001533",1101,219,41,178,272,164,152,26,65,48,52,40,12,103
"2011","Enfield 028E","E01001535",1091,150,25,125,266,144,182,33,100,57,51,42,9,108
"2011","Enfield 029A","E01001495",1372,194,34,160,378,131,194,81,120,77,71,47,24,126
"2011","Enfield 029B","E01001498",1518,182,37,145,356,181,163,76,141,116,115,81,34,188
"2011","Enfield 029C","E01001563",1240,190,52,138,345,144,120,46,99,76,82,62,20,138
"2011","Enfield 029D","E01001565",1221,189,43,146,329,168,158,50,103,60,71,54,17,93
"2011","Enfield 029E","E01001566",1308,253,44,209,382,143,156,46,79,60,90,67,23,99
"2011","Enfield 030A","E01001424",842,43,9,34,129,96,63,43,111,75,142,116,26,140
"2011","Enfield 030B","E01001426",1282,44,9,35,175,133,120,79,199,153,218,176,42,161
"2011","Enfield 030C","E01001427",1228,44,13,31,134,108,104,77,188,146,257,220,37,170
"2011","Enfield 030D","E01001429",1651,60,13,47,228,155,100,95,266,215,362,296,66,170
"2011","Enfield 030E","E01001430",1196,26,5,21,107,97,80,69,202,162,282,237,45,171
"2011","Enfield 031A","E01001463",1136,56,14,42,183,151,142,66,153,133,111,91,20,141
"2011","Enfield 031B","E01001465",1101,78,26,52,168,160,117,61,127,138,118,90,28,134
"2011","Enfield 031C","E01001466",1221,50,10,40,209,159,141,68,158,116,169,145,24,151
"2011","Enfield 031D","E01001467",1314,59,6,53,239,161,110,70,166,133,180,141,39,196
"2011","Enfield 031E","E01001497",1059,81,19,62,198,127,137,52,130,93,127,106,21,114
"2011","Enfield 031F","E01001499",1218,102,17,85,230,154,163,55,137,106,120,89,31,151
"2011","Enfield 032A","E01001392",1434,213,28,185,360,160,185,88,139,87,65,43,22,137
"2011","Enfield 032B","E01001528",1085,67,13,54,161,113,115,48,168,108,149,117,32,156
"2011","Enfield 032C","E01001529",1166,99,22,77,213,116,149,71,151,112,121,92,29,134
"2011","Enfield 032D","E01001530",968,110,17,93,247,109,107,43,88,77,73,48,25,114
"2011","Enfield 032E","E01001534",1224,180,25,155,277,140,164,50,115,75,77,62,15,146
"2011","Enfield 033A","E01001431",1095,41,14,27,154,105,69,86,153,139,212,175,37,136
"2011","Enfield 033B","E01001432",1344,62,12,50,165,152,119,78,229,182,186,141,45,171
"2011","Enfield 033C","E01001555",1273,42,9,33,178,147,138,72,200,145,189,143,46,162
"2011","Enfield 033D","E01001557",1096,61,13,48,164,129,91,65,166,133,139,109,30,148
"2011","Enfield 033E","E01001558",1059,37,7,30,148,90,102,43,172,96,182,158,24,189
"2011","Enfield 033F","E01001559",1444,62,11,51,212,143,122,95,215,164,231,179,52,200
"2011","Enfield 035A","E01001394",1257,94,21,73,254,140,156,82,140,126,143,116,27,122
"2011","Enfield 035B","E01001395",1138,71,12,59,199,128,123,58,147,132,158,114,44,122
"2011","Enfield 035C","E01001397",1462,125,25,100,283,174,203,80,161,144,160,115,45,132
"2011","Enfield 035D","E01001500",1127,139,32,107,237,126,148,55,139,85,68,55,13,130
"2011","Enfield 035E","E01001556",1155,77,12,65,184,166,175,75,159,100,109,83,26,110
"2011","Enfield 035F","E01001560",1164,71,16,55,183,116,121,86,156,119,162,129,33,150
"2011","Enfield 036A","E01001390",1590,225,43,182,455,197,171,72,135,106,64,40,24,165
"2011","Enfield 036B","E01001391",1269,131,23,108,279,152,156,68,129,112,106,91,15,136
"2011","Enfield 036C","E01001393",1722,218,38,180,402,198,244,76,153,126,118,91,27,187
"2011","Enfield 036D","E01001396",1078,113,16,97,184,114,200,48,112,87,91,72,19,129
"2011","Enfield 036E","E01001501",1411,165,22,143,363,192,167,71,148,82,120,90,30,103
"2011","Enfield 036F","E01001527",1191,183,27,156,328,129,143,53,98,79,69,49,20,109
"2011","Enfield 037A","E01001458",1252,40,11,29,164,115,114,79,181,155,268,224,44,136
"2011","Enfield 037B","E01001553",1098,46,12,34,117,98,119,69,154,152,212,177,35,131
"2011","Enfield 037C","E01001554",1242,30,9,21,177,98,97,73,188,144,263,219,44,172
"2011","Enfield 037D","E01001562",1240,52,10,42,196,106,94,65,175,126,255,201,54,171
"2011","Enfield 037E","E01032574",1388,61,7,54,237,163,148,76,164,149,185,146,39,205
"2011","Greenwich 001A","E01001690",1378,78,16,62,241,173,111,96,263,185,121,77,44,110
"2011","Greenwich 001B","E01001692",969,45,9,36,122,97,72,74,167,132,126,80,46,134
"2011","Greenwich 001C","E01001693",1072,36,8,28,140,121,102,91,172,141,133,86,47,136
"2011","Greenwich 001D","E01001694",1215,69,10,59,189,136,111,83,194,130,135,110,25,168
"2011","Greenwich 002A","E01001687",878,60,9,51,135,117,62,64,147,111,91,71,20,91
"2011","Greenwich 002B","E01001688",1681,147,35,112,308,214,152,123,230,153,191,141,50,163
"2011","Greenwich 002E","E01033739",1047,88,17,71,196,122,120,60,141,76,97,80,17,147
"2011","Greenwich 002F","E01033740",1077,127,24,103,223,115,109,57,132,101,78,54,24,135
"2011","Greenwich 002G","E01033741",1901,144,18,126,276,153,208,133,254,186,381,322,59,166
"2011","Greenwich 002H","E01033743",1262,120,18,102,242,160,104,62,154,99,130,85,45,191
"2011","Greenwich 002I","E01033745",1204,103,26,77,217,153,124,66,154,105,111,75,36,171
"2011","Greenwich 003A","E01001575",1097,44,8,36,133,121,77,82,198,152,141,101,40,149
"2011","Greenwich 003B","E01001576",1097,53,7,46,134,116,83,71,183,135,167,122,45,155
"2011","Greenwich 003C","E01001577",1202,57,16,41,170,110,74,85,249,153,156,109,47,148
"2011","Greenwich 003D","E01001578",1498,99,26,73,278,183,121,110,221,165,162,104,58,159
"2011","Greenwich 003E","E01001579",1113,39,9,30,175,145,94,71,178,145,110,73,37,156
"2011","Greenwich 004B","E01001709",866,60,16,44,146,87,83,45,131,94,113,83,30,107
"2011","Greenwich 004C","E01001711",1114,105,10,95,193,112,114,74,125,87,107,73,34,197
"2011","Greenwich 004D","E01001712",1483,101,15,86,246,163,131,95,239,132,199,141,58,177
"2011","Greenwich 004E","E01033731",876,170,25,145,288,118,47,32,72,33,28,21,7,88
"2011","Greenwich 004F","E01033734",1019,230,35,195,307,102,56,30,67,35,73,48,25,119
"2011","Greenwich 004G","E01033735",867,97,14,83,169,85,69,70,89,76,70,39,31,142
"2011","Greenwich 004H","E01033736",1001,289,40,249,373,104,49,33,40,18,32,14,18,63
"2011","Greenwich 004I","E01033737",1049,59,9,50,140,102,73,69,147,144,146,109,37,169
"2011","Greenwich 005A","E01001705",1360,54,8,46,187,139,112,81,207,176,200,153,47,204
"2011","Greenwich 005B","E01001706",1010,49,5,44,140,85,66,62,170,123,155,126,29,160
"2011","Greenwich 005C","E01001708",1179,144,21,123,314,132,110,69,133,87,87,52,35,103
"2011","Greenwich 005D","E01001710",1129,29,5,24,138,91,76,64,204,139,190,139,51,198
"2011","Greenwich 005E","E01001713",1105,45,9,36,161,91,90,60,186,133,171,136,35,168
"2011","Greenwich 006A","E01001672",1494,87,21,66,193,118,115,87,244,191,181,147,34,278
"2011","Greenwich 006B","E01001673",1430,51,12,39,142,147,95,80,249,186,242,175,67,238
"2011","Greenwich 006C","E01001674",1388,82,21,61,210,156,138,89,188,146,155,126,29,224
"2011","Greenwich 006D","E01001675",1524,63,13,50,197,132,125,93,241,172,192,152,40,309
"2011","Greenwich 006E","E01001677",1432,74,13,61,251,143,102,111,254,143,127,94,33,227
"2011","Greenwich 007B","E01001631",1453,52,9,43,216,145,132,81,227,179,208,150,58,213
"2011","Greenwich 007C","E01001632",1800,97,20,77,220,186,123,114,279,243,217,175,42,321
"2011","Greenwich 007D","E01001635",1279,95,19,76,246,130,112,81,155,105,195,165,30,160
"2011","Greenwich 007E","E01001636",1320,77,17,60,206,118,120,65,188,140,234,204,30,172
"2011","Greenwich 007F","E01033742",1089,180,20,160,271,117,99,51,97,66,112,80,32,96
"2011","Greenwich 007G","E01033744",1277,95,14,81,232,148,100,76,186,137,151,102,49,152
"2011","Greenwich 008A","E01001571",1195,104,17,87,224,167,101,79,170,116,97,71,26,137
"2011","Greenwich 008B","E01001572",1204,87,20,67,264,184,118,78,170,108,80,55,25,115
"2011","Greenwich 008C","E01001573",1092,54,12,42,203,156,114,80,164,103,83,64,19,135
"2011","Greenwich 008D","E01001574",1191,48,10,38,175,119,109,99,214,133,183,126,57,111
"2011","Greenwich 009A","E01001629",1585,80,11,69,216,164,129,126,259,196,204,148,56,211
"2011","Greenwich 009B","E01001633",1160,57,15,42,164,117,85,83,197,139,156,104,52,162
"2011","Greenwich 009C","E01001634",1157,42,14,28,141,153,92,69,210,158,172,131,41,120
"2011","Greenwich 009D","E01001637",1312,99,27,72,200,166,106,76,180,128,144,102,42,213
"2011","Greenwich 011A","E01001695",1205,52,11,41,156,90,108,86,162,175,165,120,45,211
"2011","Greenwich 011B","E01001696",950,29,5,24,109,76,78,47,135,110,167,145,22,199
"2011","Greenwich 011C","E01001697",1507,73,13,60,222,148,152,71,222,167,181,136,45,271
"2011","Greenwich 011D","E01001700",1447,90,16,74,234,120,119,73,210,151,161,122,39,289
"2011","Greenwich 011E","E01001703",1284,49,13,36,138,103,113,78,198,140,247,180,67,218
"2011","Greenwich 011F","E01001704",1229,118,12,106,257,130,112,83,138,121,136,91,45,134
"2011","Greenwich 012A","E01001588",1182,104,21,83,244,132,94,79,173,136,101,83,18,119
"2011","Greenwich 012B","E01001589",1241,98,27,71,257,99,114,72,165,131,127,93,34,178
"2011","Greenwich 012C","E01001591",1446,114,27,87,263,153,134,92,194,124,201,151,50,171
"2011","Greenwich 012D","E01001595",1335,98,22,76,225,147,110,87,186,140,144,103,41,198
"2011","Greenwich 014A","E01001590",1384,214,29,185,332,138,124,52,142,104,79,55,24,199
"2011","Greenwich 014B","E01001592",1327,227,38,189,390,155,97,65,134,80,61,42,19,118
"2011","Greenwich 014C","E01001593",1254,232,41,191,442,155,102,50,86,62,52,33,19,73
"2011","Greenwich 014D","E01001594",1342,118,19,99,244,124,96,78,199,156,158,134,24,169
"2011","Greenwich 015A","E01001698",1240,75,21,54,193,110,95,71,202,110,175,118,57,209
"2011","Greenwich 015B","E01001699",1416,80,33,47,327,325,65,80,152,116,139,83,56,132
"2011","Greenwich 015C","E01001701",1016,87,34,53,265,124,60,55,141,83,107,72,35,94
"2011","Greenwich 015D","E01001702",1066,44,6,38,104,97,82,80,151,132,187,152,35,189
"2011","Greenwich 016A","E01001581",1316,268,49,219,391,139,89,51,119,87,56,42,14,116
"2011","Greenwich 016B","E01001585",1136,281,50,231,379,99,81,44,67,40,56,39,17,89
"2011","Greenwich 016C","E01001586",1068,204,40,164,339,112,69,40,95,56,60,42,18,93
"2011","Greenwich 016D","E01001587",1484,391,81,310,480,124,117,42,84,44,65,42,23,137
"2011","Greenwich 017A","E01001678",1213,103,29,74,234,200,106,85,174,104,78,59,19,129
"2011","Greenwich 017B","E01001683",1119,79,17,62,234,143,111,68,148,103,141,111,30,92
"2011","Greenwich 017C","E01001684",1067,70,16,54,196,146,89,73,173,116,89,60,29,115
"2011","Greenwich 017D","E01001685",1142,76,11,65,213,146,88,77,169,105,161,146,15,107
"2011","Greenwich 019A","E01001646",2131,276,39,237,474,238,171,118,219,149,159,112,47,327
"2011","Greenwich 019B","E01001650",1275,81,13,68,195,152,127,98,215,160,104,81,23,143
"2011","Greenwich 019C","E01001651",1225,84,14,70,199,124,108,83,225,140,128,87,41,134
"2011","Greenwich 019D","E01001652",1156,180,35,145,315,140,136,51,91,63,67,53,14,113
"2011","Greenwich 020A","E01001679",996,119,23,96,281,142,92,62,111,64,45,29,16,80
"2011","Greenwich 020B","E01001680",1152,163,30,133,355,164,109,60,108,53,60,40,20,80
"2011","Greenwich 020C","E01001681",926,114,16,98,224,126,92,39,107,70,76,55,21,78
"2011","Greenwich 020D","E01001682",977,124,25,99,263,153,112,52,91,57,63,42,21,62
"2011","Greenwich 020E","E01001686",1318,124,27,97,326,129,102,72,168,113,148,112,36,136
"2011","Greenwich 021A","E01001580",1379,388,73,315,489,149,84,27,72,32,40,24,16,98
"2011","Greenwich 021B","E01001582",1028,213,42,171,287,113,81,40,87,53,88,58,30,66
"2011","Greenwich 021C","E01001583",1262,360,69,291,439,130,84,34,67,34,37,24,13,77
"2011","Greenwich 021D","E01001584",1120,364,72,292,388,116,71,19,46,25,34,23,11,57
"2011","Greenwich 022A","E01001645",1227,104,21,83,225,164,151,80,169,124,91,62,29,119
"2011","Greenwich 022B","E01001647",1079,142,23,119,227,120,148,52,114,81,83,60,23,112
"2011","Greenwich 022C","E01001648",1324,212,43,169,316,168,145,66,118,98,96,75,21,105
"2011","Greenwich 022D","E01001649",1145,66,12,54,186,153,118,85,188,157,96,78,18,96
"2011","Greenwich 023A","E01001605",1174,135,36,99,282,222,142,58,131,79,36,19,17,89
"2011","Greenwich 023B","E01001606",1212,167,41,126,291,231,121,69,123,71,36,24,12,103
"2011","Greenwich 023C","E01001610",1248,142,28,114,302,221,124,74,138,94,59,37,22,94
"2011","Greenwich 023D","E01001611",1188,101,26,75,300,195,114,70,161,106,63,37,26,78
"2011","Greenwich 025A","E01001620",1135,58,9,49,145,144,126,91,183,139,134,112,22,115
"2011","Greenwich 025B","E01001621",1126,100,22,78,213,160,104,68,162,116,95,64,31,108
"2011","Greenwich 025C","E01001623",1266,132,18,114,216,188,124,74,182,135,120,89,31,95
"2011","Greenwich 025D","E01001624",1156,94,25,69,236,174,128,61,171,130,78,47,31,84
"2011","Greenwich 025E","E01001625",1153,45,9,36,147,152,118,87,208,171,122,92,30,103
"2011","Greenwich 027A","E01001604",1075,162,41,121,306,177,102,47,101,60,36,25,11,84
"2011","Greenwich 027B","E01001607",1082,128,31,97,266,187,102,66,133,73,59,40,19,68
"2011","Greenwich 027C","E01001608",1043,200,44,156,306,161,91,42,67,44,33,22,11,99
"2011","Greenwich 027D","E01001609",1152,164,37,127,299,148,130,48,126,80,73,53,20,84
"2011","Greenwich 028A","E01001613",1165,131,31,100,252,190,104,74,160,103,57,39,18,94
"2011","Greenwich 028B","E01001614",1065,125,31,94,250,197,150,51,95,57,34,24,10,106
"2011","Greenwich 028C","E01001615",1147,152,29,123,283,151,118,77,127,89,56,38,18,94
"2011","Greenwich 028D","E01001617",1164,122,25,97,292,194,137,70,132,91,47,39,8,79
"2011","Greenwich 029A","E01001653",1092,49,17,32,143,142,106,75,209,151,123,86,37,94
"2011","Greenwich 029B","E01001654",1052,65,27,38,163,140,97,83,177,142,98,75,23,87
"2011","Greenwich 029C","E01001655",1069,44,6,38,145,154,107,91,194,141,110,70,40,83
"2011","Greenwich 029D","E01001660",1133,69,14,55,171,165,114,71,174,139,106,74,32,124
"2011","Greenwich 029E","E01001661",1088,80,19,61,177,153,121,73,174,126,82,55,27,102
"2011","Greenwich 030C","E01001618",1116,99,32,67,227,175,124,70,157,95,84,54,30,85
"2011","Greenwich 030D","E01001619",1403,160,36,124,346,268,155,83,141,92,80,66,14,78
"2011","Greenwich 030E","E01033729",2400,68,15,53,182,187,125,72,223,146,142,104,38,1255
"2011","Greenwich 031A","E01001597",1157,139,22,117,266,172,124,67,139,74,90,72,18,86
"2011","Greenwich 031B","E01001598",1216,140,32,108,291,209,141,56,135,84,46,32,14,114
"2011","Greenwich 031C","E01001602",1322,72,24,48,216,194,154,91,200,171,121,96,25,103
"2011","Greenwich 031D","E01001603",1159,59,11,48,183,175,121,104,204,145,95,66,29,73
"2011","Greenwich 032A","E01001596",1140,140,30,110,260,194,152,64,137,59,48,37,11,86
"2011","Greenwich 032B","E01001599",1232,102,22,80,233,220,156,79,155,111,63,49,14,113
"2011","Greenwich 032C","E01001600",1192,138,31,107,257,221,128,72,139,72,69,51,18,96
"2011","Greenwich 032D","E01001601",1116,131,39,92,243,205,123,72,118,65,56,42,14,103
"2011","Greenwich 033A","E01001669",1349,70,21,49,223,185,126,94,193,150,122,91,31,186
"2011","Greenwich 033B","E01001671",1136,87,23,64,237,171,106,74,161,109,92,68,24,99
"2011","Greenwich 033C","E01001676",1232,64,21,43,160,129,111,76,218,131,161,102,59,182
"2011","Greenwich 033D","E01032567",1222,76,21,55,233,206,108,78,162,121,89,72,17,149
"2011","Greenwich 034A","E01001656",897,182,34,148,235,109,77,26,89,48,65,48,17,66
"2011","Greenwich 034B","E01001657",1120,269,49,220,342,125,87,39,71,44,60,44,16,83
"2011","Greenwich 034C","E01001658",1113,149,26,123,309,170,93,53,118,77,69,53,16,75
"2011","Greenwich 034D","E01001659",1082,135,34,101,225,151,130,50,121,66,75,55,20,129
"2011","Greenwich 034E","E01033726",1698,104,26,78,278,211,157,101,240,192,208,149,59,207
"2011","Greenwich 035A","E01001640",1808,157,17,140,297,160,105,85,192,126,200,142,58,486
"2011","Greenwich 035B","E01033727",2102,182,33,149,303,136,109,60,157,121,165,115,50,869
"2011","Greenwich 035C","E01033728",1069,354,52,302,365,86,50,21,37,18,19,16,3,119
"2011","Greenwich 035D","E01033730",1013,232,41,191,339,117,51,30,67,54,64,41,23,59
"2011","Greenwich 036A","E01001666",1158,123,18,105,231,129,69,76,145,117,78,65,13,190
"2011","Greenwich 036B","E01001667",1163,106,24,82,200,104,93,60,156,113,147,115,32,184
"2011","Greenwich 036C","E01001668",1675,285,37,248,430,166,118,66,185,126,125,79,46,174
"2011","Greenwich 036D","E01033732",842,199,39,160,256,96,36,26,61,28,46,31,15,94
"2011","Greenwich 036E","E01033733",965,346,57,289,311,80,58,10,31,13,39,24,15,77
"2011","Greenwich 037A","E01001662",1334,307,40,267,416,127,112,55,85,58,49,36,13,125
"2011","Greenwich 037B","E01001664",1498,325,61,264,469,137,98,56,108,89,74,44,30,142
"2011","Greenwich 037C","E01001665",1511,293,49,244,432,145,102,70,91,84,94,65,29,200
"2011","Greenwich 037D","E01033738",997,165,36,129,255,94,98,44,78,59,42,23,19,162
"2011","Greenwich 038A","E01001638",1388,149,31,118,254,142,91,81,227,129,141,101,40,174
"2011","Greenwich 038B","E01001641",1368,306,42,264,405,107,92,43,89,53,70,44,26,203
"2011","Greenwich 038C","E01001642",1336,416,70,346,479,105,100,22,56,42,44,34,10,72
"2011","Greenwich 038D","E01001644",1812,444,68,376,545,151,127,64,131,63,96,77,19,191
"2011","Greenwich 038E","E01033746",1129,312,56,256,357,87,69,38,72,65,59,52,7,70
"2011","Harrow 001A","E01002112",1361,279,48,231,360,187,182,29,81,37,72,63,9,134
"2011","Harrow 001B","E01002114",1302,235,38,197,324,159,163,45,129,53,110,87,23,84
"2011","Harrow 001C","E01002225",1056,230,48,182,279,143,173,24,71,20,46,44,2,70
"2011","Harrow 001D","E01002226",1570,296,72,224,401,202,224,43,119,64,99,79,20,122
"2011","Harrow 002A","E01002113",1106,231,35,196,265,149,126,28,88,58,56,42,14,105
"2011","Harrow 002B","E01002115",1111,224,40,184,251,153,135,36,93,54,78,59,19,87
"2011","Harrow 002C","E01002116",1200,241,36,205,334,155,159,27,86,31,59,49,10,108
"2011","Harrow 002D","E01002117",1478,268,36,232,298,202,172,45,113,70,116,95,21,194
"2011","Harrow 002E","E01002118",1258,148,28,120,258,156,197,73,117,97,103,82,21,109
"2011","Harrow 003A","E01002227",1300,87,18,69,213,180,127,62,160,114,174,155,19,183
"2011","Harrow 003B","E01002228",1492,296,58,238,329,199,185,49,120,41,126,97,29,147
"2011","Harrow 003C","E01002229",1214,206,46,160,273,161,155,54,127,62,80,66,14,96
"2011","Harrow 003D","E01002230",1339,201,32,169,314,204,215,44,110,65,77,65,12,109
"2011","Harrow 004A","E01002144",1139,177,29,148,282,149,164,49,87,48,70,52,18,113
"2011","Harrow 004B","E01002146",1050,221,41,180,303,173,120,32,66,28,28,21,7,79
"2011","Harrow 004C","E01002147",982,221,50,171,244,133,141,17,68,29,42,37,5,87
"2011","Harrow 004D","E01002149",994,240,35,205,304,157,122,10,57,15,26,21,5,63
"2011","Harrow 005A","E01002140",1237,104,21,83,257,196,152,74,155,88,86,61,25,125
"2011","Harrow 005B","E01002141",1284,171,34,137,273,236,177,66,105,61,78,66,12,117
"2011","Harrow 005C","E01002142",1316,167,31,136,317,206,169,59,120,64,78,65,13,136
"2011","Harrow 005D","E01002143",1120,115,28,87,208,151,90,70,154,75,125,84,41,132
"2011","Harrow 005E","E01002145",1087,140,43,97,277,160,130,53,84,62,89,73,16,92
"2011","Harrow 006A","E01002139",998,39,7,32,161,114,67,47,158,121,149,104,45,142
"2011","Harrow 006B","E01002148",1069,169,40,129,261,140,123,48,93,53,73,46,27,109
"2011","Harrow 006C","E01002150",1305,214,40,174,324,214,139,66,113,59,75,54,21,101
"2011","Harrow 006D","E01002151",1008,71,24,47,164,146,92,58,146,83,139,100,39,109
"2011","Harrow 006E","E01002152",1172,291,57,234,325,165,120,36,57,45,45,33,12,88
"2011","Harrow 007A","E01002119",1266,103,18,85,224,161,198,55,141,105,136,108,28,143
"2011","Harrow 007B","E01002120",952,77,11,66,135,112,136,59,121,67,131,98,33,114
"2011","Harrow 007C","E01002121",1305,138,27,111,234,175,214,48,127,105,136,102,34,128
"2011","Harrow 007D","E01002122",1271,124,13,111,215,151,201,61,147,104,112,89,23,156
"2011","Harrow 007E","E01002123",1322,99,13,86,195,175,243,62,156,105,122,100,22,165
"2011","Harrow 008A","E01002106",1529,169,35,134,335,251,170,82,173,93,105,90,15,151
"2011","Harrow 008B","E01002108",1303,215,37,178,278,212,126,49,120,59,83,58,25,161
"2011","Harrow 008C","E01002109",1330,291,53,238,349,164,149,25,104,50,70,54,16,128
"2011","Harrow 008D","E01002110",1293,185,32,153,287,208,172,42,114,58,82,71,11,145
"2011","Harrow 008E","E01002111",1562,198,26,172,307,215,211,47,153,87,141,112,29,203
"2011","Harrow 009A","E01002185",1103,82,6,76,197,124,115,65,154,92,143,111,32,131
"2011","Harrow 009B","E01002186",1221,214,37,177,318,165,129,54,131,60,82,68,14,68
"2011","Harrow 009C","E01002187",1338,264,46,218,367,174,134,27,115,59,88,62,26,110
"2011","Harrow 009D","E01002190",1204,286,57,229,330,179,141,27,74,34,42,29,13,91
"2011","Harrow 010A","E01002124",1256,95,12,83,190,153,188,68,160,126,115,96,19,161
"2011","Harrow 010B","E01002125",1303,95,18,77,199,147,239,63,146,132,118,100,18,164
"2011","Harrow 010C","E01002198",1361,117,19,98,193,170,223,51,161,146,139,118,21,161
"2011","Harrow 010D","E01002200",1278,92,14,78,214,165,194,60,172,96,128,102,26,157
"2011","Harrow 010E","E01002203",1268,126,18,108,223,162,167,69,175,82,114,98,16,150
"2011","Harrow 011A","E01002232",1386,135,24,111,256,187,151,90,158,124,111,91,20,174
"2011","Harrow 011B","E01002233",1482,122,9,113,252,176,123,92,175,124,213,163,50,205
"2011","Harrow 011C","E01002234",1265,103,16,87,222,158,111,66,187,117,152,128,24,149
"2011","Harrow 011D","E01002235",1279,84,12,72,188,148,136,71,174,138,177,141,36,163
"2011","Harrow 011E","E01002236",1346,91,20,71,224,161,143,91,184,131,153,132,21,168
"2011","Harrow 012A","E01002107",1287,203,34,169,290,202,171,44,99,63,73,59,14,142
"2011","Harrow 012B","E01002197",990,123,18,105,188,145,140,38,114,73,79,64,15,90
"2011","Harrow 012C","E01002199",1131,128,17,111,223,169,127,45,132,71,104,83,21,132
"2011","Harrow 012D","E01002201",1316,147,20,127,219,223,154,50,163,87,102,77,25,171
"2011","Harrow 012E","E01002202",1476,118,13,105,188,157,197,93,222,111,212,185,27,178
"2011","Harrow 013A","E01002179",1692,168,15,153,292,173,171,95,218,134,220,181,39,221
"2011","Harrow 013B","E01002180",1533,124,17,107,301,196,147,79,194,113,190,142,48,189
"2011","Harrow 013C","E01002183",1557,130,19,111,270,195,187,79,196,152,146,120,26,202
"2011","Harrow 013D","E01002184",1373,105,18,87,242,200,155,89,191,131,128,100,28,132
"2011","Harrow 013E","E01002231",1367,119,25,94,261,192,128,93,190,115,119,98,21,150
"2011","Harrow 015A","E01002154",1492,214,36,178,363,211,177,69,139,79,101,74,27,139
"2011","Harrow 015B","E01002156",1142,218,40,178,329,172,109,39,89,35,52,39,13,99
"2011","Harrow 015C","E01002162",1343,170,22,148,306,188,126,69,141,84,109,68,41,150
"2011","Harrow 015D","E01002163",1218,165,26,139,331,184,117,39,112,51,77,64,13,142
"2011","Harrow 016A","E01002188",1121,297,57,240,356,147,112,22,54,13,25,16,9,95
"2011","Harrow 016B","E01002189",1204,295,54,241,369,151,114,39,60,34,54,34,20,88
"2011","Harrow 016C","E01002192",1038,269,45,224,280,143,99,33,73,27,43,30,13,71
"2011","Harrow 016D","E01002193",1254,244,57,187,362,172,125,49,108,45,70,55,15,79
"2011","Harrow 017A","E01002165",1317,101,15,86,188,152,225,78,170,128,122,95,27,153
"2011","Harrow 017B","E01002166",1261,98,17,81,188,170,183,59,165,128,121,95,26,149
"2011","Harrow 017C","E01002167",1226,99,14,85,149,176,191,47,158,131,123,100,23,152
"2011","Harrow 017D","E01002168",1082,62,12,50,164,143,106,66,158,119,110,92,18,154
"2011","Harrow 017E","E01002169",1248,91,12,79,189,173,153,67,136,141,135,111,24,163
"2011","Harrow 019A","E01002153",1271,247,33,214,324,209,136,51,90,39,66,55,11,109
"2011","Harrow 019B","E01002155",1183,229,40,189,354,174,105,45,83,26,61,48,13,106
"2011","Harrow 019C","E01002157",1299,221,34,187,301,211,121,50,102,52,70,52,18,171
"2011","Harrow 019D","E01002158",1076,224,43,181,283,168,90,38,76,44,33,22,11,120
"2011","Harrow 020A","E01002128",1614,243,28,215,353,193,135,113,148,126,145,112,33,158
"2011","Harrow 020B","E01002130",1786,234,33,201,352,185,206,112,201,116,167,142,25,213
"2011","Harrow 020C","E01002181",1413,231,38,193,323,192,134,64,134,79,129,105,24,127
"2011","Harrow 020D","E01002182",1558,246,44,202,347,184,145,68,151,87,146,118,28,184
"2011","Harrow 021A","E01002159",1407,235,28,207,331,177,128,62,145,64,121,94,27,144
"2011","Harrow 021B","E01002160",1489,192,30,162,378,186,138,65,145,95,83,64,19,207
"2011","Harrow 021C","E01002161",1486,225,43,182,336,174,162,52,168,85,137,107,30,147
"2011","Harrow 021D","E01002164",1315,231,40,191,402,158,122,48,111,52,80,59,21,111
"2011","Harrow 022A","E01002191",1414,303,53,250,330,240,122,43,115,42,72,52,20,147
"2011","Harrow 022B","E01002194",1223,298,51,247,383,166,112,23,70,31,45,35,10,95
"2011","Harrow 022C","E01002195",1152,216,38,178,281,196,92,41,106,53,55,40,15,112
"2011","Harrow 022D","E01002196",1288,285,54,231,362,213,111,37,103,33,35,24,11,109
"2011","Harrow 023A","E01002126",2165,485,54,431,524,238,175,68,158,82,168,134,34,267
"2011","Harrow 023B","E01002127",1325,251,28,223,321,190,118,45,91,59,80,65,15,170
"2011","Harrow 023C","E01002129",1606,349,66,283,422,156,129,46,124,72,148,123,25,160
"2011","Harrow 023D","E01002131",1231,116,14,102,225,169,113,78,163,86,115,85,30,166
"2011","Harrow 024A","E01002237",1283,149,16,133,332,154,105,73,125,86,95,60,35,164
"2011","Harrow 024B","E01002238",1317,221,27,194,331,170,157,48,92,61,81,67,14,156
"2011","Harrow 024C","E01002240",1268,188,31,157,292,179,98,55,136,83,103,75,28,134
"2011","Harrow 024D","E01002242",1383,247,32,215,317,250,106,46,117,69,88,71,17,143
"2011","Harrow 025A","E01002208",959,214,36,178,256,157,73,32,67,27,48,38,10,85
"2011","Harrow 025B","E01002209",1217,210,32,178,295,166,110,53,87,51,83,73,10,162
"2011","Harrow 025C","E01002239",1202,200,25,175,289,215,126,44,104,52,77,54,23,95
"2011","Harrow 025D","E01002241",1197,152,17,135,219,206,105,65,135,71,112,86,26,132
"2011","Harrow 027A","E01002133",1488,147,19,128,246,172,123,71,193,135,206,170,36,195
"2011","Harrow 027B","E01002136",1250,171,29,142,301,179,143,56,128,68,94,76,18,110
"2011","Harrow 027C","E01002138",1130,134,12,122,198,148,111,46,153,77,95,68,27,168
"2011","Harrow 027D","E01002213",2085,244,25,219,434,262,189,100,275,156,207,159,48,218
"2011","Harrow 028A","E01002211",1132,86,12,74,178,150,96,54,155,103,145,126,19,165
"2011","Harrow 028B","E01002212",1256,118,16,102,233,178,123,61,169,96,139,111,28,139
"2011","Harrow 028C","E01002216",1178,147,24,123,240,178,117,57,143,69,107,83,24,120
"2011","Harrow 028D","E01002217",1052,65,6,59,154,121,73,53,176,108,152,127,25,150
"2011","Harrow 029A","E01002132",1563,355,52,303,480,182,142,48,76,57,86,69,17,137
"2011","Harrow 029B","E01002134",1101,277,63,214,297,108,132,26,64,32,86,71,15,79
"2011","Harrow 029C","E01002135",1321,147,25,122,275,140,202,58,152,104,119,106,13,124
"2011","Harrow 029D","E01002137",1160,169,30,139,327,70,70,31,39,15,18,14,4,421
"2011","Harrow 030A","E01002218",1150,140,22,118,227,166,121,56,152,73,117,97,20,98
"2011","Harrow 030B","E01002219",1282,126,27,99,217,120,123,71,199,132,139,113,26,155
"2011","Harrow 030C","E01002221",1188,99,17,82,192,183,115,50,167,110,87,64,23,185
"2011","Harrow 030D","E01002222",1156,110,20,90,221,184,110,54,140,91,98,79,19,148
"2011","Harrow 031A","E01002214",1298,123,23,100,210,148,165,59,169,106,155,132,23,163
"2011","Harrow 031B","E01002215",1087,83,14,69,160,131,95,65,147,156,124,92,32,126
"2011","Harrow 031C","E01002220",1185,117,19,98,218,166,115,68,148,114,100,74,26,139
"2011","Harrow 031D","E01002223",1352,122,26,96,234,204,140,69,191,120,117,96,21,155
"2011","Harrow 031E","E01002224",1087,66,12,54,194,155,101,71,149,78,124,100,24,149
"2011","Harrow 032A","E01002204",1275,143,22,121,259,161,133,59,154,76,138,108,30,152
"2011","Harrow 032B","E01002206",1008,114,11,103,200,145,97,48,128,44,93,83,10,139
"2011","Harrow 032C","E01002207",1239,135,10,125,255,201,126,68,136,76,105,84,21,137
"2011","Harrow 032D","E01002210",1183,183,28,155,257,199,86,54,126,66,86,66,20,126
"2011","Harrow 032E","E01032576",1222,180,34,146,286,180,110,57,138,63,87,75,12,121
"2011","Harrow 033A","E01002170",996,98,7,91,167,182,116,31,119,78,86,62,24,119
"2011","Harrow 033B","E01002171",1282,133,28,105,226,180,181,62,150,107,107,91,16,136
"2011","Harrow 033C","E01002172",1156,118,22,96,194,162,128,64,149,119,98,74,24,124
"2011","Harrow 033D","E01002173",1359,162,20,142,266,229,155,48,171,78,99,76,23,151
"2011","Harrow 033E","E01002174",1192,177,27,150,207,189,146,45,134,79,85,68,17,130
"2011","Harrow 033F","E01002175",1118,149,17,132,197,157,147,46,107,84,76,58,18,155
"2011","Harrow 033G","E01002176",1360,187,24,163,235,182,168,59,142,69,112,100,12,206
"2011","Harrow 033H","E01002177",1069,116,23,93,206,156,113,38,128,71,98,81,17,143
"2011","Harrow 033I","E01002178",1225,150,24,126,240,208,120,59,138,88,91,72,19,131
"2011","Havering 001A","E01002276",1348,80,20,60,230,203,154,81,215,173,113,86,27,99
"2011","Havering 001B","E01002278",1065,47,14,33,160,144,116,93,209,121,92,48,44,83
"2011","Havering 001C","E01002312",939,49,17,32,151,149,105,77,186,125,55,28,27,42
"2011","Havering 001D","E01002313",1056,44,9,35,159,145,118,89,180,153,82,55,27,86
"2011","Havering 002A","E01002277",1111,47,12,35,176,169,117,98,164,161,88,47,41,91
"2011","Havering 002B","E01002279",1094,54,9,45,161,170,104,85,175,170,80,50,30,95
"2011","Havering 002C","E01002281",1141,39,7,32,161,173,92,89,229,176,119,67,52,63
"2011","Havering 002D","E01002283",1002,56,12,44,143,154,112,86,164,128,75,53,22,84
"2011","Havering 002E","E01002299",1238,68,9,59,192,208,123,110,202,146,84,44,40,105
"2011","Havering 003A","E01002301",1184,75,19,56,242,226,160,85,162,101,55,37,18,78
"2011","Havering 003B","E01002303",1419,65,19,46,248,218,173,111,231,160,95,58,37,118
"2011","Havering 003C","E01002304",1025,83,21,62,180,183,168,63,126,85,64,45,19,73
"2011","Havering 003D","E01002306",1083,40,9,31,153,153,123,84,223,143,79,45,34,85
"2011","Havering 003E","E01002307",1184,62,15,47,213,201,115,91,186,145,85,50,35,86
"2011","Havering 004A","E01002280",1058,34,9,25,143,118,95,73,186,146,138,78,60,125
"2011","Havering 004B","E01002282",1094,35,5,30,137,122,111,67,226,194,109,59,50,93
"2011","Havering 004C","E01002284",1258,63,11,52,199,203,115,106,217,164,82,54,28,109
"2011","Havering 004D","E01002297",1107,47,10,37,153,152,93,80,202,185,111,77,34,84
"2011","Havering 004E","E01002314",1104,47,7,40,161,142,96,96,209,159,93,57,36,101
"2011","Havering 004F","E01002316",1092,38,5,33,151,134,88,80,248,169,115,65,50,69
"2011","Havering 005A","E01002302",1131,83,23,60,238,203,141,78,167,109,43,29,14,69
"2011","Havering 005B","E01002305",1102,60,20,40,218,198,143,82,162,104,59,37,22,76
"2011","Havering 005C","E01002308",1158,73,15,58,184,183,138,82,197,141,80,51,29,80
"2011","Havering 005D","E01002326",1072,73,19,54,181,167,130,87,172,112,73,45,28,77
"2011","Havering 005E","E01002331",1104,70,17,53,171,221,125,88,185,116,54,37,17,74
"2011","Havering 006A","E01002309",1093,63,15,48,186,170,110,98,169,137,77,47,30,83
"2011","Havering 006B","E01002310",1176,55,9,46,172,174,117,96,207,162,116,82,34,77
"2011","Havering 006C","E01002311",1176,52,16,36,190,181,127,109,196,143,83,54,29,95
"2011","Havering 006D","E01002315",1094,54,13,41,182,173,122,87,178,117,86,53,33,95
"2011","Havering 007A","E01002293",1221,135,31,104,288,244,126,71,152,84,54,30,24,67
"2011","Havering 007B","E01002294",1094,113,23,90,259,219,128,62,114,85,50,37,13,64
"2011","Havering 007C","E01002296",1236,107,20,87,237,252,181,88,144,85,54,35,19,88
"2011","Havering 007D","E01002298",1118,105,25,80,257,195,116,65,175,94,38,19,19,73
"2011","Havering 007E","E01002300",1146,123,30,93,271,243,104,71,145,82,27,17,10,80
"2011","Havering 008A","E01002333",942,72,22,50,166,209,133,71,126,59,38,27,11,68
"2011","Havering 008B","E01002334",1252,126,41,85,285,233,206,68,117,96,36,24,12,85
"2011","Havering 008C","E01002336",1083,82,26,56,222,225,160,69,143,83,34,23,11,65
"2011","Havering 008D","E01002339",1155,122,26,96,276,235,156,58,121,63,32,22,10,92
"2011","Havering 008E","E01002341",976,81,13,68,213,224,130,59,131,71,16,9,7,51
"2011","Havering 009A","E01002327",1069,78,22,56,203,210,123,73,168,90,52,37,15,72
"2011","Havering 009B","E01002328",1239,77,16,61,273,259,159,96,159,81,42,20,22,93
"2011","Havering 009C","E01002332",1168,74,21,53,232,233,155,75,197,94,60,35,25,48
"2011","Havering 009D","E01002335",1063,60,20,40,193,227,109,86,188,100,41,24,17,59
"2011","Havering 009E","E01002338",980,80,7,73,196,198,119,73,140,86,36,26,10,52
"2011","Havering 009F","E01002340",993,90,11,79,235,192,100,79,117,67,40,22,18,73
"2011","Havering 010A","E01002268",947,109,35,74,191,176,120,62,107,84,31,23,8,67
"2011","Havering 010B","E01002269",1251,116,25,91,251,253,152,90,167,96,36,21,15,90
"2011","Havering 010C","E01002295",1186,136,29,107,279,232,119,67,130,82,58,38,20,83
"2011","Havering 010D","E01002377",1189,130,26,104,258,212,138,88,158,92,33,23,10,80
"2011","Havering 010E","E01002378",1237,105,40,65,266,258,128,95,149,107,26,13,13,103
"2011","Havering 010F","E01002383",1158,141,32,109,293,244,113,65,131,57,25,15,10,89
"2011","Havering 011A","E01002244",1268,105,25,80,299,239,136,77,148,111,82,47,35,71
"2011","Havering 011B","E01002245",1075,90,16,74,218,202,115,63,146,97,55,34,21,89
"2011","Havering 011C","E01002325",1161,59,12,47,184,175,142,79,215,148,81,44,37,78
"2011","Havering 011D","E01002329",1148,93,31,62,229,198,140,87,172,107,33,23,10,89
"2011","Havering 011E","E01002330",1249,79,18,61,268,198,152,98,189,130,69,38,31,66
"2011","Havering 012A","E01002337",914,167,39,128,227,189,113,32,65,37,17,12,5,67
"2011","Havering 012B","E01002354",958,130,35,95,252,204,110,52,88,33,34,23,11,55
"2011","Havering 012C","E01002376",1074,186,47,139,280,219,136,51,71,47,22,16,6,62
"2011","Havering 012D","E01002379",1097,181,39,142,270,195,119,51,94,65,33,19,14,89
"2011","Havering 012E","E01002380",1597,194,43,151,408,332,144,96,173,118,72,39,33,60
"2011","Havering 012F","E01002381",1129,144,27,117,239,216,135,54,133,93,34,19,15,81
"2011","Havering 013A","E01002243",1333,118,20,98,267,196,119,91,171,137,122,84,38,112
"2011","Havering 013B","E01002353",1481,206,34,172,351,267,168,79,163,85,59,36,23,103
"2011","Havering 013C","E01002356",1597,105,16,89,309,226,165,110,239,155,148,82,66,140
"2011","Havering 013E","E01032741",893,136,20,116,234,156,67,52,89,69,48,32,16,42
"2011","Havering 013F","E01032742",948,132,22,110,238,192,82,51,85,67,62,43,19,39
"2011","Havering 014A","E01002272",995,103,33,70,243,191,131,48,115,69,30,24,6,65
"2011","Havering 014B","E01002274",1199,142,36,106,301,253,144,61,109,74,31,21,10,84
"2011","Havering 014C","E01002317",1134,130,30,100,243,251,136,77,123,61,27,20,7,86
"2011","Havering 014D","E01002318",1207,107,18,89,265,233,133,85,173,90,31,14,17,90
"2011","Havering 014E","E01002355",1071,126,32,94,264,249,117,62,111,71,25,13,12,46
"2011","Havering 014F","E01002382",1331,184,29,155,352,274,160,71,104,70,37,28,9,79
"2011","Havering 015A","E01002270",1226,226,43,183,253,207,199,53,86,57,36,22,14,109
"2011","Havering 015B","E01002271",1125,205,28,177,248,192,180,49,65,45,46,41,5,95
"2011","Havering 015C","E01002273",1010,145,33,112,207,190,113,50,103,66,46,37,9,90
"2011","Havering 015D","E01002275",1024,130,26,104,245,185,164,40,116,44,35,24,11,65
"2011","Havering 016A","E01002319",1180,88,25,63,238,218,135,78,152,112,53,28,25,106
"2011","Havering 016B","E01002350",1150,81,18,63,253,199,120,80,130,121,95,71,24,71
"2011","Havering 016C","E01002351",1191,102,24,78,263,238,123,72,173,100,51,24,27,69
"2011","Havering 016D","E01002352",1223,127,27,100,294,243,125,75,150,77,56,38,18,76
"2011","Havering 016E","E01002358",1407,161,33,128,315,226,149,106,156,120,89,57,32,85
"2011","Havering 017A","E01002246",1176,95,13,82,214,250,119,82,167,112,45,28,17,92
"2011","Havering 017B","E01002247",1320,122,30,92,276,223,145,97,173,102,83,45,38,99
"2011","Havering 017C","E01002248",983,65,13,52,195,155,107,87,140,96,68,38,30,70
"2011","Havering 017D","E01002249",1419,138,25,113,322,232,126,111,175,122,71,49,22,122
"2011","Havering 017E","E01002250",1185,83,21,62,241,213,135,82,157,117,62,42,20,95
"2011","Havering 017F","E01002251",994,41,10,31,197,150,104,70,143,117,76,44,32,96
"2011","Havering 018A","E01002252",1058,107,26,81,202,249,101,68,138,96,30,20,10,67
"2011","Havering 018B","E01002256",1020,95,28,67,246,245,101,55,117,66,27,17,10,68
"2011","Havering 018C","E01002258",1128,114,26,88,257,217,88,57,170,107,52,24,28,66
"2011","Havering 018D","E01002259",1045,97,18,79,243,222,109,68,130,68,34,17,17,74
"2011","Havering 018E","E01002391",1072,110,28,82,254,210,121,64,117,81,26,14,12,89
"2011","Havering 019A","E01002253",1069,173,39,134,286,236,91,49,88,48,14,9,5,84
"2011","Havering 019B","E01002254",1106,158,30,128,261,252,110,56,113,49,11,7,4,96
"2011","Havering 019C","E01002257",1170,227,47,180,298,238,124,43,95,31,18,11,7,96
"2011","Havering 019D","E01002384",1089,162,34,128,288,215,124,45,103,59,23,14,9,70
"2011","Havering 020A","E01002359",938,93,29,64,223,185,98,56,121,59,25,16,9,78
"2011","Havering 020B","E01002360",963,77,22,55,209,209,110,62,114,89,30,16,14,63
"2011","Havering 020C","E01002361",1264,92,22,70,252,227,154,109,173,120,66,30,36,71
"2011","Havering 020D","E01002363",1144,72,24,48,213,203,134,94,176,116,64,31,33,72
"2011","Havering 020E","E01002367",1165,136,38,98,269,248,124,79,109,76,49,28,21,75
"2011","Havering 021A","E01002320",1127,100,20,80,253,245,128,72,153,68,19,10,9,89
"2011","Havering 021B","E01002321",1219,138,23,115,275,274,149,69,125,64,45,29,16,80
"2011","Havering 021C","E01002322",1515,115,31,84,326,328,151,138,189,109,44,29,15,115
"2011","Havering 021D","E01002323",1190,100,19,81,237,244,142,71,158,95,49,26,23,94
"2011","Havering 021E","E01002324",1080,83,19,64,206,208,109,65,169,115,51,35,16,74
"2011","Havering 022A","E01002255",1069,126,26,100,249,221,95,80,134,66,33,17,16,65
"2011","Havering 022B","E01002289",1147,109,32,77,249,217,105,92,154,91,34,21,13,96
"2011","Havering 022C","E01002292",1072,79,21,58,184,206,107,81,173,112,53,34,19,77
"2011","Havering 022D","E01002362",1116,120,26,94,268,238,131,62,113,65,34,18,16,85
"2011","Havering 022E","E01002386",1344,220,47,173,353,292,115,92,102,60,36,23,13,74
"2011","Havering 023A","E01002287",1165,94,22,72,218,260,115,92,166,109,34,23,11,77
"2011","Havering 023B","E01002291",1238,114,26,88,296,261,132,73,159,103,35,21,14,65
"2011","Havering 023C","E01002364",1017,103,31,72,229,220,120,67,135,64,26,16,10,53
"2011","Havering 023D","E01002365",955,80,18,62,173,214,99,73,122,85,28,19,9,81
"2011","Havering 023E","E01002366",1081,77,17,60,227,225,119,75,159,89,27,18,9,83
"2011","Havering 024A","E01002385",1142,128,22,106,288,226,137,63,117,77,21,15,6,85
"2011","Havering 024B","E01002387",1127,184,26,158,320,243,105,49,85,36,17,10,7,88
"2011","Havering 024C","E01002388",1180,185,42,143,308,267,105,49,114,39,20,8,12,93
"2011","Havering 024D","E01002389",1104,162,44,118,302,252,114,45,105,42,16,4,12,66
"2011","Havering 024E","E01002390",1054,164,40,124,285,239,117,36,78,44,17,12,5,74
"2011","Havering 025A","E01002265",1127,89,18,71,234,276,100,70,151,101,39,28,11,67
"2011","Havering 025B","E01002285",929,63,16,47,193,219,99,75,128,79,26,15,11,47
"2011","Havering 025C","E01002286",1201,110,27,83,240,275,128,87,149,98,27,13,14,87
"2011","Havering 025D","E01002288",1188,92,21,71,284,293,116,68,149,87,19,15,4,80
"2011","Havering 025E","E01002290",1084,95,17,78,218,261,110,70,143,77,32,18,14,78
"2011","Havering 026A","E01002260",1164,87,24,63,235,213,114,77,179,104,63,37,26,92
"2011","Havering 026B","E01002261",1184,63,15,48,233,236,116,107,181,114,58,32,26,76
"2011","Havering 026C","E01002262",1143,89,16,73,199,214,115,90,164,121,49,29,20,102
"2011","Havering 026D","E01002263",1245,121,30,91,260,275,109,95,163,115,32,15,17,75
"2011","Havering 026E","E01002264",991,58,12,46,147,175,72,78,186,141,81,49,32,53
"2011","Havering 027A","E01002266",990,60,13,47,150,190,117,87,165,124,38,25,13,59
"2011","Havering 027B","E01002267",1131,48,18,30,200,205,89,94,192,147,58,42,16,98
"2011","Havering 027C","E01002372",1150,69,18,51,187,234,135,83,173,130,36,17,19,103
"2011","Havering 027D","E01002373",1119,65,18,47,192,220,120,97,179,124,51,36,15,71
"2011","Havering 027E","E01002374",1099,57,14,43,177,211,132,82,172,126,44,23,21,98
"2011","Havering 028A","E01002368",1141,52,16,36,151,159,111,100,188,182,114,62,52,84
"2011","Havering 028B","E01002369",1369,73,12,61,224,237,157,121,236,132,74,48,26,115
"2011","Havering 028C","E01002370",1425,84,20,64,211,229,136,116,265,189,87,40,47,108
"2011","Havering 028D","E01002371",1156,71,18,53,195,197,131,109,178,124,65,50,15,86
"2011","Havering 028E","E01002375",1132,53,16,37,175,193,122,87,197,146,83,50,33,76
"2011","Havering 029A","E01002343",1253,88,20,68,226,234,168,85,197,130,45,33,12,80
"2011","Havering 029B","E01002344",1118,74,17,57,178,215,139,103,186,110,39,24,15,74
"2011","Havering 029C","E01002348",1140,61,19,42,197,252,161,100,158,117,22,15,7,72
"2011","Havering 029D","E01002349",1140,68,22,46,207,241,138,84,158,126,34,20,14,84
"2011","Havering 030A","E01002342",1121,49,16,33,172,197,95,106,164,159,73,39,34,106
"2011","Havering 030B","E01002345",1175,63,9,54,209,204,115,75,177,143,107,63,44,82
"2011","Havering 030C","E01002346",1128,60,17,43,185,181,91,92,211,141,80,55,25,87
"2011","Havering 030D","E01002347",1029,57,19,38,177,186,103,99,164,120,38,25,13,85
"2011","Hillingdon 001A","E01002473",1191,259,66,193,321,138,162,33,73,42,46,35,11,117
"2011","Hillingdon 001B","E01002475",1075,168,35,133,312,157,128,44,99,63,58,45,13,46
"2011","Hillingdon 001C","E01002476",1160,320,54,266,302,172,121,14,64,19,44,29,15,104
"2011","Hillingdon 001D","E01002477",933,246,43,203,265,117,73,27,61,28,54,50,4,62
"2011","Hillingdon 001E","E01002482",1138,302,66,236,300,167,119,27,68,23,39,22,17,93
"2011","Hillingdon 002A","E01002472",1166,227,47,180,283,162,116,49,93,42,42,27,15,152
"2011","Hillingdon 002B","E01002474",1090,200,27,173,320,145,138,38,89,42,53,39,14,65
"2011","Hillingdon 002C","E01002478",1122,220,46,174,324,160,127,38,78,47,58,28,30,70
"2011","Hillingdon 002D","E01002483",1264,180,28,152,321,182,147,58,147,70,71,44,27,88
"2011","Hillingdon 002E","E01002484",1057,149,26,123,255,144,122,60,125,84,48,40,8,70
"2011","Hillingdon 002F","E01002485",1261,177,38,139,290,218,134,58,124,78,83,53,30,99
"2011","Hillingdon 003A","E01002438",928,119,37,82,284,130,113,56,73,79,26,17,9,48
"2011","Hillingdon 003B","E01002439",1125,119,28,91,281,153,140,73,134,118,47,31,16,60
"2011","Hillingdon 003C","E01002440",1015,95,29,66,202,155,110,91,128,123,48,26,22,63
"2011","Hillingdon 003D","E01002441",1137,108,30,78,256,174,146,87,127,98,61,39,22,80
"2011","Hillingdon 003E","E01002442",1118,88,24,64,200,174,128,118,159,132,56,32,24,63
"2011","Hillingdon 004A","E01002433",1345,204,49,155,380,202,116,59,126,81,67,47,20,110
"2011","Hillingdon 004B","E01002436",1157,188,37,151,296,162,155,58,108,67,44,28,16,79
"2011","Hillingdon 004C","E01002479",1202,160,37,123,263,199,109,68,144,76,71,40,31,112
"2011","Hillingdon 004D","E01002480",1275,267,40,227,349,204,141,42,86,47,41,23,18,98
"2011","Hillingdon 004E","E01002481",1175,153,28,125,272,156,124,73,132,91,78,62,16,96
"2011","Hillingdon 005A","E01002533",1061,117,27,90,266,171,111,73,122,89,36,22,14,76
"2011","Hillingdon 005B","E01002534",1030,172,41,131,269,169,110,58,83,59,37,26,11,73
"2011","Hillingdon 005C","E01002538",1194,145,38,107,302,208,127,83,142,79,56,42,14,52
"2011","Hillingdon 005D","E01002539",1079,166,36,130,268,192,128,72,98,59,29,19,10,67
"2011","Hillingdon 006A","E01002418",1234,150,30,120,287,248,124,75,122,90,49,35,14,89
"2011","Hillingdon 006B","E01002419",1107,180,37,143,298,194,104,65,114,50,34,23,11,68
"2011","Hillingdon 006C","E01002431",1004,188,34,154,273,183,104,36,67,28,32,18,14,93
"2011","Hillingdon 006D","E01002432",1153,187,42,145,310,201,127,70,94,36,46,34,12,82
"2011","Hillingdon 006E","E01002437",1024,210,47,163,281,182,105,36,74,37,22,15,7,77
"2011","Hillingdon 007A","E01002430",1097,177,39,138,308,213,104,47,90,49,24,12,12,85
"2011","Hillingdon 007B","E01002434",954,166,39,127,279,172,116,40,61,28,17,9,8,75
"2011","Hillingdon 007C","E01002435",1051,195,52,143,299,199,97,42,74,49,26,16,10,70
"2011","Hillingdon 007D","E01002470",1212,171,32,139,303,183,156,85,120,74,43,28,15,77
"2011","Hillingdon 007E","E01002535",1340,254,37,217,403,216,146,62,86,56,42,27,15,75
"2011","Hillingdon 008A","E01002416",1267,116,27,89,297,240,136,89,161,86,44,28,16,98
"2011","Hillingdon 008B","E01002417",1135,208,30,178,298,196,103,63,95,54,44,28,16,74
"2011","Hillingdon 008C","E01002420",1153,142,34,108,288,226,107,77,103,66,64,43,21,80
"2011","Hillingdon 008D","E01002421",1196,140,28,112,294,231,146,74,121,70,49,31,18,71
"2011","Hillingdon 008E","E01002471",1189,170,35,135,348,205,99,72,116,74,30,20,10,75
"2011","Hillingdon 009A","E01002465",1108,138,38,100,269,198,104,88,125,81,40,23,17,65
"2011","Hillingdon 009B","E01002467",999,116,24,92,269,175,110,81,105,64,23,17,6,56
"2011","Hillingdon 009C","E01002494",1252,119,29,90,269,195,141,98,160,113,57,48,9,100
"2011","Hillingdon 009D","E01002536",1021,161,38,123,326,180,68,70,88,36,36,23,13,56
"2011","Hillingdon 009E","E01002537",1072,153,28,125,333,174,95,61,90,63,34,16,18,69
"2011","Hillingdon 010A","E01002415",1256,137,33,104,332,229,118,99,144,76,26,18,8,95
"2011","Hillingdon 010B","E01002466",1177,144,29,115,294,235,117,98,112,79,32,16,16,66
"2011","Hillingdon 010C","E01002468",1250,169,46,123,291,237,130,96,137,79,33,23,10,78
"2011","Hillingdon 010D","E01002469",1247,140,34,106,309,248,133,87,140,83,27,19,8,80
"2011","Hillingdon 010E","E01002495",1753,260,134,126,495,403,118,94,142,96,60,42,18,85
"2011","Hillingdon 011A","E01002458",1020,166,40,126,286,167,115,53,81,38,20,13,7,94
"2011","Hillingdon 011B","E01002459",1132,165,37,128,336,204,104,60,84,51,45,34,11,83
"2011","Hillingdon 011C","E01002460",926,153,33,120,260,155,100,47,66,56,24,14,10,65
"2011","Hillingdon 011D","E01002462",992,205,58,147,257,157,103,45,77,44,16,9,7,88
"2011","Hillingdon 011E","E01002464",1100,179,34,145,279,190,123,81,99,55,33,15,18,61
"2011","Hillingdon 013A","E01002461",1075,189,49,140,276,138,138,48,66,42,36,23,13,142
"2011","Hillingdon 013B","E01002463",1122,178,40,138,293,195,122,53,96,60,22,12,10,103
"2011","Hillingdon 013C","E01002512",1282,239,51,188,350,188,136,62,96,56,33,26,7,122
"2011","Hillingdon 013D","E01002513",1024,168,39,129,273,147,103,57,98,57,39,29,10,82
"2011","Hillingdon 013E","E01002516",1081,186,50,136,260,167,137,55,90,60,38,23,15,88
"2011","Hillingdon 014A","E01002450",1012,88,26,62,211,196,95,72,136,83,38,24,14,93
"2011","Hillingdon 014B","E01002451",1082,103,24,79,256,184,90,71,147,71,41,27,14,119
"2011","Hillingdon 014C","E01002452",1136,126,18,108,271,195,114,72,111,87,41,30,11,119
"2011","Hillingdon 014D","E01002453",1233,105,23,82,243,243,115,98,165,99,48,31,17,117
"2011","Hillingdon 014E","E01002454",1203,78,19,59,212,224,136,102,155,113,77,51,26,106
"2011","Hillingdon 015A","E01002414",3058,123,17,106,206,125,64,61,95,60,51,36,15,2273
"2011","Hillingdon 015C","E01002514",1440,254,32,222,377,222,89,82,111,89,56,40,16,160
"2011","Hillingdon 015D","E01002515",1201,138,22,116,313,204,76,72,128,87,58,39,19,125
"2011","Hillingdon 015F","E01033725",1868,206,82,124,362,240,135,103,185,148,118,85,33,371
"2011","Hillingdon 016B","E01002520",1200,131,31,100,227,156,111,71,117,90,94,65,29,203
"2011","Hillingdon 016C","E01002521",1307,172,27,145,284,200,89,85,123,121,84,53,31,149
"2011","Hillingdon 016D","E01002523",1286,135,22,113,238,130,57,72,99,84,83,66,17,388
"2011","Hillingdon 016F","E01033724",4362,186,43,143,416,273,122,118,194,130,139,109,30,2784
"2011","Hillingdon 017A","E01002410",1308,118,26,92,271,210,121,87,152,91,82,52,30,176
"2011","Hillingdon 017B","E01002412",1787,234,33,201,382,222,141,83,145,102,95,75,20,383
"2011","Hillingdon 017C","E01002456",1109,90,25,65,215,200,87,78,146,120,70,42,28,103
"2011","Hillingdon 017D","E01002509",1047,136,34,102,256,151,107,61,100,59,49,39,10,128
"2011","Hillingdon 017E","E01002511",1122,99,25,74,246,193,94,85,119,96,69,51,18,121
"2011","Hillingdon 018A","E01002422",1010,63,11,52,170,172,90,82,152,104,73,57,16,104
"2011","Hillingdon 018B","E01002423",1196,101,18,83,233,221,105,112,147,121,46,28,18,110
"2011","Hillingdon 018C","E01002424",1136,71,21,50,232,191,107,85,147,94,69,55,14,140
"2011","Hillingdon 018D","E01002425",1333,73,17,56,189,182,90,85,158,142,170,141,29,244
"2011","Hillingdon 018E","E01002427",1084,56,7,49,212,184,94,88,170,117,58,46,12,105
"2011","Hillingdon 018F","E01002428",1054,71,10,61,195,186,112,78,155,108,57,49,8,92
"2011","Hillingdon 019A","E01002408",1159,69,12,57,203,164,79,89,139,115,91,72,19,210
"2011","Hillingdon 019B","E01002409",1248,96,27,69,179,178,111,107,172,128,106,79,27,171
"2011","Hillingdon 019C","E01002429",989,62,15,47,170,130,75,65,135,122,91,73,18,139
"2011","Hillingdon 019D","E01002455",1259,108,22,86,234,173,108,92,156,124,100,76,24,164
"2011","Hillingdon 019E","E01002457",1138,63,16,47,173,142,101,77,129,137,89,71,18,227
"2011","Hillingdon 020A","E01002392",1075,53,11,42,162,119,79,83,190,144,130,90,40,115
"2011","Hillingdon 020B","E01002393",1391,80,11,69,241,174,119,103,179,161,181,134,47,153
"2011","Hillingdon 020C","E01002540",1211,83,22,61,190,176,86,94,181,142,147,114,33,112
"2011","Hillingdon 020D","E01002542",1303,71,17,54,210,138,114,90,214,141,179,151,28,146
"2011","Hillingdon 020E","E01002543",1160,72,17,55,175,156,85,68,183,155,141,110,31,125
"2011","Hillingdon 021A","E01002394",1101,78,15,63,148,126,94,81,182,112,143,122,21,137
"2011","Hillingdon 021B","E01002395",1054,76,15,61,173,121,88,63,154,110,116,90,26,153
"2011","Hillingdon 021C","E01002397",1248,49,12,37,171,128,80,104,189,139,179,129,50,209
"2011","Hillingdon 021D","E01002398",1312,82,12,70,200,145,117,107,193,143,138,112,26,187
"2011","Hillingdon 021E","E01002399",1172,73,16,57,171,161,98,80,192,126,108,95,13,163
"2011","Hillingdon 021F","E01002426",1199,69,9,60,202,165,112,93,222,142,102,73,29,92
"2011","Hillingdon 022A","E01002411",1290,84,28,56,175,138,91,76,163,132,80,58,22,351
"2011","Hillingdon 022B","E01002413",1093,74,14,60,158,138,95,93,123,134,100,57,43,178
"2011","Hillingdon 022C","E01002518",1060,108,18,90,197,134,83,65,96,56,41,26,15,280
"2011","Hillingdon 022D","E01002519",1171,104,19,85,207,170,90,82,150,147,73,57,16,148
"2011","Hillingdon 022E","E01002550",1373,121,20,101,253,184,82,110,169,176,87,59,28,191
"2011","Hillingdon 022F","E01002554",1955,218,24,194,391,265,115,151,235,160,172,122,50,248
"2011","Hillingdon 023A","E01002541",1451,162,30,132,322,216,151,88,176,140,90,60,30,106
"2011","Hillingdon 023B","E01002544",1241,112,18,94,253,149,119,96,164,106,107,86,21,135
"2011","Hillingdon 023C","E01002545",1001,48,10,38,133,116,77,65,159,104,131,100,31,168
"2011","Hillingdon 023D","E01002546",1140,51,15,36,164,142,83,97,181,146,105,87,18,171
"2011","Hillingdon 023E","E01002547",1140,63,8,55,172,140,95,69,159,119,149,117,32,174
"2011","Hillingdon 024A","E01002400",1288,79,18,61,200,159,121,86,169,163,135,110,25,176
"2011","Hillingdon 024B","E01002401",1224,60,13,47,200,157,108,93,170,140,142,116,26,154
"2011","Hillingdon 024C","E01002402",1075,47,11,36,165,135,80,61,159,139,120,90,30,169
"2011","Hillingdon 024D","E01002403",1227,57,14,43,165,150,99,80,189,147,144,126,18,196
"2011","Hillingdon 024E","E01002404",1259,68,15,53,191,167,92,92,201,192,161,132,29,95
"2011","Hillingdon 025A","E01002548",1114,78,17,61,158,154,78,97,174,183,102,66,36,90
"2011","Hillingdon 025B","E01002549",1323,122,23,99,256,198,111,99,179,118,70,51,19,170
"2011","Hillingdon 025C","E01002551",1378,78,18,60,233,176,109,108,192,165,98,78,20,219
"2011","Hillingdon 025D","E01002552",1155,80,9,71,160,133,97,97,180,156,89,67,22,163
"2011","Hillingdon 025E","E01002553",1227,52,11,41,201,156,90,90,185,176,100,75,25,177
"2011","Hillingdon 026A","E01002396",1241,71,14,57,184,156,93,88,189,130,145,114,31,185
"2011","Hillingdon 026B","E01002501",1210,87,15,72,198,151,105,68,159,138,117,91,26,187
"2011","Hillingdon 026C","E01002502",1169,45,12,33,155,155,104,77,177,155,136,111,25,165
"2011","Hillingdon 026D","E01002505",1213,59,9,50,170,158,83,103,194,167,139,99,40,140
"2011","Hillingdon 026E","E01002508",1356,50,10,40,177,130,98,109,200,161,215,175,40,216
"2011","Hillingdon 027A","E01002405",1401,66,16,50,209,160,128,110,211,164,172,135,37,181
"2011","Hillingdon 027B","E01002406",1501,93,16,77,200,203,116,120,225,159,183,146,37,202
"2011","Hillingdon 027C","E01002503",1240,53,10,43,161,128,86,77,171,186,145,121,24,233
"2011","Hillingdon 027D","E01002504",1466,103,21,82,279,183,127,103,214,155,164,135,29,138
"2011","Hillingdon 027E","E01002506",1302,64,12,52,171,145,100,87,199,161,187,155,32,188
"2011","Hillingdon 027F","E01002507",1211,78,18,60,160,129,88,92,197,157,131,107,24,179
"2011","Hillingdon 028A","E01002486",1485,97,21,76,248,186,113,127,201,166,150,118,32,197
"2011","Hillingdon 028B","E01002487",1304,75,13,62,193,165,131,87,216,173,126,95,31,138
"2011","Hillingdon 028C","E01002526",1334,73,13,60,204,153,107,113,230,165,124,86,38,165
"2011","Hillingdon 028D","E01002528",1196,64,10,54,160,170,111,93,164,177,128,101,27,129
"2011","Hillingdon 028E","E01002532",1643,165,35,130,266,242,103,134,212,175,150,108,42,196
"2011","Hillingdon 029A","E01002445",1042,38,9,29,155,156,74,111,158,142,91,60,31,117
"2011","Hillingdon 029B","E01002525",1218,121,23,98,287,200,121,75,132,119,59,41,18,104
"2011","Hillingdon 029C","E01002529",1536,153,11,142,307,201,146,116,174,144,101,72,29,194
"2011","Hillingdon 029D","E01002530",1034,37,8,29,156,136,89,87,172,144,96,58,38,117
"2011","Hillingdon 029E","E01002531",1232,108,24,84,263,184,128,102,143,115,76,62,14,113
"2011","Hillingdon 030A","E01002407",1702,112,20,92,263,190,114,128,251,191,226,185,41,227
"2011","Hillingdon 030B","E01002488",1219,75,22,53,178,158,121,117,184,129,115,91,24,142
"2011","Hillingdon 030C","E01002489",1329,82,15,67,178,162,95,105,201,159,137,105,32,210
"2011","Hillingdon 030D","E01002490",1499,75,13,62,237,221,129,145,217,173,142,115,27,160
"2011","Hillingdon 030E","E01002492",1161,72,12,60,173,148,116,91,169,135,98,81,17,159
"2011","Hillingdon 031A","E01002444",1517,77,22,55,242,220,155,166,187,198,161,127,34,111
"2011","Hillingdon 031B","E01002446",1171,75,17,58,211,187,103,107,178,153,77,53,24,80
"2011","Hillingdon 031C","E01002447",1331,58,15,43,189,193,120,157,204,196,98,63,35,116
"2011","Hillingdon 031D","E01002527",1073,122,23,99,198,155,81,92,118,110,75,53,22,122
"2011","Hillingdon 032A","E01002443",1208,75,13,62,196,167,91,130,154,158,107,83,24,130
"2011","Hillingdon 032B","E01002448",1448,80,17,63,264,191,107,125,233,192,133,98,35,123
"2011","Hillingdon 032C","E01002449",1395,83,11,72,225,219,98,167,197,175,106,72,34,125
"2011","Hillingdon 032D","E01002491",1118,59,9,50,138,149,78,65,189,136,134,102,32,170
"2011","Hillingdon 032E","E01002493",1218,46,7,39,177,139,78,96,201,177,152,126,26,152
"2011","Hillingdon 033A","E01002496",1315,133,31,102,283,242,152,80,162,112,66,39,27,85
"2011","Hillingdon 033B","E01002497",1318,129,22,107,276,203,163,86,166,134,81,53,28,80
"2011","Hillingdon 033C","E01002498",1021,123,32,91,223,190,99,74,108,92,38,29,9,74
"2011","Hillingdon 033D","E01002499",1243,112,29,83,302,197,132,97,130,123,65,39,26,85
"2011","Hillingdon 033E","E01032577",1225,129,32,97,275,212,131,79,144,94,56,37,19,105
"2011","Hounslow 001A","E01002569",1383,343,83,260,486,149,115,41,80,57,37,21,16,75
"2011","Hounslow 001B","E01002570",1362,304,62,242,443,127,134,60,72,49,64,35,29,109
"2011","Hounslow 001C","E01002573",1230,359,87,272,406,102,117,23,62,31,36,18,18,94
"2011","Hounslow 001D","E01002574",1190,290,58,232,413,118,115,21,42,32,34,25,9,125
"2011","Hounslow 001E","E01002575",1316,331,76,255,446,117,117,41,56,49,44,32,12,115
"2011","Hounslow 003A","E01002562",1066,99,23,76,193,132,140,68,128,112,105,75,30,89
"2011","Hounslow 003B","E01002564",1386,110,15,95,302,144,153,110,172,150,123,97,26,122
"2011","Hounslow 003C","E01002566",1618,196,42,154,314,191,151,83,198,170,171,136,35,144
"2011","Hounslow 003D","E01002568",2029,210,39,171,430,220,177,117,264,197,232,180,52,182
"2011","Hounslow 003F","E01033081",1020,216,56,160,319,107,90,34,66,56,67,45,22,65
"2011","Hounslow 003G","E01033082",954,164,33,131,251,134,97,54,82,67,64,46,18,41
"2011","Hounslow 004A","E01002620",1295,115,12,103,195,150,113,85,199,140,147,116,31,151
"2011","Hounslow 004B","E01002625",1289,86,10,76,203,151,131,92,186,132,124,101,23,184
"2011","Hounslow 004C","E01002626",1263,92,23,69,202,159,131,81,193,122,127,101,26,156
"2011","Hounslow 004D","E01002627",1219,89,13,76,180,152,105,61,177,127,187,154,33,141
"2011","Hounslow 004E","E01002631",1195,82,9,73,205,166,103,78,159,118,125,109,16,159
"2011","Hounslow 005A","E01002633",1164,38,6,32,138,136,88,86,185,181,153,127,26,159
"2011","Hounslow 005B","E01002634",1164,40,7,33,123,142,68,91,190,150,191,164,27,169
"2011","Hounslow 005C","E01002637",1230,53,11,42,156,123,90,79,188,159,194,164,30,188
"2011","Hounslow 005D","E01002638",1277,63,17,46,172,153,99,89,211,130,207,188,19,153
"2011","Hounslow 006A","E01002563",1288,158,24,134,345,169,167,71,106,74,71,51,20,127
"2011","Hounslow 006B","E01002565",2421,252,52,200,448,219,197,93,159,112,59,41,18,882
"2011","Hounslow 006C","E01002567",1378,235,56,179,452,149,145,85,101,94,53,32,21,64
"2011","Hounslow 006D","E01002684",1884,345,74,271,477,199,219,77,164,131,155,121,34,117
"2011","Hounslow 006E","E01002686",1323,78,18,60,173,171,165,91,174,184,132,101,31,155
"2011","Hounslow 007A","E01002571",1013,289,79,210,335,94,127,23,32,27,19,10,9,67
"2011","Hounslow 007B","E01002572",1202,110,23,87,259,159,100,79,130,134,115,76,39,116
"2011","Hounslow 007C","E01002577",1261,281,55,226,437,119,148,42,70,39,43,28,15,82
"2011","Hounslow 007D","E01002578",1103,268,54,214,339,102,137,28,45,50,37,26,11,97
"2011","Hounslow 007E","E01002689",1199,286,69,217,379,125,104,41,78,59,65,49,16,62
"2011","Hounslow 007F","E01002690",1128,287,72,215,348,114,88,50,57,46,47,28,19,91
"2011","Hounslow 008A","E01002576",1283,240,53,187,370,121,133,33,124,81,76,53,23,105
"2011","Hounslow 008B","E01002579",1339,316,82,234,467,106,161,47,63,42,49,35,14,88
"2011","Hounslow 008C","E01002580",1068,222,50,172,345,121,101,38,79,52,50,30,20,60
"2011","Hounslow 008D","E01002581",1492,364,65,299,525,145,125,37,85,65,45,34,11,101
"2011","Hounslow 008E","E01002582",1245,284,71,213,463,107,111,45,59,48,47,33,14,81
"2011","Hounslow 009A","E01002675",1824,291,52,239,524,240,175,90,143,86,86,61,25,189
"2011","Hounslow 009B","E01002678",1451,221,30,191,366,180,194,86,131,62,81,58,23,130
"2011","Hounslow 009C","E01002679",1365,192,27,165,358,166,187,74,113,92,56,47,9,127
"2011","Hounslow 009D","E01002680",1512,242,38,204,335,191,200,77,155,78,110,81,29,124
"2011","Hounslow 010A","E01002619",1448,118,17,101,224,214,110,86,193,148,149,121,28,206
"2011","Hounslow 010B","E01002622",1317,115,12,103,226,190,85,94,193,125,110,91,19,179
"2011","Hounslow 010C","E01002632",1351,117,15,102,238,190,106,90,186,142,122,97,25,160
"2011","Hounslow 010D","E01002635",1325,107,21,86,226,182,103,91,168,142,146,117,29,160
"2011","Hounslow 010E","E01002636",1520,111,17,94,244,204,125,116,210,162,175,145,30,173
"2011","Hounslow 011A","E01002618",1322,116,17,99,236,223,114,76,166,83,108,95,13,200
"2011","Hounslow 011B","E01002621",1368,103,15,88,256,172,129,88,184,116,151,118,33,169
"2011","Hounslow 011C","E01002623",1208,89,15,74,187,163,114,77,172,112,135,114,21,159
"2011","Hounslow 011D","E01002628",1491,144,18,126,291,189,162,86,194,97,128,114,14,200
"2011","Hounslow 011E","E01002629",1525,177,10,167,305,199,141,73,198,103,143,113,30,186
"2011","Hounslow 012A","E01002630",1294,169,21,148,251,167,143,70,144,90,113,92,21,147
"2011","Hounslow 012B","E01002639",1335,131,14,117,220,183,132,88,171,132,89,75,14,189
"2011","Hounslow 012C","E01002640",1449,142,8,134,259,163,130,88,160,112,107,80,27,288
"2011","Hounslow 012D","E01002674",1285,224,41,183,352,175,144,65,89,58,67,57,10,111
"2011","Hounslow 012E","E01002676",1324,227,27,200,322,177,125,55,122,50,80,64,16,166
"2011","Hounslow 013A","E01002583",1278,92,20,72,215,171,124,95,176,136,119,100,19,150
"2011","Hounslow 013B","E01002584",1264,79,12,67,178,150,91,94,200,156,139,116,23,177
"2011","Hounslow 013C","E01002585",1246,58,12,46,163,125,116,95,177,181,125,111,14,206
"2011","Hounslow 013D","E01002586",1302,74,10,64,170,174,108,112,188,180,117,96,21,179
"2011","Hounslow 013E","E01002589",1436,68,10,58,199,188,104,106,230,180,191,156,35,170
"2011","Hounslow 014A","E01002668",1516,231,40,191,477,222,128,69,125,91,85,59,26,88
"2011","Hounslow 014B","E01002669",1290,86,9,77,255,154,149,73,199,145,110,82,28,119
"2011","Hounslow 014C","E01002681",1558,176,34,142,342,181,138,78,169,161,107,84,23,206
"2011","Hounslow 014D","E01002682",1731,197,36,161,474,213,151,100,171,149,117,94,23,159
"2011","Hounslow 014E","E01002683",1896,300,43,257,570,232,213,112,121,96,101,80,21,151
"2011","Hounslow 015A","E01002642",1532,185,22,163,246,175,100,97,207,146,137,114,23,239
"2011","Hounslow 015B","E01002643",1669,168,16,152,347,205,136,104,213,157,141,116,25,198
"2011","Hounslow 015C","E01002645",1599,122,17,105,277,165,150,107,223,160,151,111,40,244
"2011","Hounslow 015D","E01002658",988,138,28,110,300,136,120,54,83,49,31,23,8,77
"2011","Hounslow 015E","E01002677",1213,168,33,135,304,164,113,74,116,77,91,69,22,106
"2011","Hounslow 016A","E01002587",1436,108,12,96,213,158,111,104,199,178,156,130,26,209
"2011","Hounslow 016B","E01002588",1200,44,8,36,139,153,84,77,204,157,200,159,41,142
"2011","Hounslow 016C","E01002660",1380,101,7,94,227,166,111,94,214,152,115,95,20,200
"2011","Hounslow 016D","E01002661",1469,101,16,85,236,149,131,107,250,149,134,114,20,212
"2011","Hounslow 016E","E01002665",1202,73,8,65,170,152,91,90,184,145,139,122,17,158
"2011","Hounslow 017A","E01002624",1143,99,9,90,184,141,76,108,149,133,118,89,29,135
"2011","Hounslow 017B","E01002646",1421,107,12,95,198,160,104,105,238,115,208,172,36,186
"2011","Hounslow 017C","E01002662",1634,182,26,156,305,198,160,107,190,127,125,105,20,240
"2011","Hounslow 017D","E01002663",1552,103,22,81,228,201,118,102,285,171,147,123,24,197
"2011","Hounslow 017E","E01002664",1341,119,9,110,219,149,107,99,176,139,131,105,26,202
"2011","Hounslow 018A","E01002641",1485,155,11,144,236,179,148,102,194,140,137,104,33,194
"2011","Hounslow 018C","E01002648",2029,185,29,156,342,212,184,141,311,186,181,139,42,287
"2011","Hounslow 018D","E01002649",1436,133,11,122,238,155,150,124,187,112,121,98,23,216
"2011","Hounslow 018E","E01002657",1379,169,28,141,347,186,138,87,154,94,66,50,16,138
"2011","Hounslow 018F","E01033083",1297,297,16,281,340,132,65,49,105,46,126,108,18,137
"2011","Hounslow 018G","E01033084",1326,134,16,118,256,124,107,96,159,122,121,95,26,207
"2011","Hounslow 019A","E01002653",1388,136,15,121,259,191,164,67,149,112,105,83,22,205
"2011","Hounslow 019B","E01002654",1360,126,25,101,288,198,153,104,173,105,74,48,26,139
"2011","Hounslow 019C","E01002655",1411,140,17,123,309,208,170,81,171,110,81,57,24,141
"2011","Hounslow 019D","E01002656",968,109,20,89,223,146,91,70,117,69,53,43,10,90
"2011","Hounslow 019E","E01002659",1013,108,22,86,215,138,103,58,134,90,62,42,20,105
"2011","Hounslow 020A","E01002667",1195,171,38,133,332,136,105,64,114,84,89,61,28,100
"2011","Hounslow 020B","E01002670",1308,146,25,121,329,175,144,73,134,96,76,48,28,135
"2011","Hounslow 020C","E01002671",1242,172,15,157,329,147,130,75,117,113,65,51,14,94
"2011","Hounslow 020D","E01002672",1197,118,25,93,247,123,84,67,157,122,127,95,32,152
"2011","Hounslow 020E","E01002673",1102,41,5,36,126,105,88,76,206,139,182,151,31,139
"2011","Hounslow 021A","E01002647",1544,122,14,108,254,192,117,115,238,141,193,146,47,172
"2011","Hounslow 021B","E01002650",1684,161,13,148,320,215,157,87,226,158,168,145,23,192
"2011","Hounslow 021C","E01002651",1359,116,14,102,218,157,123,99,188,117,110,88,22,231
"2011","Hounslow 021D","E01002652",1373,100,6,94,232,164,125,96,212,109,143,112,31,192
"2011","Hounslow 021E","E01002666",1236,70,11,59,199,254,84,81,165,118,118,88,30,147
"2011","Hounslow 022A","E01002555",1434,106,23,83,243,240,143,117,212,166,78,58,20,129
"2011","Hounslow 022B","E01002556",1190,75,14,61,220,203,103,109,177,151,69,52,17,83
"2011","Hounslow 022C","E01002590",1361,103,20,83,233,213,123,126,180,157,89,74,15,137
"2011","Hounslow 022D","E01002592",1448,76,11,65,234,206,128,124,239,188,111,82,29,142
"2011","Hounslow 022E","E01002595",1430,62,18,44,208,220,106,105,259,227,105,78,27,138
"2011","Hounslow 023A","E01002557",1293,98,22,76,217,218,122,106,201,151,80,63,17,100
"2011","Hounslow 023B","E01002558",1397,70,18,52,234,236,88,124,203,193,133,98,35,116
"2011","Hounslow 023C","E01002559",1657,100,19,81,311,249,148,158,237,208,118,96,22,128
"2011","Hounslow 023D","E01002560",1231,64,15,49,184,183,117,111,186,168,99,73,26,119
"2011","Hounslow 023E","E01002561",957,34,8,26,141,157,65,86,160,137,98,61,37,79
"2011","Hounslow 024A","E01002591",1256,54,13,41,181,196,121,109,205,188,77,56,21,125
"2011","Hounslow 024B","E01002593",1559,93,24,69,272,242,130,134,259,166,118,103,15,145
"2011","Hounslow 024C","E01002594",1422,97,9,88,228,221,108,114,243,159,113,91,22,139
"2011","Hounslow 024D","E01002611",1310,95,16,79,234,187,125,113,199,160,84,59,25,113
"2011","Hounslow 024E","E01002612",1219,103,23,80,222,171,96,95,195,142,101,80,21,94
"2011","Hounslow 024F","E01002613",1287,76,12,64,227,175,116,91,199,155,105,81,24,143
"2011","Hounslow 025B","E01002598",1328,75,22,53,181,179,115,120,206,197,121,89,32,134
"2011","Hounslow 025C","E01002599",1152,56,13,43,169,177,95,107,185,133,119,98,21,111
"2011","Hounslow 025D","E01002600",1096,49,10,39,152,160,107,101,189,174,71,54,17,93
"2011","Hounslow 025E","E01002603",1362,115,17,98,274,195,104,94,207,139,120,97,23,114
"2011","Hounslow 025F","E01033000",1208,55,9,46,187,163,78,95,197,189,133,100,33,111
"2011","Hounslow 025G","E01033030",1319,311,20,291,328,175,72,57,106,72,125,101,24,73
"2011","Hounslow 026A","E01002604",1149,31,8,23,155,115,94,88,198,147,155,118,37,166
"2011","Hounslow 026B","E01002605",1312,72,12,60,215,174,140,104,215,171,115,86,29,106
"2011","Hounslow 026C","E01002606",1183,31,7,24,141,142,95,107,228,231,114,78,36,94
"2011","Hounslow 026D","E01002607",1361,79,19,60,215,191,127,120,211,187,93,67,26,138
"2011","Hounslow 026E","E01002615",1073,53,7,46,158,138,89,88,175,160,106,73,33,106
"2011","Hounslow 027A","E01002596",1515,100,17,83,284,223,104,107,214,171,178,157,21,134
"2011","Hounslow 027B","E01002601",1205,112,27,85,237,181,136,98,169,123,57,42,15,92
"2011","Hounslow 027C","E01002602",1081,89,20,69,221,202,100,85,160,111,36,21,15,77
"2011","Hounslow 027D","E01002614",1319,105,20,85,284,220,123,107,167,143,66,49,17,104
"2011","Hounslow 027E","E01002616",978,62,15,47,176,188,83,87,147,117,51,37,14,67
"2011","Hounslow 028A","E01002608",1196,70,17,53,191,183,105,94,187,162,104,75,29,100
"2011","Hounslow 028B","E01002609",1289,102,17,85,257,190,137,100,198,123,75,54,21,107
"2011","Hounslow 028C","E01002610",1096,71,21,50,179,164,97,87,167,150,86,62,24,95
"2011","Hounslow 028D","E01002617",1206,112,27,85,280,197,119,108,150,119,40,30,10,81
"2011","Hounslow 029A","E01002687",1411,342,71,271,504,157,138,49,58,46,43,27,16,74
"2011","Hounslow 029B","E01002691",1212,197,35,162,314,150,156,65,86,68,64,52,12,112
"2011","Hounslow 029C","E01002692",1469,321,72,249,498,158,95,66,98,62,81,48,33,90
"2011","Hounslow 029D","E01002693",1248,313,56,257,391,139,112,44,82,53,37,30,7,77
"2011","Hounslow 029E","E01032573",1319,380,64,316,455,144,98,47,52,37,33,20,13,73
"2011","Kingston upon Thames 001A","E01003006",1032,220,51,169,310,119,111,34,73,50,38,25,13,77
"2011","Kingston upon Thames 001B","E01003007",1029,202,36,166,324,124,111,38,73,35,33,27,6,89
"2011","Kingston upon Thames 001C","E01003008",976,200,31,169,314,145,108,38,67,24,16,10,6,64
"2011","Kingston upon Thames 001D","E01003009",1333,273,59,214,386,171,143,46,98,72,44,32,12,100
"2011","Kingston upon Thames 001E","E01003010",1082,228,49,179,351,130,111,30,70,34,30,18,12,98
"2011","Kingston upon Thames 002A","E01002952",1094,261,85,176,265,107,136,18,45,20,66,61,5,176
"2011","Kingston upon Thames 002B","E01002953",947,183,52,131,242,96,137,26,39,36,35,27,8,153
"2011","Kingston upon Thames 002C","E01002955",1056,158,22,136,237,104,124,28,89,48,66,55,11,202
"2011","Kingston upon Thames 002D","E01002956",1219,156,28,128,245,66,103,31,54,44,58,51,7,462
"2011","Kingston upon Thames 002E","E01002959",1012,267,49,218,274,127,110,15,39,15,48,39,9,117
"2011","Kingston upon Thames 003A","E01002935",1450,283,55,228,408,119,92,65,120,49,34,22,12,280
"2011","Kingston upon Thames 003B","E01002938",1357,333,97,236,435,137,134,32,95,45,40,23,17,106
"2011","Kingston upon Thames 003C","E01002951",1137,263,48,215,357,111,96,23,62,25,66,48,18,134
"2011","Kingston upon Thames 003D","E01002954",930,179,23,156,314,89,73,21,70,32,43,30,13,109
"2011","Kingston upon Thames 003E","E01002957",1258,95,22,73,196,94,101,47,138,88,100,75,25,399
"2011","Kingston upon Thames 004A","E01002933",1377,233,42,191,405,131,122,63,120,81,70,50,20,152
"2011","Kingston upon Thames 004B","E01002934",1307,328,92,236,384,145,99,47,100,37,38,28,10,129
"2011","Kingston upon Thames 004D","E01002937",1223,266,55,211,436,119,107,30,75,35,34,22,12,121
"2011","Kingston upon Thames 004E","E01003011",1276,290,75,215,427,126,113,34,78,34,44,31,13,130
"2011","Kingston upon Thames 004F","E01033568",1161,255,57,198,364,105,67,38,58,43,52,36,16,179
"2011","Kingston upon Thames 004G","E01033569",1335,252,45,207,384,123,97,34,72,41,46,29,17,286
"2011","Kingston upon Thames 005A","E01002964",1794,216,40,176,397,125,104,61,141,90,83,59,24,577
"2011","Kingston upon Thames 005B","E01002969",1287,55,10,45,164,104,85,90,218,202,177,137,40,192
"2011","Kingston upon Thames 005C","E01002971",1334,226,35,191,365,121,112,68,113,61,46,31,15,222
"2011","Kingston upon Thames 005D","E01002972",1488,219,33,186,374,157,88,57,117,74,60,41,19,342
"2011","Kingston upon Thames 005E","E01002974",1437,207,34,173,383,129,120,59,129,72,82,62,20,256
"2011","Kingston upon Thames 006A","E01002932",1256,104,11,93,231,151,112,89,159,107,134,99,35,169
"2011","Kingston upon Thames 006B","E01002960",1159,234,43,191,304,117,103,30,99,34,53,43,10,185
"2011","Kingston upon Thames 006C","E01002962",1103,114,17,97,217,135,119,67,156,96,70,53,17,129
"2011","Kingston upon Thames 006D","E01002970",1196,100,18,82,210,125,100,65,165,150,75,51,24,206
"2011","Kingston upon Thames 006E","E01002973",1026,65,12,53,147,120,107,66,154,107,90,70,20,170
"2011","Kingston upon Thames 007A","E01002929",1211,279,59,220,360,161,121,20,71,23,53,39,14,123
"2011","Kingston upon Thames 007B","E01002930",1266,177,36,141,339,154,121,58,124,81,80,57,23,132
"2011","Kingston upon Thames 007C","E01002931",1316,223,42,181,401,161,115,41,113,56,68,49,19,138
"2011","Kingston upon Thames 007D","E01002963",1281,238,37,201,318,177,129,45,108,61,52,43,9,153
"2011","Kingston upon Thames 007E","E01002985",1183,145,32,113,255,146,116,61,167,58,95,82,13,140
"2011","Kingston upon Thames 008A","E01002927",1137,151,29,122,276,158,108,54,130,63,51,37,14,146
"2011","Kingston upon Thames 008B","E01002928",1156,188,39,149,303,151,113,40,100,51,85,75,10,125
"2011","Kingston upon Thames 008C","E01002958",1241,221,45,176,353,184,136,52,98,49,58,46,12,90
"2011","Kingston upon Thames 008D","E01002961",1260,268,45,223,372,145,107,32,85,50,51,46,5,150
"2011","Kingston upon Thames 008E","E01002986",922,147,26,121,212,108,129,45,89,52,53,45,8,87
"2011","Kingston upon Thames 009A","E01002965",1927,314,53,261,450,154,129,64,113,66,62,45,17,575
"2011","Kingston upon Thames 009B","E01002967",1534,407,71,336,514,152,120,30,77,35,42,30,12,157
"2011","Kingston upon Thames 009C","E01002968",2276,325,65,260,509,176,154,55,102,57,86,63,23,812
"2011","Kingston upon Thames 009D","E01002990",1437,342,50,292,460,171,108,42,83,48,50,32,18,133
"2011","Kingston upon Thames 009E","E01002991",1317,296,52,244,365,119,105,33,78,33,38,26,12,250
"2011","Kingston upon Thames 010A","E01002922",1223,290,45,245,378,154,97,35,68,43,32,20,12,126
"2011","Kingston upon Thames 010B","E01002926",1081,198,40,158,311,157,88,41,91,40,26,16,10,129
"2011","Kingston upon Thames 010C","E01002966",1461,273,64,209,421,146,120,50,93,50,50,30,20,258
"2011","Kingston upon Thames 010D","E01002992",1548,155,32,123,208,85,63,40,72,36,31,21,10,858
"2011","Kingston upon Thames 011A","E01002921",1302,235,44,191,422,140,125,45,83,40,44,32,12,168
"2011","Kingston upon Thames 011B","E01002987",1411,239,33,206,420,146,113,45,94,72,101,62,39,181
"2011","Kingston upon Thames 011C","E01002988",1652,244,41,203,294,114,75,28,69,43,35,26,9,750
"2011","Kingston upon Thames 011D","E01002989",1535,454,90,364,564,149,110,40,73,39,23,10,13,83
"2011","Kingston upon Thames 012A","E01002975",991,149,22,127,218,137,123,47,90,54,72,60,12,101
"2011","Kingston upon Thames 012B","E01002977",1168,99,27,72,240,181,150,65,132,101,99,75,24,101
"2011","Kingston upon Thames 012C","E01002980",1049,130,22,108,232,165,155,44,96,46,71,59,12,110
"2011","Kingston upon Thames 012D","E01002981",1118,178,32,146,251,158,124,43,120,47,64,53,11,133
"2011","Kingston upon Thames 012E","E01002984",965,169,23,146,231,127,104,38,88,53,72,62,10,83
"2011","Kingston upon Thames 013A","E01002923",1191,119,14,105,207,113,115,46,139,108,80,55,25,264
"2011","Kingston upon Thames 013B","E01002925",1249,266,48,218,426,144,115,43,72,53,22,11,11,108
"2011","Kingston upon Thames 013C","E01002993",1262,277,37,240,440,161,86,47,65,50,30,16,14,106
"2011","Kingston upon Thames 013D","E01002995",1060,326,73,253,338,114,84,23,35,21,33,29,4,86
"2011","Kingston upon Thames 013E","E01002999",1191,214,42,172,362,139,75,38,72,53,72,39,33,166
"2011","Kingston upon Thames 014A","E01002915",991,136,34,102,207,156,136,48,135,54,41,31,10,78
"2011","Kingston upon Thames 014B","E01002916",1077,148,22,126,262,164,150,45,100,43,42,33,9,123
"2011","Kingston upon Thames 014C","E01002917",1019,161,31,130,243,178,113,60,99,50,25,14,11,90
"2011","Kingston upon Thames 014D","E01002920",1108,194,31,163,305,172,132,52,94,47,34,19,15,78
"2011","Kingston upon Thames 014E","E01002924",1060,228,42,186,340,167,98,29,58,22,27,16,11,91
"2011","Kingston upon Thames 015A","E01002976",1185,173,47,126,297,210,131,65,135,71,28,21,7,75
"2011","Kingston upon Thames 015B","E01002978",1337,250,52,198,351,209,145,61,105,48,61,47,14,107
"2011","Kingston upon Thames 015C","E01002979",1168,180,33,147,338,202,127,57,89,55,44,37,7,76
"2011","Kingston upon Thames 015D","E01002982",1007,151,19,132,200,159,134,47,96,63,57,50,7,100
"2011","Kingston upon Thames 015E","E01002983",1210,228,42,186,294,190,146,44,101,33,50,35,15,124
"2011","Kingston upon Thames 016A","E01002994",1079,253,45,208,339,133,89,36,81,26,51,35,16,71
"2011","Kingston upon Thames 016B","E01002996",1106,231,46,185,340,124,109,48,74,44,27,19,8,109
"2011","Kingston upon Thames 016C","E01002997",1114,252,45,207,337,131,100,24,61,52,61,47,14,96
"2011","Kingston upon Thames 016D","E01002998",1113,149,25,124,286,142,91,60,126,83,56,42,14,120
"2011","Kingston upon Thames 016E","E01003002",1320,187,34,153,348,162,137,68,155,85,63,36,27,115
"2011","Kingston upon Thames 017A","E01002918",1223,109,20,89,236,175,96,85,203,120,78,64,14,121
"2011","Kingston upon Thames 017B","E01002919",1256,101,25,76,263,159,145,80,165,100,96,67,29,147
"2011","Kingston upon Thames 017C","E01003000",1153,89,16,73,235,156,119,67,188,112,60,43,17,127
"2011","Kingston upon Thames 017D","E01003001",1340,133,26,107,286,211,150,75,180,90,62,49,13,153
"2011","Kingston upon Thames 017E","E01003003",1176,121,23,98,266,157,114,61,158,83,77,59,18,139
"2011","Kingston upon Thames 018A","E01002939",1140,104,21,83,237,186,103,82,170,109,53,35,18,96
"2011","Kingston upon Thames 018B","E01002941",1090,125,32,93,243,200,114,66,151,68,39,23,16,84
"2011","Kingston upon Thames 018C","E01002942",996,103,24,79,233,187,109,77,110,72,28,18,10,77
"2011","Kingston upon Thames 018D","E01003004",1137,123,24,99,271,196,121,74,138,70,44,27,17,100
"2011","Kingston upon Thames 018E","E01003005",1090,107,25,82,239,195,140,81,141,95,29,19,10,63
"2011","Kingston upon Thames 019A","E01002944",979,84,26,58,207,181,95,80,134,94,33,21,12,71
"2011","Kingston upon Thames 019B","E01002945",1154,103,19,84,288,205,131,85,146,108,35,19,16,53
"2011","Kingston upon Thames 019C","E01002946",1144,110,23,87,293,226,101,85,137,91,32,21,11,69
"2011","Kingston upon Thames 019D","E01002947",1188,121,34,87,273,218,148,75,148,91,25,16,9,89
"2011","Kingston upon Thames 020A","E01002940",1104,86,23,63,204,216,111,76,177,98,55,35,20,81
"2011","Kingston upon Thames 020B","E01002943",1036,83,19,64,207,141,124,83,149,105,51,39,12,93
"2011","Kingston upon Thames 020C","E01002948",1492,176,37,139,366,216,137,79,203,128,75,54,21,112
"2011","Kingston upon Thames 020D","E01002949",1341,153,41,112,312,232,142,93,171,71,44,29,15,123
"2011","Kingston upon Thames 020E","E01002950",1148,117,24,93,234,200,117,57,176,122,57,37,20,68
"2011","Merton 001A","E01003472",957,293,50,243,330,97,92,16,30,22,26,14,12,51
"2011","Merton 001B","E01003473",1040,270,51,219,353,123,96,21,48,28,28,24,4,73
"2011","Merton 001C","E01003474",1007,279,73,206,360,96,87,14,34,18,16,11,5,103
"2011","Merton 001D","E01003475",2002,425,63,362,615,242,165,89,151,95,87,58,29,133
"2011","Merton 001E","E01003478",1182,340,71,269,405,130,101,41,44,32,18,14,4,71
"2011","Merton 002A","E01003460",1097,326,91,235,354,112,103,23,37,40,36,26,10,66
"2011","Merton 002B","E01003462",1021,308,94,214,350,90,112,19,26,14,26,17,9,76
"2011","Merton 002C","E01003464",930,261,70,191,309,80,104,14,37,21,44,39,5,60
"2011","Merton 002D","E01003465",893,298,84,214,268,73,97,7,35,18,29,26,3,68
"2011","Merton 003A","E01003400",1228,369,58,311,401,118,115,42,47,37,26,16,10,73
"2011","Merton 003B","E01003454",1033,318,56,262,349,104,61,27,51,26,30,23,7,67
"2011","Merton 003C","E01003456",1276,368,57,311,395,142,79,39,50,60,49,30,19,94
"2011","Merton 003D","E01003476",1045,235,41,194,278,118,90,34,73,53,46,37,9,118
"2011","Merton 003E","E01003477",1164,317,62,255,354,141,81,29,65,34,54,47,7,89
"2011","Merton 004A","E01003401",1027,342,53,289,353,104,55,23,35,23,32,23,9,60
"2011","Merton 004B","E01003402",1183,410,71,339,385,127,79,15,35,22,37,27,10,73
"2011","Merton 004C","E01003403",1159,359,70,289,395,110,96,28,39,32,37,21,16,63
"2011","Merton 004D","E01003404",1334,461,78,383,427,139,80,30,61,31,33,20,13,72
"2011","Merton 004E","E01003461",1223,430,91,339,419,104,107,12,37,15,16,10,6,83
"2011","Merton 005A","E01003367",2014,351,48,303,533,223,175,104,165,99,76,65,11,288
"2011","Merton 005B","E01003369",1410,251,43,208,388,175,133,81,115,106,55,28,27,106
"2011","Merton 005C","E01003370",1668,247,51,196,458,193,162,87,146,117,77,58,19,181
"2011","Merton 005D","E01003371",1274,190,31,159,354,150,124,78,98,76,47,31,16,157
"2011","Merton 005E","E01003455",1301,296,52,244,437,146,86,57,90,64,51,31,20,74
"2011","Merton 006A","E01003359",1356,265,48,217,423,167,105,59,89,76,65,49,16,107
"2011","Merton 006B","E01003360",1359,376,63,313,471,151,125,29,68,41,28,19,9,70
"2011","Merton 006C","E01003457",1191,376,76,300,422,121,82,30,49,35,18,11,7,58
"2011","Merton 006D","E01003458",1281,372,53,319,446,130,83,51,68,41,40,27,13,50
"2011","Merton 006E","E01003459",1639,356,55,301,475,197,92,86,138,117,80,49,31,98
"2011","Merton 007A","E01003394",1494,91,17,74,235,175,273,79,196,136,140,112,28,169
"2011","Merton 007B","E01003395",1113,89,16,73,222,145,140,66,150,85,81,67,14,135
"2011","Merton 007C","E01003396",1249,119,17,102,278,130,172,61,135,98,80,62,18,176
"2011","Merton 007D","E01003397",1189,102,16,86,227,135,153,70,139,112,86,63,23,165
"2011","Merton 007E","E01003398",1291,96,20,76,264,169,172,80,159,81,112,86,26,158
"2011","Merton 008A","E01003368",1254,119,22,97,239,128,161,85,173,111,105,83,22,133
"2011","Merton 008B","E01003372",1175,108,23,85,217,134,115,70,164,112,112,84,28,143
"2011","Merton 008C","E01003393",1234,106,13,93,269,113,195,91,146,103,92,65,27,119
"2011","Merton 008D","E01003406",1200,94,10,84,191,165,133,71,159,101,126,99,27,160
"2011","Merton 008E","E01003407",1449,179,28,151,331,178,210,68,140,124,91,69,22,128
"2011","Merton 009A","E01003355",1302,374,49,325,443,158,90,44,62,37,37,19,18,57
"2011","Merton 009B","E01003356",1354,343,52,291,443,154,105,44,83,35,45,37,8,102
"2011","Merton 009C","E01003358",1521,455,68,387,496,151,96,39,71,52,57,31,26,104
"2011","Merton 009D","E01003383",1274,392,79,313,432,129,85,39,58,30,31,19,12,78
"2011","Merton 009E","E01003384",1206,391,61,330,392,116,65,39,54,33,29,19,10,87
"2011","Merton 010A","E01003442",1190,380,75,305,378,127,113,17,37,27,39,28,11,72
"2011","Merton 010B","E01003443",1118,349,56,293,409,106,88,15,40,17,24,16,8,70
"2011","Merton 010C","E01003444",1125,316,53,263,380,122,92,35,56,33,31,23,8,60
"2011","Merton 010D","E01003445",1241,281,49,232,377,145,137,39,86,41,47,34,13,88
"2011","Merton 010E","E01003463",904,242,45,197,288,86,100,16,38,20,45,37,8,69
"2011","Merton 011A","E01003380",1264,307,48,259,377,168,101,63,83,62,30,20,10,73
"2011","Merton 011B","E01003382",1187,283,47,236,421,156,101,49,73,35,27,18,9,42
"2011","Merton 011C","E01003385",1193,373,70,303,380,128,94,32,44,30,33,25,8,79
"2011","Merton 011D","E01003399",1132,291,55,236,381,149,84,33,73,37,23,12,11,61
"2011","Merton 011E","E01003423",1167,250,46,204,402,142,108,39,65,50,24,15,9,87
"2011","Merton 012A","E01003357",1358,131,27,104,266,163,121,85,193,122,121,87,34,156
"2011","Merton 012B","E01003376",1188,59,18,41,191,126,137,87,186,136,118,88,30,148
"2011","Merton 012C","E01003377",1109,39,10,29,134,136,105,63,176,133,154,113,41,169
"2011","Merton 012D","E01003408",1527,227,39,188,375,199,166,88,164,121,92,61,31,95
"2011","Merton 012E","E01003410",1230,117,17,100,248,135,147,71,174,128,100,73,27,110
"2011","Merton 013A","E01003386",1551,91,20,71,261,200,195,83,212,145,141,110,31,223
"2011","Merton 013B","E01003388",1062,53,10,43,186,162,75,86,159,119,95,73,22,127
"2011","Merton 013C","E01003389",1288,78,18,60,251,143,148,98,173,121,119,90,29,157
"2011","Merton 013D","E01003392",1009,94,17,77,172,141,118,55,134,96,74,58,16,125
"2011","Merton 013E","E01003409",1221,62,11,51,168,151,164,77,186,110,142,109,33,161
"2011","Merton 014A","E01003387",1162,66,13,53,187,167,118,85,159,132,121,91,30,127
"2011","Merton 014B","E01003391",943,37,8,29,161,102,71,76,183,107,109,76,33,97
"2011","Merton 014C","E01003411",1261,95,26,69,260,164,156,80,153,118,97,72,25,138
"2011","Merton 014D","E01003412",1198,79,14,65,196,167,146,68,165,126,104,68,36,147
"2011","Merton 014E","E01003435",968,78,19,59,212,150,98,40,124,101,55,39,16,110
"2011","Merton 015A","E01003361",1252,163,35,128,331,173,149,54,114,87,55,37,18,126
"2011","Merton 015B","E01003424",1068,263,47,216,371,158,89,17,49,22,19,15,4,80
"2011","Merton 015C","E01003425",1044,227,45,182,297,150,113,32,59,45,26,16,10,95
"2011","Merton 015D","E01003426",1253,216,39,177,358,156,135,42,105,44,78,53,25,119
"2011","Merton 015E","E01003428",1084,293,49,244,383,127,62,29,50,24,39,27,12,77
"2011","Merton 016A","E01003366",1178,160,31,129,285,158,124,69,141,101,52,43,9,88
"2011","Merton 016B","E01003381",1187,284,52,232,430,156,86,56,55,34,32,23,9,54
"2011","Merton 016C","E01003446",1365,316,43,273,396,194,110,68,85,61,53,37,16,82
"2011","Merton 016D","E01003447",1152,142,25,117,273,149,119,87,157,83,68,49,19,74
"2011","Merton 016E","E01003471",1122,194,41,153,336,184,88,63,74,55,44,31,13,84
"2011","Merton 017A","E01003413",1388,112,25,87,295,189,202,86,150,91,118,80,38,145
"2011","Merton 017B","E01003414",1185,90,16,74,225,165,149,65,141,90,87,67,20,173
"2011","Merton 017C","E01003415",1183,86,18,68,204,185,134,79,155,104,80,56,24,156
"2011","Merton 017D","E01003416",1145,80,19,61,208,186,128,81,144,99,85,57,28,134
"2011","Merton 017E","E01003434",1095,75,9,66,209,168,156,63,129,79,65,51,14,151
"2011","Merton 018A","E01003373",1016,49,7,42,136,128,98,66,180,116,125,105,20,118
"2011","Merton 018B","E01003378",1442,103,19,84,258,165,160,97,205,159,131,85,46,164
"2011","Merton 018C","E01003379",1221,51,12,39,185,138,107,92,195,171,157,123,34,125
"2011","Merton 018D","E01003390",1151,42,13,29,147,122,88,75,211,178,150,119,31,138
"2011","Merton 018E","E01003405",1254,68,11,57,210,148,116,81,217,149,132,106,26,133
"2011","Merton 019A","E01003429",1052,67,13,54,197,172,115,71,134,104,65,54,11,127
"2011","Merton 019B","E01003430",1010,48,7,41,152,108,96,55,192,148,97,66,31,114
"2011","Merton 019C","E01003431",1066,47,7,40,163,148,90,70,193,113,113,71,42,129
"2011","Merton 019D","E01003432",1035,47,7,40,134,156,78,71,155,129,117,82,35,148
"2011","Merton 019E","E01003433",1102,66,14,52,178,155,123,78,162,115,97,68,29,128
"2011","Merton 020A","E01003466",1167,222,36,186,325,172,108,54,100,49,44,30,14,93
"2011","Merton 020B","E01003467",1181,211,41,170,367,183,110,51,92,43,31,24,7,93
"2011","Merton 020C","E01003468",1228,223,54,169,343,189,144,39,97,63,39,19,20,91
"2011","Merton 020D","E01003469",1188,122,24,98,262,159,117,69,179,63,91,65,26,126
"2011","Merton 020E","E01003470",1302,172,19,153,296,178,111,72,157,68,83,71,12,165
"2011","Merton 021A","E01003362",997,136,26,110,253,160,134,40,91,50,40,29,11,93
"2011","Merton 021B","E01003363",1170,137,19,118,298,213,146,66,96,65,47,38,9,102
"2011","Merton 021C","E01003364",1272,174,35,139,304,243,151,85,103,81,33,26,7,98
"2011","Merton 021D","E01003365",1045,137,33,104,256,162,120,54,90,60,55,47,8,111
"2011","Merton 021E","E01003421",1206,136,23,113,320,190,135,70,136,95,52,36,16,72
"2011","Merton 022A","E01003374",1000,69,21,48,196,122,101,44,142,90,145,118,27,91
"2011","Merton 022B","E01003375",1179,87,16,71,250,167,146,87,133,117,82,57,25,110
"2011","Merton 022C","E01003437",1370,133,21,112,284,185,172,62,192,108,102,78,24,132
"2011","Merton 022D","E01003440",1142,91,10,81,197,176,146,74,151,92,96,69,27,119
"2011","Merton 022E","E01003441",1290,109,19,90,215,175,136,89,162,121,118,93,25,165
"2011","Merton 023A","E01003427",1357,118,14,104,300,170,156,98,139,98,123,97,26,155
"2011","Merton 023B","E01003436",1092,65,19,46,204,147,142,72,154,111,85,69,16,112
"2011","Merton 023C","E01003439",1076,76,13,63,183,131,140,75,146,89,111,79,32,125
"2011","Merton 023D","E01003448",1213,84,15,69,209,167,154,72,163,133,113,86,27,118
"2011","Merton 023E","E01003453",1194,96,18,78,204,166,131,76,138,133,134,112,22,116
"2011","Merton 024A","E01003438",1196,72,13,59,212,179,118,76,186,120,102,69,33,131
"2011","Merton 024B","E01003449",1262,112,23,89,249,153,146,92,146,103,128,111,17,133
"2011","Merton 024C","E01003450",1107,64,11,53,188,168,120,72,155,130,102,75,27,108
"2011","Merton 024D","E01003451",1239,98,21,77,267,216,138,82,139,114,55,44,11,130
"2011","Merton 024E","E01003452",1405,103,20,83,250,181,145,86,233,162,94,72,22,151
"2011","Merton 025A","E01003417",1145,94,24,70,264,185,136,88,165,87,37,27,10,89
"2011","Merton 025B","E01003418",1083,85,21,64,228,203,103,71,153,110,37,24,13,93
"2011","Merton 025C","E01003419",1260,107,29,78,286,217,149,79,168,92,61,38,23,101
"2011","Merton 025D","E01003420",979,83,16,67,217,161,120,71,125,88,39,29,10,75
"2011","Merton 025E","E01003422",1008,91,17,74,231,184,126,63,100,85,38,30,8,90
"2011","Redbridge 001A","E01003744",997,204,43,161,277,170,102,36,74,40,30,14,16,64
"2011","Redbridge 001B","E01003745",1043,245,46,199,291,138,153,15,56,20,24,19,5,101
"2011","Redbridge 001C","E01003746",1042,218,41,177,303,150,144,36,52,36,28,20,8,75
"2011","Redbridge 001D","E01003747",922,211,30,181,250,136,116,30,56,23,32,22,10,68
"2011","Redbridge 001E","E01003748",1085,272,46,226,281,155,119,30,53,37,48,38,10,90
"2011","Redbridge 001F","E01003749",1215,217,41,176,376,163,148,53,84,43,60,46,14,71
"2011","Redbridge 001G","E01003750",1204,237,47,190,368,161,115,43,114,48,48,39,9,70
"2011","Redbridge 002A","E01003720",1260,68,14,54,211,185,137,91,184,162,119,89,30,103
"2011","Redbridge 002B","E01003722",1256,90,18,72,217,157,148,93,188,128,109,76,33,126
"2011","Redbridge 002C","E01003723",1188,61,16,45,197,168,142,92,191,141,91,57,34,105
"2011","Redbridge 002D","E01003726",1048,62,18,44,188,134,121,76,149,101,114,79,35,103
"2011","Redbridge 003A","E01003721",1129,110,16,94,221,175,114,64,161,80,91,73,18,113
"2011","Redbridge 003B","E01003724",964,97,22,75,202,143,136,55,123,73,52,38,14,83
"2011","Redbridge 003C","E01003725",1057,67,15,52,223,161,124,54,144,102,102,76,26,80
"2011","Redbridge 003D","E01003727",1109,57,9,48,192,156,121,92,167,130,98,61,37,96
"2011","Redbridge 004A","E01003654",1130,145,22,123,254,167,129,66,116,83,66,47,19,104
"2011","Redbridge 004B","E01003655",1155,179,40,139,299,186,138,59,97,68,51,28,23,78
"2011","Redbridge 004C","E01003658",1184,117,24,93,225,147,146,67,146,112,113,80,33,111
"2011","Redbridge 004D","E01003660",1292,178,33,145,327,220,158,66,126,73,50,35,15,94
"2011","Redbridge 005A","E01003656",1078,83,17,66,235,173,146,55,126,99,69,45,24,92
"2011","Redbridge 005B","E01003657",1568,177,40,137,360,255,213,90,186,108,84,55,29,95
"2011","Redbridge 005C","E01003659",1200,126,20,106,280,213,131,72,121,83,69,46,23,105
"2011","Redbridge 006A","E01003698",1028,118,24,94,228,177,132,43,134,65,56,42,14,75
"2011","Redbridge 006B","E01003699",1042,110,27,83,267,162,147,53,111,85,40,24,16,67
"2011","Redbridge 006C","E01003700",1641,174,43,131,328,260,198,83,203,110,127,96,31,158
"2011","Redbridge 006D","E01003701",1262,129,26,103,235,214,135,64,151,93,102,77,25,139
"2011","Redbridge 006E","E01003702",1226,116,24,92,257,205,179,67,136,111,73,45,28,82
"2011","Redbridge 006F","E01003703",1853,282,60,222,436,259,239,66,179,126,114,77,37,152
"2011","Redbridge 006G","E01003704",1218,77,13,64,250,200,136,83,143,117,100,63,37,112
"2011","Redbridge 007A","E01003668",1226,265,48,217,435,155,104,43,74,46,48,35,13,56
"2011","Redbridge 007B","E01003669",1162,235,41,194,374,165,148,25,77,39,17,9,8,82
"2011","Redbridge 007C","E01003670",1079,201,36,165,303,153,106,46,105,48,36,17,19,81
"2011","Redbridge 007D","E01003671",1126,198,45,153,333,181,137,41,76,42,31,19,12,87
"2011","Redbridge 007E","E01003672",1008,166,31,135,288,152,92,35,78,54,64,44,20,79
"2011","Redbridge 007F","E01003673",1403,329,64,265,445,206,118,38,94,48,52,28,24,73
"2011","Redbridge 007G","E01003674",1693,376,70,306,507,241,156,76,110,49,69,43,26,109
"2011","Redbridge 008A","E01003707",981,89,17,72,199,168,120,50,110,52,86,61,25,107
"2011","Redbridge 008B","E01003708",1012,69,13,56,156,136,116,49,139,104,131,90,41,112
"2011","Redbridge 008C","E01003709",1150,116,24,92,241,168,142,60,160,62,82,72,10,119
"2011","Redbridge 008D","E01003710",1114,121,23,98,213,153,169,54,142,57,79,64,15,126
"2011","Redbridge 009A","E01003759",1087,209,42,167,287,160,120,39,85,60,39,28,11,88
"2011","Redbridge 009B","E01003760",1308,154,30,124,281,162,169,84,135,97,93,57,36,133
"2011","Redbridge 009C","E01003761",1154,59,8,51,159,111,98,78,191,150,198,135,63,110
"2011","Redbridge 009D","E01003762",1231,190,44,146,383,174,119,52,103,58,57,38,19,95
"2011","Redbridge 009E","E01003763",1317,173,33,140,303,212,186,57,121,65,85,61,24,115
"2011","Redbridge 009F","E01003764",1495,256,46,210,467,191,159,64,113,63,94,73,21,88
"2011","Redbridge 009G","E01003765",1186,200,39,161,384,165,116,58,86,47,42,27,15,88
"2011","Redbridge 010A","E01003705",1576,183,23,160,311,233,199,87,175,115,108,79,29,165
"2011","Redbridge 010B","E01003706",1059,97,17,80,220,170,133,53,123,78,90,64,26,95
"2011","Redbridge 010C","E01003711",1250,137,21,116,238,191,178,60,132,109,90,69,21,115
"2011","Redbridge 010D","E01003712",937,55,11,44,143,128,102,46,126,90,126,98,28,121
"2011","Redbridge 012A","E01003646",1261,123,24,99,247,158,147,51,131,72,132,105,27,200
"2011","Redbridge 012B","E01003648",1040,136,25,111,272,158,135,39,89,38,70,56,14,103
"2011","Redbridge 012C","E01003649",1199,146,21,125,278,171,151,29,108,57,91,71,20,168
"2011","Redbridge 012D","E01003651",1077,170,27,143,213,176,117,33,93,44,86,61,25,145
"2011","Redbridge 013A","E01003639",1249,129,34,95,248,166,124,66,166,95,135,108,27,120
"2011","Redbridge 013B","E01003640",1259,133,18,115,317,175,138,67,139,73,81,65,16,136
"2011","Redbridge 013C","E01003641",1223,136,27,109,260,181,106,57,144,72,105,82,23,162
"2011","Redbridge 013D","E01003642",1172,116,21,95,230,160,120,57,152,78,112,93,19,147
"2011","Redbridge 014A","E01003774",1365,332,49,283,470,175,117,46,70,33,44,31,13,78
"2011","Redbridge 014B","E01003775",1259,279,27,252,378,173,146,29,68,33,70,57,13,83
"2011","Redbridge 014C","E01003776",1153,194,52,142,331,145,110,50,122,65,70,52,18,66
"2011","Redbridge 014D","E01003777",1399,343,68,275,476,197,129,35,62,30,47,26,21,80
"2011","Redbridge 014E","E01003778",1432,326,56,270,495,161,146,39,87,45,46,24,22,87
"2011","Redbridge 014F","E01003779",1120,203,46,157,342,142,113,51,93,47,50,36,14,79
"2011","Redbridge 014G","E01003780",1108,266,44,222,276,145,143,30,59,34,48,40,8,107
"2011","Redbridge 015A","E01003647",1302,222,21,201,277,175,106,38,145,58,120,104,16,161
"2011","Redbridge 015B","E01003650",1031,111,16,95,227,142,120,50,116,67,93,72,21,105
"2011","Redbridge 015C","E01003652",1107,150,25,125,260,164,103,33,97,48,88,76,12,164
"2011","Redbridge 015D","E01003653",1053,142,15,127,196,135,112,49,125,54,113,85,28,127
"2011","Redbridge 017A","E01003638",1176,116,18,98,228,174,122,68,127,62,98,72,26,181
"2011","Redbridge 017B","E01003643",1239,149,24,125,243,193,121,44,155,94,99,75,24,141
"2011","Redbridge 017C","E01003644",1125,130,18,112,224,187,106,40,131,69,100,76,24,138
"2011","Redbridge 017D","E01003645",1838,293,34,259,381,244,173,82,205,93,186,150,36,181
"2011","Redbridge 018A","E01003789",1102,228,35,193,354,140,107,34,87,54,30,20,10,68
"2011","Redbridge 018B","E01003794",1032,184,38,146,298,137,105,33,74,58,64,44,20,79
"2011","Redbridge 018C","E01003795",848,175,38,137,278,110,86,25,55,26,23,19,4,70
"2011","Redbridge 018D","E01003796",1164,231,47,184,336,140,115,34,93,53,55,42,13,107
"2011","Redbridge 019A","E01003661",1385,108,24,84,280,230,144,65,164,101,116,84,32,177
"2011","Redbridge 019B","E01003662",1325,102,23,79,280,198,116,79,177,87,139,110,29,147
"2011","Redbridge 019C","E01003663",1128,96,13,83,219,187,106,59,152,87,88,69,19,134
"2011","Redbridge 019D","E01003664",1218,122,23,99,284,180,119,60,138,89,98,80,18,128
"2011","Redbridge 019E","E01003665",1131,117,18,99,238,173,122,51,114,82,93,72,21,141
"2011","Redbridge 019F","E01003666",1535,150,27,123,353,227,126,75,177,109,170,124,46,148
"2011","Redbridge 019H","E01033590",797,92,16,76,180,102,54,46,75,50,107,82,25,91
"2011","Redbridge 019I","E01033592",1382,108,15,93,329,189,126,85,163,91,122,96,26,169
"2011","Redbridge 020A","E01003751",1353,144,18,126,238,203,145,46,157,79,154,132,22,187
"2011","Redbridge 020B","E01003753",1400,163,28,135,261,217,125,47,151,68,161,126,35,207
"2011","Redbridge 020C","E01003754",1143,135,21,114,200,158,114,49,118,57,136,117,19,176
"2011","Redbridge 020D","E01003757",1393,121,19,102,245,157,136,68,182,130,163,133,30,191
"2011","Redbridge 022A","E01003769",1232,92,15,77,196,130,128,68,152,83,198,164,34,185
"2011","Redbridge 022B","E01003770",1831,248,20,228,376,235,143,66,175,95,233,208,25,260
"2011","Redbridge 022C","E01003771",1332,143,21,122,246,161,130,53,151,104,183,138,45,161
"2011","Redbridge 022D","E01003773",1180,140,19,121,238,168,111,50,119,85,125,98,27,144
"2011","Redbridge 023A","E01003752",1905,265,35,230,406,272,186,72,183,83,214,172,42,224
"2011","Redbridge 023B","E01003755",1378,135,19,116,229,179,139,56,169,82,163,140,23,226
"2011","Redbridge 023C","E01003756",1500,141,26,115,246,183,149,75,191,95,171,143,28,249
"2011","Redbridge 023D","E01003758",1743,186,23,163,270,223,126,78,186,105,282,228,54,287
"2011","Redbridge 024A","E01003766",1376,98,15,83,209,161,139,80,171,106,221,191,30,191
"2011","Redbridge 024B","E01003767",1348,90,19,71,179,160,123,62,165,107,191,158,33,271
"2011","Redbridge 024C","E01003768",1320,107,11,96,213,130,126,61,160,105,191,160,31,227
"2011","Redbridge 024D","E01003772",1225,97,14,83,237,158,104,48,174,84,150,122,28,173
"2011","Redbridge 026A","E01003781",1223,176,15,161,221,145,115,54,122,62,167,134,33,161
"2011","Redbridge 026B","E01003782",1240,118,18,100,186,133,137,43,146,95,213,185,28,169
"2011","Redbridge 026C","E01003786",1034,120,18,102,232,138,89,41,84,59,105,77,28,166
"2011","Redbridge 026D","E01003787",1096,143,15,128,219,141,86,46,112,63,153,126,27,133
"2011","Redbridge 027A","E01003790",1030,156,29,127,310,119,105,38,74,64,70,51,19,94
"2011","Redbridge 027B","E01003791",1124,170,28,142,366,138,153,38,84,44,54,38,16,77
"2011","Redbridge 027C","E01003792",1042,186,41,145,360,133,91,31,54,35,46,28,18,106
"2011","Redbridge 027D","E01003793",1130,147,20,127,261,154,124,59,121,85,89,64,25,90
"2011","Redbridge 029A","E01003783",1633,194,15,179,238,159,119,70,166,102,325,265,60,260
"2011","Redbridge 029B","E01003784",1266,132,21,111,254,152,123,37,136,87,179,148,31,166
"2011","Redbridge 029C","E01003785",1361,177,21,156,237,170,125,66,155,67,199,157,42,165
"2011","Redbridge 029D","E01003788",1331,163,16,147,248,151,130,56,132,111,185,140,45,155
"2011","Redbridge 030A","E01003683",1420,75,14,61,177,129,151,57,180,125,269,235,34,257
"2011","Redbridge 030B","E01003684",1180,74,9,65,173,118,129,59,159,88,188,163,25,192
"2011","Redbridge 030C","E01003685",1301,86,9,77,142,113,139,62,164,107,193,165,28,295
"2011","Redbridge 030D","E01003686",1343,91,9,82,195,151,125,63,175,97,219,189,30,227
"2011","Redbridge 030F","E01003688",1316,88,13,75,189,114,163,43,155,94,253,223,30,217
"2011","Redbridge 030G","E01003689",1079,76,9,67,130,114,90,48,135,82,233,214,19,171
"2011","Redbridge 030H","E01033589",1265,280,23,257,271,116,95,36,76,36,162,131,31,193
"2011","Redbridge 030I","E01033591",1364,101,11,90,179,158,146,57,141,88,271,233,38,223
"2011","Redbridge 031A","E01003737",1251,146,17,129,215,168,206,58,106,78,111,94,17,163
"2011","Redbridge 031B","E01003738",1497,115,20,95,280,226,180,60,184,82,152,133,19,218
"2011","Redbridge 031C","E01003739",1512,146,28,118,293,193,149,68,170,103,183,155,28,207
"2011","Redbridge 031D","E01003740",1451,160,27,133,254,197,163,72,163,100,163,124,39,179
"2011","Redbridge 031E","E01003741",1207,101,20,81,217,199,107,55,160,94,115,92,23,159
"2011","Redbridge 031F","E01003742",1434,109,21,88,218,194,196,63,170,103,183,157,26,198
"2011","Redbridge 031G","E01003743",1212,68,10,58,178,140,127,49,136,84,201,176,25,229
"2011","Redbridge 032A","E01003728",1773,184,18,166,286,160,132,68,211,101,293,234,59,338
"2011","Redbridge 032B","E01003729",1190,58,4,54,137,92,98,58,144,101,265,221,44,237
"2011","Redbridge 032C","E01003730",1129,45,7,38,132,93,93,51,155,87,264,223,41,209
"2011","Redbridge 032D","E01003732",990,65,11,54,157,95,95,38,103,62,246,191,55,129
"2011","Redbridge 032E","E01003733",1254,75,8,67,174,114,100,50,183,90,195,170,25,273
"2011","Redbridge 033A","E01003731",1025,53,8,45,133,108,94,68,120,76,180,154,26,193
"2011","Redbridge 033B","E01003734",1190,104,13,91,164,146,115,46,147,86,174,149,25,208
"2011","Redbridge 033C","E01003735",1447,80,9,71,185,132,72,60,233,123,316,275,41,246
"2011","Redbridge 033D","E01003736",1103,98,12,86,157,98,130,36,151,77,192,148,44,164
"2011","Redbridge 034A","E01003713",1250,91,18,73,212,141,120,45,158,85,182,157,25,216
"2011","Redbridge 034B","E01003714",1505,109,27,82,215,203,165,70,200,121,218,185,33,204
"2011","Redbridge 034C","E01003715",1458,108,13,95,226,148,143,50,177,113,216,174,42,277
"2011","Redbridge 034D","E01003716",1244,129,21,108,246,141,138,56,153,88,156,127,29,137
"2011","Redbridge 034E","E01003718",1332,157,23,134,252,157,127,74,151,76,209,175,34,129
"2011","Redbridge 034F","E01003719",1468,127,8,119,288,164,146,71,160,104,220,169,51,188
"2011","Redbridge 034G","E01032581",1228,79,14,65,231,179,102,58,159,128,140,102,38,152
"2011","Redbridge 035A","E01003690",1211,190,25,165,243,118,152,44,122,61,129,107,22,152
"2011","Redbridge 035B","E01003691",1032,108,16,92,190,116,116,61,112,42,147,120,27,140
"2011","Redbridge 035C","E01003692",1133,155,20,135,215,145,118,45,104,57,149,127,22,145
"2011","Redbridge 035D","E01003693",1172,162,20,142,215,144,160,35,95,76,127,117,10,158
"2011","Redbridge 035E","E01003694",1085,139,24,115,228,120,125,43,105,62,130,110,20,133
"2011","Redbridge 035F","E01003695",1165,139,26,113,211,146,153,55,116,49,165,130,35,131
"2011","Redbridge 035G","E01003696",1377,131,19,112,230,172,194,36,126,73,113,94,19,302
"2011","Redbridge 035H","E01003697",1181,166,27,139,233,138,148,44,129,63,100,78,22,160
"2011","Redbridge 036A","E01003675",1129,170,17,153,215,159,134,44,103,51,102,79,23,151
"2011","Redbridge 036B","E01003676",1203,173,31,142,260,154,121,46,123,58,100,77,23,168
"2011","Redbridge 036C","E01003677",1096,146,24,122,225,148,140,49,96,54,89,68,21,149
"2011","Redbridge 036D","E01003678",1151,184,24,160,246,155,142,32,117,47,75,62,13,153
"2011","Redbridge 036E","E01003679",1195,169,30,139,245,183,158,42,96,54,101,82,19,147
"2011","Redbridge 036F","E01003680",1159,131,13,118,234,179,152,41,132,40,79,62,17,171
"2011","Redbridge 036G","E01003681",1278,148,22,126,246,181,169,40,129,82,121,101,20,162
"2011","Redbridge 036H","E01003682",1206,160,29,131,256,166,142,49,117,62,99,84,15,155
"2011","Richmond upon Thames 001A","E01003797",958,285,78,207,340,79,90,10,31,17,29,19,10,77
"2011","Richmond upon Thames 001B","E01003798",1105,303,72,231,367,99,125,18,51,28,37,27,10,77
"2011","Richmond upon Thames 001C","E01003799",1178,312,86,226,452,95,112,27,45,34,27,16,11,74
"2011","Richmond upon Thames 001D","E01003800",1119,208,41,167,338,119,127,40,78,64,49,28,21,96
"2011","Richmond upon Thames 001E","E01003801",1010,277,55,222,353,88,95,24,42,31,25,20,5,75
"2011","Richmond upon Thames 001F","E01003802",1033,340,82,258,336,93,93,10,43,13,38,30,8,67
"2011","Richmond upon Thames 001G","E01003803",1083,112,20,92,238,131,118,64,131,97,83,47,36,109
"2011","Richmond upon Thames 002A","E01003846",1213,353,71,282,407,115,129,13,39,22,19,9,10,116
"2011","Richmond upon Thames 002B","E01003847",1238,328,76,252,454,139,119,27,50,21,26,15,11,74
"2011","Richmond upon Thames 002C","E01003849",1122,324,64,260,408,101,117,28,41,23,31,22,9,49
"2011","Richmond upon Thames 002D","E01003851",1171,384,92,292,410,88,115,15,42,26,16,10,6,75
"2011","Richmond upon Thames 002E","E01003860",1389,426,78,348,521,117,110,27,58,27,32,21,11,71
"2011","Richmond upon Thames 002F","E01003864",1121,333,66,267,403,102,75,29,53,22,35,20,15,69
"2011","Richmond upon Thames 003A","E01003852",1011,243,34,209,351,102,94,34,56,31,34,16,18,66
"2011","Richmond upon Thames 003B","E01003853",1097,240,66,174,374,98,116,39,59,49,58,36,22,64
"2011","Richmond upon Thames 003C","E01003854",1058,251,62,189,392,76,124,31,52,38,30,19,11,64
"2011","Richmond upon Thames 003D","E01003855",1309,219,50,169,418,134,118,52,129,77,61,37,24,101
"2011","Richmond upon Thames 003E","E01003856",1237,309,58,251,483,119,120,23,55,47,34,24,10,47
"2011","Richmond upon Thames 003F","E01003857",1290,314,62,252,508,119,124,34,59,38,32,17,15,62
"2011","Richmond upon Thames 003G","E01003858",1205,312,82,230,497,86,138,23,31,27,26,13,13,65
"2011","Richmond upon Thames 004A","E01003848",1386,345,65,280,457,149,141,52,79,53,43,22,21,67
"2011","Richmond upon Thames 004C","E01003861",1405,450,84,366,476,130,94,43,70,33,34,18,16,75
"2011","Richmond upon Thames 004D","E01003862",1034,236,53,183,327,95,77,44,91,61,47,28,19,56
"2011","Richmond upon Thames 004E","E01003863",990,233,56,177,263,121,96,43,78,56,38,27,11,62
"2011","Richmond upon Thames 004F","E01003865",940,160,25,135,287,114,95,38,79,58,44,25,19,65
"2011","Richmond upon Thames 004G","E01033570",1182,336,93,243,408,95,83,26,62,39,56,39,17,77
"2011","Richmond upon Thames 004H","E01033571",1073,230,53,177,326,126,105,27,68,57,44,33,11,90
"2011","Richmond upon Thames 005A","E01003804",1256,340,62,278,425,117,164,31,51,23,29,22,7,76
"2011","Richmond upon Thames 005B","E01003807",1366,332,64,268,443,138,152,47,85,49,31,21,10,89
"2011","Richmond upon Thames 005C","E01003808",1327,329,60,269,518,117,129,24,62,34,36,24,12,78
"2011","Richmond upon Thames 005D","E01003809",1208,322,73,249,450,101,134,20,50,36,20,15,5,75
"2011","Richmond upon Thames 005E","E01003859",1116,261,65,196,428,99,107,31,54,35,27,14,13,74
"2011","Richmond upon Thames 006A","E01003873",1249,410,84,326,444,111,99,23,56,10,39,27,12,57
"2011","Richmond upon Thames 006B","E01003874",1235,410,83,327,471,103,95,27,26,20,41,33,8,42
"2011","Richmond upon Thames 006C","E01003875",1123,320,70,250,387,119,86,17,40,36,33,25,8,85
"2011","Richmond upon Thames 006D","E01003878",1032,204,51,153,277,119,86,39,123,59,50,32,18,75
"2011","Richmond upon Thames 007A","E01003866",1121,333,72,261,460,88,94,18,33,18,15,7,8,62
"2011","Richmond upon Thames 007B","E01003868",1135,340,73,267,461,97,89,21,45,15,16,8,8,51
"2011","Richmond upon Thames 007C","E01003871",1171,318,91,227,438,112,117,26,46,26,28,21,7,60
"2011","Richmond upon Thames 007D","E01003872",1102,317,72,245,412,117,94,27,42,19,18,11,7,56
"2011","Richmond upon Thames 008A","E01003821",1196,379,83,296,407,92,112,30,50,33,37,21,16,56
"2011","Richmond upon Thames 008B","E01003876",1303,407,107,300,457,121,114,27,47,28,28,23,5,74
"2011","Richmond upon Thames 008C","E01003877",1082,373,92,281,414,91,76,15,34,12,14,6,8,53
"2011","Richmond upon Thames 008D","E01003879",1245,359,102,257,386,72,86,17,30,15,18,12,6,262
"2011","Richmond upon Thames 009A","E01003892",1470,486,128,358,555,138,116,23,33,22,42,27,15,55
"2011","Richmond upon Thames 009B","E01003893",1212,336,73,263,424,116,139,23,50,24,29,19,10,71
"2011","Richmond upon Thames 009C","E01003894",1265,381,80,301,458,113,119,24,48,32,29,16,13,61
"2011","Richmond upon Thames 009D","E01003895",1268,330,66,264,468,141,117,30,48,26,34,19,15,74
"2011","Richmond upon Thames 010A","E01003905",1056,147,44,103,335,171,89,49,91,55,30,23,7,89
"2011","Richmond upon Thames 010B","E01003906",1173,157,34,123,320,178,111,63,134,80,51,33,18,79
"2011","Richmond upon Thames 010C","E01003907",1221,128,23,105,286,161,106,78,136,120,71,53,18,135
"2011","Richmond upon Thames 010D","E01003908",1324,186,38,148,398,196,127,51,115,60,53,34,19,138
"2011","Richmond upon Thames 010E","E01003909",1134,169,30,139,301,170,98,50,115,74,41,26,15,116
"2011","Richmond upon Thames 011A","E01003867",1106,220,47,173,325,124,102,43,90,41,43,32,11,118
"2011","Richmond upon Thames 011B","E01003869",1265,326,48,278,465,133,105,33,59,33,30,18,12,81
"2011","Richmond upon Thames 011C","E01003870",1353,372,69,303,467,137,100,41,60,29,42,25,17,105
"2011","Richmond upon Thames 011D","E01003910",1149,182,37,145,367,161,116,59,88,59,34,23,11,83
"2011","Richmond upon Thames 012A","E01003805",1099,324,90,234,409,100,99,23,30,21,18,16,2,75
"2011","Richmond upon Thames 012B","E01003806",1036,299,69,230,359,81,105,11,35,15,22,9,13,109
"2011","Richmond upon Thames 012C","E01003816",1118,279,64,215,309,131,101,47,71,49,43,31,12,88
"2011","Richmond upon Thames 012D","E01003817",1418,262,64,198,425,114,185,73,105,100,92,56,36,62
"2011","Richmond upon Thames 013A","E01003840",1174,131,19,112,261,161,133,73,128,93,85,63,22,109
"2011","Richmond upon Thames 013B","E01003841",1389,97,17,80,264,177,137,102,196,122,129,88,41,165
"2011","Richmond upon Thames 013C","E01003842",1215,130,25,105,287,188,95,65,150,126,64,48,16,110
"2011","Richmond upon Thames 013D","E01003843",1457,130,27,103,292,202,153,98,191,139,108,93,15,144
"2011","Richmond upon Thames 013E","E01003844",1070,174,42,132,296,181,98,53,82,50,41,31,10,95
"2011","Richmond upon Thames 013F","E01003845",1190,147,31,116,266,189,144,76,128,76,68,59,9,96
"2011","Richmond upon Thames 014A","E01003882",1338,357,78,279,483,137,120,36,53,38,24,13,11,90
"2011","Richmond upon Thames 014B","E01003883",1409,342,82,260,561,143,119,57,57,50,23,13,10,57
"2011","Richmond upon Thames 014C","E01003896",1342,327,68,259,488,114,105,41,51,38,35,19,16,143
"2011","Richmond upon Thames 014D","E01003897",1426,368,72,296,478,135,94,38,73,45,37,13,24,158
"2011","Richmond upon Thames 015A","E01003898",1128,296,55,241,413,129,106,32,45,36,20,9,11,51
"2011","Richmond upon Thames 015B","E01003899",1032,233,51,182,375,108,101,36,78,35,17,9,8,49
"2011","Richmond upon Thames 015C","E01003900",1119,136,22,114,269,134,123,55,134,83,70,52,18,115
"2011","Richmond upon Thames 015D","E01003901",1149,216,40,176,377,131,119,53,97,44,26,16,10,86
"2011","Richmond upon Thames 015E","E01003902",928,143,29,114,278,140,101,43,82,48,23,13,10,70
"2011","Richmond upon Thames 015F","E01003903",1172,141,30,111,282,154,134,51,115,88,77,62,15,130
"2011","Richmond upon Thames 015G","E01003904",1119,211,35,176,373,129,94,43,91,51,33,21,12,94
"2011","Richmond upon Thames 016A","E01003880",1077,287,59,228,387,120,105,36,25,22,22,14,8,73
"2011","Richmond upon Thames 016B","E01003881",1559,238,46,192,292,86,79,21,44,16,28,21,7,755
"2011","Richmond upon Thames 016C","E01003884",1209,294,54,240,387,128,119,29,73,39,38,23,15,102
"2011","Richmond upon Thames 016D","E01003885",1098,286,67,219,378,122,102,22,54,32,18,9,9,84
"2011","Richmond upon Thames 017A","E01003818",1116,188,35,153,340,144,128,51,94,49,44,22,22,78
"2011","Richmond upon Thames 017B","E01003819",1219,140,26,114,255,152,114,77,180,116,97,58,39,88
"2011","Richmond upon Thames 017C","E01003820",1377,205,33,172,385,170,131,70,160,94,66,37,29,96
"2011","Richmond upon Thames 018A","E01003811",1127,270,49,221,431,111,96,33,60,41,17,10,7,68
"2011","Richmond upon Thames 018B","E01003812",1377,246,51,195,463,159,118,65,104,65,40,25,15,117
"2011","Richmond upon Thames 018C","E01003890",1146,292,71,221,378,116,104,31,50,32,25,13,12,118
"2011","Richmond upon Thames 018D","E01003891",1322,328,83,245,460,148,133,40,52,32,28,19,9,101
"2011","Richmond upon Thames 019A","E01003810",1169,256,57,199,384,127,116,46,81,47,35,19,16,77
"2011","Richmond upon Thames 019B","E01003813",1150,228,59,169,422,141,111,29,56,28,34,26,8,101
"2011","Richmond upon Thames 019C","E01003814",1199,239,54,185,432,159,118,41,66,38,37,20,17,69
"2011","Richmond upon Thames 019D","E01003815",1328,225,45,180,447,190,117,55,101,66,54,38,16,73
"2011","Richmond upon Thames 020A","E01003828",1105,213,52,161,353,156,110,50,79,42,20,11,9,82
"2011","Richmond upon Thames 020B","E01003829",1220,114,29,85,263,196,112,89,147,113,86,63,23,100
"2011","Richmond upon Thames 020C","E01003830",1273,209,46,163,366,167,137,66,100,66,52,35,17,110
"2011","Richmond upon Thames 020D","E01003831",1154,187,31,156,326,197,102,63,106,70,45,34,11,58
"2011","Richmond upon Thames 020E","E01003832",1065,117,26,91,212,150,96,76,137,114,89,69,20,74
"2011","Richmond upon Thames 020F","E01003833",1029,116,28,88,294,163,88,65,116,81,52,35,17,54
"2011","Richmond upon Thames 021A","E01003886",1234,315,66,249,451,122,97,36,63,26,28,14,14,96
"2011","Richmond upon Thames 021B","E01003887",1294,347,77,270,440,142,118,40,52,37,23,11,12,95
"2011","Richmond upon Thames 021C","E01003888",1391,253,55,198,457,153,107,59,118,66,49,34,15,129
"2011","Richmond upon Thames 021D","E01003889",1294,352,66,286,478,153,107,28,49,37,24,15,9,66
"2011","Richmond upon Thames 022A","E01003834",1352,280,65,215,372,139,111,34,72,26,33,25,8,285
"2011","Richmond upon Thames 022B","E01003835",1062,257,64,193,358,102,119,25,55,31,27,19,8,88
"2011","Richmond upon Thames 022C","E01003836",1034,208,45,163,312,100,71,47,84,50,53,45,8,109
"2011","Richmond upon Thames 022D","E01003837",1273,333,63,270,437,134,117,26,71,28,45,32,13,82
"2011","Richmond upon Thames 022E","E01003838",1318,316,62,254,446,142,102,50,81,48,45,24,21,88
"2011","Richmond upon Thames 022F","E01003839",1390,279,40,239,439,152,120,57,115,68,70,42,28,90
"2011","Richmond upon Thames 023A","E01003822",1022,219,42,177,330,136,106,23,71,26,26,17,9,85
"2011","Richmond upon Thames 023B","E01003823",1278,277,49,228,387,167,172,49,73,42,38,26,12,73
"2011","Richmond upon Thames 023C","E01003824",1153,238,41,197,406,129,122,38,83,40,22,19,3,75
"2011","Richmond upon Thames 023D","E01003825",1266,241,48,193,376,179,110,55,127,61,26,17,9,91
"2011","Richmond upon Thames 023E","E01003826",1235,157,32,125,294,166,133,71,154,109,68,59,9,83
"2011","Richmond upon Thames 023F","E01003827",1316,221,53,168,450,178,145,58,119,57,18,12,6,70
"2011","Sutton 001A","E01004125",1088,53,11,42,200,137,84,81,200,147,73,50,23,113
"2011","Sutton 001B","E01004183",1223,54,14,40,207,150,113,121,209,162,83,56,27,124
"2011","Sutton 001C","E01004184",1071,52,13,39,177,158,99,92,165,141,87,50,37,100
"2011","Sutton 001D","E01004185",1047,60,16,44,168,150,94,72,166,122,106,77,29,109
"2011","Sutton 001E","E01004189",1313,64,16,48,231,205,124,110,211,171,98,69,29,99
"2011","Sutton 002A","E01004123",1550,84,14,70,292,215,157,98,228,180,116,67,49,180
"2011","Sutton 002B","E01004124",1294,60,16,44,210,203,152,99,199,148,108,65,43,115
"2011","Sutton 002C","E01004126",1024,41,15,26,156,141,75,101,179,159,72,52,20,100
"2011","Sutton 002D","E01004128",1088,62,6,56,202,179,103,92,157,135,62,39,23,96
"2011","Sutton 002E","E01004129",1243,57,17,40,195,174,114,118,212,162,114,79,35,97
"2011","Sutton 003A","E01004130",1170,96,24,72,287,193,121,79,162,114,36,24,12,82
"2011","Sutton 003B","E01004131",1164,94,20,74,241,236,140,71,142,66,48,35,13,126
"2011","Sutton 003C","E01004134",1069,108,24,84,230,176,151,74,129,75,39,25,14,87
"2011","Sutton 003D","E01004135",1081,93,23,70,238,191,125,85,145,61,45,34,11,98
"2011","Sutton 003E","E01004136",1172,91,28,63,209,221,153,94,158,104,36,28,8,106
"2011","Sutton 004A","E01004164",1136,119,29,90,246,229,120,73,155,90,43,31,12,61
"2011","Sutton 004B","E01004166",1081,111,31,80,324,185,102,66,103,70,42,24,18,78
"2011","Sutton 004C","E01004169",820,65,14,51,183,143,82,54,111,69,57,38,19,56
"2011","Sutton 004D","E01004186",1325,146,30,116,292,263,122,93,171,98,58,30,28,82
"2011","Sutton 004E","E01004188",1223,130,22,108,278,217,122,87,139,96,65,31,34,89
"2011","Sutton 005A","E01004127",1157,79,23,56,212,187,105,94,170,138,73,44,29,99
"2011","Sutton 005B","E01004163",1147,81,24,57,226,217,149,89,145,118,42,26,16,80
"2011","Sutton 005C","E01004165",1256,113,18,95,262,218,144,96,154,112,67,41,26,90
"2011","Sutton 005D","E01004167",947,66,17,49,167,156,106,55,128,121,56,32,24,92
"2011","Sutton 005E","E01004187",1124,54,15,39,225,196,150,73,156,128,51,28,23,91
"2011","Sutton 006A","E01004117",1069,116,26,90,245,203,129,73,124,71,17,12,5,91
"2011","Sutton 006B","E01004121",1153,161,38,123,279,208,121,57,121,79,55,40,15,72
"2011","Sutton 006C","E01004192",1441,198,46,152,396,229,155,82,128,108,58,37,21,87
"2011","Sutton 006D","E01004193",1625,260,56,204,431,256,156,106,178,99,59,42,17,80
"2011","Sutton 006E","E01004195",1192,129,21,108,309,174,140,84,127,85,54,41,13,90
"2011","Sutton 007A","E01004144",1196,145,37,108,293,211,132,73,124,58,62,46,16,98
"2011","Sutton 007B","E01004145",1543,137,23,114,346,279,160,106,187,121,71,47,24,136
"2011","Sutton 007C","E01004146",1184,118,19,99,273,193,128,77,141,98,59,47,12,97
"2011","Sutton 007D","E01004147",1127,117,30,87,273,209,97,71,137,81,52,37,15,90
"2011","Sutton 008A","E01004116",1077,144,39,105,269,191,141,61,115,49,26,18,8,81
"2011","Sutton 008B","E01004122",1003,137,29,108,281,174,110,56,86,49,36,24,12,74
"2011","Sutton 008C","E01004190",1038,137,33,104,254,180,124,56,113,47,26,19,7,101
"2011","Sutton 008D","E01004191",1182,110,33,77,271,221,145,81,140,94,46,33,13,74
"2011","Sutton 008E","E01004194",995,118,23,95,244,194,105,79,116,64,29,13,16,46
"2011","Sutton 008F","E01004196",1076,107,22,85,280,190,129,68,123,58,46,26,20,75
"2011","Sutton 009A","E01004115",1239,118,25,93,285,243,149,84,146,74,49,35,14,91
"2011","Sutton 009B","E01004118",1226,117,26,91,298,214,135,82,143,97,46,33,13,94
"2011","Sutton 009C","E01004119",1060,97,26,71,220,198,163,81,120,58,25,16,9,98
"2011","Sutton 009D","E01004132",1073,86,23,63,235,195,138,69,158,78,35,25,10,79
"2011","Sutton 009E","E01004133",1054,105,22,83,247,204,132,62,123,67,26,14,12,88
"2011","Sutton 010A","E01004171",1064,104,27,77,264,204,135,72,111,52,33,29,4,89
"2011","Sutton 010B","E01004172",1172,115,27,88,276,239,98,73,141,101,61,37,24,68
"2011","Sutton 010C","E01004173",1015,96,17,79,266,179,107,51,121,80,46,28,18,69
"2011","Sutton 010D","E01004175",1192,107,33,74,285,227,119,78,162,82,49,35,14,83
"2011","Sutton 010E","E01004176",1073,139,30,109,263,204,101,67,115,73,42,24,18,69
"2011","Sutton 011A","E01004076",1068,108,29,79,231,193,109,69,128,108,49,30,19,73
"2011","Sutton 011B","E01004077",1136,106,20,86,239,184,148,59,156,110,51,38,13,83
"2011","Sutton 011C","E01004078",1182,94,24,70,257,198,124,86,153,127,66,47,19,77
"2011","Sutton 011D","E01004079",1045,125,28,97,264,199,140,60,93,59,23,17,6,82
"2011","Sutton 011E","E01004080",982,113,26,87,240,188,117,54,93,60,33,23,10,84
"2011","Sutton 011F","E01004081",1070,122,33,89,261,195,101,69,146,59,54,34,20,63
"2011","Sutton 011G","E01004082",1045,117,24,93,223,220,100,67,133,74,29,18,11,82
"2011","Sutton 012A","E01004137",1156,189,35,154,327,202,108,56,101,78,45,26,19,50
"2011","Sutton 012B","E01004140",1130,80,17,63,211,142,124,100,173,114,99,73,26,87
"2011","Sutton 012C","E01004141",1137,92,26,66,270,159,119,83,162,93,66,39,27,93
"2011","Sutton 012D","E01004142",1546,141,32,109,375,236,127,109,227,137,99,61,38,95
"2011","Sutton 012E","E01004149",1241,145,29,116,305,196,146,72,153,99,60,41,19,65
"2011","Sutton 013A","E01004101",993,111,22,89,268,179,104,60,104,59,30,14,16,78
"2011","Sutton 013B","E01004103",1238,179,37,142,375,215,111,80,93,63,50,30,20,72
"2011","Sutton 013C","E01004138",1195,160,32,128,285,179,133,81,147,81,59,38,21,70
"2011","Sutton 013D","E01004139",1038,141,30,111,260,167,129,67,90,69,49,29,20,66
"2011","Sutton 013E","E01004168",1167,76,18,58,247,236,150,77,163,91,29,17,12,98
"2011","Sutton 014A","E01004143",1074,131,29,102,267,160,124,72,125,70,60,34,26,65
"2011","Sutton 014B","E01004148",1100,85,17,68,246,159,108,73,186,93,65,40,25,85
"2011","Sutton 014C","E01004159",1121,93,20,73,241,189,140,81,146,98,44,30,14,89
"2011","Sutton 014D","E01004160",1188,157,30,127,317,197,147,65,111,72,47,27,20,75
"2011","Sutton 014E","E01004161",1076,143,20,123,288,183,137,65,107,65,39,23,16,49
"2011","Sutton 015A","E01004097",1237,148,35,113,357,228,134,64,99,70,37,22,15,100
"2011","Sutton 015B","E01004098",897,153,39,114,289,131,83,32,69,33,43,33,10,64
"2011","Sutton 015C","E01004099",1084,157,37,120,330,171,114,47,106,69,34,17,17,56
"2011","Sutton 015D","E01004100",990,135,31,104,252,168,112,58,94,64,27,17,10,80
"2011","Sutton 015E","E01004102",1000,143,26,117,275,149,118,66,78,59,53,43,10,59
"2011","Sutton 016A","E01004110",1343,204,40,164,362,213,163,71,126,68,50,27,23,86
"2011","Sutton 016B","E01004111",1027,148,42,106,263,167,109,42,130,57,34,25,9,77
"2011","Sutton 016C","E01004112",1141,238,42,196,344,188,136,37,76,26,23,14,9,73
"2011","Sutton 016D","E01004120",1133,127,29,98,282,210,140,68,117,59,17,14,3,113
"2011","Sutton 016E","E01004157",927,153,19,134,261,155,106,38,74,27,30,22,8,83
"2011","Sutton 017A","E01004087",1106,176,30,146,253,209,151,58,101,41,33,22,11,84
"2011","Sutton 017B","E01004170",1336,170,35,135,357,257,127,65,134,80,54,38,16,92
"2011","Sutton 017C","E01004174",1060,121,22,99,295,191,106,68,109,61,35,17,18,74
"2011","Sutton 017D","E01004178",1497,161,36,125,369,252,151,112,183,100,80,56,24,89
"2011","Sutton 017E","E01004179",1164,175,32,143,322,182,140,45,114,66,33,18,15,87
"2011","Sutton 018A","E01004152",1137,195,32,163,265,180,102,62,138,84,53,34,19,58
"2011","Sutton 018B","E01004155",1212,231,39,192,359,170,113,61,109,77,41,26,15,51
"2011","Sutton 018C","E01004156",1295,230,24,206,366,221,114,70,99,67,66,47,19,62
"2011","Sutton 018D","E01004158",1124,199,27,172,352,181,93,43,91,53,42,31,11,70
"2011","Sutton 018E","E01004162",1157,188,32,156,318,193,81,62,111,69,59,40,19,76
"2011","Sutton 019A","E01004083",1022,39,12,27,153,168,85,82,169,146,86,48,38,94
"2011","Sutton 019B","E01004086",1186,120,25,95,258,192,124,73,163,84,70,50,20,102
"2011","Sutton 019C","E01004088",1250,31,6,25,159,172,101,88,232,204,146,96,50,117
"2011","Sutton 019D","E01004089",880,34,5,29,129,148,79,68,161,105,75,44,31,81
"2011","Sutton 019E","E01004182",1077,91,22,69,225,187,95,75,143,98,75,48,27,88
"2011","Sutton 020A","E01004104",1084,174,50,124,323,193,125,53,90,27,21,17,4,78
"2011","Sutton 020B","E01004107",1103,115,39,76,252,179,116,94,132,75,56,43,13,84
"2011","Sutton 020C","E01004177",1123,111,23,88,264,172,125,73,149,78,83,58,25,68
"2011","Sutton 020D","E01004180",1248,206,38,168,327,206,152,50,97,45,50,35,15,115
"2011","Sutton 020E","E01004181",1234,168,25,143,324,213,122,68,128,83,69,48,21,59
"2011","Sutton 021A","E01004090",831,70,11,59,138,111,68,56,130,111,93,56,37,54
"2011","Sutton 021B","E01004096",1102,171,29,142,307,180,99,62,100,63,60,42,18,60
"2011","Sutton 021C","E01004150",1137,161,19,142,313,167,82,69,138,96,55,33,22,56
"2011","Sutton 021D","E01004151",1313,238,38,200,375,179,126,67,126,63,71,57,14,68
"2011","Sutton 021E","E01004153",1297,247,42,205,356,198,110,62,128,67,58,34,24,71
"2011","Sutton 022A","E01004091",971,176,49,127,278,154,123,38,71,41,13,9,4,77
"2011","Sutton 022B","E01004092",1098,223,41,182,310,161,125,35,79,32,25,20,5,108
"2011","Sutton 022C","E01004105",1332,228,47,181,373,214,145,54,110,59,38,24,14,111
"2011","Sutton 022D","E01004106",1155,258,59,199,349,154,126,22,80,30,21,12,9,115
"2011","Sutton 022E","E01004154",1056,223,38,185,331,152,93,42,76,29,28,20,8,82
"2011","Sutton 024A","E01004084",1091,170,45,125,326,176,134,36,84,36,32,24,8,97
"2011","Sutton 024B","E01004085",1184,193,43,150,325,204,137,47,95,42,44,28,16,97
"2011","Sutton 024C","E01004108",1160,160,24,136,290,183,174,66,89,52,51,37,14,95
"2011","Sutton 024D","E01004109",1170,116,25,91,264,228,133,74,127,95,46,29,17,87
"2011","Sutton 025A","E01004093",1105,239,48,191,335,182,94,54,77,26,30,21,9,68
"2011","Sutton 025B","E01004094",1199,194,32,162,346,200,135,46,107,55,23,14,9,93
"2011","Sutton 025C","E01004095",1159,268,46,222,337,199,98,40,72,41,44,26,18,60
"2011","Sutton 025D","E01004114",1212,292,65,227,334,176,167,28,65,25,38,32,6,87
"2011","Sutton 025E","E01032623",1254,292,62,230,342,164,159,36,82,31,37,28,9,111
"2011","Waltham Forest 001A","E01004349",1018,73,20,53,171,162,101,73,137,113,83,58,25,105
"2011","Waltham Forest 001B","E01004350",1098,102,26,76,189,188,147,89,137,102,76,55,21,68
"2011","Waltham Forest 001C","E01004351",1130,111,21,90,257,211,157,65,109,90,45,28,17,85
"2011","Waltham Forest 001D","E01004356",1175,71,17,54,233,189,139,81,130,105,97,72,25,130
"2011","Waltham Forest 001E","E01004357",1105,113,26,87,216,171,167,64,112,90,79,56,23,93
"2011","Waltham Forest 002A","E01004352",1380,256,45,211,392,244,168,50,90,49,36,20,16,95
"2011","Waltham Forest 002B","E01004353",1336,207,49,158,332,233,174,54,97,83,67,38,29,89
"2011","Waltham Forest 002C","E01004354",1293,177,45,132,354,230,143,51,131,80,47,27,20,80
"2011","Waltham Forest 002D","E01004358",1200,145,36,109,316,198,127,57,121,92,58,24,34,86
"2011","Waltham Forest 002E","E01004359",1246,137,32,105,301,228,145,64,103,88,57,37,20,123
"2011","Waltham Forest 003A","E01004384",1248,73,30,43,211,168,118,93,171,170,138,104,34,106
"2011","Waltham Forest 003B","E01004385",963,100,16,84,207,126,121,62,110,71,90,58,32,76
"2011","Waltham Forest 003C","E01004386",1224,147,39,108,303,230,162,69,102,75,41,35,6,95
"2011","Waltham Forest 003D","E01004389",1148,67,20,47,219,167,162,66,164,133,94,66,28,76
"2011","Waltham Forest 003E","E01004390",1112,60,14,46,176,158,132,88,162,143,111,90,21,82
"2011","Waltham Forest 004A","E01004355",1164,107,26,81,256,202,124,53,137,85,90,70,20,110
"2011","Waltham Forest 004B","E01004360",980,102,24,78,237,167,119,54,96,70,51,39,12,84
"2011","Waltham Forest 004C","E01004413",1088,51,13,38,203,179,99,77,152,137,107,69,38,83
"2011","Waltham Forest 004D","E01004415",1138,70,18,52,225,189,139,68,135,108,90,71,19,114
"2011","Waltham Forest 004E","E01004416",1243,106,30,76,294,194,151,71,147,83,86,61,25,111
"2011","Waltham Forest 005A","E01004361",999,95,29,66,224,162,152,51,108,70,52,40,12,85
"2011","Waltham Forest 005B","E01004414",1140,72,19,53,238,194,141,78,126,109,73,58,15,109
"2011","Waltham Forest 005C","E01004417",1179,90,23,67,211,193,159,62,171,122,78,57,21,93
"2011","Waltham Forest 005D","E01004451",1284,102,24,78,270,213,175,90,142,103,65,47,18,124
"2011","Waltham Forest 005E","E01004452",1165,73,21,52,219,192,134,84,172,95,100,71,29,96
"2011","Waltham Forest 006A","E01004450",1160,101,31,70,230,212,149,78,154,80,45,34,11,111
"2011","Waltham Forest 006B","E01004453",1203,82,26,56,230,186,164,78,154,91,94,72,22,124
"2011","Waltham Forest 006C","E01004454",1200,82,20,62,215,207,137,87,154,105,96,75,21,117
"2011","Waltham Forest 006D","E01004455",1124,65,10,55,183,149,141,58,142,120,152,128,24,114
"2011","Waltham Forest 006E","E01004456",1134,46,11,35,141,132,84,84,178,139,164,115,49,166
"2011","Waltham Forest 007A","E01004379",1060,125,22,103,268,189,116,56,103,70,40,21,19,93
"2011","Waltham Forest 007B","E01004380",1094,140,32,108,272,168,130,68,101,76,56,40,16,83
"2011","Waltham Forest 007C","E01004381",1326,163,34,129,367,182,151,67,118,78,71,48,23,129
"2011","Waltham Forest 007D","E01004383",1156,112,25,87,273,189,149,55,119,80,71,52,19,108
"2011","Waltham Forest 007E","E01004387",1122,155,37,118,296,208,106,51,97,72,35,21,14,102
"2011","Waltham Forest 007F","E01004388",1110,145,32,113,274,151,124,68,111,80,75,53,22,82
"2011","Waltham Forest 008A","E01004343",1310,116,21,95,312,233,179,75,122,90,64,39,25,119
"2011","Waltham Forest 008B","E01004344",1277,80,23,57,233,148,167,79,176,98,158,123,35,138
"2011","Waltham Forest 008C","E01004382",892,49,8,41,154,118,84,57,115,80,122,100,22,113
"2011","Waltham Forest 008D","E01004418",1194,84,15,69,217,188,136,88,144,122,99,72,27,116
"2011","Waltham Forest 008E","E01004419",1191,73,14,59,278,176,138,69,117,135,92,66,26,113
"2011","Waltham Forest 009A","E01004398",1412,58,15,43,202,151,144,80,199,172,212,171,41,194
"2011","Waltham Forest 009B","E01004399",1209,44,16,28,156,122,134,64,173,148,192,152,40,176
"2011","Waltham Forest 009C","E01004400",1267,68,18,50,242,116,166,82,173,132,139,102,37,149
"2011","Waltham Forest 009D","E01004402",1267,71,20,51,219,131,156,73,162,130,177,134,43,148
"2011","Waltham Forest 009E","E01004403",1267,58,12,46,248,118,139,75,183,127,186,135,51,133
"2011","Waltham Forest 010A","E01004345",1372,100,26,74,231,160,179,84,181,135,133,99,34,169
"2011","Waltham Forest 010B","E01004348",1981,192,32,160,397,212,256,130,232,185,190,149,41,187
"2011","Waltham Forest 010C","E01004377",1269,163,30,133,297,157,142,68,117,88,98,76,22,139
"2011","Waltham Forest 010D","E01004378",1354,130,25,105,309,154,169,72,123,128,137,99,38,132
"2011","Waltham Forest 011A","E01004342",1559,95,19,76,276,135,194,74,181,142,163,132,31,299
"2011","Waltham Forest 011B","E01004346",1165,91,18,73,267,156,138,73,120,97,111,90,21,112
"2011","Waltham Forest 011C","E01004347",1478,150,34,116,390,194,175,84,153,108,113,81,32,111
"2011","Waltham Forest 011D","E01004460",1414,120,23,97,261,154,153,75,169,102,186,151,35,194
"2011","Waltham Forest 011E","E01004462",1362,107,24,83,307,152,154,74,136,118,163,136,27,151
"2011","Waltham Forest 012A","E01004396",1340,96,22,74,266,135,187,84,160,125,159,126,33,128
"2011","Waltham Forest 012B","E01004457",1430,142,27,115,361,142,179,54,153,119,132,111,21,148
"2011","Waltham Forest 012C","E01004458",1400,107,20,87,266,159,189,80,164,137,157,129,28,141
"2011","Waltham Forest 012D","E01004459",1028,29,5,24,147,87,89,53,144,116,209,169,40,154
"2011","Waltham Forest 012E","E01004463",1525,173,34,139,472,187,183,71,140,105,101,81,20,93
"2011","Waltham Forest 013A","E01004407",1102,27,8,19,122,104,75,57,159,129,280,218,62,149
"2011","Waltham Forest 013B","E01004410",1345,97,15,82,322,133,118,61,167,136,182,125,57,129
"2011","Waltham Forest 013C","E01004464",1105,58,14,44,191,98,105,69,151,130,160,122,38,143
"2011","Waltham Forest 013D","E01004469",1140,88,15,73,160,129,121,57,138,117,199,168,31,131
"2011","Waltham Forest 013E","E01004470",1112,94,25,69,214,130,117,58,124,119,130,101,29,126
"2011","Waltham Forest 013F","E01004471",1218,93,27,66,242,123,129,59,149,133,164,128,36,126
"2011","Waltham Forest 014A","E01004391",1429,144,18,126,344,177,155,92,160,114,125,98,27,118
"2011","Waltham Forest 014B","E01004393",1922,133,53,80,342,274,197,205,149,159,131,102,29,332
"2011","Waltham Forest 014C","E01004401",1577,113,21,92,317,168,231,85,177,162,129,92,37,195
"2011","Waltham Forest 014D","E01004404",1511,98,18,80,274,163,183,100,180,187,186,139,47,140
"2011","Waltham Forest 014E","E01004461",1609,130,26,104,352,183,231,94,179,134,145,115,30,161
"2011","Waltham Forest 015A","E01004412",1322,185,34,151,357,146,150,57,106,104,93,69,24,124
"2011","Waltham Forest 015B","E01004465",1096,111,22,89,293,127,107,64,101,80,106,89,17,107
"2011","Waltham Forest 015C","E01004466",1246,186,39,147,383,134,133,52,119,71,88,70,18,80
"2011","Waltham Forest 015D","E01004467",1530,80,22,58,279,193,184,79,188,204,159,120,39,164
"2011","Waltham Forest 015E","E01004468",1206,187,28,159,318,153,142,54,102,77,72,48,24,101
"2011","Waltham Forest 016A","E01004406",1424,128,25,103,264,134,192,86,154,126,153,114,39,187
"2011","Waltham Forest 016B","E01004408",1289,155,33,122,310,120,136,64,143,88,141,104,37,132
"2011","Waltham Forest 016C","E01004409",1273,134,21,113,326,128,158,58,118,108,127,98,29,116
"2011","Waltham Forest 016D","E01004411",1402,147,18,129,273,150,171,86,177,100,119,102,17,179
"2011","Waltham Forest 016E","E01004443",1385,122,14,108,229,133,149,75,140,120,206,180,26,211
"2011","Waltham Forest 016F","E01004447",1447,132,27,105,312,156,198,62,162,108,152,129,23,165
"2011","Waltham Forest 017A","E01004392",1793,136,25,111,416,159,229,83,187,140,206,147,59,237
"2011","Waltham Forest 017B","E01004394",1350,104,20,84,274,157,129,81,181,122,172,138,34,130
"2011","Waltham Forest 017C","E01004397",1870,175,22,153,432,202,171,106,190,153,203,169,34,238
"2011","Waltham Forest 017D","E01004444",1811,109,13,96,282,188,246,91,215,188,246,198,48,246
"2011","Waltham Forest 017E","E01004446",1433,110,18,92,256,179,193,86,172,111,149,122,27,177
"2011","Waltham Forest 018A","E01004395",1160,119,22,97,273,122,161,59,131,116,86,66,20,93
"2011","Waltham Forest 018B","E01004421",1493,90,15,75,204,150,170,75,176,141,247,220,27,240
"2011","Waltham Forest 018C","E01004445",1323,112,23,89,245,122,185,91,131,134,150,126,24,153
"2011","Waltham Forest 018D","E01004448",1359,86,17,69,291,156,186,110,140,124,163,131,32,103
"2011","Waltham Forest 018E","E01004449",1261,39,12,27,157,113,114,78,196,142,224,174,50,198
"2011","Waltham Forest 019A","E01004363",1184,93,24,69,256,153,155,56,124,114,87,69,18,146
"2011","Waltham Forest 019B","E01004364",1244,79,15,64,195,137,109,64,154,129,171,147,24,206
"2011","Waltham Forest 019C","E01004366",1440,137,21,116,302,168,137,71,150,99,188,162,26,188
"2011","Waltham Forest 019D","E01004367",1219,76,16,60,201,133,175,63,149,106,175,157,18,141
"2011","Waltham Forest 019E","E01004368",1505,136,25,111,349,166,182,75,146,123,138,109,29,190
"2011","Waltham Forest 020A","E01004365",1805,61,13,48,210,193,268,83,217,173,248,211,37,352
"2011","Waltham Forest 020B","E01004405",1216,106,29,77,237,114,131,70,121,136,166,134,32,135
"2011","Waltham Forest 020C","E01004420",1655,97,13,84,214,141,194,109,209,163,284,205,79,244
"2011","Waltham Forest 020D","E01004423",1392,66,10,56,213,111,161,92,197,146,236,191,45,170
"2011","Waltham Forest 020G","E01033153",1759,64,12,52,200,161,158,120,265,181,333,274,59,277
"2011","Waltham Forest 021A","E01004362",1285,175,42,133,336,127,146,56,97,96,114,99,15,138
"2011","Waltham Forest 021B","E01004436",1343,150,25,125,322,142,129,60,126,86,179,148,31,149
"2011","Waltham Forest 021C","E01004437",1490,148,14,134,329,151,148,93,140,126,175,124,51,180
"2011","Waltham Forest 021D","E01004439",1275,143,25,118,310,140,147,61,114,93,118,92,26,149
"2011","Waltham Forest 021E","E01004442",1421,216,23,193,372,151,130,51,105,67,122,91,31,207
"2011","Waltham Forest 022A","E01004422",1186,69,16,53,192,147,147,75,161,125,132,113,19,138
"2011","Waltham Forest 022B","E01004424",1312,62,10,52,177,122,171,79,157,140,210,164,46,194
"2011","Waltham Forest 022C","E01004425",1499,103,23,80,268,183,160,116,205,157,158,125,33,149
"2011","Waltham Forest 022D","E01004426",1267,60,17,43,202,170,135,84,137,142,163,136,27,174
"2011","Waltham Forest 022E","E01004427",1527,82,23,59,291,158,218,92,179,213,153,114,39,141
"2011","Waltham Forest 023A","E01004369",1328,101,15,86,261,135,197,80,121,132,127,104,23,174
"2011","Waltham Forest 023B","E01004370",1347,114,16,98,285,137,163,64,155,129,111,87,24,189
"2011","Waltham Forest 023C","E01004372",1398,153,32,121,332,150,172,91,125,146,116,100,16,113
"2011","Waltham Forest 023D","E01004432",1263,91,13,78,230,152,168,62,174,118,126,103,23,142
"2011","Waltham Forest 023E","E01004435",1429,92,15,77,240,166,190,80,176,135,165,132,33,185
"2011","Waltham Forest 024A","E01004333",1282,112,17,95,248,115,148,88,136,114,154,111,43,167
"2011","Waltham Forest 024B","E01004334",1056,26,0,26,145,94,107,79,152,159,164,115,49,130
"2011","Waltham Forest 024C","E01004438",1706,210,27,183,381,167,150,91,177,122,134,109,25,274
"2011","Waltham Forest 024D","E01004440",1733,162,21,141,410,217,191,111,142,116,179,121,58,205
"2011","Waltham Forest 024E","E01004441",1321,173,19,154,353,165,161,64,111,73,97,75,22,124
"2011","Waltham Forest 025A","E01004371",1377,157,27,130,305,165,130,77,136,104,137,111,26,166
"2011","Waltham Forest 025B","E01004373",1376,63,13,50,214,134,187,101,161,158,151,106,45,207
"2011","Waltham Forest 025C","E01004374",1470,141,26,115,326,146,171,83,175,129,117,86,31,182
"2011","Waltham Forest 025D","E01004375",1447,96,14,82,257,135,209,93,151,147,161,127,34,198
"2011","Waltham Forest 025E","E01004376",1637,128,24,104,255,155,229,105,185,144,170,137,33,266
"2011","Waltham Forest 026A","E01004336",1438,63,10,53,207,121,162,107,194,103,157,125,32,324
"2011","Waltham Forest 026B","E01004428",1208,41,4,37,156,134,101,76,174,137,205,160,45,184
"2011","Waltham Forest 026C","E01004429",1353,85,15,70,227,162,177,78,165,120,158,115,43,181
"2011","Waltham Forest 026D","E01004430",1817,147,21,126,317,171,228,137,211,149,165,126,39,292
"2011","Waltham Forest 026E","E01004434",1482,81,20,61,242,163,185,80,196,142,192,143,49,201
"2011","Waltham Forest 027A","E01004335",1238,41,7,34,143,95,91,98,184,155,212,167,45,219
"2011","Waltham Forest 027B","E01004337",1436,68,9,59,188,110,251,90,164,200,172,130,42,193
"2011","Waltham Forest 027C","E01004338",1451,80,9,71,274,148,204,97,169,133,132,98,34,214
"2011","Waltham Forest 027D","E01004339",1364,108,13,95,289,126,164,130,146,108,127,100,27,166
"2011","Waltham Forest 027E","E01004340",1406,70,16,54,207,155,137,103,193,152,199,149,50,190
"2011","Waltham Forest 027F","E01004341",1295,59,6,53,209,118,120,87,165,141,205,151,54,191
"2011","Waltham Forest 028A","E01004327",919,48,12,36,159,102,109,57,121,102,91,66,25,130
"2011","Waltham Forest 028B","E01004328",1439,78,13,65,286,128,229,79,161,123,119,89,30,236
"2011","Waltham Forest 028C","E01004329",1486,87,17,70,224,129,164,92,155,138,156,112,44,341
"2011","Waltham Forest 028D","E01004330",1434,98,23,75,254,127,247,65,183,105,96,70,26,259
"2011","Waltham Forest 028E","E01004331",1388,80,20,60,256,119,150,78,156,112,140,108,32,297
"2011","Waltham Forest 028F","E01004332",1379,70,9,61,220,135,197,76,143,145,160,130,30,233
"2011","Bracknell Forest 001C","E01016252",1094,182,55,127,294,147,149,76,103,85,20,12,8,38
"2011","Bracknell Forest 001D","E01016253",970,214,60,154,289,130,105,48,77,28,19,10,9,60
"2011","Bracknell Forest 001E","E01032727",2084,365,101,264,578,318,264,107,218,110,40,22,18,84
"2011","Bracknell Forest 002A","E01016184",1632,335,82,253,462,232,166,98,134,83,31,15,16,91
"2011","Bracknell Forest 002B","E01016185",1063,193,35,158,252,140,96,57,99,59,29,11,18,138
"2011","Bracknell Forest 002C","E01016186",1326,248,50,198,365,173,189,77,111,58,23,16,7,82
"2011","Bracknell Forest 002D","E01016187",1206,284,64,220,405,166,115,47,72,26,27,16,11,64
"2011","Bracknell Forest 002E","E01016188",1212,294,68,226,352,187,94,60,88,62,15,7,8,60
"2011","Bracknell Forest 003A","E01016190",1074,169,40,129,257,123,108,62,140,106,35,16,19,74
"2011","Bracknell Forest 003B","E01016238",847,122,27,95,230,117,83,59,99,71,24,18,6,42
"2011","Bracknell Forest 003C","E01016243",1078,227,48,179,303,175,97,49,97,56,21,9,12,53
"2011","Bracknell Forest 003D","E01016245",1734,360,68,292,554,271,138,83,114,66,27,18,9,121
"2011","Bracknell Forest 003E","E01016246",1135,250,55,195,376,173,91,43,85,45,14,6,8,58
"2011","Bracknell Forest 003F","E01016247",1251,275,56,219,370,222,84,55,100,54,32,13,19,59
"2011","Bracknell Forest 004A","E01016239",1071,96,26,70,215,160,110,93,168,123,34,17,17,72
"2011","Bracknell Forest 004B","E01016240",1099,95,16,79,231,167,97,82,173,130,64,32,32,60
"2011","Bracknell Forest 004C","E01016241",1103,92,20,72,207,155,119,100,188,138,47,27,20,57
"2011","Bracknell Forest 004D","E01016242",1262,124,23,101,266,171,102,109,203,152,62,35,27,73
"2011","Bracknell Forest 005A","E01016180",982,152,34,118,260,131,96,66,84,63,21,14,7,109
"2011","Bracknell Forest 005B","E01016181",1002,170,60,110,296,119,109,37,72,39,17,15,2,143
"2011","Bracknell Forest 005C","E01016182",1061,184,37,147,326,172,113,46,93,47,22,14,8,58
"2011","Bracknell Forest 005D","E01016183",896,138,30,108,270,140,94,50,70,57,24,11,13,53
"2011","Bracknell Forest 005E","E01016222",1009,199,42,157,322,170,82,53,73,39,19,7,12,52
"2011","Bracknell Forest 006B","E01016191",1131,139,29,110,269,165,105,77,153,117,38,24,14,68
"2011","Bracknell Forest 006C","E01016223",1111,108,15,93,236,167,103,95,180,125,40,17,23,57
"2011","Bracknell Forest 006D","E01016224",1215,116,18,98,281,155,128,97,203,132,53,27,26,50
"2011","Bracknell Forest 006E","E01016226",986,96,14,82,226,146,105,87,149,96,29,9,20,52
"2011","Bracknell Forest 006F","E01032724",966,102,20,82,186,135,72,77,153,135,52,30,22,54
"2011","Bracknell Forest 006G","E01032728",1040,121,28,93,252,160,96,84,141,107,36,25,11,43
"2011","Bracknell Forest 007A","E01016225",1566,201,38,163,409,233,148,110,207,110,51,25,26,97
"2011","Bracknell Forest 007B","E01016233",1661,172,26,146,370,237,124,140,246,175,95,51,44,102
"2011","Bracknell Forest 007C","E01016248",1088,102,27,75,215,181,99,89,182,116,38,19,19,66
"2011","Bracknell Forest 007D","E01016249",1117,109,14,95,211,143,109,102,177,137,85,56,29,44
"2011","Bracknell Forest 007E","E01016250",1170,135,28,107,234,191,91,83,183,143,31,19,12,79
"2011","Bracknell Forest 008A","E01016200",1062,162,27,135,285,176,96,76,119,73,16,9,7,59
"2011","Bracknell Forest 008B","E01016201",1078,188,42,146,279,171,85,77,126,69,24,12,12,59
"2011","Bracknell Forest 008C","E01016202",1011,177,33,144,293,175,77,77,103,61,21,10,11,27
"2011","Bracknell Forest 008D","E01016203",926,76,13,63,223,161,77,76,140,85,42,26,16,46
"2011","Bracknell Forest 008E","E01016204",925,89,12,77,182,155,77,95,134,99,40,22,18,54
"2011","Bracknell Forest 009A","E01016209",1125,119,25,94,219,191,109,98,185,105,31,17,14,68
"2011","Bracknell Forest 009B","E01016210",892,77,29,48,167,113,63,68,178,125,47,21,26,54
"2011","Bracknell Forest 009D","E01016213",882,107,22,85,219,127,63,70,120,89,33,18,15,54
"2011","Bracknell Forest 009E","E01016214",1083,169,33,136,296,197,89,81,111,64,22,10,12,54
"2011","Bracknell Forest 009F","E01016215",891,71,17,54,153,128,63,95,151,132,37,22,15,61
"2011","Bracknell Forest 009G","E01032725",1123,242,55,187,346,164,70,59,101,69,27,12,15,45
"2011","Bracknell Forest 009H","E01032726",1028,69,11,58,204,141,93,92,190,131,42,25,17,66
"2011","Bracknell Forest 010A","E01016205",1028,106,17,89,242,165,95,96,148,89,36,25,11,51
"2011","Bracknell Forest 010B","E01016217",1063,130,24,106,263,170,90,87,132,94,30,17,13,67
"2011","Bracknell Forest 010C","E01016218",1039,105,18,87,224,150,87,89,167,139,37,19,18,41
"2011","Bracknell Forest 010D","E01016231",1380,176,31,145,297,187,109,116,202,121,74,41,33,98
"2011","Bracknell Forest 010E","E01016232",1057,117,22,95,234,165,101,96,145,102,25,14,11,72
"2011","Bracknell Forest 011A","E01016212",942,82,27,55,184,138,79,90,164,107,36,28,8,62
"2011","Bracknell Forest 011B","E01016216",961,103,19,84,210,147,97,95,145,100,31,16,15,33
"2011","Bracknell Forest 011C","E01016219",1045,151,30,121,271,173,67,75,134,81,32,15,17,61
"2011","Bracknell Forest 011D","E01016220",1002,112,20,92,251,151,82,82,147,110,22,11,11,45
"2011","Bracknell Forest 011E","E01016221",990,125,23,102,226,156,89,78,160,98,20,8,12,38
"2011","Bracknell Forest 012A","E01016206",1296,297,80,217,386,182,97,60,132,59,17,10,7,66
"2011","Bracknell Forest 012B","E01016208",1352,223,67,156,436,184,129,60,140,68,30,20,10,82
"2011","Bracknell Forest 012C","E01016229",846,131,24,107,237,136,104,38,72,46,20,12,8,62
"2011","Bracknell Forest 012D","E01016230",1222,125,34,91,345,77,54,40,52,28,16,9,7,485
"2011","Bracknell Forest 013A","E01016207",1128,125,32,93,308,139,110,74,127,118,63,47,16,64
"2011","Bracknell Forest 013B","E01016234",899,131,29,102,244,162,71,66,101,60,14,8,6,50
"2011","Bracknell Forest 013C","E01016235",1051,194,58,136,299,163,73,54,112,65,19,8,11,72
"2011","Bracknell Forest 013D","E01016236",1061,92,17,75,198,164,77,91,197,133,37,21,16,72
"2011","Bracknell Forest 013E","E01016237",923,131,33,98,241,194,72,68,91,55,13,9,4,58
"2011","Bracknell Forest 014A","E01016192",971,131,22,109,268,140,104,61,130,79,21,14,7,37
"2011","Bracknell Forest 014B","E01016194",911,162,49,113,267,149,108,37,86,39,17,8,9,46
"2011","Bracknell Forest 014C","E01016195",862,124,29,95,222,125,84,67,114,64,20,10,10,42
"2011","Bracknell Forest 014D","E01016227",953,166,38,128,278,151,86,52,96,51,9,3,6,64
"2011","Bracknell Forest 014E","E01016228",1127,207,49,158,297,169,128,62,122,55,33,26,7,54
"2011","Bracknell Forest 015A","E01016193",974,122,21,101,231,169,84,80,124,81,25,17,8,58
"2011","Bracknell Forest 015B","E01016196",1968,751,686,65,365,287,65,85,147,102,70,54,16,96
"2011","Bracknell Forest 015C","E01016197",982,98,23,75,216,139,89,84,136,97,49,35,14,74
"2011","Bracknell Forest 015D","E01016198",867,125,25,100,208,139,96,59,100,65,18,9,9,57
"2011","Bracknell Forest 015E","E01016199",948,154,28,126,260,160,81,59,105,51,17,9,8,61
"2011","Brighton and Hove 001A","E01016924",1010,117,13,104,244,160,147,45,118,72,21,11,10,86
"2011","Brighton and Hove 001B","E01016926",1051,57,14,43,202,140,118,73,178,114,64,43,21,105
"2011","Brighton and Hove 001C","E01016927",1124,113,19,94,254,185,148,75,136,83,33,22,11,97
"2011","Brighton and Hove 001D","E01016929",1144,138,32,106,263,182,130,73,157,68,40,24,16,93
"2011","Brighton and Hove 001E","E01016931",1094,123,33,90,268,184,131,61,146,74,28,16,12,79
"2011","Brighton and Hove 002A","E01016898",1760,65,13,52,185,178,158,111,242,141,64,44,20,616
"2011","Brighton and Hove 002B","E01016899",3041,45,7,38,132,97,80,56,112,85,58,44,14,2376
"2011","Brighton and Hove 002C","E01016914",2016,27,3,24,115,69,90,61,176,169,91,69,22,1218
"2011","Brighton and Hove 002D","E01016915",1128,19,4,15,93,69,80,68,198,151,123,101,22,327
"2011","Brighton and Hove 003A","E01016923",1081,145,24,121,271,167,154,70,121,41,27,15,12,85
"2011","Brighton and Hove 003B","E01016928",1114,181,42,139,301,173,195,38,96,38,19,11,8,73
"2011","Brighton and Hove 003C","E01016998",1011,156,36,120,313,153,156,40,81,42,13,7,6,57
"2011","Brighton and Hove 003D","E01016999",1038,172,33,139,287,140,151,48,96,44,25,20,5,75
"2011","Brighton and Hove 003E","E01017000",1175,219,33,186,335,177,158,41,87,51,36,22,14,71
"2011","Brighton and Hove 004A","E01016925",1114,79,8,71,244,145,119,75,185,114,45,25,20,108
"2011","Brighton and Hove 004B","E01016930",1364,194,42,152,367,185,171,60,170,75,35,21,14,107
"2011","Brighton and Hove 004C","E01017001",1039,254,51,203,307,115,130,25,63,34,17,16,1,94
"2011","Brighton and Hove 004D","E01017003",1166,236,46,190,357,121,109,37,92,46,26,16,10,142
"2011","Brighton and Hove 005A","E01016916",1052,88,26,62,195,184,118,88,188,107,26,14,12,58
"2011","Brighton and Hove 005B","E01016917",1047,68,12,56,207,186,107,89,202,113,20,10,10,55
"2011","Brighton and Hove 005C","E01016918",1020,56,15,41,159,156,101,76,192,129,61,36,25,90
"2011","Brighton and Hove 005D","E01016919",1039,64,22,42,207,175,98,74,182,116,48,34,14,75
"2011","Brighton and Hove 005E","E01016920",1131,108,28,80,254,227,136,85,156,72,24,15,9,69
"2011","Brighton and Hove 006A","E01016882",1010,66,16,50,182,155,102,76,175,122,66,46,20,66
"2011","Brighton and Hove 006B","E01016883",1024,121,35,86,241,184,126,53,146,76,21,15,6,56
"2011","Brighton and Hove 006C","E01016884",1101,84,21,63,219,155,130,85,166,96,62,45,17,104
"2011","Brighton and Hove 006D","E01016885",930,36,6,30,150,106,90,61,203,120,94,70,24,70
"2011","Brighton and Hove 006E","E01016886",1084,86,21,65,236,177,135,71,151,88,47,38,9,93
"2011","Brighton and Hove 007A","E01016980",1050,190,38,152,273,148,154,34,94,48,26,17,9,83
"2011","Brighton and Hove 007B","E01016982",905,161,35,126,259,144,138,25,67,33,22,13,9,56
"2011","Brighton and Hove 007C","E01016983",1008,172,38,134,251,131,183,27,63,29,40,35,5,112
"2011","Brighton and Hove 007D","E01016984",1049,240,60,180,304,132,179,23,54,23,16,13,3,78
"2011","Brighton and Hove 007E","E01016985",1107,162,34,128,315,175,157,28,85,48,30,20,10,107
"2011","Brighton and Hove 008A","E01016900",1256,50,8,42,136,91,93,91,195,168,116,85,31,316
"2011","Brighton and Hove 008B","E01016902",1095,84,13,71,209,154,113,60,154,98,50,30,20,173
"2011","Brighton and Hove 008C","E01016904",1139,35,5,30,141,119,95,84,223,162,112,77,35,168
"2011","Brighton and Hove 008D","E01016905",1314,87,18,69,217,95,121,84,188,132,79,65,14,311
"2011","Brighton and Hove 008E","E01016909",1513,55,11,44,155,139,84,68,178,133,72,55,17,629
"2011","Brighton and Hove 009A","E01016906",1172,38,6,32,176,146,129,83,184,154,95,67,28,167
"2011","Brighton and Hove 009B","E01016907",1470,37,7,30,130,99,92,83,193,150,56,39,17,630
"2011","Brighton and Hove 009C","E01016908",1068,21,7,14,116,104,99,56,231,168,98,72,26,175
"2011","Brighton and Hove 009D","E01016910",1131,34,6,28,144,92,101,54,162,131,81,56,25,332
"2011","Brighton and Hove 009E","E01016911",1154,39,12,27,164,127,132,69,165,122,62,44,18,274
"2011","Brighton and Hove 010A","E01016901",1236,141,37,104,287,159,137,52,111,63,28,18,10,258
"2011","Brighton and Hove 010B","E01016903",1533,175,31,144,399,135,127,45,104,62,47,21,26,439
"2011","Brighton and Hove 010C","E01016934",1013,248,45,203,317,89,94,30,60,31,16,10,6,128
"2011","Brighton and Hove 010D","E01016939",1120,180,27,153,399,126,120,34,74,42,16,8,8,129
"2011","Brighton and Hove 010E","E01016940",1229,256,44,212,397,116,136,36,79,22,25,11,14,162
"2011","Brighton and Hove 011A","E01016981",1150,250,47,203,332,130,146,27,88,15,64,49,15,98
"2011","Brighton and Hove 011B","E01017002",1245,245,54,191,367,180,170,28,88,40,36,24,12,91
"2011","Brighton and Hove 011C","E01017004",1262,212,39,173,377,153,110,54,115,79,45,22,23,117
"2011","Brighton and Hove 011D","E01017005",1251,261,44,217,425,151,139,33,100,31,33,19,14,78
"2011","Brighton and Hove 011E","E01017006",1236,242,42,200,411,152,118,43,95,67,27,9,18,81
"2011","Brighton and Hove 012A","E01016921",1143,70,12,58,239,176,127,93,186,110,63,44,19,79
"2011","Brighton and Hove 012B","E01016922",930,66,13,53,214,134,100,78,141,82,46,25,21,69
"2011","Brighton and Hove 012C","E01016973",1039,84,22,62,251,143,122,75,151,104,44,21,23,65
"2011","Brighton and Hove 012D","E01016977",1143,83,24,59,235,170,138,77,165,122,57,40,17,96
"2011","Brighton and Hove 012E","E01016978",1206,86,24,62,250,178,126,93,204,129,74,52,22,66
"2011","Brighton and Hove 013A","E01016879",1070,85,21,64,189,157,127,67,169,102,58,45,13,116
"2011","Brighton and Hove 013B","E01016880",905,39,7,32,125,107,105,57,181,126,99,68,31,66
"2011","Brighton and Hove 013C","E01016881",1032,90,22,68,212,111,114,79,155,115,80,50,30,76
"2011","Brighton and Hove 013D","E01016887",1013,99,9,90,229,203,132,54,134,66,38,26,12,58
"2011","Brighton and Hove 013E","E01016888",1008,125,26,99,286,153,128,40,96,56,33,21,12,91
"2011","Brighton and Hove 013F","E01016976",1208,116,25,91,262,208,155,77,163,101,40,21,19,86
"2011","Brighton and Hove 014A","E01016932",1240,256,43,213,380,125,121,39,90,47,36,25,11,146
"2011","Brighton and Hove 014B","E01016933",1108,233,39,194,324,149,111,35,72,28,48,35,13,108
"2011","Brighton and Hove 014C","E01016935",1160,189,29,160,393,135,120,42,103,52,35,21,14,91
"2011","Brighton and Hove 014D","E01016936",1313,211,25,186,425,149,123,52,100,41,30,16,14,182
"2011","Brighton and Hove 014E","E01016937",1799,212,32,180,507,210,157,79,174,111,71,45,26,278
"2011","Brighton and Hove 015A","E01016890",1567,135,15,120,296,132,95,68,141,102,46,26,20,552
"2011","Brighton and Hove 015B","E01016966",1531,130,20,110,289,129,107,63,113,75,49,31,18,576
"2011","Brighton and Hove 015C","E01016970",1325,180,30,150,365,152,108,55,99,79,27,17,10,260
"2011","Brighton and Hove 015D","E01016971",1781,129,22,107,276,115,112,67,120,89,45,17,28,828
"2011","Brighton and Hove 015E","E01016972",1561,196,31,165,445,155,124,60,123,48,39,18,21,371
"2011","Brighton and Hove 016A","E01016979",1181,186,45,141,293,171,150,50,108,67,49,37,12,107
"2011","Brighton and Hove 016B","E01016990",1204,168,29,139,389,128,142,44,117,84,41,23,18,91
"2011","Brighton and Hove 016C","E01016991",1334,218,48,170,404,180,123,57,121,80,65,44,21,86
"2011","Brighton and Hove 016D","E01016996",1169,180,23,157,357,140,144,49,111,80,36,21,15,72
"2011","Brighton and Hove 017A","E01017007",1094,60,11,49,168,150,153,75,210,136,56,31,25,86
"2011","Brighton and Hove 017B","E01017008",1177,111,22,89,283,191,177,70,159,85,26,17,9,75
"2011","Brighton and Hove 017C","E01017009",1114,87,14,73,231,199,144,79,186,98,39,27,12,51
"2011","Brighton and Hove 017D","E01017010",1275,134,28,106,272,200,174,78,180,101,48,35,13,88
"2011","Brighton and Hove 017E","E01017011",975,50,14,36,153,107,97,82,193,137,67,43,24,89
"2011","Brighton and Hove 017F","E01017012",1276,114,25,89,296,195,175,73,189,116,44,29,15,74
"2011","Brighton and Hove 018A","E01016892",1329,117,29,88,323,126,118,51,104,69,36,22,14,385
"2011","Brighton and Hove 018B","E01016893",1549,193,36,157,479,141,143,62,97,58,25,7,18,351
"2011","Brighton and Hove 018C","E01016912",1637,113,14,99,303,127,104,57,153,96,40,27,13,644
"2011","Brighton and Hove 018D","E01016913",1527,86,16,70,227,128,81,62,93,80,26,15,11,744
"2011","Brighton and Hove 018E","E01016946",1113,164,33,131,374,118,109,40,89,46,36,20,16,137
"2011","Brighton and Hove 019A","E01016860",1240,173,28,145,389,153,110,72,133,87,48,21,27,75
"2011","Brighton and Hove 019B","E01016871",1430,209,46,163,412,181,154,82,151,85,57,34,23,99
"2011","Brighton and Hove 019C","E01016872",1542,222,42,180,498,205,149,92,143,72,65,34,31,96
"2011","Brighton and Hove 019D","E01016873",1450,193,42,151,418,182,171,75,154,95,73,38,35,89
"2011","Brighton and Hove 019E","E01016878",1406,250,50,200,452,167,147,43,99,60,64,52,12,124
"2011","Brighton and Hove 020A","E01016870",1212,213,41,172,425,121,124,43,90,52,42,24,18,102
"2011","Brighton and Hove 020B","E01016874",1339,258,50,208,413,175,135,46,123,50,45,29,16,94
"2011","Brighton and Hove 020C","E01016875",1205,222,35,187,416,115,128,43,95,46,41,27,14,99
"2011","Brighton and Hove 020D","E01016876",1259,203,30,173,416,155,114,44,113,55,41,29,12,118
"2011","Brighton and Hove 020E","E01016877",1419,251,48,203,464,179,132,55,107,59,55,34,21,117
"2011","Brighton and Hove 021A","E01016974",1208,131,34,97,270,182,162,88,169,86,46,27,19,74
"2011","Brighton and Hove 021B","E01016975",1088,92,23,69,220,141,122,70,182,107,62,38,24,92
"2011","Brighton and Hove 021C","E01016992",1095,212,42,170,341,133,140,38,79,49,25,20,5,78
"2011","Brighton and Hove 021D","E01016994",1234,123,23,100,406,153,173,59,125,84,49,32,17,62
"2011","Brighton and Hove 021E","E01016997",1113,188,34,154,339,155,146,40,90,48,33,24,9,74
"2011","Brighton and Hove 022A","E01016889",1553,152,24,128,359,122,94,80,120,68,30,18,12,528
"2011","Brighton and Hove 022B","E01016891",1500,129,24,105,303,146,103,81,132,79,60,27,33,467
"2011","Brighton and Hove 022C","E01016894",1646,158,31,127,372,116,132,52,114,66,52,46,6,584
"2011","Brighton and Hove 022D","E01016896",1477,165,21,144,404,142,127,45,107,63,31,21,10,393
"2011","Brighton and Hove 022E","E01016897",1419,177,29,148,408,130,141,56,105,59,31,18,13,312
"2011","Brighton and Hove 023A","E01016987",1299,221,41,180,389,156,165,51,96,45,66,42,24,110
"2011","Brighton and Hove 023B","E01016989",1188,201,43,158,363,134,142,37,112,51,61,43,18,87
"2011","Brighton and Hove 023C","E01016993",1004,95,21,74,228,120,97,55,159,105,86,63,23,59
"2011","Brighton and Hove 023D","E01016995",1165,223,42,181,366,150,157,28,81,33,36,27,9,91
"2011","Brighton and Hove 024A","E01016938",1499,241,49,192,517,178,137,59,132,57,28,12,16,150
"2011","Brighton and Hove 024B","E01016950",1442,252,49,203,505,186,145,65,94,52,20,8,12,123
"2011","Brighton and Hove 024C","E01016951",1254,184,30,154,377,152,117,56,103,80,43,21,22,142
"2011","Brighton and Hove 024D","E01016967",1736,278,41,237,523,208,171,74,144,87,43,20,23,208
"2011","Brighton and Hove 024E","E01016968",1441,270,32,238,440,141,110,81,112,50,40,14,26,197
"2011","Brighton and Hove 025A","E01016864",1054,43,12,31,162,100,107,69,211,145,96,67,29,121
"2011","Brighton and Hove 025B","E01016865",1091,15,9,6,122,110,74,71,244,200,135,87,48,120
"2011","Brighton and Hove 025C","E01016866",1000,27,5,22,119,110,98,74,204,153,123,96,27,92
"2011","Brighton and Hove 025D","E01016867",1049,51,12,39,175,112,98,72,187,161,102,82,20,91
"2011","Brighton and Hove 025E","E01016868",1114,32,11,21,125,102,110,78,263,186,117,80,37,101
"2011","Brighton and Hove 025F","E01016895",1087,52,11,41,149,110,103,77,178,157,111,83,28,150
"2011","Brighton and Hove 026A","E01016849",1350,277,51,226,444,137,185,45,90,38,35,19,16,99
"2011","Brighton and Hove 026B","E01016852",1423,178,32,146,438,159,122,85,133,82,47,21,26,179
"2011","Brighton and Hove 026C","E01016853",1621,236,25,211,558,206,165,88,120,69,42,19,23,137
"2011","Brighton and Hove 026D","E01016855",1536,264,51,213,511,179,167,81,122,64,57,36,21,91
"2011","Brighton and Hove 026E","E01016856",1308,187,34,153,386,166,157,58,130,64,57,37,20,103
"2011","Brighton and Hove 027A","E01016952",1504,142,16,126,384,123,101,84,124,75,33,20,13,438
"2011","Brighton and Hove 027B","E01016953",1393,246,35,211,447,136,126,62,94,49,36,23,13,197
"2011","Brighton and Hove 027C","E01016964",1860,112,12,100,347,161,154,100,163,131,125,78,47,567
"2011","Brighton and Hove 027E","E01016969",1752,220,35,185,477,157,147,71,116,91,52,34,18,421
"2011","Brighton and Hove 027F","E01033328",1256,186,19,167,349,129,130,48,92,48,37,20,17,237
"2011","Brighton and Hove 027G","E01033329",1758,208,32,176,406,136,89,65,88,73,63,35,28,630
"2011","Brighton and Hove 028A","E01016857",1217,177,29,148,384,157,122,56,103,63,57,39,18,98
"2011","Brighton and Hove 028B","E01016858",1256,178,20,158,447,158,138,67,97,71,42,17,25,58
"2011","Brighton and Hove 028C","E01016859",1110,203,43,160,362,126,143,49,93,50,37,20,17,47
"2011","Brighton and Hove 028D","E01016986",1206,190,31,159,375,157,156,44,97,51,67,45,22,69
"2011","Brighton and Hove 028E","E01016988",1070,172,26,146,342,124,103,31,107,71,50,32,18,70
"2011","Brighton and Hove 029A","E01016850",1558,206,35,171,490,163,175,80,122,63,39,20,19,220
"2011","Brighton and Hove 029B","E01016851",1514,270,49,221,513,158,171,65,98,67,42,14,28,130
"2011","Brighton and Hove 029C","E01016854",1487,209,27,182,447,188,128,73,123,110,77,34,43,132
"2011","Brighton and Hove 029D","E01016954",1654,231,35,196,411,174,155,96,186,105,51,28,23,245
"2011","Brighton and Hove 029E","E01016955",1579,188,24,164,421,158,188,76,161,82,41,16,25,264
"2011","Brighton and Hove 030A","E01016941",1715,175,26,149,396,150,151,101,180,154,82,54,28,326
"2011","Brighton and Hove 030B","E01016945",1511,173,24,149,423,184,148,60,116,99,49,24,25,259
"2011","Brighton and Hove 030C","E01016947",1309,73,13,60,226,171,92,87,214,179,129,91,38,138
"2011","Brighton and Hove 030D","E01016948",1384,148,24,124,381,132,144,58,135,100,45,31,14,241
"2011","Brighton and Hove 030E","E01016949",1388,133,24,109,301,131,121,65,159,123,91,67,24,264
"2011","Brighton and Hove 031A","E01016861",1420,276,46,230,462,154,167,48,92,57,50,22,28,114
"2011","Brighton and Hove 031B","E01016862",1288,225,28,197,440,99,127,42,82,50,36,17,19,187
"2011","Brighton and Hove 031C","E01016942",1171,67,17,50,211,98,119,77,186,151,79,52,27,183
"2011","Brighton and Hove 031D","E01016943",1234,174,28,146,391,138,139,46,110,48,28,12,16,160
"2011","Brighton and Hove 031E","E01016944",1351,199,26,173,427,136,152,65,133,45,30,14,16,164
"2011","Brighton and Hove 032A","E01016863",1247,128,18,110,317,134,142,66,173,130,77,44,33,80
"2011","Brighton and Hove 032B","E01016869",1392,134,26,108,349,141,173,71,166,145,75,49,26,138
"2011","Brighton and Hove 032C","E01016957",1433,263,54,209,365,143,159,42,74,50,30,23,7,307
"2011","Brighton and Hove 032D","E01016963",1535,281,29,252,500,122,174,65,107,60,46,28,18,180
"2011","Brighton and Hove 033A","E01016956",1107,129,25,104,267,188,167,63,131,62,33,13,20,67
"2011","Brighton and Hove 033B","E01016958",1216,159,32,127,323,203,172,60,128,67,34,21,13,70
"2011","Brighton and Hove 033C","E01016959",1034,200,46,154,290,143,165,30,74,33,28,17,11,71
"2011","Brighton and Hove 033D","E01016960",1220,181,27,154,376,162,169,49,121,57,33,20,13,72
"2011","Brighton and Hove 033E","E01016961",1290,155,35,120,346,218,175,57,145,61,45,28,17,88
"2011","Brighton and Hove 033F","E01016962",1227,178,46,132,352,167,201,40,102,49,19,15,4,119
"2011","Isle of Wight 001A","E01017300",1611,260,58,202,457,160,246,93,159,115,49,25,24,72
"2011","Isle of Wight 001B","E01017303",928,109,12,97,240,107,104,75,122,94,18,12,6,59
"2011","Isle of Wight 001C","E01017305",996,90,14,76,233,111,107,75,165,120,35,14,21,60
"2011","Isle of Wight 001D","E01017306",976,60,14,46,182,113,86,82,199,144,42,26,16,68
"2011","Isle of Wight 001E","E01017309",1225,97,25,72,225,146,109,126,236,172,35,20,15,79
"2011","Isle of Wight 002A","E01017301",716,97,26,71,194,109,67,52,85,60,16,8,8,36
"2011","Isle of Wight 002B","E01017302",1205,132,30,102,283,167,119,70,176,137,34,21,13,87
"2011","Isle of Wight 002C","E01017304",1010,92,29,63,232,130,99,61,176,118,35,23,12,67
"2011","Isle of Wight 002D","E01017316",1227,146,33,113,344,155,170,84,131,111,22,11,11,64
"2011","Isle of Wight 002E","E01017329",1680,194,61,133,339,243,214,127,251,167,39,23,16,106
"2011","Isle of Wight 003A","E01017307",1433,144,41,103,315,205,132,110,259,154,55,39,16,59
"2011","Isle of Wight 003B","E01017308",1240,103,29,74,224,149,116,133,209,170,56,43,13,80
"2011","Isle of Wight 003D","E01033229",1042,73,26,47,220,145,144,94,182,105,32,24,8,47
"2011","Isle of Wight 003E","E01033237",907,27,8,19,128,82,73,93,186,168,87,45,42,63
"2011","Isle of Wight 004A","E01017335",1159,74,15,59,218,113,161,88,190,149,91,50,41,75
"2011","Isle of Wight 004B","E01017336",1269,72,10,62,245,104,155,102,247,151,116,64,52,77
"2011","Isle of Wight 004C","E01017337",1218,104,27,77,284,99,146,95,194,118,81,44,37,97
"2011","Isle of Wight 004D","E01017346",1140,80,21,59,243,144,130,83,192,128,88,53,35,52
"2011","Isle of Wight 005A","E01017286",1118,190,45,145,303,131,166,60,130,74,19,9,10,45
"2011","Isle of Wight 005B","E01017287",1216,86,26,60,280,179,131,106,228,108,29,13,16,69
"2011","Isle of Wight 005C","E01017367",1374,135,26,109,352,178,179,100,195,122,34,16,18,79
"2011","Isle of Wight 005D","E01017368",1084,89,22,67,240,132,124,91,187,136,36,20,16,49
"2011","Isle of Wight 006A","E01017282",1017,62,19,43,197,127,142,79,200,108,40,23,17,62
"2011","Isle of Wight 006B","E01017283",1128,103,26,77,252,133,167,101,168,111,35,21,14,58
"2011","Isle of Wight 006C","E01017338",976,86,22,64,199,118,132,62,151,90,82,62,20,56
"2011","Isle of Wight 006D","E01017341",1058,52,12,40,155,129,113,83,234,161,68,40,28,63
"2011","Isle of Wight 006E","E01017342",1231,96,25,71,269,146,117,84,208,159,66,38,28,86
"2011","Isle of Wight 007A","E01017339",1206,64,16,48,193,138,136,98,256,133,77,48,29,111
"2011","Isle of Wight 007B","E01017340",1243,54,17,37,213,131,126,109,288,180,65,35,30,77
"2011","Isle of Wight 007C","E01017343",943,49,9,40,151,93,99,94,201,122,65,38,27,69
"2011","Isle of Wight 007D","E01017344",1159,99,34,65,242,177,165,106,170,105,45,29,16,50
"2011","Isle of Wight 007E","E01017345",1364,55,16,39,195,118,114,126,303,230,112,52,60,111
"2011","Isle of Wight 008A","E01017310",937,59,13,46,209,123,150,66,145,89,36,28,8,60
"2011","Isle of Wight 008B","E01017311",1159,80,23,57,212,158,99,100,231,166,46,23,23,67
"2011","Isle of Wight 008C","E01017331",1013,48,12,36,173,108,98,85,224,154,86,46,40,37
"2011","Isle of Wight 008D","E01017332",896,22,4,18,108,95,54,88,217,184,76,41,35,52
"2011","Isle of Wight 008E","E01017334",1470,124,28,96,223,133,164,180,250,243,89,79,10,64
"2011","Isle of Wight 009A","E01017295",932,41,14,27,178,116,72,86,211,126,40,28,12,62
"2011","Isle of Wight 009B","E01017325",952,38,10,28,167,126,76,72,205,145,61,30,31,62
"2011","Isle of Wight 009C","E01017326",1129,56,13,43,199,122,110,105,240,180,50,25,25,67
"2011","Isle of Wight 009D","E01017328",1058,39,14,25,184,126,80,85,261,149,69,48,21,65
"2011","Isle of Wight 009E","E01017333",2406,112,32,80,330,207,296,265,425,427,218,184,34,126
"2011","Isle of Wight 010A","E01017284",1154,121,46,75,323,163,176,66,141,70,30,16,14,64
"2011","Isle of Wight 010B","E01017285",1328,125,27,98,318,173,212,93,202,117,41,17,24,47
"2011","Isle of Wight 010C","E01017288",867,76,18,58,193,113,141,58,130,87,23,13,10,46
"2011","Isle of Wight 010D","E01017351",1011,124,26,98,247,141,172,52,132,65,31,19,12,47
"2011","Isle of Wight 010E","E01017352",788,88,16,72,209,117,114,42,115,52,14,8,6,37
"2011","Isle of Wight 011A","E01017292",1171,100,28,72,255,155,94,112,218,127,33,22,11,77
"2011","Isle of Wight 011B","E01017293",1396,116,40,76,353,228,105,107,219,139,24,12,12,105
"2011","Isle of Wight 011C","E01017296",952,100,29,71,216,135,163,75,109,72,29,19,10,53
"2011","Isle of Wight 011D","E01017321",872,71,17,54,189,87,106,69,166,108,25,17,8,51
"2011","Isle of Wight 011E","E01017322",1072,41,13,28,156,120,104,105,238,157,64,35,29,87
"2011","Isle of Wight 011F","E01017327",1181,78,17,61,235,159,132,97,212,150,50,30,20,68
"2011","Isle of Wight 012A","E01017312",1089,72,20,52,187,132,172,98,218,126,38,22,16,46
"2011","Isle of Wight 012D","E01017315",1020,56,16,40,153,97,129,94,225,148,47,32,15,71
"2011","Isle of Wight 012E","E01017354",825,118,35,83,185,96,167,76,84,49,21,13,8,29
"2011","Isle of Wight 012F","E01017361",934,80,22,58,235,97,175,63,123,95,29,16,13,37
"2011","Isle of Wight 012G","E01017362",1078,62,20,42,194,115,188,91,198,130,37,23,14,63
"2011","Isle of Wight 012H","E01033239",1616,154,41,113,370,218,261,129,234,140,49,28,21,61
"2011","Isle of Wight 013A","E01017290",1006,102,30,72,235,117,201,54,142,87,26,9,17,42
"2011","Isle of Wight 013B","E01017291",801,90,26,64,217,101,116,44,116,61,15,10,5,41
"2011","Isle of Wight 013C","E01017294",1171,111,35,76,287,148,186,87,175,83,23,14,9,71
"2011","Isle of Wight 013D","E01017353",933,117,39,78,225,125,166,54,124,70,20,13,7,32
"2011","Isle of Wight 014A","E01017289",1482,108,30,78,279,154,227,136,268,175,72,38,34,63
"2011","Isle of Wight 014B","E01017347",1174,40,15,25,209,124,153,124,232,164,54,28,26,74
"2011","Isle of Wight 014C","E01017348",1010,43,12,31,188,105,149,93,157,136,59,34,25,80
"2011","Isle of Wight 014D","E01017349",1580,75,21,54,292,176,239,167,273,196,68,33,35,94
"2011","Isle of Wight 014E","E01017350",1349,55,15,40,244,141,143,111,303,184,77,47,30,91
"2011","Isle of Wight 015A","E01017317",1098,57,14,43,214,124,160,84,208,145,43,20,23,63
"2011","Isle of Wight 015B","E01017320",742,38,7,31,119,118,111,39,153,89,28,11,17,47
"2011","Isle of Wight 015C","E01017323",880,101,33,68,204,108,161,55,135,68,14,10,4,34
"2011","Isle of Wight 015D","E01017324",1093,64,18,46,232,142,188,91,167,110,37,20,17,62
"2011","Isle of Wight 015E","E01017355",1112,69,15,54,231,144,159,85,201,118,28,12,16,77
"2011","Isle of Wight 015F","E01017358",906,63,17,46,161,115,116,75,180,103,42,25,17,51
"2011","Isle of Wight 016A","E01017318",856,33,7,26,134,83,72,78,182,154,55,32,23,65
"2011","Isle of Wight 016B","E01017319",876,57,21,36,139,118,123,68,165,105,49,22,27,52
"2011","Isle of Wight 016C","E01017356",1090,56,17,39,188,114,184,93,195,138,52,29,23,70
"2011","Isle of Wight 016D","E01017357",1082,54,14,40,189,98,158,85,195,153,73,48,25,77
"2011","Isle of Wight 016E","E01017359",1089,96,23,73,209,131,173,79,177,100,69,49,20,55
"2011","Isle of Wight 016F","E01017360",1270,66,21,45,228,103,244,118,207,174,77,46,31,53
"2011","Isle of Wight 017A","E01017297",1047,114,31,83,227,119,188,80,133,101,22,17,5,63
"2011","Isle of Wight 017B","E01017298",1067,97,27,70,254,149,170,73,171,85,13,6,7,55
"2011","Isle of Wight 017C","E01017299",927,87,22,65,226,90,165,65,122,72,30,16,14,70
"2011","Isle of Wight 017D","E01017369",1048,83,27,56,197,134,197,75,182,117,20,13,7,43
"2011","Isle of Wight 018A","E01017363",1167,66,11,55,207,110,226,88,210,139,62,38,24,59
"2011","Isle of Wight 018B","E01017364",1078,85,22,63,250,99,225,82,165,91,39,22,17,42
"2011","Isle of Wight 018C","E01017365",1017,122,43,79,277,113,199,57,119,71,30,16,14,29
"2011","Isle of Wight 018D","E01017366",1064,44,13,31,168,97,136,110,210,165,62,35,27,72
"2011","Isle of Wight 018E","E01017370",1327,67,16,51,257,152,184,105,253,181,59,38,21,69
"2011","Medway 001A","E01016070",1256,80,26,54,238,178,141,104,219,204,47,27,20,45
"2011","Medway 001B","E01016071",1212,50,12,38,203,159,111,114,224,239,50,30,20,62
"2011","Medway 001C","E01016072",967,63,20,43,177,133,128,86,135,143,48,37,11,54
"2011","Medway 001D","E01016074",1282,90,27,63,215,187,168,112,216,182,67,44,23,45
"2011","Medway 002A","E01016142",975,88,31,57,200,162,140,78,134,99,25,15,10,49
"2011","Medway 002B","E01016144",1142,108,39,69,258,192,137,89,152,85,39,28,11,82
"2011","Medway 002C","E01016145",994,92,24,68,205,204,115,76,114,90,33,16,17,65
"2011","Medway 002D","E01016149",1023,55,18,37,197,131,116,101,182,161,37,23,14,43
"2011","Medway 003A","E01016073",1526,182,54,128,385,246,162,119,177,129,37,22,15,89
"2011","Medway 003B","E01016075",1075,57,17,40,182,172,79,107,186,185,45,28,17,62
"2011","Medway 003C","E01016076",1785,137,44,93,385,294,162,168,264,196,57,40,17,122
"2011","Medway 003D","E01016077",1063,59,26,33,170,135,79,112,186,187,67,51,16,68
"2011","Medway 003E","E01016143",1677,185,41,144,375,264,179,141,203,176,61,33,28,93
"2011","Medway 004A","E01016146",1440,107,30,77,281,201,133,121,229,205,64,46,18,99
"2011","Medway 004B","E01016147",1357,118,17,101,277,257,116,118,208,146,50,30,20,67
"2011","Medway 004C","E01016148",1452,160,32,128,363,248,175,95,196,93,48,36,12,74
"2011","Medway 005A","E01016133",1024,82,26,56,239,208,109,66,128,87,20,14,6,85
"2011","Medway 005B","E01016134",1064,98,23,75,236,181,104,69,145,109,43,24,19,79
"2011","Medway 005C","E01016138",1122,88,22,66,253,196,111,87,184,94,35,19,16,74
"2011","Medway 005D","E01016139",1194,90,21,69,257,204,116,96,181,119,42,22,20,89
"2011","Medway 006A","E01016135",1115,78,17,61,183,154,113,91,228,142,53,31,22,73
"2011","Medway 006B","E01016136",1097,67,19,48,175,154,95,100,200,136,82,49,33,88
"2011","Medway 006C","E01016137",1150,59,19,40,206,156,85,119,219,183,67,34,33,56
"2011","Medway 006D","E01016140",1087,70,23,47,196,141,97,87,171,170,90,56,34,65
"2011","Medway 006E","E01016141",1228,81,19,62,205,183,111,107,224,158,72,46,26,87
"2011","Medway 007A","E01016035",1390,60,18,42,191,174,101,78,215,177,122,77,45,272
"2011","Medway 007D","E01016112",2152,377,100,277,610,328,186,116,165,114,56,38,18,200
"2011","Medway 007E","E01032798",2871,272,121,151,555,606,140,156,273,240,147,99,48,482
"2011","Medway 008A","E01016151",1218,69,18,51,212,160,116,116,223,172,64,42,22,86
"2011","Medway 008B","E01016152",1104,70,22,48,155,146,93,101,204,167,104,66,38,64
"2011","Medway 008C","E01016153",999,38,11,27,117,129,77,95,189,201,89,53,36,64
"2011","Medway 008D","E01016155",1121,45,16,29,150,141,103,118,244,169,89,65,24,62
"2011","Medway 009A","E01016033",810,15,5,10,80,81,49,52,170,164,87,57,30,112
"2011","Medway 009B","E01016036",2054,59,15,44,174,131,77,100,212,170,84,55,29,1047
"2011","Medway 009C","E01016037",1316,62,10,52,180,139,98,91,189,179,76,45,31,302
"2011","Medway 009D","E01016039",1247,49,10,39,174,159,94,104,194,205,94,59,35,174
"2011","Medway 010A","E01016030",1274,70,15,55,211,197,112,98,226,169,94,60,34,97
"2011","Medway 010B","E01016032",889,23,8,15,106,92,58,72,159,185,103,66,37,91
"2011","Medway 010C","E01016034",1895,169,44,125,397,263,188,151,291,209,72,51,21,155
"2011","Medway 010D","E01016038",1064,56,8,48,178,134,83,88,185,184,73,46,27,83
"2011","Medway 011A","E01016150",1130,38,12,26,157,134,97,106,231,205,88,62,26,74
"2011","Medway 011B","E01016154",1209,61,16,45,205,162,131,108,205,193,75,39,36,69
"2011","Medway 011C","E01016156",1220,63,20,43,215,191,128,114,195,188,56,27,29,70
"2011","Medway 011D","E01016157",1428,84,25,59,269,212,131,120,233,216,64,39,25,99
"2011","Medway 011E","E01016158",1554,83,23,60,283,251,135,141,286,199,89,52,37,87
"2011","Medway 012A","E01016031",1270,51,14,37,172,138,85,108,203,218,140,99,41,155
"2011","Medway 012B","E01016041",1257,72,8,64,194,174,88,112,217,176,81,51,30,143
"2011","Medway 012C","E01016045",1234,79,13,66,205,160,91,94,206,177,84,47,37,138
"2011","Medway 012D","E01016049",1424,54,13,41,211,158,105,125,231,216,125,80,45,199
"2011","Medway 013A","E01016040",1281,70,26,44,208,154,103,98,233,176,104,65,39,135
"2011","Medway 013B","E01016042",1064,44,16,28,170,135,82,84,190,182,83,41,42,94
"2011","Medway 013C","E01016043",1043,55,8,47,199,149,107,78,181,123,72,50,22,79
"2011","Medway 013D","E01016177",1127,62,16,46,194,176,120,84,199,155,49,28,21,88
"2011","Medway 013E","E01016178",1046,89,18,71,211,154,96,78,173,117,55,35,20,73
"2011","Medway 014A","E01016117",1342,93,19,74,263,174,100,94,166,167,126,73,53,159
"2011","Medway 014B","E01016129",1486,202,49,153,386,206,109,104,156,154,88,54,34,81
"2011","Medway 014C","E01016130",1452,217,41,176,446,157,134,78,135,93,60,37,23,132
"2011","Medway 014D","E01016131",1234,194,36,158,386,170,106,70,108,62,38,22,16,100
"2011","Medway 015A","E01016016",1158,66,19,47,175,139,98,73,183,197,107,72,35,120
"2011","Medway 015B","E01016017",1306,80,18,62,183,131,79,74,215,214,124,76,48,206
"2011","Medway 015C","E01016019",1308,59,14,45,186,114,130,97,204,227,135,95,40,156
"2011","Medway 015D","E01016110",1801,136,19,117,288,146,130,95,185,166,86,46,40,569
"2011","Medway 015E","E01016111",895,32,15,17,159,80,50,62,139,173,136,90,46,64
"2011","Medway 016A","E01016044",1258,80,15,65,216,168,100,99,203,187,81,47,34,124
"2011","Medway 016B","E01016046",1133,47,8,39,222,153,107,99,188,154,69,37,32,94
"2011","Medway 016C","E01016047",1262,48,5,43,223,173,91,101,200,170,95,57,38,161
"2011","Medway 016D","E01016048",1250,64,16,48,238,181,103,102,202,184,71,45,26,105
"2011","Medway 017A","E01016113",1098,109,33,76,233,167,99,79,152,134,50,33,17,75
"2011","Medway 017B","E01016114",1196,82,21,61,259,153,104,77,176,143,85,55,30,117
"2011","Medway 017C","E01016115",1384,60,15,45,241,209,117,124,259,200,69,40,29,105
"2011","Medway 017D","E01016118",1344,106,25,81,306,196,113,113,194,130,59,30,29,127
"2011","Medway 018A","E01016160",1021,37,9,28,135,113,103,79,218,174,86,68,18,76
"2011","Medway 018B","E01016161",1071,33,8,25,138,127,85,103,241,188,90,62,28,66
"2011","Medway 018C","E01016162",1198,81,19,62,210,188,118,105,211,171,43,30,13,71
"2011","Medway 018D","E01016163",959,52,11,41,156,135,81,91,169,166,42,26,16,67
"2011","Medway 018E","E01016164",1037,34,11,23,143,151,95,97,224,179,47,29,18,67
"2011","Medway 018F","E01016165",928,69,21,48,181,140,98,76,162,92,47,33,14,63
"2011","Medway 019A","E01016159",940,32,14,18,111,105,88,88,175,172,93,63,30,76
"2011","Medway 019B","E01016174",1056,91,23,68,227,133,93,69,154,134,58,38,20,97
"2011","Medway 019C","E01016175",1381,146,26,120,319,240,163,88,172,121,39,27,12,93
"2011","Medway 019D","E01016179",1028,90,23,67,249,162,106,70,147,77,33,23,10,94
"2011","Medway 020A","E01016061",1255,47,7,40,158,155,99,92,232,244,124,74,50,104
"2011","Medway 020B","E01016063",1180,39,8,31,133,116,102,96,228,247,123,77,46,96
"2011","Medway 020C","E01016064",1092,62,15,47,178,120,89,100,185,175,96,53,43,87
"2011","Medway 020D","E01016069",1334,49,11,38,175,106,119,92,231,285,171,106,65,106
"2011","Medway 021A","E01016020",900,58,11,47,154,105,75,65,158,113,73,50,23,99
"2011","Medway 021B","E01016021",1139,75,15,60,171,158,91,88,205,172,71,44,27,108
"2011","Medway 021C","E01016022",1061,66,8,58,146,106,74,71,185,150,98,73,25,165
"2011","Medway 021D","E01016125",1308,97,26,71,279,209,106,96,182,166,60,35,25,113
"2011","Medway 022A","E01016018",1385,82,18,64,211,169,100,125,226,263,117,67,50,92
"2011","Medway 022B","E01016023",1096,32,13,19,112,76,87,74,205,239,162,119,43,109
"2011","Medway 022C","E01016024",1371,57,13,44,192,179,92,114,201,269,129,66,63,138
"2011","Medway 022D","E01016062",1093,34,9,25,158,143,85,103,201,170,112,80,32,87
"2011","Medway 023A","E01016093",1114,131,45,86,281,204,144,81,133,70,17,11,6,53
"2011","Medway 023B","E01016096",990,88,27,61,196,178,101,74,162,105,29,21,8,57
"2011","Medway 023C","E01016166",1078,78,20,58,210,211,99,92,164,135,34,22,12,55
"2011","Medway 023D","E01016167",1039,74,22,52,193,156,107,79,194,133,41,25,16,62
"2011","Medway 024A","E01016116",1272,73,15,58,217,168,109,112,246,191,68,51,17,88
"2011","Medway 024B","E01016127",1115,86,22,64,264,175,138,78,151,107,46,27,19,70
"2011","Medway 024C","E01016128",1608,68,17,51,218,188,119,104,217,194,363,332,31,137
"2011","Medway 024D","E01016132",1228,148,36,112,331,187,119,82,146,85,32,20,12,98
"2011","Medway 025A","E01016094",1093,90,31,59,253,224,93,97,157,92,24,14,10,63
"2011","Medway 025B","E01016095",940,109,19,90,242,155,73,75,141,65,25,15,10,55
"2011","Medway 025C","E01016097",1073,73,9,64,194,163,95,108,183,126,60,30,30,71
"2011","Medway 025D","E01016098",983,63,10,53,150,155,81,91,159,153,69,49,20,62
"2011","Medway 025E","E01016102",1081,57,14,43,177,147,94,71,222,149,89,55,34,75
"2011","Medway 026A","E01016119",1095,121,32,89,245,186,107,70,124,95,55,36,19,92
"2011","Medway 026B","E01016120",988,36,8,28,174,126,83,94,162,191,67,39,28,55
"2011","Medway 026C","E01016124",1224,102,16,86,300,181,119,87,177,121,55,38,17,82
"2011","Medway 026D","E01016126",1218,118,30,88,278,234,122,94,128,99,38,28,10,107
"2011","Medway 027A","E01016025",1035,83,16,67,154,134,104,85,145,160,95,70,25,75
"2011","Medway 027B","E01016065",1071,70,28,42,187,183,100,99,211,138,32,18,14,51
"2011","Medway 027C","E01016066",1123,58,12,46,173,135,95,94,219,182,81,51,30,86
"2011","Medway 027D","E01016067",1170,56,14,42,191,151,119,89,201,182,84,42,42,97
"2011","Medway 027E","E01016068",1141,56,16,40,142,138,98,92,197,213,126,90,36,79
"2011","Medway 028A","E01016026",921,90,28,62,235,152,104,75,107,81,22,15,7,55
"2011","Medway 028B","E01016027",1165,122,34,88,299,208,132,89,134,87,27,17,10,67
"2011","Medway 028C","E01016028",1018,114,34,80,230,178,104,94,143,89,16,10,6,50
"2011","Medway 028D","E01016029",967,78,21,57,182,146,101,83,149,124,36,17,19,68
"2011","Medway 029A","E01016087",1245,141,29,112,292,224,135,90,153,100,45,30,15,65
"2011","Medway 029B","E01016088",1109,100,22,78,189,180,112,86,176,134,60,36,24,72
"2011","Medway 029C","E01016089",1119,102,18,84,278,183,101,75,165,85,38,25,13,92
"2011","Medway 029D","E01016090",1080,80,26,54,246,223,108,84,160,80,25,16,9,74
"2011","Medway 030A","E01016085",1196,150,51,99,284,196,154,74,165,73,28,15,13,72
"2011","Medway 030B","E01016086",960,143,53,90,263,156,99,51,103,58,17,10,7,70
"2011","Medway 030C","E01016091",1136,116,24,92,295,206,109,74,144,79,36,26,10,77
"2011","Medway 030D","E01016176",1155,147,36,111,292,193,144,80,114,69,21,9,12,95
"2011","Medway 031A","E01016058",1133,81,20,61,265,214,121,87,157,122,33,15,18,53
"2011","Medway 031B","E01016059",956,31,7,24,150,116,88,76,191,165,71,38,33,68
"2011","Medway 031C","E01016079",1039,93,26,67,229,161,105,67,169,111,39,24,15,65
"2011","Medway 031D","E01016083",933,30,7,23,118,101,85,72,200,167,95,72,23,65
"2011","Medway 031E","E01016084",1069,50,13,37,186,142,93,80,186,175,76,55,21,81
"2011","Medway 032A","E01016101",1098,86,18,68,221,212,115,79,179,97,24,17,7,85
"2011","Medway 032B","E01016103",1127,117,30,87,245,225,156,78,131,93,22,15,7,60
"2011","Medway 032C","E01016104",1090,113,25,88,255,220,106,84,158,76,24,11,13,54
"2011","Medway 032D","E01016107",1171,134,36,98,270,243,125,80,146,96,14,7,7,63
"2011","Medway 033A","E01016121",1096,84,24,60,200,202,111,99,179,130,36,20,16,55
"2011","Medway 033B","E01016122",1093,93,19,74,229,175,130,86,164,89,35,20,15,92
"2011","Medway 033C","E01016123",1164,72,19,53,200,228,128,94,188,144,41,20,21,69
"2011","Medway 033D","E01016173",1133,55,8,47,214,147,124,93,200,148,81,47,34,71
"2011","Medway 034A","E01016078",1156,95,18,77,269,230,89,107,177,110,35,21,14,44
"2011","Medway 034B","E01016080",1095,97,27,70,202,215,102,104,176,107,36,18,18,56
"2011","Medway 034C","E01016081",1181,102,27,75,310,212,108,89,159,84,35,19,16,82
"2011","Medway 034D","E01016082",1185,100,31,69,248,193,125,93,190,115,38,26,12,83
"2011","Medway 035A","E01016050",1305,171,29,142,326,233,147,89,160,79,24,12,12,76
"2011","Medway 035B","E01016051",1142,189,42,147,266,209,121,58,111,71,40,29,11,77
"2011","Medway 035C","E01016052",1244,190,44,146,320,227,148,58,131,74,29,18,11,67
"2011","Medway 035D","E01016053",1103,141,35,106,267,196,138,64,132,78,20,14,6,67
"2011","Medway 035E","E01016054",1150,171,42,129,298,201,119,72,149,64,21,11,10,55
"2011","Medway 036A","E01016092",1147,79,20,59,257,228,125,89,187,99,20,13,7,63
"2011","Medway 036B","E01016099",1129,71,20,51,235,237,115,95,186,99,30,17,13,61
"2011","Medway 036C","E01016100",1157,88,22,66,231,200,120,91,171,138,46,30,16,72
"2011","Medway 036D","E01016105",1014,93,22,71,235,171,113,74,150,82,29,11,18,67
"2011","Medway 036E","E01016106",1029,80,21,59,208,199,104,90,176,84,26,12,14,62
"2011","Medway 037A","E01016168",1145,70,14,56,213,173,123,84,196,155,70,44,26,61
"2011","Medway 037B","E01016169",1324,128,34,94,294,228,125,109,191,106,32,18,14,111
"2011","Medway 037C","E01016171",1093,53,14,39,164,111,100,117,216,182,80,49,31,70
"2011","Medway 037D","E01016172",1052,121,29,92,267,189,99,82,130,73,28,16,12,63
"2011","Medway 038A","E01016055",1147,60,13,47,208,168,136,91,187,173,53,27,26,71
"2011","Medway 038B","E01016056",1047,74,19,55,211,186,99,109,156,121,40,17,23,51
"2011","Medway 038C","E01016057",1267,93,22,71,238,194,128,125,211,167,43,27,16,68
"2011","Medway 038D","E01016060",1260,111,22,89,256,230,124,116,179,124,30,15,15,90
"2011","Medway 038E","E01016170",1196,80,18,62,213,171,109,122,213,179,34,22,12,75
"2011","Milton Keynes 001A","E01016796",1099,200,34,166,307,160,137,64,99,59,15,5,10,58
"2011","Milton Keynes 001B","E01016797",1236,214,58,156,362,164,155,55,115,71,30,17,13,70
"2011","Milton Keynes 001C","E01016798",1381,312,65,247,426,188,114,47,113,54,13,3,10,114
"2011","Milton Keynes 001D","E01016799",1331,237,46,191,363,176,151,70,149,105,23,12,11,57
"2011","Milton Keynes 001E","E01016800",1213,215,54,161,342,155,160,60,108,91,26,15,11,56
"2011","Milton Keynes 002A","E01016759",1018,155,34,121,220,168,103,67,127,112,33,18,15,33
"2011","Milton Keynes 002B","E01016760",1733,311,67,244,490,290,164,90,164,94,49,23,26,81
"2011","Milton Keynes 002C","E01016761",1045,190,50,140,291,135,138,56,101,68,13,7,6,53
"2011","Milton Keynes 002D","E01016801",990,160,49,111,263,133,134,48,104,70,28,18,10,50
"2011","Milton Keynes 002E","E01016802",1042,204,48,156,307,137,153,50,70,44,23,15,8,54
"2011","Milton Keynes 002F","E01016803",979,181,54,127,235,153,146,48,85,67,21,13,8,43
"2011","Milton Keynes 003A","E01016786",1051,91,21,70,239,159,122,96,153,137,12,4,8,42
"2011","Milton Keynes 003B","E01016787",1117,103,24,79,231,181,79,83,186,146,42,26,16,66
"2011","Milton Keynes 003C","E01016788",1230,145,39,106,286,215,116,88,175,89,21,12,9,95
"2011","Milton Keynes 003D","E01016789",1005,105,27,78,238,198,90,87,120,83,12,5,7,72
"2011","Milton Keynes 003E","E01016790",1001,104,25,79,254,176,79,79,136,104,17,8,9,52
"2011","Milton Keynes 004A","E01016791",1075,140,32,108,268,209,97,63,124,99,9,5,4,66
"2011","Milton Keynes 004B","E01016792",982,130,33,97,237,170,87,69,110,90,20,10,10,69
"2011","Milton Keynes 004C","E01016793",1453,165,38,127,371,275,117,112,175,122,28,16,12,88
"2011","Milton Keynes 004D","E01016794",1135,154,34,120,305,191,115,76,116,93,36,13,23,49
"2011","Milton Keynes 004E","E01016795",1204,141,25,116,312,190,123,80,138,117,39,21,18,64
"2011","Milton Keynes 005A","E01016762",970,120,21,99,272,124,62,51,120,111,44,24,20,66
"2011","Milton Keynes 005B","E01016764",1122,163,32,131,279,213,96,76,131,91,21,5,16,52
"2011","Milton Keynes 005C","E01016766",1025,106,20,86,187,176,73,83,152,116,55,45,10,77
"2011","Milton Keynes 005D","E01016767",1038,176,36,140,292,191,91,61,83,57,17,7,10,70
"2011","Milton Keynes 005E","E01016771",958,74,11,63,201,147,77,59,149,112,63,43,20,76
"2011","Milton Keynes 006A","E01016806",1338,57,11,46,211,162,79,102,254,253,109,65,44,111
"2011","Milton Keynes 006B","E01016807",1273,83,14,69,201,188,104,106,230,183,75,43,32,103
"2011","Milton Keynes 006C","E01016809",1038,82,20,62,186,159,81,90,154,146,51,26,25,89
"2011","Milton Keynes 006D","E01016835",1166,90,22,68,203,142,88,103,204,166,94,54,40,76
"2011","Milton Keynes 007A","E01016763",1037,145,30,115,232,177,75,67,137,117,28,18,10,59
"2011","Milton Keynes 007B","E01016769",1036,218,39,179,265,159,82,53,96,70,30,14,16,63
"2011","Milton Keynes 007C","E01016770",1294,150,28,122,312,207,97,89,166,112,70,54,16,91
"2011","Milton Keynes 007D","E01016773",1296,192,39,153,309,228,110,72,160,99,37,33,4,89
"2011","Milton Keynes 008A","E01016836",1224,125,25,100,262,176,120,100,159,123,73,57,16,86
"2011","Milton Keynes 008B","E01016837",1353,168,28,140,263,180,133,73,178,132,101,81,20,125
"2011","Milton Keynes 008C","E01016838",1096,98,25,73,212,133,88,86,183,155,71,50,21,70
"2011","Milton Keynes 008D","E01016841",1586,187,47,140,372,249,104,129,237,154,88,45,43,66
"2011","Milton Keynes 009A","E01016721",1203,73,12,61,177,145,85,94,209,213,83,44,39,124
"2011","Milton Keynes 009B","E01016765",1156,136,23,113,276,161,92,84,156,124,58,37,21,69
"2011","Milton Keynes 009C","E01016772",975,81,26,55,184,143,56,74,141,140,81,54,27,75
"2011","Milton Keynes 009D","E01016804",1166,73,14,59,203,173,84,76,198,182,89,49,40,88
"2011","Milton Keynes 010A","E01016812",1188,130,21,109,270,184,117,101,156,138,42,22,20,50
"2011","Milton Keynes 010B","E01016817",1166,143,20,123,252,185,91,90,147,124,71,46,25,63
"2011","Milton Keynes 010C","E01016818",1266,259,49,210,340,195,123,64,104,102,34,17,17,45
"2011","Milton Keynes 010D","E01016840",1927,208,41,167,448,316,143,157,294,176,99,66,33,86
"2011","Milton Keynes 011A","E01016719",1128,104,24,80,253,206,87,78,165,129,38,27,11,68
"2011","Milton Keynes 011B","E01016722",1260,149,34,115,279,217,114,78,178,117,36,19,17,92
"2011","Milton Keynes 011C","E01016805",1102,168,30,138,291,207,94,68,119,72,21,10,11,62
"2011","Milton Keynes 011D","E01016808",1033,119,26,93,220,212,87,76,127,83,39,23,16,70
"2011","Milton Keynes 012A","E01016810",933,42,10,32,127,116,71,66,191,152,107,71,36,61
"2011","Milton Keynes 012B","E01016811",966,36,10,26,109,90,49,78,175,209,141,79,62,79
"2011","Milton Keynes 012C","E01016819",796,32,11,21,73,98,80,70,127,161,83,49,34,72
"2011","Milton Keynes 012D","E01016839",1088,46,11,35,120,139,54,90,241,206,100,52,48,92
"2011","Milton Keynes 013A","E01016717",1158,80,15,65,217,190,79,91,196,168,61,36,25,76
"2011","Milton Keynes 013B","E01016720",1032,50,7,43,166,140,71,84,184,185,82,55,27,70
"2011","Milton Keynes 013C","E01016723",1322,186,34,152,296,229,101,62,151,118,71,48,23,108
"2011","Milton Keynes 013D","E01016724",1316,108,15,93,244,194,92,91,202,184,87,55,32,114
"2011","Milton Keynes 014A","E01016718",1184,46,5,41,140,110,66,108,201,250,133,91,42,130
"2011","Milton Keynes 014B","E01016729",1588,86,6,80,208,151,91,126,270,326,151,91,60,179
"2011","Milton Keynes 014D","E01016768",1673,210,41,169,383,199,134,126,200,205,92,59,33,124
"2011","Milton Keynes 014E","E01033499",1196,167,10,157,250,130,65,80,152,165,106,51,55,81
"2011","Milton Keynes 014F","E01033500",1249,316,41,275,393,169,57,50,90,54,49,31,18,71
"2011","Milton Keynes 015A","E01016776",1149,182,41,141,291,177,75,61,132,85,38,27,11,108
"2011","Milton Keynes 015B","E01016813",1112,162,29,133,215,172,67,100,142,119,52,27,25,83
"2011","Milton Keynes 015C","E01016815",978,104,15,89,219,190,74,69,127,98,31,17,14,66
"2011","Milton Keynes 015D","E01016816",1122,158,35,123,319,210,99,56,105,64,35,22,13,76
"2011","Milton Keynes 016A","E01016731",1146,162,29,133,246,143,90,77,155,140,65,46,19,68
"2011","Milton Keynes 016B","E01016732",1100,138,34,104,262,144,86,72,146,122,57,42,15,73
"2011","Milton Keynes 016D","E01016784",1260,155,24,131,264,172,95,93,184,153,55,23,32,89
"2011","Milton Keynes 016E","E01033501",1447,241,36,205,412,189,102,81,113,107,48,26,22,154
"2011","Milton Keynes 016F","E01033506",1440,281,51,230,407,225,90,65,121,93,36,19,17,122
"2011","Milton Keynes 017A","E01016783",1360,192,35,157,323,232,69,87,166,136,61,45,16,94
"2011","Milton Keynes 017C","E01016820",1206,211,44,167,288,166,101,55,132,94,52,34,18,107
"2011","Milton Keynes 017D","E01016821",978,141,26,115,247,144,62,53,136,95,34,24,10,66
"2011","Milton Keynes 017E","E01016823",1320,177,29,148,297,215,68,91,154,159,59,30,29,100
"2011","Milton Keynes 017F","E01033503",1126,254,61,193,321,147,101,59,95,61,26,12,14,62
"2011","Milton Keynes 017G","E01033508",1238,238,52,186,347,198,103,63,113,75,36,25,11,65
"2011","Milton Keynes 017H","E01033509",1176,179,26,153,312,183,69,68,127,94,61,38,23,83
"2011","Milton Keynes 017I","E01033511",1138,142,23,119,326,155,73,57,104,111,53,30,23,117
"2011","Milton Keynes 017J","E01033512",1199,294,72,222,327,185,86,46,107,54,28,22,6,72
"2011","Milton Keynes 018A","E01016726",1246,47,13,34,147,138,67,105,198,249,154,85,69,141
"2011","Milton Keynes 018B","E01016733",1300,50,7,43,154,101,76,135,221,256,134,93,41,173
"2011","Milton Keynes 018C","E01016845",1316,90,9,81,145,119,75,96,249,267,178,120,58,97
"2011","Milton Keynes 018D","E01016846",1205,66,14,52,209,143,75,95,239,211,84,64,20,83
"2011","Milton Keynes 018E","E01016848",1096,51,14,37,156,156,68,106,183,210,110,94,16,56
"2011","Milton Keynes 019B","E01016780",1283,177,28,149,292,221,125,81,159,95,39,22,17,94
"2011","Milton Keynes 019C","E01016781",1111,259,45,214,311,172,71,38,86,45,22,16,6,107
"2011","Milton Keynes 019D","E01016814",1241,236,43,193,313,182,118,76,129,106,27,16,11,54
"2011","Milton Keynes 019E","E01033505",1395,192,35,157,334,160,156,99,136,143,115,96,19,60
"2011","Milton Keynes 019F","E01033522",1069,158,25,133,284,182,72,50,110,78,50,40,10,85
"2011","Milton Keynes 019G","E01033523",1031,170,33,137,300,150,83,51,86,64,45,31,14,82
"2011","Milton Keynes 019H","E01033525",1195,151,35,116,303,181,97,69,136,99,50,33,17,109
"2011","Milton Keynes 020A","E01016774",1283,295,53,242,343,197,117,46,99,71,23,17,6,92
"2011","Milton Keynes 020B","E01016775",1280,211,38,173,319,180,100,78,135,107,33,20,13,117
"2011","Milton Keynes 020C","E01016777",1210,142,27,115,273,206,70,90,168,109,93,66,27,59
"2011","Milton Keynes 020D","E01016778",1286,188,31,157,290,209,92,85,152,122,63,35,28,85
"2011","Milton Keynes 021A","E01016725",1207,80,7,73,230,124,75,83,191,203,128,79,49,93
"2011","Milton Keynes 021B","E01016727",1313,123,20,103,229,208,100,110,178,164,79,64,15,122
"2011","Milton Keynes 021C","E01016728",1482,167,17,150,319,208,102,108,174,165,105,80,25,134
"2011","Milton Keynes 021D","E01016847",1427,52,11,41,279,171,88,107,259,246,121,78,43,104
"2011","Milton Keynes 022A","E01016822",1132,112,20,92,234,187,71,88,165,127,59,29,30,89
"2011","Milton Keynes 022B","E01016824",1164,182,39,143,277,202,87,69,124,99,34,13,21,90
"2011","Milton Keynes 022C","E01016825",1105,139,17,122,264,178,69,92,118,124,41,28,13,80
"2011","Milton Keynes 022D","E01016827",1274,212,34,178,318,202,76,86,148,121,37,20,17,74
"2011","Milton Keynes 022E","E01016828",1380,282,58,224,392,200,116,53,129,87,33,13,20,88
"2011","Milton Keynes 023B","E01016842",1061,47,5,42,80,116,63,78,220,221,145,83,62,91
"2011","Milton Keynes 023C","E01016843",981,28,7,21,107,88,70,67,188,235,113,76,37,85
"2011","Milton Keynes 023D","E01016844",1109,38,5,33,137,110,68,80,224,246,127,98,29,79
"2011","Milton Keynes 023E","E01033497",807,92,19,73,205,101,73,52,115,88,37,21,16,44
"2011","Milton Keynes 023F","E01033498",1022,108,16,92,191,130,87,77,146,147,82,44,38,54
"2011","Milton Keynes 024A","E01016734",881,156,39,117,224,115,121,58,85,61,18,12,6,43
"2011","Milton Keynes 024B","E01016735",1542,280,58,222,436,217,142,98,135,92,34,16,18,108
"2011","Milton Keynes 024C","E01016736",943,177,30,147,239,131,105,61,95,65,10,5,5,60
"2011","Milton Keynes 024D","E01016826",1147,234,40,194,323,168,100,58,77,43,25,15,10,119
"2011","Milton Keynes 025B","E01016752",1217,185,32,153,296,208,80,74,124,111,40,23,17,99
"2011","Milton Keynes 025C","E01016753",1618,227,51,176,415,265,95,87,211,147,70,44,26,101
"2011","Milton Keynes 025D","E01016755",1327,208,40,168,343,241,99,73,119,94,54,37,17,96
"2011","Milton Keynes 025E","E01033514",965,219,43,176,306,152,50,46,62,44,30,16,14,56
"2011","Milton Keynes 025F","E01033515",1343,252,64,188,400,178,99,59,114,67,38,27,11,136
"2011","Milton Keynes 025G","E01033517",1095,251,63,188,323,167,89,37,87,40,20,13,7,81
"2011","Milton Keynes 026A","E01016754",1230,142,20,122,275,200,110,80,150,140,69,33,36,64
"2011","Milton Keynes 026B","E01016756",1625,222,46,176,371,257,131,95,205,151,78,47,31,115
"2011","Milton Keynes 026C","E01016757",1189,106,25,81,282,217,86,94,167,124,37,20,17,76
"2011","Milton Keynes 026D","E01016758",1309,211,35,176,332,216,101,75,141,96,39,20,19,98
"2011","Milton Keynes 027A","E01016737",1198,108,24,84,240,222,90,81,193,153,37,21,16,74
"2011","Milton Keynes 027B","E01016738",1238,61,16,45,179,158,87,127,253,196,86,54,32,91
"2011","Milton Keynes 027C","E01016739",1189,86,17,69,217,191,99,108,199,170,33,22,11,86
"2011","Milton Keynes 027D","E01016740",1000,82,23,59,199,161,78,101,179,132,27,14,13,41
"2011","Milton Keynes 027E","E01016741",1212,51,7,44,172,149,88,103,242,250,86,41,45,71
"2011","Milton Keynes 028A","E01016748",1457,245,46,199,342,259,114,102,167,102,36,19,17,90
"2011","Milton Keynes 028C","E01016750",1213,165,30,135,310,216,85,88,143,90,33,17,16,83
"2011","Milton Keynes 028D","E01016751",1165,165,30,135,307,230,79,64,124,82,37,23,14,77
"2011","Milton Keynes 028E","E01033519",1303,230,45,185,377,205,70,59,132,105,37,18,19,88
"2011","Milton Keynes 028F","E01033520",1274,226,42,184,361,242,84,67,116,64,33,18,15,81
"2011","Milton Keynes 029A","E01016829",1119,68,11,57,165,159,99,105,223,175,70,27,43,55
"2011","Milton Keynes 029B","E01016831",1199,84,23,61,239,234,90,99,191,150,34,18,16,78
"2011","Milton Keynes 029C","E01016832",938,73,18,55,166,173,81,83,173,103,27,14,13,59
"2011","Milton Keynes 029D","E01016833",970,165,41,124,236,184,84,59,101,62,30,15,15,49
"2011","Milton Keynes 029E","E01016834",1043,40,7,33,140,157,75,96,231,177,57,30,27,70
"2011","Milton Keynes 030A","E01016710",1182,87,18,69,178,181,110,120,217,160,55,37,18,74
"2011","Milton Keynes 030B","E01016714",1267,67,16,51,182,170,103,109,231,171,144,106,38,90
"2011","Milton Keynes 030C","E01016716",1367,100,27,73,243,175,114,120,237,236,82,52,30,60
"2011","Milton Keynes 030D","E01016745",1192,71,19,52,245,199,100,112,191,166,43,30,13,65
"2011","Milton Keynes 031A","E01016711",1699,218,52,166,394,299,185,114,194,156,43,23,20,96
"2011","Milton Keynes 031B","E01016713",1244,101,19,82,249,231,108,94,241,132,30,8,22,58
"2011","Milton Keynes 031C","E01016715",1147,64,15,49,179,156,94,111,219,177,67,36,31,80
"2011","Milton Keynes 031D","E01016830",872,84,21,63,194,177,70,79,112,96,20,12,8,40
"2011","Milton Keynes 032A","E01016742",1049,22,3,19,93,90,39,110,243,238,130,85,45,84
"2011","Milton Keynes 032B","E01016743",1408,71,17,54,199,187,73,126,290,259,107,67,40,96
"2011","Milton Keynes 032C","E01016744",1067,46,14,32,135,141,76,82,216,178,102,60,42,91
"2011","Milton Keynes 032D","E01016746",1195,71,16,55,183,156,118,103,255,169,79,52,27,61
"2011","Portsmouth 001A","E01017112",1304,42,12,30,145,110,122,122,257,265,123,83,40,118
"2011","Portsmouth 001B","E01017115",947,26,4,22,120,94,103,77,209,181,64,49,15,73
"2011","Portsmouth 001C","E01017117",1119,35,7,28,173,130,101,96,215,218,66,40,26,85
"2011","Portsmouth 001D","E01017119",1200,32,4,28,143,134,139,125,255,224,65,35,30,83
"2011","Portsmouth 001E","E01017120",1036,22,5,17,124,80,100,83,230,250,81,56,25,66
"2011","Portsmouth 002A","E01017051",1346,74,13,61,191,151,114,113,275,235,101,62,39,92
"2011","Portsmouth 002B","E01017052",1006,51,16,35,168,117,86,92,191,185,53,37,16,63
"2011","Portsmouth 002C","E01017053",936,22,7,15,113,84,75,78,182,196,94,64,30,92
"2011","Portsmouth 002D","E01017118",1095,21,7,14,122,123,92,76,224,247,86,46,40,104
"2011","Portsmouth 003A","E01017050",1103,194,35,159,262,159,113,49,127,94,31,18,13,74
"2011","Portsmouth 003B","E01017061",1220,194,61,133,329,180,144,65,119,71,30,19,11,88
"2011","Portsmouth 003C","E01017063",1132,179,53,126,292,219,106,73,111,52,21,12,9,79
"2011","Portsmouth 003D","E01017064",1103,150,32,118,275,192,103,63,132,87,31,24,7,70
"2011","Portsmouth 004A","E01017054",1006,63,19,44,166,130,100,83,190,177,40,20,20,57
"2011","Portsmouth 004B","E01017113",1100,64,18,46,233,155,116,95,158,172,35,19,16,72
"2011","Portsmouth 004C","E01017114",1112,228,64,164,334,150,114,50,101,77,22,14,8,36
"2011","Portsmouth 004D","E01017116",1037,58,21,37,197,140,87,78,172,149,73,39,34,83
"2011","Portsmouth 006A","E01017055",1097,103,24,79,264,177,100,89,145,105,55,32,23,59
"2011","Portsmouth 006B","E01017056",954,114,23,91,222,144,83,66,135,73,21,13,8,96
"2011","Portsmouth 006C","E01017057",1112,136,21,115,253,179,116,87,135,88,28,13,15,90
"2011","Portsmouth 006D","E01017058",1242,115,39,76,232,187,114,110,177,128,48,30,18,131
"2011","Portsmouth 006E","E01017060",1037,133,28,105,243,175,91,83,133,82,17,8,9,80
"2011","Portsmouth 007A","E01017086",955,83,27,56,187,159,109,82,158,86,21,14,7,70
"2011","Portsmouth 007B","E01017089",1148,65,16,49,236,161,88,82,171,176,79,46,33,90
"2011","Portsmouth 007C","E01017090",1131,90,20,70,260,178,83,79,190,124,26,17,9,101
"2011","Portsmouth 007D","E01017091",1049,69,26,43,238,158,58,84,182,143,57,35,22,60
"2011","Portsmouth 007E","E01017092",1073,80,24,56,226,167,100,100,164,123,36,24,12,77
"2011","Portsmouth 008A","E01017014",1154,92,22,70,257,183,119,97,177,130,21,11,10,78
"2011","Portsmouth 008B","E01017046",1389,182,37,145,315,217,141,124,173,126,35,20,15,76
"2011","Portsmouth 008C","E01017047",1173,71,19,52,240,187,112,108,198,135,34,16,18,88
"2011","Portsmouth 008D","E01017048",1130,92,26,66,216,178,121,97,179,128,25,12,13,94
"2011","Portsmouth 008E","E01017085",1076,71,16,55,225,201,104,77,168,121,37,20,17,72
"2011","Portsmouth 009A","E01017084",1072,98,29,69,237,157,107,86,156,107,43,21,22,81
"2011","Portsmouth 009B","E01017087",1139,104,27,77,240,162,98,86,149,122,86,60,26,92
"2011","Portsmouth 009C","E01017088",1260,113,29,84,266,188,138,85,168,148,56,36,20,98
"2011","Portsmouth 009D","E01017105",1036,66,17,49,215,145,79,79,179,170,35,20,15,68
"2011","Portsmouth 009E","E01017107",1153,70,14,56,220,162,109,96,207,151,48,27,21,90
"2011","Portsmouth 010A","E01017104",841,31,7,24,139,135,75,77,157,131,38,21,17,58
"2011","Portsmouth 010B","E01017106",1084,49,13,36,167,168,92,97,201,180,61,39,22,69
"2011","Portsmouth 010C","E01017108",1129,57,7,50,160,130,102,108,201,231,75,43,32,65
"2011","Portsmouth 010D","E01017109",968,49,11,38,153,131,94,76,167,173,54,41,13,71
"2011","Portsmouth 011A","E01017041",1028,78,29,49,208,166,107,90,156,120,27,16,11,76
"2011","Portsmouth 011B","E01017043",1008,71,16,55,198,157,99,79,160,95,52,24,28,97
"2011","Portsmouth 011C","E01017044",1158,84,19,65,252,158,107,104,182,139,50,24,26,82
"2011","Portsmouth 011D","E01017049",1127,86,23,63,234,172,137,97,170,120,29,16,13,82
"2011","Portsmouth 011E","E01017110",1101,64,14,50,207,165,96,114,183,141,57,37,20,74
"2011","Portsmouth 011F","E01017111",1078,68,9,59,227,162,103,89,162,156,42,27,15,69
"2011","Portsmouth 012A","E01017013",1127,72,18,54,212,175,97,112,195,136,43,27,16,85
"2011","Portsmouth 012B","E01017042",1025,64,21,43,180,155,83,94,190,137,42,26,16,80
"2011","Portsmouth 012C","E01017045",992,58,14,44,207,151,72,88,150,146,52,29,23,68
"2011","Portsmouth 012D","E01017075",1155,42,12,30,220,165,98,107,186,172,62,37,25,103
"2011","Portsmouth 012E","E01017082",1265,70,19,51,236,185,108,116,230,172,56,30,26,92
"2011","Portsmouth 012F","E01017083",1282,88,31,57,250,186,109,110,188,185,62,34,28,104
"2011","Portsmouth 013A","E01017036",1084,29,7,22,108,110,91,100,214,226,104,63,41,102
"2011","Portsmouth 013B","E01017037",1028,20,2,18,87,79,79,66,223,238,143,86,57,93
"2011","Portsmouth 013C","E01017038",1096,31,9,22,125,103,88,70,253,211,116,85,31,99
"2011","Portsmouth 013D","E01017102",1156,50,12,38,143,119,121,89,199,246,81,53,28,108
"2011","Portsmouth 013E","E01017103",857,18,1,17,65,69,60,65,166,211,97,63,34,106
"2011","Portsmouth 014A","E01017015",1042,77,17,60,225,170,92,97,160,121,26,15,11,74
"2011","Portsmouth 014B","E01017016",1122,86,18,68,241,197,118,86,172,118,29,11,18,75
"2011","Portsmouth 014C","E01017017",1099,112,35,77,254,176,94,101,144,98,26,18,8,94
"2011","Portsmouth 014D","E01017018",1132,89,22,67,235,184,121,68,168,132,39,23,16,96
"2011","Portsmouth 014E","E01017019",1513,96,25,71,297,204,128,146,227,220,94,57,37,101
"2011","Portsmouth 014F","E01017020",1643,131,36,95,319,239,162,133,258,204,65,35,30,132
"2011","Portsmouth 015A","E01017076",1251,72,20,52,233,175,90,112,223,167,55,31,24,124
"2011","Portsmouth 015B","E01017077",1261,75,26,49,186,169,84,114,225,209,90,54,36,109
"2011","Portsmouth 015C","E01017078",1153,97,11,86,187,163,96,97,209,152,44,27,17,108
"2011","Portsmouth 015D","E01017079",1253,68,18,50,159,140,87,101,179,155,75,51,24,289
"2011","Portsmouth 015E","E01017080",1609,89,23,66,211,169,84,107,218,196,99,72,27,436
"2011","Portsmouth 015F","E01017081",1274,73,13,60,230,187,66,94,189,147,58,34,24,230
"2011","Portsmouth 016A","E01017031",1398,46,13,33,163,122,85,107,280,274,159,95,64,162
"2011","Portsmouth 016B","E01017032",2348,22,6,16,84,56,52,54,146,137,128,77,51,1669
"2011","Portsmouth 016D","E01017034",1627,103,63,40,433,333,60,83,137,198,102,65,37,178
"2011","Portsmouth 016E","E01017039",1230,39,6,33,117,105,95,95,207,233,133,86,47,206
"2011","Portsmouth 016F","E01017040",1033,36,6,30,100,76,56,70,204,219,131,98,33,141
"2011","Portsmouth 016G","E01033381",1209,137,26,111,189,102,66,61,114,113,73,47,26,354
"2011","Portsmouth 016H","E01033383",977,35,12,23,92,77,66,88,145,199,86,49,37,189
"2011","Portsmouth 017A","E01017021",1054,107,32,75,232,183,96,87,130,132,30,21,9,57
"2011","Portsmouth 017B","E01017093",1358,61,11,50,183,106,101,58,98,120,49,32,17,582
"2011","Portsmouth 017C","E01017096",1031,109,20,89,237,157,110,78,156,97,25,13,12,62
"2011","Portsmouth 017D","E01017099",1213,94,17,77,260,177,106,81,158,103,51,32,19,183
"2011","Portsmouth 017E","E01017100",1037,103,29,74,199,173,96,76,149,120,46,38,8,75
"2011","Portsmouth 017F","E01017101",1139,107,34,73,274,161,101,81,161,110,42,24,18,102
"2011","Portsmouth 018A","E01017035",1012,33,10,23,104,81,58,103,173,187,142,102,40,131
"2011","Portsmouth 018B","E01017128",1492,99,13,86,180,117,59,50,110,78,56,40,16,743
"2011","Portsmouth 018C","E01017129",1711,77,19,58,165,101,65,59,106,100,63,38,25,975
"2011","Portsmouth 018D","E01017130",1351,31,2,29,106,89,69,88,221,241,191,137,54,315
"2011","Portsmouth 018E","E01017132",1861,46,9,37,134,117,91,112,238,244,158,107,51,721
"2011","Portsmouth 018F","E01017133",1423,82,17,65,185,119,80,75,168,129,91,57,34,494
"2011","Portsmouth 019A","E01017023",1306,139,30,109,277,129,97,61,130,97,42,16,26,334
"2011","Portsmouth 019B","E01017025",1734,152,29,123,274,159,91,88,150,108,74,42,32,638
"2011","Portsmouth 019C","E01017026",1561,127,22,105,259,144,112,83,134,78,47,32,15,577
"2011","Portsmouth 019D","E01017029",1398,117,20,97,304,168,77,73,155,97,43,24,19,364
"2011","Portsmouth 019E","E01017030",1623,102,17,85,267,141,70,67,120,97,41,27,14,718
"2011","Portsmouth 020A","E01017022",1212,125,25,100,224,96,61,60,101,84,45,18,27,416
"2011","Portsmouth 020B","E01017024",1587,130,18,112,271,133,74,64,114,78,39,17,22,684
"2011","Portsmouth 020C","E01017027",1562,90,17,73,208,103,81,66,104,85,44,28,16,781
"2011","Portsmouth 020D","E01017028",1936,68,8,60,164,106,83,61,137,82,75,46,29,1160
"2011","Portsmouth 020E","E01017124",1406,193,36,157,329,149,104,89,116,80,51,31,20,295
"2011","Portsmouth 021A","E01017094",1161,146,36,110,308,178,75,65,124,90,39,26,13,136
"2011","Portsmouth 021B","E01017095",1389,167,39,128,395,189,102,86,193,129,36,18,18,92
"2011","Portsmouth 021C","E01017097",1242,117,27,90,310,156,93,84,130,102,34,19,15,216
"2011","Portsmouth 021D","E01017098",1081,78,18,60,229,178,70,83,157,115,52,38,14,119
"2011","Portsmouth 022A","E01017122",1425,200,41,159,327,157,109,82,134,85,59,35,24,272
"2011","Portsmouth 022B","E01017125",1298,195,49,146,222,130,116,63,131,84,72,56,16,285
"2011","Portsmouth 022C","E01017127",1663,221,39,182,347,172,97,116,141,92,70,45,25,407
"2011","Portsmouth 022D","E01017135",1366,191,49,142,260,133,98,60,135,100,55,39,16,334
"2011","Portsmouth 023A","E01017067",1089,115,32,83,253,150,108,86,173,106,39,26,13,59
"2011","Portsmouth 023B","E01017068",1396,188,58,130,370,200,125,100,169,116,52,27,25,76
"2011","Portsmouth 023C","E01017069",1305,207,54,153,331,174,128,106,98,115,48,33,15,98
"2011","Portsmouth 023D","E01017070",1164,173,24,149,257,159,106,40,83,62,54,40,14,230
"2011","Portsmouth 023E","E01017074",1311,143,36,107,298,195,115,97,193,133,54,35,19,83
"2011","Portsmouth 024A","E01017073",1377,234,45,189,284,157,109,76,137,122,53,25,28,205
"2011","Portsmouth 024B","E01017123",1636,299,81,218,423,173,133,97,128,87,65,43,22,231
"2011","Portsmouth 024C","E01017131",1539,212,94,118,256,105,71,32,114,85,44,33,11,620
"2011","Portsmouth 024E","E01033380",1306,261,54,207,297,121,81,42,49,28,25,23,2,402
"2011","Portsmouth 024F","E01033384",1105,260,74,186,327,109,85,45,93,41,26,16,10,119
"2011","Portsmouth 025A","E01017071",1327,164,37,127,274,147,123,55,108,87,26,11,15,343
"2011","Portsmouth 025B","E01017072",1149,196,56,140,294,122,91,54,72,56,49,44,5,215
"2011","Portsmouth 025C","E01017121",1337,213,42,171,328,165,112,63,122,62,48,26,22,224
"2011","Portsmouth 025D","E01017126",1473,164,33,131,345,144,105,71,110,100,78,49,29,356
"2011","Portsmouth 026A","E01017059",1041,123,35,88,213,177,100,78,153,112,21,19,2,64
"2011","Portsmouth 026B","E01017062",1138,254,133,121,346,158,80,48,84,55,18,8,10,95
"2011","Portsmouth 026C","E01017066",1335,119,32,87,303,222,147,108,197,129,29,16,13,81
"2011","Portsmouth 026D","E01032604",1100,145,36,109,292,171,115,85,119,72,23,13,10,78
"2011","Reading 001A","E01016407",1045,186,27,159,305,172,94,49,131,52,15,8,7,41
"2011","Reading 001B","E01016408",1123,117,24,93,260,213,112,75,157,91,30,19,11,68
"2011","Reading 001C","E01016410",1247,268,47,221,340,203,131,56,88,58,34,22,12,69
"2011","Reading 001D","E01016411",1068,229,45,184,295,183,115,47,87,43,20,11,9,49
"2011","Reading 001E","E01016412",1148,161,38,123,288,216,96,67,136,73,49,34,15,62
"2011","Reading 002A","E01016386",1032,290,72,218,328,117,88,32,64,29,24,16,8,60
"2011","Reading 002B","E01016387",1084,263,57,206,318,155,98,35,77,46,18,10,8,74
"2011","Reading 002C","E01016425",1205,299,60,239,388,165,96,47,78,33,23,16,7,76
"2011","Reading 002D","E01016426",978,268,64,204,337,103,92,15,51,15,24,10,14,73
"2011","Reading 002E","E01016430",990,279,57,222,280,130,102,26,63,25,21,10,11,64
"2011","Reading 003A","E01016364",1038,290,37,253,344,108,81,34,68,34,11,5,6,68
"2011","Reading 003B","E01016409",1148,170,29,141,293,167,91,67,167,81,44,21,23,68
"2011","Reading 003C","E01016427",1088,260,41,219,344,129,81,28,88,48,22,14,8,88
"2011","Reading 003D","E01016428",1252,263,45,218,354,170,120,55,113,73,33,13,20,71
"2011","Reading 003E","E01016429",1159,210,43,167,306,181,110,64,105,66,27,13,14,90
"2011","Reading 004A","E01016362",1169,263,28,235,330,172,95,52,103,65,47,24,23,42
"2011","Reading 004B","E01016363",1280,185,18,167,248,151,93,78,200,149,90,57,33,86
"2011","Reading 004C","E01016365",1279,309,44,265,375,180,90,49,99,71,47,22,25,59
"2011","Reading 004D","E01016366",1176,235,35,200,286,141,117,56,127,87,53,28,25,74
"2011","Reading 004E","E01016367",1174,196,23,173,263,150,97,82,145,121,57,36,21,63
"2011","Reading 005A","E01016380",1230,189,38,151,304,185,123,67,151,103,35,19,16,73
"2011","Reading 005B","E01016383",1128,118,29,89,269,202,101,64,171,114,42,22,20,47
"2011","Reading 005C","E01016384",1225,238,48,190,357,201,118,65,96,54,23,13,10,73
"2011","Reading 005D","E01016431",1147,160,33,127,259,180,134,66,130,111,33,20,13,74
"2011","Reading 005E","E01016432",1027,122,21,101,241,176,104,61,139,83,38,19,19,63
"2011","Reading 006A","E01016381",1004,90,16,74,171,149,99,71,160,121,79,50,29,64
"2011","Reading 006B","E01016382",1230,83,11,72,213,136,94,83,236,200,109,81,28,76
"2011","Reading 006C","E01016385",1127,125,17,108,245,158,107,104,166,111,56,33,23,55
"2011","Reading 006D","E01016396",898,71,13,58,134,98,68,72,181,145,74,40,34,55
"2011","Reading 006E","E01016397",936,59,11,48,154,114,61,71,158,179,71,41,30,69
"2011","Reading 007A","E01016355",1487,323,33,290,416,166,80,90,160,98,61,48,13,93
"2011","Reading 007B","E01016358",1363,173,18,155,283,135,96,94,224,161,114,77,37,83
"2011","Reading 007C","E01016359",1502,140,20,120,294,172,120,108,253,216,100,68,32,99
"2011","Reading 007D","E01016360",1536,130,13,117,274,150,108,105,271,222,131,96,35,145
"2011","Reading 007E","E01016361",1305,147,16,131,289,157,100,87,199,150,97,57,40,79
"2011","Reading 008A","E01016356",1147,158,17,141,275,139,60,62,158,136,86,60,26,73
"2011","Reading 008B","E01016357",1309,214,32,182,336,150,90,82,167,135,65,41,24,70
"2011","Reading 008C","E01016395",927,98,16,82,203,128,86,66,146,103,50,30,20,47
"2011","Reading 008D","E01016398",1287,161,26,135,316,190,93,75,171,135,84,41,43,62
"2011","Reading 008E","E01016399",1075,139,22,117,273,140,68,72,153,118,35,22,13,77
"2011","Reading 008F","E01016400",1161,140,17,123,246,160,93,81,173,128,65,32,33,75
"2011","Reading 009A","E01016394",853,52,9,43,113,107,83,77,190,109,72,51,21,50
"2011","Reading 009B","E01016433",1004,94,20,74,216,157,96,87,157,101,48,29,19,48
"2011","Reading 009C","E01016434",1262,110,21,89,237,234,93,92,222,140,50,36,14,84
"2011","Reading 009D","E01016435",957,68,9,59,166,165,94,81,169,105,55,37,18,54
"2011","Reading 009E","E01016436",1080,86,17,69,212,172,132,75,151,129,64,52,12,59
"2011","Reading 010B","E01016402",1586,132,15,117,187,103,74,60,123,67,62,46,16,778
"2011","Reading 010C","E01016404",1547,199,28,171,334,154,86,76,207,145,115,92,23,231
"2011","Reading 010D","E01016405",1598,134,15,119,280,133,90,80,246,160,145,122,23,330
"2011","Reading 010E","E01016406",1329,146,13,133,214,84,49,56,122,81,91,68,23,486
"2011","Reading 010F","E01033417",963,239,31,208,300,116,33,52,54,47,31,18,13,91
"2011","Reading 010G","E01033421",1404,249,25,224,290,145,55,66,191,146,110,76,34,152
"2011","Reading 011B","E01016353",1446,196,14,182,266,149,70,116,218,177,144,99,45,110
"2011","Reading 011D","E01016378",1784,402,32,370,433,167,72,74,157,113,134,91,43,232
"2011","Reading 011E","E01016391",1425,238,26,212,342,167,75,85,199,119,106,69,37,94
"2011","Reading 011F","E01033415",1366,370,34,336,327,115,71,71,102,102,116,92,24,92
"2011","Reading 011G","E01033418",1007,300,32,268,280,104,55,40,72,26,50,40,10,80
"2011","Reading 011H","E01033420",966,278,25,253,287,93,33,40,65,40,58,36,22,72
"2011","Reading 011I","E01033422",960,155,11,144,251,113,48,62,116,83,67,39,28,65
"2011","Reading 011J","E01033423",1019,237,19,218,275,98,52,48,97,85,68,38,30,59
"2011","Reading 012A","E01016401",1163,255,33,222,268,81,67,36,71,45,52,39,13,288
"2011","Reading 012B","E01016403",1448,313,26,287,352,136,89,52,113,65,54,39,15,274
"2011","Reading 012C","E01016416",1461,173,25,148,225,103,36,46,116,63,58,37,21,641
"2011","Reading 012D","E01016417",1463,164,22,142,220,91,52,39,66,58,70,50,20,703
"2011","Reading 012E","E01016418",1403,174,27,147,249,89,38,45,66,46,36,28,8,660
"2011","Reading 013A","E01016388",1077,148,21,127,223,172,98,74,161,100,47,35,12,54
"2011","Reading 013B","E01016389",1170,81,10,71,205,125,55,69,225,173,127,64,63,110
"2011","Reading 013C","E01016390",1220,278,36,242,346,160,73,57,127,62,66,49,17,51
"2011","Reading 013D","E01016392",1570,298,43,255,426,228,97,96,163,104,86,67,19,72
"2011","Reading 013E","E01016393",1143,221,22,199,295,155,62,76,127,88,58,45,13,61
"2011","Reading 014A","E01016374",1343,289,34,255,317,150,60,90,157,113,61,40,21,106
"2011","Reading 014B","E01016375",1000,112,13,99,181,95,47,58,158,110,77,55,22,162
"2011","Reading 014C","E01016376",1279,203,27,176,252,100,46,81,129,92,94,66,28,282
"2011","Reading 014D","E01016379",1481,251,21,230,373,152,46,88,156,115,71,46,25,229
"2011","Reading 014E","E01016413",1536,243,25,218,289,100,32,23,56,34,37,22,15,722
"2011","Reading 014F","E01016414",1318,280,23,257,317,105,56,31,87,41,56,39,17,345
"2011","Reading 015A","E01016419",1278,189,26,163,300,199,108,82,164,124,47,40,7,65
"2011","Reading 015B","E01016420",903,31,9,22,106,117,59,69,211,154,74,43,31,82
"2011","Reading 015C","E01016421",947,89,24,65,160,155,100,73,160,111,51,43,8,48
"2011","Reading 015D","E01016422",899,86,22,64,157,151,83,70,135,99,66,48,18,52
"2011","Reading 015E","E01016423",977,69,15,54,145,138,85,75,183,145,68,51,17,69
"2011","Reading 015F","E01016424",995,136,22,114,225,189,95,54,109,69,48,32,16,70
"2011","Reading 016A","E01016370",2749,145,13,132,159,66,46,39,94,69,58,39,19,2073
"2011","Reading 016B","E01016371",1216,188,25,163,244,105,93,75,136,78,52,32,20,245
"2011","Reading 016C","E01016373",1041,79,11,68,151,119,49,70,181,142,116,62,54,134
"2011","Reading 016D","E01016415",1097,91,11,80,152,105,74,64,192,161,113,61,52,145
"2011","Reading 017A","E01016368",951,50,10,40,109,70,68,95,197,189,90,63,27,83
"2011","Reading 017B","E01016372",878,47,4,43,95,86,62,66,163,158,119,84,35,82
"2011","Reading 017C","E01016377",1234,105,8,97,169,126,91,77,211,182,79,55,24,194
"2011","Reading 017D","E01016438",907,37,9,28,112,104,71,84,170,169,83,51,32,77
"2011","Reading 017E","E01016442",2056,265,30,235,401,232,117,150,296,293,162,103,59,140
"2011","Reading 017F","E01016443",1006,48,7,41,126,96,74,89,210,192,103,67,36,68
"2011","Reading 018A","E01016369",1143,95,18,77,212,167,109,87,175,151,69,45,24,78
"2011","Reading 018B","E01016437",1009,77,9,68,172,130,94,86,174,143,67,47,20,66
"2011","Reading 018C","E01016439",1119,65,13,52,173,153,99,97,191,183,74,48,26,84
"2011","Reading 018D","E01016440",1057,54,11,43,178,135,86,87,181,182,76,54,22,78
"2011","Reading 018E","E01016441",981,55,12,43,115,114,68,92,190,184,84,58,26,79
"2011","Slough 001A","E01016450",1037,53,15,38,155,142,68,65,190,178,91,54,37,95
"2011","Slough 001B","E01016451",1012,28,7,21,136,106,57,114,194,180,103,80,23,94
"2011","Slough 001C","E01016452",1151,76,17,59,199,153,86,83,200,156,85,56,29,113
"2011","Slough 001D","E01016453",1044,70,12,58,194,160,103,92,189,128,40,23,17,68
"2011","Slough 001E","E01016454",1049,60,12,48,174,163,89,93,179,153,70,39,31,68
"2011","Slough 001F","E01016455",944,67,19,48,150,150,76,73,153,135,60,44,16,80
"2011","Slough 002A","E01016483",1301,66,12,54,165,133,124,97,242,195,140,107,33,139
"2011","Slough 002B","E01016484",1162,64,12,52,165,120,119,100,204,170,112,82,30,108
"2011","Slough 002C","E01016485",1230,59,12,47,176,146,128,81,203,173,118,102,16,146
"2011","Slough 002D","E01016486",1123,38,8,30,154,128,105,89,200,202,109,74,35,98
"2011","Slough 002E","E01016487",1273,73,11,62,159,138,136,101,212,159,147,118,29,148
"2011","Slough 002F","E01016488",1282,75,21,54,210,154,150,111,219,162,104,70,34,97
"2011","Slough 003A","E01016493",921,113,26,87,225,153,82,72,101,82,19,11,8,74
"2011","Slough 003B","E01016494",1429,189,31,158,336,226,105,116,183,117,73,44,29,84
"2011","Slough 003C","E01016495",1108,140,18,122,284,165,77,91,176,75,44,30,14,56
"2011","Slough 003D","E01016496",871,75,9,66,196,133,70,65,143,88,54,36,18,47
"2011","Slough 003E","E01016497",1007,138,31,107,232,165,92,68,118,68,45,32,13,81
"2011","Slough 003F","E01016498",1220,99,17,82,213,204,90,97,208,137,87,51,36,85
"2011","Slough 003G","E01016499",965,45,6,39,159,107,74,74,191,115,91,59,32,109
"2011","Slough 004A","E01016444",1178,45,8,37,137,102,110,80,190,178,189,153,36,147
"2011","Slough 004B","E01016445",1231,52,10,42,153,131,115,78,203,163,180,155,25,156
"2011","Slough 004C","E01016446",1132,68,6,62,131,123,99,70,165,142,176,158,18,158
"2011","Slough 004D","E01016447",1289,65,8,57,169,140,119,73,229,175,179,151,28,140
"2011","Slough 004E","E01016448",1687,95,10,85,237,160,156,107,265,251,239,204,35,177
"2011","Slough 004F","E01016449",1463,36,6,30,151,131,149,95,269,234,214,171,43,184
"2011","Slough 005A","E01016516",1177,52,9,43,137,123,113,76,205,152,165,135,30,154
"2011","Slough 005B","E01016517",1099,40,7,33,138,101,83,82,210,164,142,127,15,139
"2011","Slough 005C","E01016518",1292,81,16,65,228,173,110,125,175,146,116,95,21,138
"2011","Slough 005D","E01016519",1716,202,20,182,365,195,125,105,220,174,118,101,17,212
"2011","Slough 005E","E01016520",1124,44,10,34,149,122,106,68,201,150,140,108,32,144
"2011","Slough 005F","E01016521",1224,75,9,66,200,146,108,91,206,165,118,91,27,115
"2011","Slough 006A","E01016467",1056,94,19,75,179,170,100,93,176,120,55,35,20,69
"2011","Slough 006B","E01016468",1250,139,31,108,254,205,104,102,200,101,53,37,16,92
"2011","Slough 006C","E01016469",1211,116,33,83,241,177,130,96,172,110,77,51,26,92
"2011","Slough 006D","E01016470",1198,103,23,80,240,204,127,90,169,129,51,27,24,85
"2011","Slough 006E","E01016471",976,81,18,63,191,158,86,91,126,107,60,41,19,76
"2011","Slough 006F","E01016472",1167,67,10,57,190,182,101,93,191,153,86,60,26,104
"2011","Slough 007A","E01016456",1558,70,6,64,212,119,148,92,237,212,249,211,38,219
"2011","Slough 007B","E01016457",1381,102,12,90,185,146,147,75,221,142,172,131,41,191
"2011","Slough 007C","E01016458",1173,58,6,52,117,143,112,85,166,150,189,165,24,153
"2011","Slough 007D","E01016459",1624,115,14,101,246,167,157,91,245,190,226,182,44,187
"2011","Slough 007E","E01016460",1369,106,11,95,189,151,116,96,248,189,114,98,16,160
"2011","Slough 007F","E01016461",1896,174,18,156,353,219,189,106,277,224,188,149,39,166
"2011","Slough 008A","E01016473",1479,192,32,160,341,250,102,99,183,100,90,65,25,122
"2011","Slough 008B","E01016474",1400,114,16,98,258,203,121,102,224,168,117,85,32,93
"2011","Slough 008C","E01016475",1490,89,16,73,196,154,168,79,290,199,157,117,40,158
"2011","Slough 008D","E01016476",1227,163,30,133,256,209,94,101,161,99,79,61,18,65
"2011","Slough 008E","E01016477",1727,195,34,161,395,265,146,141,215,159,94,60,34,117
"2011","Slough 008F","E01016478",1375,133,20,113,286,180,120,111,197,129,98,72,26,121
"2011","Slough 009A","E01016462",1832,165,8,157,321,186,155,107,245,220,229,189,40,204
"2011","Slough 009B","E01016463",1369,54,6,48,143,118,148,94,208,193,228,185,43,183
"2011","Slough 009C","E01016464",1387,68,10,58,178,110,125,85,192,190,234,192,42,205
"2011","Slough 009D","E01016465",1931,165,24,141,316,163,201,131,333,238,221,169,52,163
"2011","Slough 009F","E01032729",1144,81,8,73,162,112,75,76,192,159,158,129,29,129
"2011","Slough 009G","E01032730",1119,170,20,150,206,99,79,89,135,116,116,79,37,109
"2011","Slough 010A","E01016506",1390,183,26,157,336,228,99,104,153,140,66,41,25,81
"2011","Slough 010B","E01016507",1136,133,20,113,247,167,102,75,151,101,62,46,16,98
"2011","Slough 010C","E01016508",1223,149,23,126,268,199,101,109,149,86,61,46,15,101
"2011","Slough 010D","E01016509",1157,135,29,106,239,207,105,85,149,96,51,36,15,90
"2011","Slough 010E","E01016510",1139,181,18,163,242,165,119,60,105,64,75,56,19,128
"2011","Slough 011A","E01016511",1370,120,18,102,263,156,90,97,216,159,136,110,26,133
"2011","Slough 011B","E01016512",1411,163,15,148,292,137,136,124,178,172,122,96,26,87
"2011","Slough 011C","E01016513",1379,182,26,156,288,207,125,78,181,88,85,67,18,145
"2011","Slough 011D","E01016514",1354,181,31,150,366,177,79,107,152,114,87,68,19,91
"2011","Slough 011E","E01016515",1496,242,40,202,367,170,136,44,193,87,89,71,18,168
"2011","Slough 012A","E01016500",1295,149,17,132,285,200,109,83,164,108,76,56,20,121
"2011","Slough 012B","E01016501",1068,78,8,70,183,137,76,92,168,135,101,59,42,98
"2011","Slough 012C","E01016502",967,84,12,72,172,132,81,70,149,106,59,39,20,114
"2011","Slough 012D","E01016503",1115,83,11,72,213,130,91,89,176,155,77,61,16,101
"2011","Slough 012E","E01016504",1060,136,25,111,244,151,107,52,107,80,52,42,10,131
"2011","Slough 012F","E01016505",1161,89,14,75,197,130,84,117,195,148,104,71,33,97
"2011","Slough 013B","E01016490",1372,55,12,43,195,141,116,125,260,231,132,88,44,117
"2011","Slough 013C","E01016491",1224,157,33,124,234,185,119,101,161,124,61,34,27,82
"2011","Slough 013D","E01016492",1171,125,24,101,244,181,90,90,162,112,54,46,8,113
"2011","Slough 013E","E01032731",1043,143,28,115,219,161,84,56,105,86,96,75,21,93
"2011","Slough 013F","E01032732",1148,86,9,77,209,169,84,120,177,130,98,73,25,75
"2011","Slough 014A","E01016479",1146,75,17,58,182,160,115,114,177,123,83,65,18,117
"2011","Slough 014B","E01016480",1026,74,12,62,175,153,88,96,152,138,73,35,38,77
"2011","Slough 014C","E01016481",1143,103,19,84,247,190,103,92,168,139,46,27,19,55
"2011","Slough 014D","E01016482",1384,131,21,110,268,235,109,143,186,152,66,41,25,94
"2011","Southampton 001A","E01017144",965,133,12,121,158,60,57,32,82,49,33,24,9,361
"2011","Southampton 001B","E01017145",1064,237,25,212,275,124,97,57,72,55,29,25,4,118
"2011","Southampton 001C","E01017146",1822,320,34,286,316,147,81,39,71,45,29,23,6,774
"2011","Southampton 001D","E01017148",1929,198,18,180,207,78,70,28,47,26,19,12,7,1256
"2011","Southampton 001E","E01017149",1103,53,4,49,91,53,68,49,157,138,73,51,22,421
"2011","Southampton 002A","E01017180",1152,114,16,98,262,189,101,84,168,137,24,17,7,73
"2011","Southampton 002B","E01017181",1031,36,7,29,164,143,72,90,222,193,64,50,14,47
"2011","Southampton 002C","E01017183",1216,94,15,79,274,228,95,107,188,130,26,17,9,74
"2011","Southampton 002D","E01017185",1219,68,13,55,204,174,101,107,232,187,78,41,37,68
"2011","Southampton 002E","E01017187",1182,77,14,63,242,149,92,90,221,187,51,31,20,73
"2011","Southampton 003A","E01017264",2306,39,9,30,96,85,68,55,121,113,71,54,17,1658
"2011","Southampton 003B","E01017265",1171,72,14,58,146,143,106,104,230,215,58,36,22,97
"2011","Southampton 003C","E01017270",1060,70,10,60,163,102,63,65,122,139,35,20,15,301
"2011","Southampton 003D","E01017271",815,107,21,86,169,103,74,63,111,95,33,27,6,60
"2011","Southampton 004A","E01017182",985,32,8,24,126,135,64,100,204,238,54,39,15,32
"2011","Southampton 004B","E01017184",1066,51,8,43,151,147,64,107,209,238,54,39,15,45
"2011","Southampton 004C","E01017186",1230,70,16,54,188,145,109,102,214,238,88,60,28,76
"2011","Southampton 004D","E01017188",1203,40,10,30,177,109,88,102,248,232,105,73,32,102
"2011","Southampton 005A","E01017266",1093,49,4,45,97,64,55,79,169,153,76,58,18,351
"2011","Southampton 005B","E01017267",1029,56,6,50,131,68,70,45,110,104,55,45,10,390
"2011","Southampton 005E","E01017272",982,62,10,52,145,94,73,65,181,195,74,56,18,93
"2011","Southampton 005F","E01032756",2509,116,13,103,185,108,106,81,189,167,134,111,23,1423
"2011","Southampton 006A","E01017147",1069,213,23,190,253,124,89,51,111,75,27,19,8,126
"2011","Southampton 006B","E01017150",1042,217,35,182,289,111,99,33,89,35,21,16,5,148
"2011","Southampton 006C","E01017151",1151,128,18,110,236,159,104,64,172,162,53,34,19,73
"2011","Southampton 006D","E01017152",1168,134,20,114,280,154,88,78,132,129,63,35,28,110
"2011","Southampton 007A","E01017238",985,38,12,26,138,141,71,99,175,183,73,54,19,67
"2011","Southampton 007B","E01017241",954,37,10,27,139,104,58,92,241,189,45,29,16,49
"2011","Southampton 007C","E01017242",1125,89,12,77,194,172,80,103,204,191,44,27,17,48
"2011","Southampton 007D","E01017243",1289,85,16,69,238,170,117,124,227,196,41,25,16,91
"2011","Southampton 007E","E01017244",921,32,8,24,125,116,59,87,193,192,60,45,15,57
"2011","Southampton 008A","E01017174",941,48,10,38,178,147,103,102,173,125,28,21,7,37
"2011","Southampton 008B","E01017175",1116,132,23,109,261,148,120,80,157,111,34,25,9,73
"2011","Southampton 008C","E01017176",1177,76,17,59,250,169,135,98,180,131,48,27,21,90
"2011","Southampton 008D","E01017179",1047,50,12,38,182,135,68,86,213,176,52,31,21,85
"2011","Southampton 009A","E01017226",1088,267,22,245,265,98,70,46,78,54,39,24,15,171
"2011","Southampton 009D","E01017231",1486,152,12,140,164,74,53,39,103,63,32,20,12,806
"2011","Southampton 009E","E01017232",988,192,22,170,170,77,63,26,50,36,12,10,2,362
"2011","Southampton 009F","E01032753",1990,341,37,304,276,120,90,52,78,55,52,41,11,926
"2011","Southampton 010A","E01017246",1483,153,21,132,318,175,118,86,275,209,56,41,15,93
"2011","Southampton 010B","E01017250",983,75,17,58,154,109,62,73,182,193,81,59,22,54
"2011","Southampton 010C","E01017251",1144,89,11,78,225,112,68,84,220,205,65,36,29,76
"2011","Southampton 010D","E01017253",1197,70,12,58,206,127,101,104,217,198,86,65,21,88
"2011","Southampton 011A","E01017247",1174,172,19,153,305,156,99,54,137,107,44,30,14,100
"2011","Southampton 011B","E01017248",1090,193,39,154,301,152,95,53,122,70,20,14,6,84
"2011","Southampton 011C","E01017249",994,220,23,197,284,127,89,27,94,58,19,14,5,76
"2011","Southampton 011D","E01017252",1132,254,34,220,312,166,80,48,75,62,33,21,12,102
"2011","Southampton 011E","E01017254",1205,188,18,170,298,153,96,53,133,117,68,50,18,99
"2011","Southampton 012A","E01017236",949,24,4,20,119,95,66,92,218,231,60,35,25,44
"2011","Southampton 012B","E01017237",1038,29,7,22,108,121,89,102,224,206,84,54,30,75
"2011","Southampton 012C","E01017239",1097,60,18,42,176,131,84,111,201,213,51,36,15,70
"2011","Southampton 012D","E01017240",854,24,8,16,90,90,74,67,197,184,86,45,41,42
"2011","Southampton 012E","E01017245",975,29,7,22,90,101,62,71,241,233,89,59,30,59
"2011","Southampton 013A","E01017227",1171,50,3,47,85,67,41,32,64,59,44,29,15,729
"2011","Southampton 013B","E01017228",1227,122,16,106,247,113,111,71,167,149,79,49,30,168
"2011","Southampton 013C","E01017233",1238,131,26,105,253,138,99,61,161,147,51,32,19,197
"2011","Southampton 013D","E01017234",1553,106,16,90,172,102,61,65,151,135,79,60,19,682
"2011","Southampton 013E","E01017235",1372,91,12,79,131,75,50,44,95,110,55,40,15,721
"2011","Southampton 014A","E01017171",1425,154,27,127,330,188,152,89,200,145,68,49,19,99
"2011","Southampton 014B","E01017172",1410,147,26,121,317,189,117,99,228,154,65,31,34,94
"2011","Southampton 014C","E01017173",1054,96,13,83,261,147,101,78,165,113,32,15,17,61
"2011","Southampton 014D","E01017177",1164,159,30,129,273,160,115,79,167,98,32,19,13,81
"2011","Southampton 014E","E01017178",1132,185,27,158,307,145,98,75,120,98,27,19,8,77
"2011","Southampton 015A","E01017207",1064,28,8,20,131,105,78,86,236,225,116,80,36,59
"2011","Southampton 015B","E01017209",1063,108,12,96,261,141,71,80,157,133,42,24,18,70
"2011","Southampton 015C","E01017211",1245,115,11,104,231,156,103,105,214,166,67,44,23,88
"2011","Southampton 015D","E01017212",1011,107,16,91,223,154,67,65,151,122,46,34,12,76
"2011","Southampton 015E","E01017213",1221,141,24,117,314,173,84,84,166,144,47,26,21,68
"2011","Southampton 016A","E01017200",1284,119,31,88,278,179,135,116,214,149,33,21,12,61
"2011","Southampton 016B","E01017201",944,36,9,27,116,104,87,92,219,172,63,47,16,55
"2011","Southampton 016C","E01017202",1156,41,5,36,188,128,105,93,250,176,105,53,52,70
"2011","Southampton 016D","E01017203",1149,93,25,68,249,164,104,93,185,128,59,36,23,74
"2011","Southampton 016E","E01017204",1137,74,18,56,236,194,92,109,184,143,34,18,16,71
"2011","Southampton 017A","E01017157",1439,95,5,90,121,58,47,22,78,90,49,39,10,879
"2011","Southampton 017B","E01017158",1665,194,15,179,218,120,84,51,121,101,69,59,10,707
"2011","Southampton 017C","E01017159",1506,72,4,68,115,68,61,37,125,121,41,30,11,866
"2011","Southampton 017D","E01017160",1305,173,15,158,250,106,69,56,124,112,34,28,6,381
"2011","Southampton 018A","E01017198",1015,59,10,49,191,129,103,98,201,160,35,22,13,39
"2011","Southampton 018B","E01017199",1121,66,12,54,193,199,123,109,203,135,26,15,11,67
"2011","Southampton 018C","E01017205",906,33,8,25,94,87,90,69,214,161,78,56,22,80
"2011","Southampton 018D","E01017206",1176,69,14,55,223,150,125,102,199,161,62,38,24,85
"2011","Southampton 019A","E01017208",970,29,4,25,127,116,81,95,209,171,78,49,29,64
"2011","Southampton 019B","E01017210",1012,29,6,23,110,110,70,83,244,200,90,63,27,76
"2011","Southampton 019C","E01017214",1069,81,15,66,193,158,104,77,192,128,60,41,19,76
"2011","Southampton 019D","E01017215",1263,150,33,117,260,238,133,97,162,114,42,25,17,67
"2011","Southampton 019E","E01017216",1104,85,16,69,231,149,78,87,185,154,66,51,15,69
"2011","Southampton 020A","E01017189",1293,145,17,128,244,128,103,84,151,127,63,40,23,248
"2011","Southampton 020B","E01017190",1472,229,34,195,354,147,56,66,102,52,21,17,4,445
"2011","Southampton 020C","E01017191",1433,172,19,153,249,143,100,98,228,191,77,56,21,175
"2011","Southampton 020D","E01017196",1730,346,38,308,440,204,77,86,139,71,45,28,17,322
"2011","Southampton 020E","E01017197",1138,195,18,177,312,143,76,57,107,73,52,42,10,123
"2011","Southampton 021A","E01017192",1574,161,26,135,359,172,104,134,225,228,71,44,27,120
"2011","Southampton 021B","E01017193",1326,145,23,122,264,195,94,99,178,204,61,34,27,86
"2011","Southampton 021C","E01017194",1484,158,19,139,296,169,114,92,193,221,77,51,26,164
"2011","Southampton 021D","E01017195",1577,148,14,134,302,223,123,136,253,190,92,54,38,110
"2011","Southampton 022A","E01017153",1187,45,3,42,111,65,114,85,198,167,188,167,21,214
"2011","Southampton 022B","E01017154",1531,44,9,35,164,89,152,115,264,280,261,193,68,162
"2011","Southampton 022C","E01017155",1250,54,7,47,118,85,111,99,195,198,187,149,38,203
"2011","Southampton 022D","E01017156",1259,49,7,42,73,87,109,90,194,234,203,181,22,220
"2011","Southampton 022F","E01032738",1207,95,9,86,172,90,50,64,99,79,67,33,34,491
"2011","Southampton 022G","E01032750",1333,65,2,63,101,87,71,56,136,169,114,89,25,534
"2011","Southampton 023A","E01017136",1479,114,10,104,193,90,44,47,85,64,23,16,7,819
"2011","Southampton 023B","E01017137",1656,66,7,59,82,55,19,28,75,49,26,18,8,1256
"2011","Southampton 023C","E01017138",2025,217,32,185,314,149,45,56,110,92,52,24,28,990
"2011","Southampton 023D","E01017140",1223,95,10,85,197,122,81,78,155,139,91,51,40,265
"2011","Southampton 024A","E01017217",1118,84,23,61,190,152,102,93,203,152,61,46,15,81
"2011","Southampton 024B","E01017223",1241,148,39,109,294,187,111,89,179,106,51,31,20,76
"2011","Southampton 024C","E01017224",1012,111,21,90,246,168,106,72,142,67,31,16,15,69
"2011","Southampton 024D","E01017225",1092,88,17,71,191,145,119,88,187,158,52,39,13,64
"2011","Southampton 025A","E01017162",1011,61,12,49,165,147,119,65,200,169,37,31,6,48
"2011","Southampton 025B","E01017163",1033,23,6,17,95,106,82,79,250,234,116,68,48,48
"2011","Southampton 025C","E01017164",1125,81,22,59,212,165,109,88,199,150,63,38,25,58
"2011","Southampton 025D","E01017165",997,28,7,21,120,110,91,105,221,179,63,44,19,80
"2011","Southampton 025E","E01017166",1007,30,10,20,118,97,70,82,248,211,94,62,32,57
"2011","Southampton 026A","E01017256",1490,126,32,94,307,278,140,136,230,155,48,35,13,70
"2011","Southampton 026B","E01017257",1187,55,17,38,229,171,125,121,217,166,41,19,22,62
"2011","Southampton 026C","E01017259",1078,81,25,56,213,170,101,98,190,145,21,14,7,59
"2011","Southampton 026D","E01017260",1001,53,15,38,183,170,106,96,199,132,24,9,15,38
"2011","Southampton 026E","E01017262",978,39,11,28,132,145,96,94,210,155,49,36,13,58
"2011","Southampton 027A","E01017167",1039,23,4,19,90,98,80,96,266,219,116,70,46,51
"2011","Southampton 027B","E01017168",1220,67,14,53,207,146,105,113,240,221,77,49,28,44
"2011","Southampton 027C","E01017169",1054,34,14,20,142,122,76,91,262,173,94,68,26,60
"2011","Southampton 027D","E01017170",1107,49,11,38,171,150,109,92,249,163,65,47,18,59
"2011","Southampton 028A","E01017218",974,44,15,29,144,88,82,91,198,189,46,30,16,92
"2011","Southampton 028B","E01017219",1297,76,13,63,225,148,126,121,248,190,92,45,47,71
"2011","Southampton 028C","E01017220",1371,84,18,66,241,194,116,138,247,178,71,48,23,102
"2011","Southampton 028D","E01017221",1232,96,20,76,236,191,111,99,211,165,49,29,20,74
"2011","Southampton 028E","E01017222",1141,87,22,65,252,163,107,94,187,131,35,20,15,85
"2011","Southampton 029A","E01017139",1976,74,14,60,170,120,116,112,246,246,120,98,22,772
"2011","Southampton 029C","E01017142",2227,330,55,275,414,177,122,66,90,65,41,24,17,922
"2011","Southampton 029E","E01032745",2021,65,2,63,167,91,66,81,143,130,86,63,23,1192
"2011","Southampton 029F","E01032746",1088,223,28,195,277,121,52,60,58,43,28,19,9,226
"2011","Southampton 029G","E01032748",1002,213,25,188,283,98,48,45,73,58,27,13,14,157
"2011","Southampton 029H","E01032751",1001,118,16,102,194,91,80,68,128,106,70,46,24,146
"2011","Southampton 029I","E01032755",748,23,1,22,70,40,90,59,139,133,127,97,30,67
"2011","Southampton 030A","E01017255",1160,98,21,77,212,186,96,122,206,153,35,24,11,52
"2011","Southampton 030B","E01017258",1148,68,16,52,192,167,115,98,215,153,63,41,22,77
"2011","Southampton 030C","E01017261",1266,104,22,82,246,213,126,124,206,149,30,19,11,68
"2011","Southampton 030D","E01017263",1038,50,11,39,177,153,106,84,181,180,55,36,19,52
"2011","Southampton 031A","E01017273",1000,115,34,81,225,154,91,66,133,108,46,37,9,62
"2011","Southampton 031B","E01017275",1230,104,26,78,260,135,115,106,197,156,64,36,28,93
"2011","Southampton 031C","E01017276",1302,79,18,61,249,157,115,121,248,160,78,48,30,95
"2011","Southampton 031D","E01017278",1017,90,16,74,225,158,89,92,176,105,30,15,15,52
"2011","Southampton 031E","E01017279",1223,122,27,95,290,193,107,99,187,119,47,27,20,59
"2011","Southampton 032A","E01017274",1015,30,10,20,133,94,72,90,242,198,90,61,29,66
"2011","Southampton 032B","E01017277",1090,50,17,33,183,173,103,94,204,167,47,28,19,69
"2011","Southampton 032C","E01017280",977,22,0,22,122,113,87,100,231,179,67,38,29,56
"2011","Southampton 032D","E01017281",1135,18,4,14,112,100,91,111,276,224,159,78,81,44
"2011","West Berkshire 001A","E01016277",1031,201,61,140,267,117,119,51,80,59,15,9,6,122
"2011","West Berkshire 001B","E01016286",1142,231,45,186,298,115,114,73,104,113,31,18,13,63
"2011","West Berkshire 001C","E01016287",1083,168,31,137,301,111,149,63,112,108,16,13,3,55
"2011","West Berkshire 001D","E01016288",1197,187,53,134,341,137,166,70,99,110,24,15,9,63
"2011","West Berkshire 002A","E01016303",1078,186,42,144,297,122,164,53,113,85,17,9,8,41
"2011","West Berkshire 002B","E01016304",1182,162,45,117,290,114,179,83,128,134,44,27,17,48
"2011","West Berkshire 002C","E01016305",962,128,26,102,241,87,124,78,91,154,20,11,9,39
"2011","West Berkshire 002D","E01016306",979,85,24,61,182,102,95,65,174,195,40,19,21,41
"2011","West Berkshire 003A","E01016256",1292,310,74,236,405,110,161,61,96,58,26,15,11,65
"2011","West Berkshire 003B","E01016257",928,230,44,186,293,110,114,16,60,27,22,11,11,56
"2011","West Berkshire 003C","E01016313",1167,207,34,173,340,146,122,70,120,76,34,19,15,52
"2011","West Berkshire 003D","E01016314",947,208,65,143,303,94,92,20,40,21,15,14,1,154
"2011","West Berkshire 004A","E01016315",1185,222,54,168,333,210,132,53,119,50,14,6,8,52
"2011","West Berkshire 004B","E01016316",1515,281,59,222,441,226,142,81,165,81,19,13,6,79
"2011","West Berkshire 004C","E01016317",1063,192,38,154,276,143,86,50,111,58,77,63,14,70
"2011","West Berkshire 004D","E01016318",1133,174,32,142,297,224,105,70,129,64,19,9,10,51
"2011","West Berkshire 005A","E01016258",1160,128,28,100,243,215,112,82,171,124,31,21,10,54
"2011","West Berkshire 005B","E01016261",1241,204,44,160,324,215,121,74,132,65,13,5,8,93
"2011","West Berkshire 005C","E01016349",884,107,15,92,192,146,95,86,126,77,13,2,11,42
"2011","West Berkshire 005D","E01016350",1101,113,28,85,237,222,107,95,154,99,15,6,9,59
"2011","West Berkshire 006A","E01016259",1177,139,25,114,270,232,102,90,159,85,25,15,10,75
"2011","West Berkshire 006B","E01016260",1238,170,38,132,299,233,130,95,126,73,35,20,15,77
"2011","West Berkshire 006C","E01016262",965,104,29,75,203,207,98,73,130,78,17,9,8,55
"2011","West Berkshire 006D","E01016272",1195,173,34,139,315,218,107,68,138,71,26,13,13,79
"2011","West Berkshire 006E","E01016273",1018,92,18,74,162,149,98,90,177,142,45,25,20,63
"2011","West Berkshire 007A","E01016263",1534,314,65,249,462,216,148,67,145,81,22,9,13,79
"2011","West Berkshire 007B","E01016278",936,175,65,110,284,173,74,40,85,37,10,6,4,58
"2011","West Berkshire 007C","E01016283",1333,256,54,202,344,155,127,31,95,47,26,18,8,252
"2011","West Berkshire 007D","E01016284",1023,161,37,124,292,138,104,52,112,75,26,13,13,63
"2011","West Berkshire 007E","E01016285",1135,210,44,166,284,114,172,88,103,81,20,5,15,63
"2011","West Berkshire 008A","E01016271",1100,94,19,75,188,186,95,90,195,136,44,32,12,72
"2011","West Berkshire 008B","E01016274",1079,146,43,103,255,188,110,49,153,70,32,20,12,76
"2011","West Berkshire 008C","E01016275",1107,166,33,133,256,197,89,84,154,84,29,15,14,48
"2011","West Berkshire 008D","E01016276",1111,143,25,118,257,204,105,63,152,91,24,10,14,72
"2011","West Berkshire 009A","E01016327",889,163,39,124,251,125,103,53,86,54,16,9,7,38
"2011","West Berkshire 009B","E01016328",1256,165,50,115,298,189,148,84,141,124,32,15,17,75
"2011","West Berkshire 009C","E01016344",1093,121,22,99,265,173,89,91,118,144,36,21,15,56
"2011","West Berkshire 009D","E01016345",1013,148,30,118,224,166,101,86,125,90,30,22,8,43
"2011","West Berkshire 010A","E01016296",1174,165,49,116,276,135,162,89,183,99,30,11,19,35
"2011","West Berkshire 010B","E01016297",1099,116,27,89,193,136,134,85,189,169,22,8,14,55
"2011","West Berkshire 010C","E01016298",852,133,31,102,224,90,117,62,101,76,20,14,6,29
"2011","West Berkshire 010D","E01016299",1105,176,38,138,281,168,121,70,145,82,32,24,8,30
"2011","West Berkshire 011A","E01016254",1005,148,38,110,224,142,143,59,145,78,27,17,10,39
"2011","West Berkshire 011B","E01016255",1120,203,58,145,326,128,165,61,98,71,18,11,7,50
"2011","West Berkshire 011C","E01016264",1040,137,33,104,256,76,104,40,44,37,13,9,4,333
"2011","West Berkshire 011D","E01016265",1065,209,62,147,327,129,135,49,78,58,23,14,9,57
"2011","West Berkshire 011E","E01016266",998,203,60,143,260,124,126,41,83,66,28,26,2,67
"2011","West Berkshire 011F","E01016339",2155,346,56,290,514,332,178,148,277,201,79,66,13,80
"2011","West Berkshire 012A","E01016310",1268,178,31,147,276,154,132,87,208,126,51,28,23,56
"2011","West Berkshire 012B","E01016311",1212,236,45,191,336,160,97,57,141,93,36,24,12,56
"2011","West Berkshire 012C","E01016323",988,165,33,132,239,143,100,79,128,74,24,14,10,36
"2011","West Berkshire 012D","E01016324",1015,147,35,112,250,136,117,59,138,98,23,13,10,47
"2011","West Berkshire 012E","E01016325",1031,104,26,78,188,130,110,104,187,124,42,22,20,42
"2011","West Berkshire 013A","E01016279",1584,211,41,170,304,205,132,124,239,191,96,64,32,82
"2011","West Berkshire 013B","E01016280",1307,133,19,114,238,142,102,112,256,193,80,48,32,51
"2011","West Berkshire 013C","E01016281",1058,159,27,132,235,172,94,67,140,96,38,24,14,57
"2011","West Berkshire 013D","E01016282",1097,188,38,150,297,156,91,64,149,96,21,13,8,35
"2011","West Berkshire 014A","E01016329",1134,150,37,113,271,221,91,110,131,101,16,8,8,43
"2011","West Berkshire 014B","E01016340",1117,100,21,79,204,151,113,105,193,152,33,13,20,66
"2011","West Berkshire 014C","E01016341",1057,86,21,65,216,150,109,88,178,145,27,15,12,58
"2011","West Berkshire 014D","E01016342",1517,160,41,119,341,247,112,136,245,158,34,16,18,84
"2011","West Berkshire 014E","E01016343",1104,122,28,94,235,196,112,79,172,104,16,7,9,68
"2011","West Berkshire 015A","E01016267",1057,215,49,166,321,161,111,55,79,40,18,12,6,57
"2011","West Berkshire 015B","E01016268",1117,167,28,139,231,162,101,86,161,98,44,31,13,67
"2011","West Berkshire 015C","E01016269",1053,196,52,144,312,158,116,59,70,61,19,12,7,62
"2011","West Berkshire 015D","E01016270",1053,203,40,163,394,153,75,40,68,44,13,11,2,63
"2011","West Berkshire 016A","E01016330",1085,137,19,118,209,197,97,95,175,107,26,14,12,42
"2011","West Berkshire 016B","E01016331",1135,103,33,70,215,163,99,107,186,160,34,17,17,68
"2011","West Berkshire 016C","E01016332",1060,133,28,105,198,169,126,77,167,109,29,13,16,52
"2011","West Berkshire 016D","E01016334",1219,179,28,151,283,177,87,75,166,122,50,25,25,80
"2011","West Berkshire 016E","E01016336",874,55,10,45,118,93,68,99,173,145,56,36,20,67
"2011","West Berkshire 017A","E01016333",965,212,37,175,255,165,67,50,79,51,19,10,9,67
"2011","West Berkshire 017B","E01016335",1165,188,34,154,284,200,112,73,140,99,17,8,9,52
"2011","West Berkshire 017C","E01016337",1525,171,33,138,345,210,115,138,238,190,41,20,21,77
"2011","West Berkshire 017D","E01016338",1406,246,49,197,345,255,89,79,174,107,22,8,14,89
"2011","West Berkshire 018A","E01016300",1036,196,39,157,268,117,121,71,120,80,21,12,9,42
"2011","West Berkshire 018B","E01016301",1468,250,74,176,396,170,215,108,137,76,42,25,17,74
"2011","West Berkshire 018C","E01016302",1211,221,62,159,317,140,165,59,125,107,20,13,7,57
"2011","West Berkshire 018D","E01016326",937,198,38,160,261,103,116,58,93,61,21,18,3,26
"2011","West Berkshire 019A","E01016293",1964,354,89,265,478,248,152,109,259,145,72,49,23,147
"2011","West Berkshire 019B","E01016346",1042,165,19,146,215,119,85,89,161,128,52,37,15,28
"2011","West Berkshire 019C","E01016347",1131,185,25,160,260,128,80,81,167,118,63,40,23,49
"2011","West Berkshire 019D","E01016348",1600,270,38,232,402,219,133,112,225,125,65,45,20,49
"2011","West Berkshire 020A","E01016294",1142,170,26,144,306,176,110,66,162,91,25,9,16,36
"2011","West Berkshire 020B","E01016295",1061,71,14,57,171,92,79,96,235,178,84,39,45,55
"2011","West Berkshire 020C","E01016312",1455,255,36,219,339,179,123,94,193,148,58,29,29,66
"2011","West Berkshire 020D","E01016319",1140,182,45,137,306,153,113,47,165,83,27,17,10,64
"2011","West Berkshire 020E","E01016320",1033,187,38,149,258,140,96,63,145,60,25,15,10,59
"2011","West Berkshire 021A","E01016289",1001,227,54,173,316,143,90,39,84,31,13,8,5,58
"2011","West Berkshire 021B","E01016290",1126,186,35,151,312,177,96,58,158,64,12,4,8,63
"2011","West Berkshire 021C","E01016291",1230,273,58,215,376,179,116,51,110,58,13,9,4,54
"2011","West Berkshire 021D","E01016292",1132,154,32,122,237,130,123,90,192,120,21,14,7,65
"2011","West Berkshire 021E","E01016321",1114,170,22,148,275,162,85,76,139,104,38,20,18,65
"2011","West Berkshire 021F","E01016322",903,173,30,143,253,157,82,37,75,50,8,6,2,68
"2011","West Berkshire 022A","E01016307",1098,186,49,137,266,156,104,76,134,102,24,15,9,50
"2011","West Berkshire 022B","E01016308",1326,321,63,258,375,181,152,50,90,62,31,22,9,64
"2011","West Berkshire 022C","E01016309",1616,298,78,220,412,184,198,83,153,108,35,23,12,145
"2011","Windsor and Maidenhead 001A","E01016570",1164,245,58,187,344,197,99,54,78,46,23,16,7,78
"2011","Windsor and Maidenhead 001B","E01016572",915,174,50,124,253,139,76,46,89,53,31,18,13,54
"2011","Windsor and Maidenhead 001C","E01016582",1049,136,20,116,206,117,138,63,115,93,101,91,10,80
"2011","Windsor and Maidenhead 001D","E01016600",820,193,51,142,241,103,96,25,44,28,38,35,3,52
"2011","Windsor and Maidenhead 002A","E01016530",1020,147,23,124,222,139,124,74,132,99,31,17,14,52
"2011","Windsor and Maidenhead 002B","E01016531",1036,279,89,190,353,100,140,21,64,21,12,9,3,46
"2011","Windsor and Maidenhead 002C","E01016532",1427,322,71,251,426,148,177,88,118,59,25,15,10,64
"2011","Windsor and Maidenhead 002D","E01016533",1361,328,95,233,481,147,191,43,61,32,17,10,7,61
"2011","Windsor and Maidenhead 002E","E01016578",1096,233,83,150,264,137,189,52,91,51,30,23,7,49
"2011","Windsor and Maidenhead 002F","E01016579",1231,245,83,162,335,120,166,76,114,69,36,18,18,70
"2011","Windsor and Maidenhead 002G","E01016581",1052,189,64,125,318,124,157,48,82,51,17,7,10,66
"2011","Windsor and Maidenhead 003A","E01016571",1130,208,38,170,326,141,89,56,115,71,39,25,14,85
"2011","Windsor and Maidenhead 003B","E01016573",1012,75,16,59,163,120,119,109,174,122,77,56,21,53
"2011","Windsor and Maidenhead 003C","E01016574",1052,80,12,68,210,157,107,85,154,112,82,67,15,65
"2011","Windsor and Maidenhead 003D","E01016599",1175,84,22,62,206,132,130,88,210,159,82,50,32,84
"2011","Windsor and Maidenhead 004A","E01016583",1199,255,56,199,389,157,118,43,86,42,34,22,12,75
"2011","Windsor and Maidenhead 004B","E01016585",1267,329,65,264,394,139,117,51,76,50,39,29,10,72
"2011","Windsor and Maidenhead 004C","E01016586",975,244,67,177,348,116,96,22,50,18,16,12,4,65
"2011","Windsor and Maidenhead 004D","E01016591",1248,306,93,213,390,159,130,35,65,35,26,17,9,102
"2011","Windsor and Maidenhead 004E","E01016592",1282,334,65,269,365,157,100,57,92,71,34,24,10,72
"2011","Windsor and Maidenhead 005A","E01016525",1144,315,60,255,369,121,104,35,72,41,21,14,7,66
"2011","Windsor and Maidenhead 005B","E01016528",1149,209,46,163,346,129,122,60,101,64,42,32,10,76
"2011","Windsor and Maidenhead 005C","E01016529",1136,121,24,97,218,136,97,96,158,133,96,71,25,81
"2011","Windsor and Maidenhead 005D","E01016536",1409,319,64,255,395,157,96,100,135,88,59,31,28,60
"2011","Windsor and Maidenhead 005E","E01016584",1220,167,29,138,259,148,124,99,174,109,86,67,19,54
"2011","Windsor and Maidenhead 005G","E01032733",765,117,20,97,195,111,47,51,107,77,37,25,12,23
"2011","Windsor and Maidenhead 005H","E01032734",1088,145,28,117,242,143,76,98,149,90,85,45,40,60
"2011","Windsor and Maidenhead 006A","E01016526",1296,314,58,256,434,171,106,38,84,35,41,28,13,73
"2011","Windsor and Maidenhead 006B","E01016527",1162,261,47,214,346,142,98,59,92,66,38,29,9,60
"2011","Windsor and Maidenhead 006C","E01016534",1125,255,79,176,336,144,127,32,89,37,17,16,1,88
"2011","Windsor and Maidenhead 006D","E01016598",953,186,43,143,285,140,101,35,77,36,25,15,10,68
"2011","Windsor and Maidenhead 006E","E01016601",1132,222,47,175,304,164,89,64,100,79,34,13,21,76
"2011","Windsor and Maidenhead 006F","E01016602",1104,215,59,156,294,183,141,47,81,51,20,16,4,72
"2011","Windsor and Maidenhead 007A","E01016535",917,127,27,100,235,119,102,72,115,55,41,31,10,51
"2011","Windsor and Maidenhead 007B","E01016537",1073,148,32,116,206,97,123,73,143,125,70,55,15,88
"2011","Windsor and Maidenhead 007C","E01016538",1176,196,36,160,335,137,123,77,107,95,41,22,19,65
"2011","Windsor and Maidenhead 007D","E01016593",1190,118,24,94,203,145,109,115,198,173,63,38,25,66
"2011","Windsor and Maidenhead 007E","E01016594",1052,126,23,103,208,121,88,79,160,130,84,53,31,56
"2011","Windsor and Maidenhead 008A","E01016559",1081,186,50,136,291,191,136,53,99,43,15,6,9,67
"2011","Windsor and Maidenhead 008B","E01016560",1057,110,22,88,186,122,116,85,189,142,49,21,28,58
"2011","Windsor and Maidenhead 008C","E01016561",1376,230,55,175,349,232,118,102,149,78,28,18,10,90
"2011","Windsor and Maidenhead 008D","E01016562",1054,172,43,129,291,192,100,48,102,73,21,13,8,55
"2011","Windsor and Maidenhead 008E","E01016563",1050,180,36,144,301,216,69,64,83,48,12,6,6,77
"2011","Windsor and Maidenhead 008F","E01016580",1115,110,19,91,208,161,101,95,185,141,50,25,25,64
"2011","Windsor and Maidenhead 009A","E01016539",1162,272,69,203,333,145,142,41,80,38,42,26,16,69
"2011","Windsor and Maidenhead 009B","E01016540",1229,235,61,174,317,139,204,53,95,72,33,13,20,81
"2011","Windsor and Maidenhead 009C","E01016541",1062,192,39,153,296,171,112,53,102,51,25,21,4,60
"2011","Windsor and Maidenhead 009D","E01016542",851,132,43,89,220,118,88,62,105,57,27,16,11,42
"2011","Windsor and Maidenhead 009E","E01016543",1189,268,81,187,349,162,171,55,65,43,22,12,10,54
"2011","Windsor and Maidenhead 010A","E01016544",1396,289,83,206,528,161,114,78,95,77,23,10,13,31
"2011","Windsor and Maidenhead 010B","E01016567",1921,229,53,176,495,161,99,136,113,126,21,14,7,541
"2011","Windsor and Maidenhead 010C","E01016568",885,99,19,80,199,138,80,73,111,104,17,5,12,64
"2011","Windsor and Maidenhead 010D","E01016569",777,100,23,77,188,131,66,60,84,84,22,6,16,42
"2011","Windsor and Maidenhead 011A","E01016564",1150,189,45,144,302,157,111,77,101,70,55,31,24,88
"2011","Windsor and Maidenhead 011B","E01016565",1132,258,80,178,356,144,123,52,69,45,26,22,4,59
"2011","Windsor and Maidenhead 011C","E01016566",1290,191,44,147,339,195,117,105,123,94,67,35,32,59
"2011","Windsor and Maidenhead 011D","E01016577",1285,180,38,142,310,176,174,85,126,92,60,43,17,82
"2011","Windsor and Maidenhead 012A","E01016545",1463,370,90,280,476,156,127,57,118,68,41,29,12,50
"2011","Windsor and Maidenhead 012B","E01016547",1305,337,67,270,464,138,114,44,92,44,23,14,9,49
"2011","Windsor and Maidenhead 012C","E01016550",1146,212,75,137,354,197,71,72,83,76,27,14,13,54
"2011","Windsor and Maidenhead 012D","E01016552",1162,231,49,182,375,143,91,55,116,62,25,10,15,64
"2011","Windsor and Maidenhead 013A","E01016551",1132,163,36,127,285,200,132,60,125,73,34,23,11,60
"2011","Windsor and Maidenhead 013B","E01016553",1054,120,28,92,267,175,99,84,132,83,24,13,11,70
"2011","Windsor and Maidenhead 013C","E01016557",1378,141,39,102,315,232,126,109,208,123,41,27,14,83
"2011","Windsor and Maidenhead 013D","E01016558",1149,74,29,45,361,219,65,93,141,96,45,26,19,55
"2011","Windsor and Maidenhead 014A","E01016548",1405,301,68,233,423,208,119,83,98,63,42,29,13,68
"2011","Windsor and Maidenhead 014B","E01016549",1348,230,50,180,396,169,114,75,143,94,42,31,11,85
"2011","Windsor and Maidenhead 014C","E01016554",1046,105,28,77,212,148,91,82,168,119,51,27,24,70
"2011","Windsor and Maidenhead 014D","E01016555",1057,94,21,73,214,136,87,76,166,159,53,27,26,72
"2011","Windsor and Maidenhead 014E","E01016556",1260,112,31,81,275,182,125,89,218,141,45,19,26,73
"2011","Windsor and Maidenhead 015A","E01016546",1213,378,77,301,414,115,117,31,49,36,25,14,11,48
"2011","Windsor and Maidenhead 015B","E01016595",1206,216,64,152,368,169,96,53,105,79,45,21,24,75
"2011","Windsor and Maidenhead 015C","E01016596",1302,307,57,250,436,148,107,53,92,57,37,22,15,65
"2011","Windsor and Maidenhead 015D","E01016597",1298,286,86,200,380,180,157,39,92,30,34,24,10,100
"2011","Windsor and Maidenhead 016A","E01016575",1280,210,56,154,336,192,175,77,101,65,35,24,11,89
"2011","Windsor and Maidenhead 016B","E01016576",1260,227,56,171,370,190,140,58,90,60,35,25,10,90
"2011","Windsor and Maidenhead 016C","E01016587",1133,167,41,126,317,171,105,71,114,80,35,27,8,73
"2011","Windsor and Maidenhead 016D","E01016588",1312,166,40,126,328,165,124,123,169,132,41,29,12,64
"2011","Windsor and Maidenhead 016E","E01016589",1122,234,52,182,337,164,119,54,84,52,28,21,7,50
"2011","Windsor and Maidenhead 017A","E01016522",1433,346,92,254,442,200,118,53,86,45,35,21,14,108
"2011","Windsor and Maidenhead 017B","E01016523",1173,228,62,166,294,109,136,58,63,54,30,19,11,201
"2011","Windsor and Maidenhead 017C","E01016524",1443,331,94,237,459,159,164,67,92,49,34,20,14,88
"2011","Windsor and Maidenhead 017D","E01016609",1273,192,40,152,309,174,128,99,149,102,44,23,21,76
"2011","Windsor and Maidenhead 018A","E01016603",1213,308,80,228,369,145,133,43,59,34,43,30,13,79
"2011","Windsor and Maidenhead 018B","E01016604",1319,303,116,187,429,144,154,32,83,43,44,28,16,87
"2011","Windsor and Maidenhead 018C","E01016605",1089,203,52,151,316,136,110,69,109,67,19,9,10,60
"2011","Windsor and Maidenhead 018D","E01016606",1177,264,80,184,388,148,112,39,71,35,28,17,11,92
"2011","Windsor and Maidenhead 018E","E01016607",1181,244,80,164,334,137,109,25,55,34,28,21,7,215
"2011","Windsor and Maidenhead 018F","E01016608",1251,254,61,193,362,152,128,69,104,70,36,22,14,76
"2011","Wokingham 001A","E01016675",746,181,57,124,224,60,115,26,48,21,22,12,10,49
"2011","Wokingham 001B","E01016676",1076,284,66,218,340,151,119,21,54,21,14,12,2,72
"2011","Wokingham 001C","E01016677",1065,206,55,151,290,117,133,67,93,74,26,20,6,59
"2011","Wokingham 001D","E01016678",1011,186,45,141,277,104,126,48,120,64,42,31,11,44
"2011","Wokingham 002A","E01016619",1110,272,69,203,338,145,104,58,74,40,23,13,10,56
"2011","Wokingham 002B","E01016620",1087,238,56,182,318,135,89,58,105,57,23,12,11,64
"2011","Wokingham 002C","E01016692",991,208,41,167,276,151,88,50,95,58,19,9,10,46
"2011","Wokingham 002D","E01016693",1054,271,53,218,338,153,92,42,70,29,21,8,13,38
"2011","Wokingham 002E","E01016694",978,241,47,194,312,124,95,45,87,29,16,6,10,29
"2011","Wokingham 002F","E01016695",1112,274,54,220,337,174,88,35,87,40,17,11,6,60
"2011","Wokingham 003A","E01016621",1087,157,34,123,298,170,98,79,119,67,29,17,12,70
"2011","Wokingham 003B","E01016623",1046,154,28,126,293,161,111,64,116,75,24,14,10,48
"2011","Wokingham 003C","E01016624",1016,185,28,157,289,177,90,55,92,46,19,11,8,63
"2011","Wokingham 003D","E01016684",1174,193,41,152,306,190,143,45,113,80,24,17,7,80
"2011","Wokingham 003E","E01016685",1109,248,48,200,318,132,115,46,85,41,37,25,12,87
"2011","Wokingham 004A","E01016622",918,189,40,149,280,133,88,42,73,37,13,5,8,63
"2011","Wokingham 004B","E01016657",1024,266,54,212,341,138,100,37,49,45,7,2,5,41
"2011","Wokingham 004C","E01016658",999,204,41,163,283,170,73,39,70,54,13,10,3,93
"2011","Wokingham 004D","E01016659",1058,162,30,132,307,178,76,49,135,60,21,9,12,70
"2011","Wokingham 004E","E01016660",1207,194,33,161,322,207,118,68,127,67,17,7,10,87
"2011","Wokingham 005A","E01016615",1040,79,13,66,199,124,95,65,192,145,69,53,16,72
"2011","Wokingham 005B","E01016616",1000,130,25,105,209,158,107,60,153,96,36,25,11,51
"2011","Wokingham 005C","E01016617",891,109,24,85,222,159,90,68,108,60,27,17,10,48
"2011","Wokingham 005D","E01016662",1180,114,26,88,233,161,109,100,188,145,64,42,22,66
"2011","Wokingham 006A","E01016613",1095,143,18,125,212,129,112,40,153,93,91,76,15,122
"2011","Wokingham 006B","E01016614",1021,146,22,124,224,144,113,51,123,75,61,50,11,84
"2011","Wokingham 006C","E01016618",941,147,24,123,237,128,91,36,96,59,40,34,6,107
"2011","Wokingham 006D","E01016664",832,165,23,142,235,127,65,41,78,29,21,11,10,71
"2011","Wokingham 006E","E01016668",1132,234,26,208,293,146,88,52,116,44,43,26,17,116
"2011","Wokingham 006F","E01016669",1256,213,22,191,349,165,129,78,127,64,35,30,5,96
"2011","Wokingham 007A","E01016661",1012,136,18,118,259,161,114,79,124,54,27,17,10,58
"2011","Wokingham 007B","E01016663",1139,161,26,135,290,182,118,73,134,84,30,16,14,67
"2011","Wokingham 007C","E01016686",900,120,26,94,217,170,82,64,121,65,17,11,6,44
"2011","Wokingham 007D","E01016687",940,125,29,96,221,165,93,60,137,69,19,13,6,51
"2011","Wokingham 007E","E01016688",1344,120,24,96,235,164,77,77,130,62,26,17,9,453
"2011","Wokingham 007F","E01016689",1023,142,18,124,257,172,104,64,139,74,25,17,8,46
"2011","Wokingham 008B","E01016652",949,214,29,185,245,162,66,45,80,39,15,8,7,83
"2011","Wokingham 008C","E01016653",1210,234,36,198,248,152,67,33,67,47,24,12,12,338
"2011","Wokingham 008D","E01016665",1158,213,34,179,291,198,95,61,136,73,29,20,9,62
"2011","Wokingham 008E","E01016666",1067,186,30,156,315,168,96,52,98,50,26,20,6,76
"2011","Wokingham 008G","E01032761",1963,427,64,363,517,260,150,66,127,58,52,33,19,306
"2011","Wokingham 009A","E01016647",1361,332,61,271,359,182,107,58,116,64,45,27,18,98
"2011","Wokingham 009B","E01016701",1282,273,62,211,369,188,114,53,113,48,36,28,8,88
"2011","Wokingham 009C","E01016702",1352,245,55,190,354,201,123,69,130,86,67,49,18,77
"2011","Wokingham 009D","E01016703",1333,279,53,226,378,174,119,69,123,67,44,33,11,80
"2011","Wokingham 009E","E01016704",1420,228,44,184,338,182,112,92,188,115,77,49,28,88
"2011","Wokingham 010A","E01016627",1384,286,76,210,420,209,125,65,120,54,32,21,11,73
"2011","Wokingham 010B","E01016628",1099,230,55,175,305,180,110,57,89,54,18,10,8,56
"2011","Wokingham 010C","E01016656",1048,213,58,155,315,127,159,39,65,39,25,16,9,66
"2011","Wokingham 010D","E01016700",1445,314,60,254,433,213,118,68,112,60,26,19,7,101
"2011","Wokingham 011A","E01016644",1066,197,26,171,301,200,72,59,99,56,21,15,6,61
"2011","Wokingham 011B","E01016645",1192,236,29,207,345,204,103,70,96,71,20,13,7,47
"2011","Wokingham 011C","E01016646",1208,245,31,214,332,208,102,62,97,59,26,13,13,77
"2011","Wokingham 011D","E01016648",1101,257,39,218,294,190,82,54,87,48,30,19,11,59
"2011","Wokingham 011E","E01016649",1139,228,42,186,315,198,78,58,103,50,36,20,16,73
"2011","Wokingham 012A","E01016651",1052,223,36,187,295,151,81,53,107,42,26,17,9,74
"2011","Wokingham 012B","E01016654",1046,234,44,190,284,176,74,43,93,44,24,15,9,74
"2011","Wokingham 012C","E01016655",1018,217,31,186,305,159,69,52,88,58,16,9,7,54
"2011","Wokingham 012D","E01016679",1644,293,46,247,412,222,145,93,178,107,88,62,26,106
"2011","Wokingham 012E","E01016680",906,132,15,117,193,122,65,59,108,88,58,42,16,81
"2011","Wokingham 012G","E01032758",1158,259,51,208,301,153,97,62,112,70,37,21,16,67
"2011","Wokingham 012H","E01032759",1074,233,35,198,297,152,108,55,88,71,27,18,9,43
"2011","Wokingham 013A","E01016626",1177,233,42,191,355,171,86,46,112,73,43,29,14,58
"2011","Wokingham 013B","E01016671",1039,234,57,177,363,160,53,47,79,40,30,17,13,33
"2011","Wokingham 013C","E01016673",1210,125,24,101,250,124,109,101,177,173,72,42,30,79
"2011","Wokingham 013D","E01016674",1059,153,31,122,277,161,88,51,136,96,40,21,19,57
"2011","Wokingham 013E","E01016696",1115,242,43,199,352,138,61,72,125,54,21,14,7,50
"2011","Wokingham 014A","E01016670",1506,425,97,328,451,221,104,56,104,49,26,14,12,70
"2011","Wokingham 014B","E01016672",1309,298,56,242,368,217,110,53,114,51,24,14,10,74
"2011","Wokingham 014E","E01032763",1657,393,88,305,536,214,112,53,139,75,41,34,7,94
"2011","Wokingham 015A","E01016612",1592,435,98,337,466,224,153,47,102,47,19,7,12,99
"2011","Wokingham 015B","E01016629",997,233,54,179,313,161,65,34,75,33,17,7,10,66
"2011","Wokingham 015C","E01016630",1134,276,53,223,348,178,67,45,103,30,13,4,9,74
"2011","Wokingham 015D","E01016635",1020,243,49,194,295,170,70,41,83,29,9,7,2,80
"2011","Wokingham 016A","E01016625",1148,292,46,246,354,164,90,43,88,40,15,6,9,62
"2011","Wokingham 016B","E01016631",993,172,30,142,272,146,63,58,127,70,25,14,11,60
"2011","Wokingham 016C","E01016632",1155,276,49,227,358,198,74,54,77,42,15,9,6,61
"2011","Wokingham 016D","E01016634",1053,254,49,205,297,157,103,38,77,48,23,9,14,56
"2011","Wokingham 016E","E01016699",1095,266,70,196,337,131,93,32,81,62,20,11,9,73
"2011","Wokingham 017A","E01016682",1374,276,71,205,386,209,160,64,111,84,40,28,12,44
"2011","Wokingham 017B","E01016683",1389,266,57,209,408,206,167,68,122,61,25,14,11,66
"2011","Wokingham 017C","E01016690",1302,238,47,191,324,140,153,84,145,117,35,19,16,66
"2011","Wokingham 017D","E01016691",847,206,54,152,233,90,103,35,65,43,26,20,6,46
"2011","Wokingham 018A","E01016610",2026,361,88,273,628,267,182,126,173,124,49,25,24,116
"2011","Wokingham 018B","E01016611",1109,181,106,75,283,351,68,48,74,47,25,13,12,32
"2011","Wokingham 018C","E01016641",1011,220,64,156,267,116,142,37,84,53,34,26,8,58
"2011","Wokingham 018D","E01016642",833,107,28,79,188,92,80,60,128,99,34,20,14,45
"2011","Wokingham 019A","E01016633",1001,259,71,188,319,127,82,28,58,36,13,11,2,79
"2011","Wokingham 019B","E01016636",1059,228,53,175,341,158,111,29,75,38,16,9,7,63
"2011","Wokingham 019C","E01016637",807,195,60,135,261,109,88,21,43,20,11,5,6,59
"2011","Wokingham 019D","E01016638",954,222,35,187,307,140,73,40,65,42,7,5,2,58
"2011","Wokingham 019E","E01016639",1158,262,64,198,334,169,98,51,97,59,22,9,13,66
"2011","Wokingham 019F","E01016640",1148,275,76,199,365,131,131,40,67,45,28,25,3,66
"2011","Wokingham 019G","E01016643",1018,285,67,218,321,145,57,34,75,23,13,6,7,65
"2011","Wokingham 020A","E01016705",1050,188,38,150,262,119,88,48,93,66,134,126,8,52
"2011","Wokingham 020B","E01016706",1236,283,62,221,401,178,103,50,97,37,14,7,7,73
"2011","Wokingham 020C","E01016707",1140,205,49,156,322,182,118,70,101,56,13,7,6,73
"2011","Wokingham 020D","E01016708",1188,288,71,217,365,165,110,35,100,41,15,10,5,69
"2011","Wokingham 020E","E01016709",1075,232,45,187,344,169,96,38,79,39,10,6,4,68
"2011","Aylesbury Vale 001A","E01017648",1357,227,61,166,383,186,120,66,166,80,22,17,5,107
"2011","Aylesbury Vale 001B","E01017649",1545,194,41,153,345,167,121,94,168,125,53,26,27,278
"2011","Aylesbury Vale 001C","E01017650",1193,185,59,126,314,179,116,66,134,80,26,13,13,93
"2011","Aylesbury Vale 001F","E01032960",2153,283,77,206,490,224,260,109,200,120,43,26,17,424
"2011","Aylesbury Vale 002A","E01017644",1148,93,26,67,277,173,98,98,183,118,22,13,9,86
"2011","Aylesbury Vale 002B","E01017645",1219,89,15,74,177,81,68,64,99,90,48,26,22,503
"2011","Aylesbury Vale 002C","E01017646",1265,128,26,102,292,147,110,98,210,163,40,19,21,77
"2011","Aylesbury Vale 002D","E01017647",1184,222,59,163,378,188,89,58,111,49,15,9,6,74
"2011","Aylesbury Vale 003A","E01017671",1170,243,59,184,328,160,155,46,103,51,18,10,8,66
"2011","Aylesbury Vale 003B","E01017672",1099,200,68,132,297,131,164,51,81,81,23,16,7,71
"2011","Aylesbury Vale 003C","E01017695",932,119,30,89,246,139,107,84,89,79,35,23,12,34
"2011","Aylesbury Vale 003D","E01017696",928,159,41,118,259,130,125,42,88,53,17,12,5,55
"2011","Aylesbury Vale 004A","E01017693",818,139,31,108,237,108,114,44,73,54,11,8,3,38
"2011","Aylesbury Vale 004B","E01017694",1619,251,74,177,466,231,219,98,137,94,29,18,11,94
"2011","Aylesbury Vale 004C","E01017713",1069,97,34,63,252,157,124,85,144,138,26,16,10,46
"2011","Aylesbury Vale 004D","E01017714",1045,193,54,139,308,127,155,54,86,57,18,9,9,47
"2011","Aylesbury Vale 004E","E01017717",1214,209,60,149,311,144,185,61,116,106,25,12,13,57
"2011","Aylesbury Vale 004F","E01017718",1166,175,46,129,326,129,203,48,116,74,29,23,6,66
"2011","Aylesbury Vale 005A","E01017735",972,180,39,141,249,131,139,51,88,56,21,8,13,57
"2011","Aylesbury Vale 005B","E01017736",1076,147,46,101,236,143,128,69,131,128,30,18,12,64
"2011","Aylesbury Vale 005C","E01017737",997,158,38,120,285,168,97,68,100,60,13,7,6,48
"2011","Aylesbury Vale 005D","E01017738",1081,161,41,120,300,144,148,49,109,85,34,27,7,51
"2011","Aylesbury Vale 006A","E01017669",1119,190,50,140,286,156,163,44,103,70,31,17,14,76
"2011","Aylesbury Vale 006B","E01017670",1152,198,53,145,297,160,177,55,109,66,29,16,13,61
"2011","Aylesbury Vale 006C","E01017715",837,128,37,91,225,112,146,36,75,55,15,7,8,45
"2011","Aylesbury Vale 006D","E01017716",1317,233,68,165,340,177,208,59,98,87,21,13,8,94
"2011","Aylesbury Vale 007A","E01017641",1233,201,60,141,346,186,141,58,138,66,22,12,10,75
"2011","Aylesbury Vale 007B","E01017731",947,119,37,82,215,111,107,67,137,106,20,12,8,65
"2011","Aylesbury Vale 007C","E01017732",1058,172,43,129,308,146,148,46,82,62,29,22,7,65
"2011","Aylesbury Vale 007D","E01017733",884,137,36,101,222,113,143,34,95,75,18,8,10,47
"2011","Aylesbury Vale 007E","E01017734",1064,210,52,158,335,128,159,37,62,42,12,8,4,79
"2011","Aylesbury Vale 008A","E01017703",923,129,32,97,260,118,137,48,96,55,15,9,6,65
"2011","Aylesbury Vale 008B","E01017704",938,183,56,127,255,96,163,40,84,48,19,16,3,50
"2011","Aylesbury Vale 008C","E01017719",855,82,19,63,208,143,73,58,117,96,19,7,12,59
"2011","Aylesbury Vale 008D","E01017720",965,121,34,87,254,124,141,72,117,66,10,5,5,60
"2011","Aylesbury Vale 008F","E01032958",1122,183,57,126,322,129,165,53,112,71,21,12,9,66
"2011","Aylesbury Vale 008G","E01032959",1145,179,50,129,301,151,88,69,135,104,53,31,22,65
"2011","Aylesbury Vale 009A","E01017651",1161,208,51,157,324,164,168,54,87,53,25,17,8,78
"2011","Aylesbury Vale 009B","E01017652",1070,190,44,146,299,162,133,58,94,66,24,18,6,44
"2011","Aylesbury Vale 009C","E01017657",1012,168,59,109,303,144,159,40,70,49,16,11,5,63
"2011","Aylesbury Vale 009D","E01017658",1074,193,59,134,306,137,146,63,90,52,27,18,9,60
"2011","Aylesbury Vale 009E","E01017701",1555,246,67,179,460,250,159,83,131,102,31,15,16,93
"2011","Aylesbury Vale 009F","E01017702",1074,160,41,119,259,140,155,65,112,127,18,12,6,38
"2011","Aylesbury Vale 010A","E01017642",885,161,32,129,249,103,122,46,82,63,14,8,6,45
"2011","Aylesbury Vale 010B","E01017643",990,170,42,128,248,94,170,49,94,95,25,13,12,45
"2011","Aylesbury Vale 010C","E01017673",937,157,38,119,255,124,137,34,87,58,18,8,10,67
"2011","Aylesbury Vale 010D","E01017674",1512,138,37,101,281,171,257,131,157,206,81,69,12,90
"2011","Aylesbury Vale 011A","E01017659",1120,56,18,38,199,149,89,82,213,175,71,50,21,86
"2011","Aylesbury Vale 011B","E01017660",1222,147,38,109,325,214,105,77,163,109,30,14,16,52
"2011","Aylesbury Vale 011C","E01017661",1112,69,16,53,187,158,90,87,206,167,64,44,20,84
"2011","Aylesbury Vale 011D","E01017664",1125,207,55,152,337,177,89,72,103,67,22,13,9,51
"2011","Aylesbury Vale 012A","E01017705",943,68,27,41,219,167,87,80,146,101,29,15,14,46
"2011","Aylesbury Vale 012B","E01017706",963,56,11,45,184,121,83,86,186,132,45,27,18,70
"2011","Aylesbury Vale 012C","E01017707",927,24,9,15,122,121,80,75,175,148,91,64,27,91
"2011","Aylesbury Vale 012D","E01017708",1090,39,10,29,160,136,83,98,207,205,82,57,25,80
"2011","Aylesbury Vale 013A","E01017665",1103,62,16,46,139,142,94,104,179,188,116,77,39,79
"2011","Aylesbury Vale 013B","E01017666",1183,90,21,69,246,174,84,80,192,164,98,74,24,55
"2011","Aylesbury Vale 013C","E01017667",911,51,8,43,160,116,79,77,160,139,51,36,15,78
"2011","Aylesbury Vale 013D","E01017668",1123,67,17,50,218,194,113,104,182,140,39,27,12,66
"2011","Aylesbury Vale 014A","E01017697",1089,111,27,84,276,197,95,80,139,120,17,6,11,54
"2011","Aylesbury Vale 014B","E01017698",1036,80,18,62,234,135,101,80,167,112,45,31,14,82
"2011","Aylesbury Vale 014C","E01017699",1164,88,11,77,237,134,99,70,158,127,205,186,19,46
"2011","Aylesbury Vale 014D","E01017700",1078,134,37,97,292,193,109,87,131,68,8,4,4,56
"2011","Aylesbury Vale 015B","E01017634",1186,147,22,125,304,138,110,86,141,124,66,56,10,70
"2011","Aylesbury Vale 015C","E01017662",963,68,14,54,235,121,99,53,131,103,86,72,14,67
"2011","Aylesbury Vale 015D","E01017663",1112,72,11,61,177,110,125,72,142,169,153,128,25,92
"2011","Aylesbury Vale 015E","E01032955",928,134,25,109,285,145,60,61,99,63,36,17,19,45
"2011","Aylesbury Vale 015F","E01032961",822,101,17,84,211,102,77,57,113,76,40,20,20,45
"2011","Aylesbury Vale 016A","E01017653",1155,92,23,69,274,184,96,87,183,138,39,27,12,62
"2011","Aylesbury Vale 016B","E01017654",1022,40,14,26,152,130,87,88,187,179,92,69,23,67
"2011","Aylesbury Vale 016C","E01017655",1461,162,44,118,372,244,135,111,226,124,31,16,15,56
"2011","Aylesbury Vale 016E","E01032956",1231,220,47,173,424,209,91,65,106,76,10,5,5,30
"2011","Aylesbury Vale 016F","E01032957",1059,185,41,144,344,183,71,67,92,54,24,15,9,39
"2011","Aylesbury Vale 016G","E01032962",1157,176,39,137,386,214,94,74,86,70,20,9,11,37
"2011","Aylesbury Vale 017A","E01017635",994,104,22,82,243,194,82,70,143,74,18,8,10,66
"2011","Aylesbury Vale 017B","E01017636",1101,102,21,81,304,174,104,81,149,94,32,21,11,61
"2011","Aylesbury Vale 017C","E01017637",949,124,25,99,285,149,83,64,97,59,19,14,5,69
"2011","Aylesbury Vale 017D","E01017638",917,138,41,97,269,171,95,54,79,41,13,7,6,57
"2011","Aylesbury Vale 017E","E01017639",1196,204,60,144,335,221,103,68,117,46,20,8,12,82
"2011","Aylesbury Vale 017F","E01017640",1085,149,35,114,280,203,101,65,128,63,20,17,3,76
"2011","Aylesbury Vale 018A","E01017709",1174,36,10,26,158,113,110,86,223,226,125,102,23,97
"2011","Aylesbury Vale 018B","E01017710",1090,51,7,44,183,140,98,95,209,170,61,49,12,83
"2011","Aylesbury Vale 018C","E01017711",1082,42,8,34,154,124,104,100,206,187,86,62,24,79
"2011","Aylesbury Vale 018D","E01017712",1496,107,16,91,268,153,115,112,260,246,130,91,39,105
"2011","Aylesbury Vale 019A","E01017687",1529,133,25,108,364,213,84,94,254,162,94,64,30,131
"2011","Aylesbury Vale 019B","E01017688",911,106,16,90,244,170,81,53,116,70,29,20,9,42
"2011","Aylesbury Vale 019C","E01017689",1041,144,35,109,235,190,101,70,142,68,23,12,11,68
"2011","Aylesbury Vale 019D","E01017690",853,88,26,62,191,148,97,54,116,78,23,10,13,58
"2011","Aylesbury Vale 019E","E01017691",1063,139,30,109,302,223,96,67,96,51,20,8,12,69
"2011","Aylesbury Vale 019F","E01017692",1181,161,40,121,313,207,88,87,148,83,43,27,16,51
"2011","Aylesbury Vale 020A","E01017721",1237,118,30,88,354,205,104,113,156,119,45,26,19,23
"2011","Aylesbury Vale 020B","E01017722",1162,96,22,74,283,205,89,101,187,118,20,15,5,63
"2011","Aylesbury Vale 020C","E01017723",966,53,20,33,157,121,65,72,177,180,79,53,26,62
"2011","Aylesbury Vale 020D","E01017724",961,42,10,32,140,105,94,84,180,173,73,48,25,70
"2011","Aylesbury Vale 021A","E01017627",1167,177,57,120,321,165,164,66,113,86,20,9,11,55
"2011","Aylesbury Vale 021B","E01017628",1203,217,66,151,358,178,156,47,93,45,37,34,3,72
"2011","Aylesbury Vale 021C","E01017629",1185,242,68,174,343,166,158,50,90,58,19,12,7,59
"2011","Aylesbury Vale 021D","E01017630",1110,182,48,134,314,175,136,57,95,59,28,15,13,64
"2011","Aylesbury Vale 021E","E01017631",1154,187,45,142,308,164,127,68,109,87,30,17,13,74
"2011","Aylesbury Vale 021F","E01017632",1191,200,46,154,352,191,159,54,88,57,30,22,8,60
"2011","Aylesbury Vale 022A","E01017675",1066,231,54,177,332,151,95,40,100,53,16,2,14,48
"2011","Aylesbury Vale 022B","E01017676",1039,196,51,145,291,141,176,45,84,49,11,11,0,46
"2011","Aylesbury Vale 022C","E01017677",992,213,49,164,301,147,121,36,63,50,6,5,1,55
"2011","Aylesbury Vale 022D","E01017678",1007,182,33,149,304,129,141,43,85,55,18,13,5,50
"2011","Aylesbury Vale 022E","E01017679",1127,204,50,154,298,164,114,63,112,73,32,15,17,67
"2011","Aylesbury Vale 022F","E01017680",704,88,25,63,131,67,99,52,119,104,15,5,10,29
"2011","Aylesbury Vale 023A","E01017681",895,133,38,95,202,123,114,53,114,96,20,11,9,40
"2011","Aylesbury Vale 023B","E01017682",833,212,59,153,290,89,72,27,51,22,11,6,5,59
"2011","Aylesbury Vale 023C","E01017683",1285,247,56,191,342,167,194,62,110,69,18,12,6,76
"2011","Aylesbury Vale 023D","E01017684",797,172,46,126,244,94,134,20,61,29,11,7,4,32
"2011","Aylesbury Vale 024A","E01017726",765,143,44,99,244,80,115,35,62,41,19,14,5,26
"2011","Aylesbury Vale 024B","E01017727",1106,244,59,185,373,142,104,47,78,41,14,9,5,63
"2011","Aylesbury Vale 024C","E01017728",1527,279,141,138,508,230,101,82,122,90,23,13,10,92
"2011","Aylesbury Vale 024D","E01017729",1189,204,45,159,348,178,138,58,86,63,29,24,5,85
"2011","Aylesbury Vale 024E","E01017730",1046,131,41,90,270,159,113,66,145,86,27,14,13,49
"2011","Chiltern 001A","E01017750",1613,301,78,223,457,192,259,57,131,76,26,18,8,114
"2011","Chiltern 001B","E01017752",1605,325,98,227,487,206,245,54,107,74,26,15,11,81
"2011","Chiltern 001C","E01017766",1655,333,85,248,493,174,278,60,121,59,31,22,9,106
"2011","Chiltern 001D","E01017778",908,188,49,139,265,125,133,35,71,31,7,5,2,53
"2011","Chiltern 002A","E01017747",970,149,34,115,236,127,100,46,101,72,64,45,19,75
"2011","Chiltern 002B","E01017748",1274,134,39,95,257,137,157,83,185,145,80,57,23,96
"2011","Chiltern 002C","E01017749",1194,192,49,143,371,192,119,62,119,43,20,15,5,76
"2011","Chiltern 002D","E01017789",869,76,23,53,188,126,87,65,154,89,37,21,16,47
"2011","Chiltern 002E","E01017790",923,54,10,44,163,87,88,63,172,150,77,51,26,69
"2011","Chiltern 002F","E01017795",1564,178,35,143,335,224,175,103,215,152,85,54,31,97
"2011","Chiltern 003A","E01017769",1206,211,50,161,373,147,142,56,95,57,44,28,16,81
"2011","Chiltern 003B","E01017771",1017,173,36,137,273,144,137,55,103,58,15,9,6,59
"2011","Chiltern 003C","E01017780",948,132,24,108,265,142,127,53,88,50,28,24,4,63
"2011","Chiltern 003D","E01017781",858,81,15,66,198,89,114,53,115,83,80,61,19,45
"2011","Chiltern 004A","E01017770",1081,123,20,103,250,126,138,92,123,98,60,47,13,71
"2011","Chiltern 004B","E01017791",1051,135,31,104,274,138,113,68,130,96,39,24,15,58
"2011","Chiltern 004C","E01017792",1330,183,46,137,377,158,141,62,181,107,61,31,30,60
"2011","Chiltern 004D","E01017793",1130,112,27,85,256,133,156,85,159,117,46,33,13,66
"2011","Chiltern 005A","E01017768",1539,336,104,232,451,197,193,47,139,55,29,21,8,92
"2011","Chiltern 005B","E01017779",824,210,67,143,235,96,90,23,60,33,11,6,5,66
"2011","Chiltern 005C","E01017785",1259,211,59,152,386,190,153,70,98,57,19,10,9,75
"2011","Chiltern 005D","E01017786",1118,207,69,138,314,160,128,38,115,49,20,12,8,87
"2011","Chiltern 005E","E01017787",1129,209,64,145,345,159,140,36,91,50,19,10,9,80
"2011","Chiltern 005F","E01017788",1207,124,31,93,272,161,169,104,170,106,29,15,14,72
"2011","Chiltern 006A","E01017741",1051,192,39,153,276,123,99,62,114,82,36,19,17,67
"2011","Chiltern 006B","E01017742",1104,239,47,192,363,143,96,47,74,47,17,9,8,78
"2011","Chiltern 006C","E01017743",1155,153,30,123,262,124,132,83,142,124,57,32,25,78
"2011","Chiltern 006D","E01017763",1121,276,65,211,390,147,85,44,66,29,24,18,6,60
"2011","Chiltern 006E","E01017764",1194,322,64,258,404,134,99,31,61,20,14,8,6,109
"2011","Chiltern 006F","E01017765",1167,330,91,239,381,134,105,16,69,19,20,10,10,93
"2011","Chiltern 007A","E01017739",909,204,45,159,320,122,83,18,59,26,13,5,8,64
"2011","Chiltern 007B","E01017740",981,171,44,127,248,132,121,52,113,64,33,18,15,47
"2011","Chiltern 007C","E01017744",1040,209,50,159,294,125,110,51,102,66,25,11,14,58
"2011","Chiltern 007D","E01017745",1235,268,72,196,431,131,120,43,111,59,22,14,8,50
"2011","Chiltern 007E","E01017746",1090,210,38,172,348,161,99,44,97,36,21,14,7,74
"2011","Chiltern 008A","E01017762",1005,265,77,188,321,129,110,17,42,23,26,14,12,72
"2011","Chiltern 008B","E01017775",1051,197,43,154,279,136,96,53,96,82,37,23,14,75
"2011","Chiltern 008C","E01017776",1138,178,40,138,287,145,138,74,114,88,40,26,14,74
"2011","Chiltern 008D","E01017777",1100,272,63,209,332,173,104,31,68,29,16,8,8,75
"2011","Chiltern 010A","E01017759",1225,231,66,165,373,164,163,48,102,61,21,8,13,62
"2011","Chiltern 010B","E01017760",1166,296,80,216,349,137,154,36,68,34,19,14,5,73
"2011","Chiltern 010C","E01017761",1452,267,71,196,423,207,202,55,114,71,22,17,5,91
"2011","Chiltern 010D","E01017794",1626,358,92,266,530,207,185,54,101,57,40,25,15,94
"2011","Chiltern 011A","E01017754",1100,216,67,149,319,166,149,32,71,36,38,31,7,73
"2011","Chiltern 011B","E01017755",1099,198,54,144,333,142,148,47,98,49,26,20,6,58
"2011","Chiltern 011C","E01017756",1041,213,63,150,326,152,122,36,60,31,25,19,6,76
"2011","Chiltern 011D","E01017757",832,163,35,128,255,119,103,23,71,33,15,11,4,50
"2011","Chiltern 011E","E01017758",908,172,47,125,254,98,90,26,81,22,94,86,8,71
"2011","Chiltern 012A","E01017751",1511,373,112,261,513,194,135,32,59,32,33,21,12,140
"2011","Chiltern 012B","E01017753",865,122,23,99,218,95,113,51,104,74,38,24,14,50
"2011","Chiltern 012C","E01017767",1497,249,56,193,362,214,202,61,169,108,38,20,18,94
"2011","Chiltern 013A","E01017773",1077,169,56,113,285,187,116,70,99,68,15,9,6,68
"2011","Chiltern 013B","E01017774",919,148,46,102,249,153,118,45,83,47,13,10,3,63
"2011","Chiltern 013C","E01017782",1001,273,72,201,336,134,91,22,50,18,19,11,8,58
"2011","Chiltern 013D","E01017783",1057,245,77,168,308,114,155,36,85,38,18,11,7,58
"2011","Chiltern 013E","E01017784",1149,270,92,178,354,148,145,32,75,25,15,7,8,85
"2011","Chiltern 013F","E01032609",905,129,33,96,194,153,105,55,117,81,13,4,9,58
"2011","South Bucks 001A","E01017796",1222,228,76,152,338,128,116,69,118,75,26,20,6,124
"2011","South Bucks 001B","E01017797",1044,277,83,194,357,114,96,18,49,32,21,11,10,80
"2011","South Bucks 001C","E01017798",1198,325,97,228,396,140,97,25,64,43,28,19,9,80
"2011","South Bucks 001D","E01017799",1350,342,79,263,414,158,159,41,68,53,24,16,8,91
"2011","South Bucks 001E","E01017800",1254,250,126,124,378,153,112,74,112,81,28,18,10,66
"2011","South Bucks 001F","E01017801",1105,282,87,195,327,155,116,25,60,28,26,16,10,86
"2011","South Bucks 001G","E01017802",1089,145,43,102,286,134,123,76,144,82,38,24,14,61
"2011","South Bucks 002A","E01017818",1375,261,73,188,399,165,168,57,105,69,53,38,15,98
"2011","South Bucks 002B","E01017819",1081,305,96,209,334,92,130,20,48,22,33,29,4,97
"2011","South Bucks 002C","E01017820",1019,258,73,185,344,101,88,51,52,53,24,18,6,48
"2011","South Bucks 002D","E01017821",1162,262,95,167,347,107,153,39,56,40,59,51,8,99
"2011","South Bucks 002E","E01017822",1382,341,91,250,404,149,189,26,70,33,43,37,6,127
"2011","South Bucks 003A","E01017810",1155,143,41,102,249,160,147,93,150,115,39,23,16,59
"2011","South Bucks 003B","E01017811",847,118,33,85,198,121,117,54,116,55,17,13,4,51
"2011","South Bucks 003C","E01017812",1209,120,37,83,294,183,172,79,136,100,40,28,12,85
"2011","South Bucks 003D","E01017813",1441,193,51,142,377,212,208,94,128,87,40,26,14,102
"2011","South Bucks 004A","E01017815",1277,276,68,208,404,183,152,47,66,35,29,18,11,85
"2011","South Bucks 004B","E01017816",1195,225,58,167,340,154,136,77,108,63,15,10,5,77
"2011","South Bucks 004C","E01017817",1342,273,92,181,378,144,147,68,122,71,43,30,13,96
"2011","South Bucks 004D","E01017823",972,176,61,115,279,121,160,40,76,50,22,9,13,48
"2011","South Bucks 005A","E01017830",1336,196,39,157,358,194,173,78,119,104,40,23,17,74
"2011","South Bucks 005B","E01017831",1189,227,57,170,345,177,135,61,81,58,29,23,6,76
"2011","South Bucks 005C","E01017832",1242,201,59,142,322,148,170,72,108,80,62,49,13,79
"2011","South Bucks 005D","E01017834",1151,148,37,111,268,174,149,59,100,78,42,27,15,133
"2011","South Bucks 005E","E01017835",1325,173,37,136,323,217,161,75,157,114,36,27,9,69
"2011","South Bucks 006A","E01017803",934,198,56,142,293,130,121,47,43,33,18,10,8,51
"2011","South Bucks 006B","E01017806",1232,202,51,151,322,188,173,71,104,57,16,11,5,99
"2011","South Bucks 006C","E01017814",1147,170,46,124,292,188,167,69,119,54,25,17,8,63
"2011","South Bucks 006D","E01017833",1301,307,91,216,405,139,186,70,86,52,14,9,5,42
"2011","South Bucks 007A","E01017804",1096,179,46,133,284,173,106,61,97,81,31,19,12,84
"2011","South Bucks 007B","E01017805",1313,137,39,98,281,196,130,114,185,143,56,35,21,71
"2011","South Bucks 007C","E01017807",1100,141,31,110,289,226,108,74,119,76,14,9,5,53
"2011","South Bucks 007D","E01017808",1090,123,26,97,262,177,98,69,152,118,43,26,17,48
"2011","South Bucks 007E","E01017809",1092,135,27,108,242,167,109,68,140,111,49,34,15,71
"2011","South Bucks 008A","E01017824",1255,212,41,171,310,186,161,94,101,90,33,18,15,68
"2011","South Bucks 008B","E01017825",1277,163,31,132,316,213,168,101,109,79,17,9,8,111
"2011","South Bucks 008C","E01017826",1062,107,30,77,221,186,114,84,122,104,47,28,19,77
"2011","South Bucks 008D","E01017827",1256,148,32,116,311,159,155,101,128,122,57,45,12,75
"2011","South Bucks 008E","E01017828",1164,143,27,116,302,163,118,81,125,103,45,28,17,84
"2011","South Bucks 008F","E01017829",1521,229,46,183,378,246,211,69,124,87,50,36,14,127
"2011","Wycombe 001A","E01017929",961,103,28,75,217,127,112,57,154,108,29,16,13,54
"2011","Wycombe 001B","E01017930",1243,254,65,189,389,177,129,44,115,50,13,8,5,72
"2011","Wycombe 001C","E01017931",1029,153,55,98,236,137,121,65,139,92,26,12,14,60
"2011","Wycombe 001D","E01017932",1157,209,61,148,336,155,149,57,99,65,26,17,9,61
"2011","Wycombe 001E","E01017933",1164,133,38,95,248,175,122,82,177,103,38,29,9,86
"2011","Wycombe 002A","E01017885",1254,231,69,162,337,172,187,59,115,61,30,17,13,62
"2011","Wycombe 002B","E01017886",1068,235,70,165,301,125,153,53,79,48,15,9,6,59
"2011","Wycombe 002C","E01017887",808,167,56,111,251,113,109,35,49,36,11,7,4,37
"2011","Wycombe 002D","E01017888",1216,327,170,157,360,152,145,36,53,38,12,7,5,93
"2011","Wycombe 003A","E01017869",974,182,57,125,306,135,136,40,70,30,10,4,6,65
"2011","Wycombe 003B","E01017870",899,172,58,114,286,115,121,33,65,25,4,2,2,78
"2011","Wycombe 003C","E01017871",1152,188,63,125,317,169,134,58,115,68,18,13,5,85
"2011","Wycombe 003D","E01017872",1161,203,70,133,330,175,178,66,84,52,14,8,6,59
"2011","Wycombe 003E","E01017873",1055,160,45,115,284,176,126,59,126,64,10,8,2,50
"2011","Wycombe 003F","E01017874",787,121,55,66,230,142,64,39,66,56,9,6,3,60
"2011","Wycombe 004A","E01017915",988,112,35,77,212,122,148,91,115,111,20,13,7,57
"2011","Wycombe 004B","E01017916",923,174,59,115,248,120,154,56,57,47,13,8,5,54
"2011","Wycombe 004C","E01017917",1098,164,46,118,273,177,145,70,107,76,27,13,14,59
"2011","Wycombe 004D","E01017918",1102,153,47,106,265,174,106,89,129,99,29,14,15,58
"2011","Wycombe 006A","E01017857",1060,72,15,57,177,124,89,77,164,142,116,90,26,99
"2011","Wycombe 006B","E01017858",1322,146,28,118,219,135,79,84,126,89,61,38,23,383
"2011","Wycombe 006C","E01017859",1060,133,25,108,253,147,100,74,126,76,52,42,10,99
"2011","Wycombe 006D","E01017860",1013,87,10,77,190,123,95,77,160,129,72,49,23,80
"2011","Wycombe 006E","E01017861",1163,205,48,157,334,173,109,61,108,57,48,28,20,68
"2011","Wycombe 006F","E01017862",1334,204,51,153,353,182,137,78,166,97,35,22,13,82
"2011","Wycombe 006G","E01017863",1244,206,50,156,314,176,128,75,137,89,33,17,16,86
"2011","Wycombe 007A","E01017842",2249,545,258,287,612,325,288,88,136,113,29,12,17,113
"2011","Wycombe 007B","E01017853",1017,169,44,125,293,127,147,50,85,55,29,17,12,62
"2011","Wycombe 007C","E01017854",928,155,42,113,231,117,155,50,83,60,17,9,8,60
"2011","Wycombe 007D","E01017878",1924,425,134,291,580,185,299,81,145,80,41,30,11,88
"2011","Wycombe 008A","E01017920",900,121,34,87,244,115,99,55,92,72,32,19,13,70
"2011","Wycombe 008B","E01017921",1395,200,31,169,400,135,84,55,128,86,61,43,18,246
"2011","Wycombe 008C","E01017922",1228,167,24,143,298,159,120,67,146,87,79,60,19,105
"2011","Wycombe 008D","E01017923",1204,123,22,101,256,132,77,63,153,79,91,71,20,230
"2011","Wycombe 008E","E01017924",1121,279,57,222,334,121,97,35,71,33,46,26,20,105
"2011","Wycombe 009A","E01017937",1093,239,70,169,327,148,133,47,66,30,16,9,7,87
"2011","Wycombe 009B","E01017938",987,193,47,146,320,145,106,36,60,39,12,5,7,76
"2011","Wycombe 009C","E01017940",1177,142,36,106,303,185,139,100,141,87,24,12,12,56
"2011","Wycombe 009D","E01017942",1083,176,41,135,301,176,113,57,104,58,21,14,7,77
"2011","Wycombe 010A","E01017850",990,64,10,54,176,102,75,69,171,127,96,73,23,110
"2011","Wycombe 010B","E01017851",1294,151,26,125,295,135,123,69,157,114,79,64,15,171
"2011","Wycombe 010C","E01017852",1759,141,32,109,294,182,169,71,239,160,243,218,25,260
"2011","Wycombe 010D","E01017919",1063,143,22,121,261,132,77,72,113,77,34,27,7,154
"2011","Wycombe 011A","E01017925",1516,175,36,139,333,200,133,113,183,132,65,41,24,182
"2011","Wycombe 011B","E01017926",1020,74,12,62,213,130,69,72,167,154,77,54,23,64
"2011","Wycombe 011C","E01017927",1076,146,35,111,253,136,115,70,145,88,49,40,9,74
"2011","Wycombe 011D","E01017928",1027,107,12,95,198,144,84,89,156,107,70,45,25,72
"2011","Wycombe 012A","E01017911",1190,98,18,80,232,149,116,94,189,143,88,66,22,81
"2011","Wycombe 012B","E01017912",1056,132,28,104,233,123,113,65,128,98,71,55,16,93
"2011","Wycombe 012C","E01017913",1332,129,23,106,263,150,128,79,187,165,113,90,23,118
"2011","Wycombe 012D","E01017914",1020,113,32,81,232,155,110,68,129,93,56,42,14,64
"2011","Wycombe 013A","E01017903",1180,58,5,53,134,93,110,78,202,149,187,166,21,169
"2011","Wycombe 013B","E01017904",1310,74,10,64,193,131,129,94,183,151,177,150,27,178
"2011","Wycombe 013C","E01017905",1721,122,23,99,255,162,114,102,251,169,184,144,40,362
"2011","Wycombe 013D","E01017906",1252,19,4,15,99,86,126,75,222,198,271,237,34,156
"2011","Wycombe 013E","E01017907",1216,79,16,63,146,141,118,82,216,151,168,142,26,115
"2011","Wycombe 014A","E01017899",1150,76,20,56,210,141,115,91,206,155,83,55,28,73
"2011","Wycombe 014B","E01017900",977,93,20,73,174,132,77,76,165,109,74,53,21,77
"2011","Wycombe 014C","E01017901",850,64,6,58,143,100,69,60,161,119,73,47,26,61
"2011","Wycombe 014D","E01017902",1117,74,19,55,196,137,108,74,206,152,82,49,33,88
"2011","Wycombe 015A","E01017836",1196,132,27,105,225,147,109,71,170,102,97,82,15,143
"2011","Wycombe 015B","E01017837",1775,140,19,121,288,148,88,95,186,96,91,71,20,643
"2011","Wycombe 015C","E01017838",1149,140,24,116,216,117,91,60,161,97,92,77,15,175
"2011","Wycombe 015D","E01017839",1205,154,21,133,249,107,63,49,113,60,35,25,10,375
"2011","Wycombe 015E","E01017840",1344,188,31,157,344,181,135,76,136,87,87,70,17,110
"2011","Wycombe 015F","E01017841",1072,246,84,162,297,146,100,38,86,28,36,26,10,95
"2011","Wycombe 016A","E01017908",1857,209,39,170,422,244,192,123,282,196,91,56,35,98
"2011","Wycombe 016B","E01017909",1630,257,31,226,453,225,174,96,175,112,51,35,16,87
"2011","Wycombe 016C","E01017910",1859,315,62,253,555,230,134,82,177,92,85,52,33,189
"2011","Wycombe 016D","E01017941",1087,135,37,98,267,163,127,74,147,90,33,21,12,51
"2011","Wycombe 017A","E01017843",1140,145,38,107,272,181,105,86,152,111,23,17,6,65
"2011","Wycombe 017B","E01017844",1158,123,24,99,213,160,104,81,173,126,88,73,15,90
"2011","Wycombe 017C","E01017845",1268,142,31,111,236,176,103,101,165,166,99,70,29,80
"2011","Wycombe 017D","E01017855",1025,152,34,118,267,132,144,54,108,93,30,25,5,45
"2011","Wycombe 017E","E01017856",1008,79,20,59,158,115,115,98,171,164,52,38,14,56
"2011","Wycombe 018A","E01017864",967,194,45,149,257,165,99,52,79,41,15,10,5,65
"2011","Wycombe 018B","E01017865",1078,169,54,115,320,146,161,37,101,45,12,7,5,87
"2011","Wycombe 018C","E01017867",1044,105,26,79,210,124,122,69,177,128,42,28,14,67
"2011","Wycombe 018D","E01017868",1097,164,35,129,334,158,139,69,87,57,22,14,8,67
"2011","Wycombe 019A","E01017934",1270,142,33,109,289,180,145,67,162,155,58,40,18,72
"2011","Wycombe 019B","E01017935",1439,233,48,185,424,194,189,83,129,103,26,18,8,58
"2011","Wycombe 019C","E01017936",1180,209,52,157,339,140,131,54,108,73,29,11,18,97
"2011","Wycombe 019D","E01017939",1031,117,34,83,236,139,153,88,128,85,27,19,8,58
"2011","Wycombe 020A","E01017866",1066,221,73,148,331,107,146,35,80,57,12,8,4,77
"2011","Wycombe 020B","E01017875",1052,308,169,139,316,111,125,21,61,24,23,17,6,63
"2011","Wycombe 020C","E01017876",1487,335,87,248,479,198,148,56,116,46,18,11,7,91
"2011","Wycombe 020D","E01017877",1167,218,60,158,325,176,118,65,98,65,27,15,12,75
"2011","Wycombe 021A","E01017846",967,95,22,73,201,132,117,75,150,98,33,14,19,66
"2011","Wycombe 021B","E01017847",1056,219,49,170,340,125,135,42,74,42,17,10,7,62
"2011","Wycombe 021C","E01017848",877,178,43,135,253,134,89,33,87,29,20,12,8,54
"2011","Wycombe 021D","E01017849",1093,249,65,184,336,148,132,42,79,34,19,15,4,54
"2011","Wycombe 022A","E01017889",957,135,27,108,236,115,113,80,132,82,21,11,10,43
"2011","Wycombe 022B","E01017890",935,181,49,132,281,133,99,37,106,33,17,8,9,48
"2011","Wycombe 022C","E01017891",983,210,50,160,286,114,106,44,96,56,16,5,11,55
"2011","Wycombe 022D","E01017892",1028,272,87,185,361,142,85,30,46,21,12,7,5,59
"2011","Wycombe 022E","E01017893",1118,164,33,131,276,127,145,61,135,107,39,28,11,64
"2011","Wycombe 022F","E01017894",1095,274,67,207,339,122,133,33,83,42,17,10,7,52
"2011","Wycombe 023A","E01017895",921,182,48,134,280,99,86,51,82,73,17,4,13,51
"2011","Wycombe 023B","E01017896",973,222,64,158,382,93,116,23,46,26,8,5,3,57
"2011","Wycombe 023C","E01017897",1158,185,34,151,299,132,156,73,143,93,30,16,14,47
"2011","Wycombe 023D","E01017898",939,113,20,93,197,128,90,76,141,113,35,17,18,46
"2011","Wycombe 024A","E01017880",1026,150,47,103,290,185,108,53,117,54,15,9,6,54
"2011","Wycombe 024B","E01017881",1263,214,48,166,339,179,141,65,151,63,29,18,11,82
"2011","Wycombe 024C","E01017882",1140,169,40,129,285,175,155,68,121,73,20,14,6,74
"2011","Wycombe 024D","E01017883",1178,266,78,188,326,162,118,40,102,52,27,19,8,85
"2011","Wycombe 024E","E01017884",985,111,21,90,265,178,90,79,119,79,14,8,6,50
"2011","Wycombe 024F","E01032610",1188,174,37,137,323,177,150,80,135,57,30,20,10,62
"2011","Eastbourne 001A","E01020924",1036,67,22,45,196,150,126,66,187,116,41,24,17,87
"2011","Eastbourne 001B","E01020925",1117,32,5,27,165,100,90,105,254,156,109,82,27,106
"2011","Eastbourne 001C","E01020927",1076,52,16,36,186,151,102,84,210,143,57,43,14,91
"2011","Eastbourne 001D","E01020928",1084,49,11,38,167,149,102,98,257,162,56,29,27,44
"2011","Eastbourne 001E","E01020930",1081,34,9,25,157,137,95,102,215,153,54,34,20,134
"2011","Eastbourne 002A","E01020917",1046,32,12,20,159,113,86,105,216,169,80,50,30,86
"2011","Eastbourne 002B","E01020918",1132,51,17,34,191,153,98,117,225,136,63,40,23,98
"2011","Eastbourne 002C","E01020919",1076,32,3,29,174,159,109,106,219,136,57,32,25,84
"2011","Eastbourne 002D","E01020923",1002,25,9,16,160,112,87,90,235,161,67,40,27,65
"2011","Eastbourne 002E","E01020949",1142,71,20,51,234,197,116,88,206,129,48,29,19,53
"2011","Eastbourne 003A","E01020926",1158,101,34,67,241,182,115,82,184,92,38,19,19,123
"2011","Eastbourne 003B","E01020929",1093,36,11,25,173,123,101,86,256,180,78,50,28,60
"2011","Eastbourne 003C","E01020955",1035,44,22,22,138,126,100,108,226,173,67,33,34,53
"2011","Eastbourne 003D","E01020956",1066,59,20,39,189,169,110,112,226,142,32,19,13,27
"2011","Eastbourne 003E","E01020957",1013,45,12,33,174,146,100,95,219,124,41,22,19,69
"2011","Eastbourne 004A","E01020920",1055,54,13,41,146,118,84,95,238,181,71,49,22,68
"2011","Eastbourne 004B","E01020921",1006,66,23,43,191,147,95,84,189,99,46,28,18,89
"2011","Eastbourne 004C","E01020922",1037,61,23,38,186,95,109,76,217,158,55,29,26,80
"2011","Eastbourne 004D","E01020945",1315,126,35,91,378,225,158,69,148,85,38,25,13,88
"2011","Eastbourne 004E","E01020950",1102,82,30,52,239,181,107,80,203,107,27,14,13,76
"2011","Eastbourne 006A","E01020940",982,124,18,106,278,179,127,28,89,55,22,9,13,80
"2011","Eastbourne 006B","E01020941",1152,71,10,61,221,122,145,101,191,130,65,45,20,106
"2011","Eastbourne 006C","E01020942",1119,106,28,78,340,177,123,50,115,72,30,16,14,106
"2011","Eastbourne 006D","E01020946",1179,187,42,145,374,188,127,44,104,60,22,16,6,73
"2011","Eastbourne 006E","E01020947",1062,103,24,79,263,145,112,73,171,83,32,19,13,80
"2011","Eastbourne 007A","E01020914",1426,78,14,64,310,171,147,111,256,137,49,29,20,167
"2011","Eastbourne 007B","E01020915",1160,72,11,61,296,145,139,80,180,101,59,36,23,88
"2011","Eastbourne 007C","E01020952",1242,67,20,47,220,162,136,96,258,138,77,49,28,88
"2011","Eastbourne 007D","E01020953",1120,77,21,56,278,162,150,76,172,89,24,17,7,92
"2011","Eastbourne 007E","E01020954",1228,104,22,82,278,211,149,88,180,68,32,16,16,118
"2011","Eastbourne 008A","E01020948",965,158,18,140,224,148,110,45,114,66,31,22,9,69
"2011","Eastbourne 008B","E01020963",1173,144,30,114,336,145,165,55,113,65,49,33,16,101
"2011","Eastbourne 008C","E01020965",1409,133,20,113,331,178,156,114,193,119,75,41,34,110
"2011","Eastbourne 008D","E01020966",1152,107,20,87,285,139,129,81,180,77,83,54,29,71
"2011","Eastbourne 009A","E01020938",1094,93,17,76,290,150,121,76,148,86,40,24,16,90
"2011","Eastbourne 009B","E01020939",1094,137,24,113,355,139,118,53,116,53,26,11,15,97
"2011","Eastbourne 009C","E01020943",1162,149,26,123,347,160,124,52,137,67,27,16,11,99
"2011","Eastbourne 009D","E01020964",1127,109,27,82,347,143,137,70,145,71,33,22,11,72
"2011","Eastbourne 009E","E01020967",1140,106,31,75,311,179,137,60,146,72,59,41,18,70
"2011","Eastbourne 010A","E01020910",1301,50,16,34,210,111,165,112,250,163,54,33,21,186
"2011","Eastbourne 010B","E01020911",1671,66,13,53,266,137,147,153,273,263,84,47,37,282
"2011","Eastbourne 010C","E01020912",1693,61,11,50,226,135,136,146,270,310,97,57,40,312
"2011","Eastbourne 010D","E01020916",1274,58,17,41,265,153,110,103,220,159,57,29,28,149
"2011","Eastbourne 011A","E01020935",1441,92,18,74,340,169,156,128,236,127,59,28,31,134
"2011","Eastbourne 011B","E01020936",1135,116,31,85,292,140,111,78,133,85,37,23,14,143
"2011","Eastbourne 011C","E01020937",1143,113,20,93,274,115,105,85,121,83,48,30,18,199
"2011","Eastbourne 011D","E01020968",1201,129,24,105,298,129,103,83,148,109,38,27,11,164
"2011","Eastbourne 012A","E01020931",1263,128,31,97,280,141,129,49,93,42,29,17,12,372
"2011","Eastbourne 012B","E01020932",755,105,20,85,223,110,96,46,81,44,28,20,8,22
"2011","Eastbourne 012C","E01020933",709,124,22,102,204,95,71,25,43,20,12,7,5,115
"2011","Eastbourne 012D","E01020934",838,134,21,113,266,111,98,28,71,50,22,14,8,58
"2011","Eastbourne 012E","E01020944",1057,164,40,124,316,144,137,36,95,44,28,20,8,93
"2011","Eastbourne 013A","E01020913",1518,86,26,60,286,209,162,134,256,183,106,69,37,96
"2011","Eastbourne 013B","E01020951",1082,47,15,32,226,146,137,77,193,132,42,24,18,82
"2011","Eastbourne 013C","E01020959",970,66,14,52,186,145,135,75,172,101,29,22,7,61
"2011","Eastbourne 013D","E01020961",986,58,16,42,222,179,123,74,164,84,36,27,9,46
"2011","Eastbourne 013E","E01020962",1449,151,38,113,359,235,183,77,227,96,48,24,24,73
"2011","Eastbourne 014A","E01020960",1856,218,65,153,477,264,224,125,268,127,57,24,33,96
"2011","Eastbourne 014B","E01032831",1226,151,48,103,334,208,170,65,147,71,34,16,18,46
"2011","Eastbourne 014C","E01032832",1140,92,21,71,247,135,129,82,186,118,59,42,17,92
"2011","Eastbourne 014D","E01032833",1107,151,42,109,313,166,132,67,113,84,40,16,24,41
"2011","Hastings 001A","E01020969",1107,96,25,71,245,189,121,63,180,106,36,27,9,71
"2011","Hastings 001B","E01020970",2009,228,66,162,491,316,263,132,230,128,50,38,12,171
"2011","Hastings 001C","E01020971",1488,87,20,67,274,210,174,120,259,164,83,64,19,117
"2011","Hastings 001D","E01020987",1318,130,37,93,283,253,127,99,186,119,32,18,14,89
"2011","Hastings 002A","E01020974",1055,72,19,53,231,137,163,76,146,98,62,49,13,70
"2011","Hastings 002B","E01020986",1089,113,19,94,275,184,121,58,135,87,48,40,8,68
"2011","Hastings 002C","E01020988",1198,119,39,80,272,214,140,81,153,111,38,32,6,70
"2011","Hastings 002D","E01021007",1064,105,32,73,269,183,160,68,129,78,16,14,2,56
"2011","Hastings 002E","E01021008",1076,91,21,70,234,179,139,66,172,88,49,30,19,58
"2011","Hastings 002F","E01021009",1373,115,32,83,305,239,174,102,209,112,44,22,22,73
"2011","Hastings 003A","E01020993",968,20,4,16,118,86,103,83,210,171,93,53,40,84
"2011","Hastings 003B","E01020994",1045,31,9,22,138,106,98,94,215,184,118,88,30,61
"2011","Hastings 003C","E01020995",1019,36,8,28,123,104,87,80,258,162,81,59,22,88
"2011","Hastings 003D","E01020996",1270,87,28,59,243,164,139,90,233,122,100,68,32,92
"2011","Hastings 003E","E01021019",1164,39,15,24,172,127,105,96,262,197,95,65,30,71
"2011","Hastings 004A","E01021004",1272,65,17,48,253,190,189,92,215,135,57,47,10,76
"2011","Hastings 004B","E01021005",1116,39,16,23,140,94,89,97,262,195,117,90,27,83
"2011","Hastings 004C","E01021006",1357,79,22,57,298,174,157,112,234,159,75,41,34,69
"2011","Hastings 004D","E01021013",1332,74,25,49,244,175,142,105,274,160,57,29,28,101
"2011","Hastings 005A","E01020972",1056,19,5,14,110,99,104,65,228,189,161,118,43,81
"2011","Hastings 005B","E01020973",1192,59,28,31,211,176,129,79,255,132,70,51,19,81
"2011","Hastings 005C","E01020977",1171,72,16,56,210,131,138,80,246,128,98,59,39,68
"2011","Hastings 005D","E01021015",1068,28,5,23,120,93,98,86,252,154,158,99,59,79
"2011","Hastings 006A","E01021010",1169,69,19,50,270,174,135,101,193,107,25,19,6,95
"2011","Hastings 006B","E01021011",1109,65,14,51,218,166,146,77,207,108,44,27,17,78
"2011","Hastings 006C","E01021012",1186,82,20,62,271,169,123,80,188,111,95,64,31,67
"2011","Hastings 006D","E01021020",1240,55,15,40,166,147,138,104,252,193,107,82,25,78
"2011","Hastings 006E","E01021021",1394,112,32,80,306,230,140,90,228,133,69,45,24,86
"2011","Hastings 007A","E01021000",1095,86,23,63,263,138,171,56,157,101,51,22,29,72
"2011","Hastings 007B","E01021001",904,46,13,33,221,116,131,63,142,83,35,20,15,67
"2011","Hastings 007C","E01021002",1062,65,10,55,246,125,178,69,153,91,57,35,22,78
"2011","Hastings 007D","E01021003",1257,110,19,91,331,110,260,71,149,102,63,34,29,61
"2011","Hastings 007E","E01021014",1320,49,12,37,243,149,136,81,281,171,102,57,45,108
"2011","Hastings 008A","E01020975",1316,98,21,77,325,190,173,68,171,108,95,62,33,88
"2011","Hastings 008B","E01020976",1436,106,29,77,326,226,181,82,222,121,71,43,28,101
"2011","Hastings 008C","E01020990",1214,52,12,40,222,141,128,82,225,140,130,92,38,94
"2011","Hastings 008D","E01020991",1025,112,21,91,262,115,136,51,114,92,67,42,25,76
"2011","Hastings 008E","E01020992",1416,67,18,49,252,137,177,94,283,169,144,73,71,93
"2011","Hastings 009A","E01020978",1534,80,13,67,262,172,174,128,298,161,140,74,66,119
"2011","Hastings 009B","E01020979",1479,65,12,53,240,180,167,112,267,209,155,83,72,84
"2011","Hastings 009C","E01020980",1209,76,19,57,236,122,148,77,223,152,85,46,39,90
"2011","Hastings 009D","E01020981",1203,82,23,59,317,137,168,68,166,92,87,52,35,86
"2011","Hastings 010A","E01020997",1126,85,20,65,244,166,134,81,186,104,51,34,17,75
"2011","Hastings 010B","E01020998",1337,103,21,82,313,182,179,65,196,134,83,49,34,82
"2011","Hastings 010C","E01020999",1214,112,33,79,273,208,173,74,174,87,59,51,8,54
"2011","Hastings 010D","E01021016",1211,69,21,48,226,144,164,104,201,159,88,60,28,56
"2011","Hastings 010E","E01021017",1241,54,23,31,219,169,172,111,227,157,49,27,22,83
"2011","Hastings 010F","E01021018",1439,126,32,94,303,265,173,97,206,113,35,27,8,121
"2011","Hastings 011A","E01020982",1419,55,12,43,208,152,142,104,266,226,178,123,55,88
"2011","Hastings 011B","E01020983",1253,52,12,40,221,136,121,90,207,164,127,70,57,135
"2011","Hastings 011C","E01020984",1594,119,26,93,264,187,212,144,251,172,166,95,71,79
"2011","Hastings 011D","E01020985",1429,100,19,81,353,138,215,86,204,141,108,50,58,84
"2011","Hastings 011E","E01020989",1398,68,16,52,241,169,168,84,252,167,183,112,71,66
"2011","Lewes 001A","E01021022",1477,240,55,185,386,165,237,74,155,90,47,33,14,83
"2011","Lewes 001B","E01021024",899,100,22,78,184,107,129,59,151,79,42,27,15,48
"2011","Lewes 001C","E01021025",1365,268,66,202,407,144,213,56,99,72,28,19,9,78
"2011","Lewes 001D","E01021052",903,153,36,117,284,128,112,45,83,39,7,5,2,52
"2011","Lewes 001E","E01021053",851,122,24,98,236,106,135,48,99,44,16,9,7,45
"2011","Lewes 002A","E01021023",1454,208,47,161,400,228,180,87,138,78,26,14,12,109
"2011","Lewes 002B","E01021026",1498,327,71,256,434,168,228,48,114,46,56,43,13,77
"2011","Lewes 002C","E01021032",1451,275,45,230,427,148,232,49,111,65,32,23,9,112
"2011","Lewes 002D","E01021067",857,135,28,107,220,126,109,44,101,46,11,5,6,65
"2011","Lewes 002E","E01021068",873,147,45,102,226,78,131,36,66,38,16,12,4,135
"2011","Lewes 003A","E01021033",1235,115,14,101,315,177,160,81,149,145,30,17,13,63
"2011","Lewes 003B","E01021034",993,96,20,76,240,146,109,71,126,99,31,19,12,75
"2011","Lewes 003C","E01021035",1308,197,25,172,410,136,180,77,109,76,37,12,25,86
"2011","Lewes 003D","E01021036",1037,205,41,164,306,113,106,42,102,61,27,16,11,75
"2011","Lewes 003E","E01021037",1149,53,8,45,168,124,112,95,221,223,72,41,31,81
"2011","Lewes 003F","E01021038",1274,218,31,187,419,131,157,38,95,74,35,18,17,107
"2011","Lewes 004A","E01021054",1098,118,28,90,289,118,136,79,162,106,26,14,12,64
"2011","Lewes 004B","E01021055",1177,136,30,106,312,153,132,84,157,103,33,18,15,67
"2011","Lewes 004C","E01021056",1183,174,34,140,342,191,162,54,113,71,19,13,6,57
"2011","Lewes 004D","E01021057",1088,66,18,48,218,109,187,96,185,128,34,13,21,65
"2011","Lewes 005A","E01021039",1022,206,34,172,352,105,125,36,62,36,22,10,12,78
"2011","Lewes 005B","E01021040",1301,194,25,169,354,107,185,62,117,116,102,86,16,64
"2011","Lewes 005C","E01021041",1051,228,29,199,324,115,106,44,85,43,35,24,11,71
"2011","Lewes 005D","E01021042",925,130,19,111,260,120,107,55,95,66,24,13,11,68
"2011","Lewes 005E","E01021043",1109,167,20,147,313,106,104,61,129,92,50,23,27,87
"2011","Lewes 006A","E01021027",1101,117,29,88,292,156,152,66,165,77,27,14,13,49
"2011","Lewes 006B","E01021028",1194,90,27,63,266,216,176,86,168,82,32,18,14,78
"2011","Lewes 006C","E01021029",1128,102,29,73,264,178,169,80,157,73,30,22,8,75
"2011","Lewes 006D","E01021030",838,101,26,75,195,137,129,59,95,43,26,18,8,53
"2011","Lewes 006E","E01021031",1063,78,16,62,203,171,156,105,175,103,33,19,14,39
"2011","Lewes 007A","E01021061",1155,95,28,67,234,176,156,79,193,100,36,14,22,86
"2011","Lewes 007B","E01021063",1248,100,19,81,269,225,166,94,179,105,29,20,9,81
"2011","Lewes 007C","E01021064",1171,82,21,61,254,171,171,108,202,116,28,20,8,39
"2011","Lewes 007D","E01021065",847,48,13,35,155,119,104,72,154,126,39,21,18,30
"2011","Lewes 007E","E01021066",1106,75,20,55,192,188,136,92,194,121,40,29,11,68
"2011","Lewes 008A","E01021045",1281,97,35,62,243,178,146,119,219,178,44,23,21,57
"2011","Lewes 008B","E01021046",1109,80,23,57,208,180,125,107,184,123,50,34,16,52
"2011","Lewes 008C","E01021047",1058,77,23,54,193,138,137,106,173,138,47,34,13,49
"2011","Lewes 008D","E01021048",1195,78,17,61,248,151,128,103,216,136,55,27,28,80
"2011","Lewes 009A","E01021044",1309,89,20,69,223,162,145,105,245,184,69,46,23,87
"2011","Lewes 009B","E01021049",1070,52,16,36,180,115,110,113,247,144,58,30,28,51
"2011","Lewes 009C","E01021050",997,60,17,43,177,134,92,99,184,131,51,29,22,69
"2011","Lewes 009D","E01021051",900,49,21,28,136,137,106,88,156,136,30,13,17,62
"2011","Lewes 010A","E01021058",1307,80,25,55,272,193,177,92,236,124,58,43,15,75
"2011","Lewes 010B","E01021059",1059,80,23,57,198,139,158,68,176,137,46,29,17,57
"2011","Lewes 010C","E01021060",1183,57,19,38,181,179,163,114,217,163,43,28,15,66
"2011","Lewes 010D","E01021062",1054,43,10,33,188,166,112,85,175,154,52,28,24,79
"2011","Lewes 011A","E01021069",1111,146,48,98,290,164,136,55,131,78,34,21,13,77
"2011","Lewes 011B","E01021075",1213,106,30,76,305,219,136,86,159,107,19,11,8,76
"2011","Lewes 011C","E01021077",1022,122,31,91,256,142,140,48,143,71,38,31,7,62
"2011","Lewes 011D","E01021081",1067,107,26,81,275,157,155,54,148,92,27,15,12,52
"2011","Lewes 011E","E01021082",1140,126,31,95,319,194,169,63,141,77,13,8,5,38
"2011","Lewes 011F","E01021083",971,127,33,94,257,165,103,47,120,60,23,11,12,69
"2011","Lewes 012A","E01021072",1016,140,38,102,276,194,116,49,125,56,16,11,5,44
"2011","Lewes 012B","E01021073",1006,108,27,81,223,157,121,63,149,98,22,14,8,65
"2011","Lewes 012C","E01021074",1120,62,15,47,219,155,167,84,216,125,41,22,19,51
"2011","Lewes 012D","E01021076",1332,73,19,54,230,185,161,132,249,148,63,39,24,91
"2011","Lewes 012E","E01021078",906,150,34,116,252,148,114,43,101,29,17,14,3,52
"2011","Lewes 013A","E01021070",1109,105,17,88,269,143,113,78,176,117,46,31,15,62
"2011","Lewes 013B","E01021071",1284,81,26,55,304,159,187,94,222,133,38,18,20,66
"2011","Lewes 013C","E01021079",1026,108,29,79,274,138,110,61,152,82,46,29,17,55
"2011","Lewes 013D","E01021080",995,137,35,102,238,123,122,60,138,56,46,31,15,75
"2011","Rother 001A","E01021132",1011,124,28,96,270,126,114,37,92,53,130,126,4,65
"2011","Rother 001B","E01021133",1217,130,30,100,296,147,224,65,143,92,50,31,19,70
"2011","Rother 001C","E01021134",1082,111,24,87,256,147,191,77,129,98,17,8,9,56
"2011","Rother 001D","E01021139",860,90,20,70,206,104,124,67,125,78,23,16,7,43
"2011","Rother 001E","E01021140",1322,184,44,140,322,173,252,72,131,69,45,36,9,74
"2011","Rother 001F","E01021141",1083,174,41,133,326,115,188,52,89,53,19,11,8,67
"2011","Rother 002A","E01021103",1102,90,26,64,223,126,232,70,167,95,49,30,19,50
"2011","Rother 002B","E01021114",1084,91,29,62,216,155,216,59,156,98,43,29,14,50
"2011","Rother 002C","E01021115",1149,160,38,122,319,136,211,59,138,53,18,9,9,55
"2011","Rother 002D","E01021116",1106,99,17,82,220,155,212,66,166,92,28,20,8,68
"2011","Rother 003A","E01021098",1214,142,32,110,313,143,228,67,140,88,24,12,12,69
"2011","Rother 003B","E01021099",1236,206,57,149,341,124,262,49,93,45,63,58,5,53
"2011","Rother 003C","E01021100",1317,169,34,135,282,151,252,79,159,72,49,40,9,104
"2011","Rother 003D","E01021104",996,158,44,114,255,124,197,41,76,56,30,18,12,59
"2011","Rother 003E","E01021105",914,110,24,86,203,101,140,63,120,53,38,20,18,86
"2011","Rother 004A","E01021101",1206,111,33,78,306,131,225,64,158,92,55,39,16,64
"2011","Rother 004B","E01021102",1196,67,18,49,246,117,232,107,183,134,56,34,22,54
"2011","Rother 004C","E01021117",1168,115,27,88,254,121,232,87,150,99,61,43,18,49
"2011","Rother 004D","E01021118",1146,86,16,70,248,113,203,107,184,118,32,24,8,55
"2011","Rother 004E","E01021119",740,21,7,14,83,75,98,75,151,145,51,27,24,41
"2011","Rother 005A","E01021087",1208,138,38,100,332,164,236,43,101,69,51,42,9,74
"2011","Rother 005B","E01021088",1127,107,24,83,248,163,216,82,142,88,35,25,10,46
"2011","Rother 005C","E01021089",1107,89,19,70,235,138,193,88,173,85,38,24,14,68
"2011","Rother 005D","E01021109",1289,127,28,99,295,162,222,71,140,87,39,29,10,146
"2011","Rother 005E","E01021110",1638,188,40,148,410,263,293,93,165,100,58,45,13,68
"2011","Rother 006A","E01021084",1269,114,29,85,291,159,176,92,152,118,54,31,23,113
"2011","Rother 006B","E01021085",1176,169,35,134,299,172,164,64,145,63,21,10,11,79
"2011","Rother 006C","E01021086",1168,144,27,117,295,153,164,65,145,80,34,26,8,88
"2011","Rother 006D","E01021096",961,104,28,76,232,88,196,62,105,41,73,63,10,60
"2011","Rother 006E","E01021097",971,129,32,97,258,111,177,53,99,54,16,9,7,74
"2011","Rother 007A","E01021111",655,53,12,41,165,91,67,36,120,76,17,12,5,30
"2011","Rother 007B","E01021113",970,49,20,29,192,152,125,77,171,103,34,19,15,67
"2011","Rother 007C","E01021131",1169,65,15,50,171,131,125,105,236,143,83,60,23,110
"2011","Rother 007D","E01021135",1195,45,8,37,147,154,127,107,269,177,95,64,31,74
"2011","Rother 007E","E01021136",846,21,10,11,107,84,82,67,191,154,99,62,37,41
"2011","Rother 007F","E01021137",1024,40,13,27,163,122,139,101,195,125,72,50,22,67
"2011","Rother 008A","E01021112",1008,75,19,56,209,165,128,75,152,72,26,16,10,106
"2011","Rother 008B","E01021120",761,53,20,33,179,122,103,60,122,56,33,26,7,33
"2011","Rother 008C","E01021126",998,79,17,62,224,150,113,57,164,85,69,49,20,57
"2011","Rother 008D","E01021127",1098,59,20,39,199,157,114,105,194,149,61,42,19,60
"2011","Rother 008E","E01021128",1271,81,11,70,258,212,165,94,216,116,50,27,23,79
"2011","Rother 009A","E01021093",1033,143,47,96,283,156,178,46,94,51,29,23,6,53
"2011","Rother 009B","E01021095",870,101,38,63,228,164,129,43,108,45,14,4,10,38
"2011","Rother 009C","E01021123",1036,143,43,100,287,168,140,54,127,48,25,19,6,44
"2011","Rother 009D","E01021124",1077,143,41,102,272,191,179,63,111,57,25,18,7,36
"2011","Rother 009E","E01021125",822,107,28,79,227,131,142,37,86,32,19,10,9,41
"2011","Rother 009F","E01021129",1251,121,51,70,315,218,179,69,155,80,52,26,26,62
"2011","Rother 009G","E01021138",756,73,16,57,170,109,125,44,101,67,25,18,7,42
"2011","Rother 010A","E01021094",905,93,17,76,248,145,145,41,116,57,23,17,6,37
"2011","Rother 010B","E01021106",995,128,40,88,242,160,120,62,136,74,30,14,16,43
"2011","Rother 010C","E01021107",1018,107,33,74,276,191,142,49,129,57,18,10,8,49
"2011","Rother 010D","E01021108",1021,81,19,62,210,181,117,65,171,89,31,13,18,76
"2011","Rother 010E","E01021130",976,76,18,58,197,158,151,67,146,86,38,17,21,57
"2011","Rother 011A","E01021090",1199,58,14,44,255,161,142,78,248,118,71,47,24,68
"2011","Rother 011B","E01021091",1391,88,24,64,321,177,158,95,272,140,103,52,51,37
"2011","Rother 011C","E01021092",1350,70,12,58,289,167,151,82,268,132,118,84,34,73
"2011","Rother 011D","E01021121",1141,95,20,75,266,197,138,85,192,84,32,27,5,52
"2011","Rother 011E","E01021122",962,72,17,55,204,116,142,73,169,107,44,27,17,35
"2011","Wealden 001A","E01021167",1574,226,52,174,458,182,225,81,159,99,43,35,8,101
"2011","Wealden 001B","E01021168",1231,194,47,147,423,135,153,64,104,51,21,13,8,86
"2011","Wealden 001C","E01021169",968,151,40,111,303,91,162,45,73,38,15,11,4,90
"2011","Wealden 001D","E01021186",880,134,38,96,254,103,167,43,58,54,24,11,13,43
"2011","Wealden 002A","E01021171",1441,288,88,200,425,164,187,52,121,67,30,17,13,107
"2011","Wealden 002B","E01021172",1231,219,69,150,331,163,196,60,124,55,16,9,7,67
"2011","Wealden 002C","E01021173",1006,200,56,144,282,115,164,37,86,37,23,20,3,62
"2011","Wealden 002D","E01021218",848,148,36,112,248,119,137,27,74,32,16,14,2,47
"2011","Wealden 003A","E01021156",1212,136,27,109,316,201,139,74,178,75,31,15,16,62
"2011","Wealden 003B","E01021157",1330,170,45,125,403,200,148,65,167,75,25,14,11,77
"2011","Wealden 003C","E01021158",1559,209,48,161,387,240,223,87,182,104,26,12,14,101
"2011","Wealden 004A","E01021159",1668,315,84,231,514,231,200,67,140,71,37,29,8,93
"2011","Wealden 004B","E01021160",1111,168,47,121,254,185,143,59,118,75,60,53,7,49
"2011","Wealden 004C","E01021161",1143,142,26,116,294,185,136,100,133,62,37,22,15,54
"2011","Wealden 004D","E01021162",1160,207,62,145,353,169,140,39,120,39,13,9,4,80
"2011","Wealden 005A","E01021202",772,134,33,101,232,90,119,34,59,35,10,2,8,59
"2011","Wealden 005B","E01021203",1080,175,35,140,318,113,203,45,93,48,18,13,5,67
"2011","Wealden 005C","E01021229",1238,234,61,173,345,154,190,40,106,48,27,17,10,94
"2011","Wealden 005D","E01021230",1228,246,62,184,373,128,194,37,89,44,22,15,7,95
"2011","Wealden 005E","E01021231",1198,177,37,140,304,159,182,54,140,80,30,16,14,72
"2011","Wealden 006A","E01021151",1305,146,30,116,333,192,202,63,160,91,27,15,12,91
"2011","Wealden 006B","E01021152",1230,58,13,45,363,139,124,70,201,129,78,55,23,68
"2011","Wealden 006C","E01021153",1432,149,29,120,371,208,176,100,200,121,28,18,10,79
"2011","Wealden 006D","E01021154",1074,73,16,57,198,149,144,89,198,138,30,15,15,55
"2011","Wealden 006E","E01021155",882,92,26,66,203,118,139,69,113,75,33,19,14,40
"2011","Wealden 007A","E01021163",1537,274,76,198,431,178,244,71,124,67,54,43,11,94
"2011","Wealden 007B","E01021164",1333,219,46,173,345,136,258,66,131,56,56,45,11,66
"2011","Wealden 007C","E01021187",1078,196,48,148,263,121,219,67,82,57,25,14,11,48
"2011","Wealden 008A","E01021144",1315,259,80,179,394,172,211,46,94,44,18,11,7,77
"2011","Wealden 008B","E01021145",1472,222,56,166,411,162,248,85,138,76,56,42,14,74
"2011","Wealden 008C","E01021170",2063,291,79,212,591,260,387,100,195,101,31,15,16,107
"2011","Wealden 008D","E01021217",900,146,29,117,236,120,152,46,79,52,19,13,6,50
"2011","Wealden 009A","E01021219",1020,129,38,91,294,174,105,63,127,62,16,11,5,50
"2011","Wealden 009B","E01021220",1143,132,20,112,260,168,147,84,183,90,34,21,13,45
"2011","Wealden 009C","E01021223",830,82,17,65,189,142,76,58,148,77,17,9,8,41
"2011","Wealden 009D","E01021224",1038,63,24,39,179,106,131,107,193,147,46,29,17,66
"2011","Wealden 009E","E01021225",1123,89,22,67,298,185,149,84,154,81,22,13,9,61
"2011","Wealden 009F","E01021226",994,91,33,58,211,159,114,91,146,95,21,14,7,66
"2011","Wealden 010A","E01021150",858,118,29,89,236,119,140,35,83,34,48,44,4,45
"2011","Wealden 010B","E01021191",1166,126,28,98,287,152,143,93,192,88,38,16,22,47
"2011","Wealden 010C","E01021192",1172,124,33,91,288,161,182,82,134,93,25,13,12,83
"2011","Wealden 010D","E01021193",1222,103,27,76,245,135,176,83,209,134,42,28,14,95
"2011","Wealden 010E","E01021194",1106,129,28,101,290,174,151,70,116,76,25,17,8,75
"2011","Wealden 011A","E01021149",944,137,27,110,237,120,141,44,100,60,38,29,9,67
"2011","Wealden 011B","E01021189",1048,158,43,115,267,115,202,51,90,60,35,27,8,70
"2011","Wealden 011C","E01021190",1148,122,31,91,288,152,219,50,157,81,15,13,2,64
"2011","Wealden 011D","E01021200",772,57,12,45,164,94,137,54,116,82,22,16,6,46
"2011","Wealden 011E","E01021201",1080,154,34,120,281,123,210,59,110,66,19,8,11,58
"2011","Wealden 012A","E01021221",946,91,29,62,244,109,103,66,142,103,22,13,9,66
"2011","Wealden 012B","E01021222",1113,89,24,65,257,147,147,91,188,114,23,13,10,57
"2011","Wealden 012C","E01021227",1226,144,34,110,348,165,165,78,129,92,31,24,7,74
"2011","Wealden 012D","E01021228",1109,138,37,101,334,187,102,65,116,45,19,8,11,103
"2011","Wealden 013A","E01021146",1243,173,44,129,309,176,175,72,127,99,37,21,16,75
"2011","Wealden 013B","E01021147",1244,182,47,135,305,125,285,64,108,65,39,28,11,71
"2011","Wealden 013C","E01021148",1138,145,44,101,301,132,199,57,111,75,46,41,5,72
"2011","Wealden 013D","E01021165",872,161,41,120,231,113,153,44,71,36,12,7,5,51
"2011","Wealden 014A","E01021188",839,123,30,93,184,99,225,41,57,43,17,13,4,50
"2011","Wealden 014B","E01021198",1050,99,29,70,240,131,197,74,139,82,24,15,9,64
"2011","Wealden 014C","E01021199",986,127,37,90,248,133,223,49,77,58,12,9,3,59
"2011","Wealden 014D","E01021204",860,76,24,52,199,108,169,48,128,63,25,17,8,44
"2011","Wealden 014E","E01021205",945,124,45,79,224,122,193,53,98,61,17,10,7,53
"2011","Wealden 015A","E01021174",1166,95,20,75,276,161,180,103,151,99,25,14,11,76
"2011","Wealden 015B","E01021175",1021,78,21,57,242,151,153,70,158,105,18,10,8,46
"2011","Wealden 015C","E01021176",935,80,18,62,192,162,121,63,141,90,22,14,8,64
"2011","Wealden 015D","E01021177",783,44,13,31,169,123,89,64,143,79,36,27,9,36
"2011","Wealden 016A","E01021180",923,69,18,51,204,122,151,67,157,74,31,21,10,48
"2011","Wealden 016B","E01021181",897,72,22,50,219,139,139,72,115,70,18,11,7,53
"2011","Wealden 016C","E01021182",1075,60,12,48,248,151,125,91,195,127,24,15,9,54
"2011","Wealden 016D","E01021183",918,37,10,27,133,109,101,65,206,135,71,52,19,61
"2011","Wealden 017A","E01021178",903,45,13,32,112,84,119,92,193,149,58,36,22,51
"2011","Wealden 017B","E01021179",1024,40,13,27,141,92,125,82,235,168,70,41,29,71
"2011","Wealden 017C","E01021184",1011,99,22,77,219,183,117,69,155,97,27,18,9,45
"2011","Wealden 017D","E01021185",989,54,14,40,162,102,107,81,221,162,48,37,11,52
"2011","Wealden 018A","E01021142",731,93,27,66,165,95,125,51,111,59,7,6,1,25
"2011","Wealden 018B","E01021143",846,127,26,101,234,91,150,58,72,52,27,18,9,35
"2011","Wealden 018C","E01021166",1639,320,68,252,473,213,267,63,143,52,28,19,9,80
"2011","Wealden 018D","E01021195",1425,146,38,108,323,186,250,79,166,131,62,46,16,82
"2011","Wealden 018E","E01021196",1408,89,19,70,287,216,208,118,228,150,28,17,11,84
"2011","Wealden 018F","E01021197",1479,148,40,108,330,178,215,97,161,89,26,15,11,235
"2011","Wealden 019A","E01021212",1304,83,25,58,280,231,156,97,214,152,35,17,18,56
"2011","Wealden 019B","E01021213",1273,72,20,52,271,194,161,107,209,134,53,33,20,72
"2011","Wealden 019C","E01021214",1029,69,17,52,224,159,148,79,165,117,20,6,14,48
"2011","Wealden 019D","E01021215",823,75,18,57,204,114,130,60,111,73,23,17,6,33
"2011","Wealden 019E","E01021216",812,46,17,29,163,113,119,66,155,92,31,17,14,27
"2011","Wealden 020A","E01021206",1013,97,29,68,230,128,168,68,149,89,24,16,8,60
"2011","Wealden 020B","E01021207",972,76,22,54,205,120,169,82,159,99,26,18,8,36
"2011","Wealden 020C","E01021208",1362,143,36,107,364,241,172,71,177,85,29,22,7,80
"2011","Wealden 020D","E01021209",1137,121,36,85,257,181,146,83,152,100,23,12,11,74
"2011","Wealden 020E","E01021210",1103,154,39,115,299,194,117,75,129,48,12,9,3,75
"2011","Wealden 020F","E01021211",1056,66,12,54,247,142,205,70,155,108,34,21,13,29
"2011","Wealden 021A","E01021232",1116,85,22,63,268,162,156,84,184,101,21,13,8,55
"2011","Wealden 021B","E01021233",994,82,30,52,254,169,113,66,154,74,29,22,7,53
"2011","Wealden 021C","E01021234",997,102,19,83,291,159,159,51,109,57,17,12,5,52
"2011","Wealden 021D","E01021235",948,135,43,92,227,159,142,54,120,53,10,7,3,48
"2011","Wealden 021E","E01021236",1033,82,15,67,199,148,131,79,188,119,38,23,15,49
"2011","Basingstoke and Deane 001A","E01022553",1093,149,32,117,314,196,87,63,130,89,18,12,6,47
"2011","Basingstoke and Deane 001B","E01022554",1212,175,33,142,302,222,93,90,153,92,28,17,11,57
"2011","Basingstoke and Deane 001C","E01022555",1100,125,25,100,235,178,97,96,151,112,37,24,13,69
"2011","Basingstoke and Deane 001D","E01022556",1153,103,16,87,207,173,98,89,202,141,78,59,19,62
"2011","Basingstoke and Deane 001E","E01022560",911,116,27,89,209,150,98,71,134,76,12,9,3,45
"2011","Basingstoke and Deane 002A","E01022493",983,203,59,144,281,126,126,53,78,55,14,6,8,47
"2011","Basingstoke and Deane 002B","E01022536",976,153,31,122,261,141,136,43,96,74,18,13,5,54
"2011","Basingstoke and Deane 002C","E01022537",973,185,50,135,296,165,87,50,95,33,16,7,9,46
"2011","Basingstoke and Deane 002D","E01022557",1106,150,35,115,279,159,98,91,157,91,29,19,10,52
"2011","Basingstoke and Deane 002E","E01022558",953,170,26,144,214,159,73,93,102,86,17,10,7,39
"2011","Basingstoke and Deane 002F","E01022559",966,173,41,132,249,163,89,65,96,56,17,11,6,58
"2011","Basingstoke and Deane 003A","E01022488",839,125,32,93,179,91,94,55,119,93,35,20,15,48
"2011","Basingstoke and Deane 003B","E01022489",1046,219,66,153,252,101,170,56,103,69,18,14,4,58
"2011","Basingstoke and Deane 003C","E01022499",1082,230,57,173,355,151,101,48,79,49,18,10,8,51
"2011","Basingstoke and Deane 003D","E01022500",1008,201,57,144,260,118,165,50,81,70,12,8,4,51
"2011","Basingstoke and Deane 003E","E01022513",1155,243,64,179,308,119,155,49,130,71,34,18,16,46
"2011","Basingstoke and Deane 004A","E01022472",908,180,46,134,250,122,135,26,76,60,27,19,8,32
"2011","Basingstoke and Deane 004B","E01022473",908,116,25,91,223,142,94,75,115,74,18,11,7,51
"2011","Basingstoke and Deane 004C","E01022520",1228,174,38,136,276,156,139,98,152,134,37,15,22,62
"2011","Basingstoke and Deane 004D","E01022521",1254,238,67,171,330,189,142,75,127,73,25,15,10,55
"2011","Basingstoke and Deane 004E","E01022522",1176,219,47,172,300,157,191,67,108,49,19,10,9,66
"2011","Basingstoke and Deane 005A","E01022490",1300,285,61,224,350,167,106,50,151,103,27,8,19,61
"2011","Basingstoke and Deane 005B","E01022491",1335,262,59,203,341,206,114,87,149,87,31,16,15,58
"2011","Basingstoke and Deane 005C","E01022492",1208,264,70,194,354,153,136,58,99,54,20,13,7,70
"2011","Basingstoke and Deane 005D","E01022546",998,238,61,177,297,129,100,40,81,37,15,7,8,61
"2011","Basingstoke and Deane 005E","E01022547",1228,279,64,215,321,172,147,58,124,62,15,9,6,50
"2011","Basingstoke and Deane 006A","E01022495",1124,225,33,192,324,210,63,79,100,57,19,6,13,47
"2011","Basingstoke and Deane 006B","E01022496",1841,426,98,328,595,308,122,76,128,63,19,8,11,104
"2011","Basingstoke and Deane 006C","E01022497",1051,223,38,185,269,184,75,72,106,59,25,9,16,38
"2011","Basingstoke and Deane 006D","E01022498",1192,243,53,190,322,210,83,70,120,64,18,6,12,62
"2011","Basingstoke and Deane 007B","E01022539",892,52,13,39,153,131,66,84,168,147,40,22,18,51
"2011","Basingstoke and Deane 007C","E01022540",1377,99,14,85,224,223,83,128,256,212,64,32,32,88
"2011","Basingstoke and Deane 007E","E01022542",893,56,13,43,147,113,59,90,176,140,46,23,23,66
"2011","Basingstoke and Deane 007F","E01022543",1200,78,18,60,224,190,74,120,225,185,46,25,21,58
"2011","Basingstoke and Deane 007H","E01032843",1238,231,43,188,378,181,70,78,112,97,39,20,19,52
"2011","Basingstoke and Deane 007I","E01032844",1115,97,17,80,247,135,55,105,179,181,56,36,20,60
"2011","Basingstoke and Deane 007J","E01032851",1458,79,26,53,277,189,91,151,278,244,63,35,28,86
"2011","Basingstoke and Deane 008A","E01022470",1441,335,82,253,420,205,109,74,126,57,26,15,11,89
"2011","Basingstoke and Deane 008B","E01022471",1173,246,53,193,361,176,110,59,100,50,12,8,4,59
"2011","Basingstoke and Deane 008C","E01022494",1804,335,63,272,529,262,129,117,183,115,51,26,25,83
"2011","Basingstoke and Deane 008D","E01022523",1492,123,21,102,259,186,87,114,281,268,73,43,30,101
"2011","Basingstoke and Deane 009A","E01022524",1372,67,13,54,263,173,103,119,238,239,70,48,22,100
"2011","Basingstoke and Deane 009B","E01022525",1174,135,29,106,247,206,89,96,176,123,44,35,9,58
"2011","Basingstoke and Deane 009C","E01022526",1222,119,29,90,270,165,72,95,179,189,37,22,15,96
"2011","Basingstoke and Deane 009D","E01022527",1140,142,28,114,198,158,80,78,176,169,52,31,21,87
"2011","Basingstoke and Deane 010B","E01022566",989,91,27,64,195,182,71,70,141,148,25,18,7,66
"2011","Basingstoke and Deane 010C","E01022567",886,45,10,35,148,123,44,64,176,170,50,35,15,66
"2011","Basingstoke and Deane 010D","E01022568",1053,89,24,65,178,161,72,90,199,165,38,18,20,61
"2011","Basingstoke and Deane 010E","E01022570",1167,121,34,87,283,193,79,88,188,96,43,25,18,76
"2011","Basingstoke and Deane 010F","E01032840",1403,243,41,202,381,213,71,91,166,113,44,22,22,81
"2011","Basingstoke and Deane 010G","E01032841",1240,238,40,198,388,179,68,64,123,95,24,9,15,61
"2011","Basingstoke and Deane 011B","E01022502",1188,161,25,136,268,230,93,75,174,100,25,16,9,62
"2011","Basingstoke and Deane 011C","E01022506",964,118,18,100,212,170,75,81,145,91,28,13,15,44
"2011","Basingstoke and Deane 011D","E01022507",1185,139,33,106,247,222,82,73,171,147,44,24,20,60
"2011","Basingstoke and Deane 011E","E01032842",1070,284,31,253,299,128,40,57,99,74,42,30,12,47
"2011","Basingstoke and Deane 011F","E01032847",1016,152,32,120,219,136,71,77,142,109,56,34,22,54
"2011","Basingstoke and Deane 012A","E01022481",1374,131,26,105,286,228,98,114,239,155,42,28,14,81
"2011","Basingstoke and Deane 012B","E01022482",1107,96,16,80,181,135,74,84,207,172,60,43,17,98
"2011","Basingstoke and Deane 012D","E01022503",1096,188,43,145,319,174,76,55,119,79,28,20,8,58
"2011","Basingstoke and Deane 012E","E01032845",1310,198,39,159,318,187,108,89,165,120,50,31,19,75
"2011","Basingstoke and Deane 012F","E01032846",1237,287,40,247,337,198,42,56,109,89,78,55,23,41
"2011","Basingstoke and Deane 013A","E01022484",901,46,8,38,117,106,70,92,176,168,60,37,23,66
"2011","Basingstoke and Deane 013B","E01022485",852,68,17,51,130,119,64,80,157,145,28,16,12,61
"2011","Basingstoke and Deane 013C","E01022486",1479,204,40,164,338,208,109,100,215,169,54,30,24,82
"2011","Basingstoke and Deane 013D","E01022487",896,52,12,40,124,127,54,84,194,149,48,25,23,64
"2011","Basingstoke and Deane 013E","E01022569",950,124,27,97,228,156,93,60,111,103,42,34,8,33
"2011","Basingstoke and Deane 014A","E01022548",952,75,26,49,154,160,73,86,184,142,42,22,20,36
"2011","Basingstoke and Deane 014B","E01022549",1164,72,23,49,179,161,84,98,248,195,49,24,25,78
"2011","Basingstoke and Deane 014C","E01022550",1143,77,14,63,168,175,78,104,223,199,60,28,32,59
"2011","Basingstoke and Deane 014D","E01022551",1125,104,17,87,215,168,90,98,174,159,51,36,15,66
"2011","Basingstoke and Deane 014E","E01022552",1082,71,18,53,146,148,96,87,218,191,46,28,18,79
"2011","Basingstoke and Deane 015A","E01022528",950,162,42,120,235,162,84,58,119,58,12,5,7,60
"2011","Basingstoke and Deane 015B","E01022529",1046,151,33,118,271,155,117,87,132,84,17,8,9,32
"2011","Basingstoke and Deane 015C","E01022530",942,177,49,128,288,169,87,35,87,36,17,10,7,46
"2011","Basingstoke and Deane 015D","E01022531",1125,205,49,156,272,192,122,65,121,79,13,7,6,56
"2011","Basingstoke and Deane 016A","E01022475",1308,140,31,109,313,229,95,118,185,130,31,11,20,67
"2011","Basingstoke and Deane 016B","E01022476",1365,168,27,141,294,242,113,111,200,120,27,13,14,90
"2011","Basingstoke and Deane 016C","E01022480",963,67,18,49,168,156,84,83,187,115,36,21,15,67
"2011","Basingstoke and Deane 016D","E01022504",1090,202,46,156,315,182,76,55,86,61,41,24,17,72
"2011","Basingstoke and Deane 016E","E01022505",1149,139,36,103,256,211,85,103,160,101,25,14,11,69
"2011","Basingstoke and Deane 017A","E01022467",1194,244,69,175,320,197,131,65,97,55,14,7,7,71
"2011","Basingstoke and Deane 017B","E01022468",1255,252,74,178,354,172,133,50,138,77,25,12,13,54
"2011","Basingstoke and Deane 017C","E01022469",1093,208,49,159,292,156,131,58,112,70,15,6,9,51
"2011","Basingstoke and Deane 017D","E01022561",1077,194,56,138,267,111,165,76,136,61,22,13,9,45
"2011","Basingstoke and Deane 017E","E01022562",979,208,56,152,276,131,134,45,95,40,14,6,8,36
"2011","Basingstoke and Deane 018A","E01022515",919,100,18,82,184,186,88,85,137,98,16,8,8,25
"2011","Basingstoke and Deane 018B","E01022516",1081,172,47,125,289,192,110,66,111,65,14,10,4,62
"2011","Basingstoke and Deane 018C","E01022517",959,155,36,119,259,165,96,62,106,49,18,11,7,49
"2011","Basingstoke and Deane 018D","E01022518",1487,289,45,244,397,263,135,77,150,75,25,13,12,76
"2011","Basingstoke and Deane 018E","E01022519",965,163,34,129,256,182,83,69,101,50,15,9,6,46
"2011","Basingstoke and Deane 019A","E01022474",1097,61,9,52,186,176,73,82,243,164,41,22,19,71
"2011","Basingstoke and Deane 019B","E01022477",1047,133,27,106,246,161,71,93,153,103,24,17,7,63
"2011","Basingstoke and Deane 019C","E01022478",1072,88,21,67,200,174,82,97,193,141,43,20,23,54
"2011","Basingstoke and Deane 019D","E01022479",1001,76,13,63,162,156,59,85,209,145,43,23,20,66
"2011","Basingstoke and Deane 019E","E01022509",1067,177,28,149,306,234,65,59,99,65,11,6,5,51
"2011","Basingstoke and Deane 020A","E01022514",1124,191,57,134,281,141,193,73,107,72,22,14,8,44
"2011","Basingstoke and Deane 020B","E01022563",1314,272,68,204,388,156,140,73,124,70,21,14,7,70
"2011","Basingstoke and Deane 020C","E01022564",1271,188,43,145,316,139,143,107,199,106,22,12,10,51
"2011","Basingstoke and Deane 020D","E01022565",1178,149,35,114,298,176,95,99,169,112,17,4,13,63
"2011","Basingstoke and Deane 021B","E01022510",1228,240,61,179,351,196,86,62,116,64,20,9,11,93
"2011","Basingstoke and Deane 021C","E01022511",948,204,42,162,292,148,67,42,88,32,7,3,4,68
"2011","Basingstoke and Deane 021D","E01022512",1017,196,45,151,299,177,71,51,81,33,12,5,7,97
"2011","Basingstoke and Deane 021E","E01032848",1087,204,41,163,338,175,83,54,105,61,20,10,10,47
"2011","Basingstoke and Deane 021F","E01032849",1047,224,46,178,310,170,68,49,95,67,21,13,8,43
"2011","Basingstoke and Deane 021G","E01032850",1109,218,41,177,311,192,86,59,112,74,14,8,6,43
"2011","Basingstoke and Deane 022A","E01022532",1009,216,50,166,303,134,117,50,82,43,13,6,7,51
"2011","Basingstoke and Deane 022B","E01022533",1308,260,63,197,343,139,150,92,139,74,35,22,13,76
"2011","Basingstoke and Deane 022C","E01022534",1198,183,38,145,314,154,108,96,165,103,26,11,15,49
"2011","Basingstoke and Deane 022D","E01022535",1047,150,37,113,266,123,118,87,137,96,24,8,16,46
"2011","East Hampshire 001A","E01022581",1060,226,56,170,296,114,153,44,93,54,23,13,10,57
"2011","East Hampshire 001B","E01022582",1050,236,69,167,326,103,134,41,81,41,19,12,7,69
"2011","East Hampshire 001C","E01022604",883,160,48,112,243,97,133,38,79,44,14,12,2,75
"2011","East Hampshire 001D","E01022605",1210,168,53,115,332,130,141,51,107,57,25,16,9,199
"2011","East Hampshire 002A","E01022574",958,132,31,101,216,105,89,63,139,112,47,39,8,55
"2011","East Hampshire 002B","E01022575",1056,52,18,34,175,69,68,94,248,206,70,45,25,74
"2011","East Hampshire 002C","E01022576",1057,97,15,82,198,119,109,111,165,153,54,34,20,51
"2011","East Hampshire 002D","E01022579",806,63,16,47,127,83,64,81,168,137,40,27,13,43
"2011","East Hampshire 003A","E01022571",900,92,19,73,234,145,77,89,125,72,10,5,5,56
"2011","East Hampshire 003B","E01022572",965,102,23,79,235,135,79,90,158,89,18,9,9,59
"2011","East Hampshire 003C","E01022573",1847,288,69,219,518,253,161,114,229,125,36,21,15,123
"2011","East Hampshire 003D","E01022577",1016,164,33,131,296,126,94,75,115,75,20,10,10,51
"2011","East Hampshire 003E","E01022578",2136,311,76,235,647,247,189,127,269,153,42,26,16,151
"2011","East Hampshire 003F","E01022580",926,118,26,92,219,134,90,65,144,80,17,10,7,59
"2011","East Hampshire 004A","E01022603",1048,105,35,70,228,109,141,74,152,119,53,31,22,67
"2011","East Hampshire 004B","E01022634",787,64,15,49,154,114,84,79,143,91,18,8,10,40
"2011","East Hampshire 004C","E01022639",1346,83,38,45,362,273,81,151,170,107,37,23,14,82
"2011","East Hampshire 004D","E01022640",1078,65,17,48,244,130,114,109,196,112,46,29,17,62
"2011","East Hampshire 006A","E01022615",2103,202,49,153,466,289,306,153,306,196,71,51,20,114
"2011","East Hampshire 006B","E01022633",1028,96,24,72,221,153,95,106,170,122,10,7,3,55
"2011","East Hampshire 006C","E01022635",1062,50,13,37,168,110,102,103,211,165,68,48,20,85
"2011","East Hampshire 006D","E01022636",1001,84,27,57,196,127,111,98,172,132,19,11,8,62
"2011","East Hampshire 006E","E01022641",950,86,24,62,193,131,128,74,157,109,19,10,9,53
"2011","East Hampshire 007A","E01022591",1776,384,106,278,507,184,281,68,134,91,32,19,13,95
"2011","East Hampshire 007B","E01022593",885,137,41,96,259,127,137,47,83,37,9,7,2,49
"2011","East Hampshire 007C","E01022594",1056,164,43,121,300,114,133,72,112,78,27,17,10,56
"2011","East Hampshire 007D","E01022595",1395,271,70,201,401,206,143,65,124,71,25,14,11,89
"2011","East Hampshire 007E","E01022596",1040,202,54,148,345,141,149,37,62,35,25,20,5,44
"2011","East Hampshire 007F","E01022627",1637,298,94,204,457,177,250,71,152,82,31,17,14,119
"2011","East Hampshire 008A","E01022630",1665,261,62,199,467,165,266,93,165,100,43,23,20,105
"2011","East Hampshire 008D","E01022642",806,99,30,69,216,98,95,43,115,74,19,8,11,47
"2011","East Hampshire 008E","E01032663",1736,166,50,116,369,227,247,139,265,194,49,30,19,80
"2011","East Hampshire 009A","E01022583",1208,177,48,129,282,154,160,68,145,94,30,15,15,98
"2011","East Hampshire 009B","E01022584",1187,152,52,100,255,134,173,72,153,111,63,41,22,74
"2011","East Hampshire 009C","E01022585",1163,203,56,147,321,159,150,70,114,46,15,6,9,85
"2011","East Hampshire 009D","E01022586",1264,236,62,174,357,147,184,65,98,50,56,48,8,71
"2011","East Hampshire 009E","E01022587",1222,163,28,135,323,172,169,84,135,87,31,19,12,58
"2011","East Hampshire 010A","E01022616",1186,109,25,84,217,138,153,111,218,130,36,25,11,74
"2011","East Hampshire 010B","E01022617",1157,182,39,143,298,147,167,57,131,61,58,51,7,56
"2011","East Hampshire 010C","E01022618",1210,240,70,170,367,149,144,58,100,46,45,37,8,61
"2011","East Hampshire 010D","E01022631",940,160,37,123,262,94,162,51,90,57,18,11,7,46
"2011","East Hampshire 010E","E01022632",836,131,29,102,244,96,106,52,95,56,21,14,7,35
"2011","East Hampshire 011A","E01022592",1686,292,86,206,432,147,271,84,181,125,59,46,13,95
"2011","East Hampshire 011B","E01022597",1955,302,70,232,532,188,281,90,149,108,41,30,11,264
"2011","East Hampshire 011C","E01022619",943,168,46,122,287,114,93,56,80,59,23,16,7,63
"2011","East Hampshire 011D","E01022624",1650,343,82,261,514,230,131,64,183,49,15,9,6,121
"2011","East Hampshire 011E","E01022625",1855,349,94,255,557,229,218,82,167,91,45,27,18,117
"2011","East Hampshire 012A","E01022620",851,79,23,56,190,104,113,72,132,87,22,12,10,52
"2011","East Hampshire 012B","E01022621",926,67,17,50,187,117,82,72,172,128,39,25,14,62
"2011","East Hampshire 012C","E01022622",938,136,35,101,236,107,88,59,121,105,38,24,14,48
"2011","East Hampshire 012D","E01022623",1575,206,57,149,391,173,176,100,235,148,39,22,17,107
"2011","East Hampshire 012F","E01032664",743,102,17,85,199,84,98,46,102,51,19,11,8,42
"2011","East Hampshire 012G","E01032665",972,122,25,97,226,108,89,75,160,92,36,22,14,64
"2011","East Hampshire 013A","E01022588",1211,179,38,141,343,192,118,74,124,83,16,8,8,82
"2011","East Hampshire 013B","E01022589",1300,198,48,150,358,176,151,81,158,76,30,19,11,72
"2011","East Hampshire 013C","E01022590",1114,171,33,138,290,175,131,69,122,64,15,9,6,77
"2011","East Hampshire 013D","E01022607",878,115,27,88,194,114,109,63,137,76,21,16,5,49
"2011","East Hampshire 013E","E01022608",1009,171,52,119,270,169,90,63,105,54,19,14,5,68
"2011","East Hampshire 014A","E01022606",1858,310,85,225,484,285,242,100,181,114,24,15,9,118
"2011","East Hampshire 014B","E01022611",1086,172,50,122,276,176,98,64,139,58,23,12,11,80
"2011","East Hampshire 014C","E01022613",1030,167,52,115,254,143,102,52,128,87,23,15,8,74
"2011","East Hampshire 014D","E01022614",795,89,16,73,144,101,95,60,136,84,36,32,4,50
"2011","East Hampshire 016A","E01022610",960,155,34,121,242,127,137,53,113,52,21,13,8,60
"2011","East Hampshire 016B","E01022628",870,154,45,109,218,122,99,46,100,57,19,13,6,55
"2011","East Hampshire 016C","E01022629",988,221,67,154,310,113,101,26,83,52,20,15,5,62
"2011","East Hampshire 016D","E01032615",759,88,30,58,186,128,78,49,110,66,23,13,10,31
"2011","East Hampshire 016E","E01032616",1190,176,37,139,336,204,108,69,122,73,18,8,10,84
"2011","East Hampshire 017A","E01022599",883,130,29,101,255,112,126,50,93,64,7,5,2,46
"2011","East Hampshire 017B","E01022600",1115,195,46,149,287,168,144,46,129,45,37,32,5,64
"2011","East Hampshire 017C","E01022601",1038,154,38,116,294,131,154,46,91,75,30,17,13,63
"2011","East Hampshire 017D","E01022602",957,199,52,147,311,126,126,26,62,44,20,10,10,43
"2011","East Hampshire 017E","E01032625",745,133,41,92,233,96,103,28,52,38,23,17,6,39
"2011","Eastleigh 001A","E01022705",1035,220,38,182,293,154,97,45,103,39,21,18,3,63
"2011","Eastleigh 001B","E01022706",1175,320,58,262,343,167,95,36,86,31,18,11,7,79
"2011","Eastleigh 001C","E01022707",1435,342,64,278,437,200,105,54,119,49,17,10,7,112
"2011","Eastleigh 001D","E01022708",1249,236,46,190,354,175,105,71,123,78,16,8,8,91
"2011","Eastleigh 001E","E01022709",1142,254,52,202,309,180,103,60,96,50,24,9,15,66
"2011","Eastleigh 002A","E01022659",1225,125,22,103,255,188,97,118,199,116,28,17,11,99
"2011","Eastleigh 002B","E01022660",1067,116,16,100,227,176,95,92,164,109,21,6,15,67
"2011","Eastleigh 002C","E01022675",1114,138,40,98,293,185,101,90,166,72,16,7,9,53
"2011","Eastleigh 002D","E01022676",1190,148,38,110,298,195,112,85,149,109,28,14,14,66
"2011","Eastleigh 002E","E01022704",1272,167,35,132,344,240,110,82,159,68,23,15,8,79
"2011","Eastleigh 003A","E01022661",1205,175,32,143,295,207,130,84,138,93,14,9,5,69
"2011","Eastleigh 003B","E01022662",1021,172,40,132,258,143,100,62,123,66,29,18,11,68
"2011","Eastleigh 003C","E01022663",1229,206,43,163,326,182,113,74,147,82,25,11,14,74
"2011","Eastleigh 003D","E01022664",1104,211,42,169,334,167,98,51,104,65,14,11,3,60
"2011","Eastleigh 003E","E01022665",1113,169,27,142,286,163,95,71,157,70,26,10,16,76
"2011","Eastleigh 004A","E01022648",930,102,23,79,213,143,93,82,119,98,30,19,11,50
"2011","Eastleigh 004B","E01022667",1157,117,25,92,257,181,99,99,165,132,41,28,13,66
"2011","Eastleigh 004C","E01022672",1202,90,17,73,234,185,98,112,205,143,50,27,23,85
"2011","Eastleigh 004D","E01022673",1558,120,25,95,319,204,119,152,262,220,67,43,24,95
"2011","Eastleigh 004E","E01022674",1247,112,23,89,271,189,92,113,215,159,31,14,17,65
"2011","Eastleigh 005A","E01022643",1232,122,27,95,279,203,109,106,201,124,25,18,7,63
"2011","Eastleigh 005B","E01022644",948,90,21,69,212,169,100,70,135,93,26,13,13,53
"2011","Eastleigh 005C","E01022646",1158,97,26,71,238,200,102,125,174,122,25,13,12,75
"2011","Eastleigh 005D","E01022647",1139,144,39,105,259,177,128,97,147,97,29,16,13,61
"2011","Eastleigh 005E","E01022649",1055,40,13,27,164,138,97,111,198,183,59,34,25,65
"2011","Eastleigh 005F","E01022650",855,94,16,78,180,111,81,83,128,109,22,13,9,47
"2011","Eastleigh 006A","E01022668",1938,210,29,181,369,254,171,156,328,228,88,61,27,134
"2011","Eastleigh 006B","E01022677",1438,102,22,80,251,187,123,118,282,195,79,50,29,101
"2011","Eastleigh 006C","E01022678",1300,94,20,74,258,162,110,125,221,190,44,31,13,96
"2011","Eastleigh 006D","E01022680",1111,78,14,64,164,144,110,93,215,177,85,45,40,45
"2011","Eastleigh 006E","E01022681",1122,51,3,48,167,172,92,114,210,197,45,26,19,74
"2011","Eastleigh 007A","E01022666",1638,176,31,145,370,207,157,159,256,168,67,46,21,78
"2011","Eastleigh 007B","E01022669",1348,134,21,113,305,186,83,127,214,157,60,41,19,82
"2011","Eastleigh 007C","E01022670",1158,105,16,89,198,133,86,101,225,170,73,45,28,67
"2011","Eastleigh 007D","E01022671",1178,82,19,63,232,157,82,108,209,191,47,26,21,70
"2011","Eastleigh 007E","E01022679",1365,141,24,117,297,181,92,118,226,153,58,26,32,99
"2011","Eastleigh 008A","E01022645",851,100,22,78,175,187,98,78,89,66,15,9,6,43
"2011","Eastleigh 008B","E01022682",1018,127,26,101,265,157,126,67,121,65,22,14,8,68
"2011","Eastleigh 008C","E01022683",1039,137,26,111,285,158,115,67,122,60,24,20,4,71
"2011","Eastleigh 008D","E01022684",1115,94,21,73,275,184,107,97,167,91,32,21,11,68
"2011","Eastleigh 008E","E01022685",859,94,16,78,188,139,80,87,118,78,22,13,9,53
"2011","Eastleigh 008F","E01022686",1205,155,43,112,299,178,138,84,146,93,27,18,9,85
"2011","Eastleigh 008G","E01022687",1300,216,49,167,377,211,115,77,131,68,19,6,13,86
"2011","Eastleigh 009A","E01022713",1261,139,33,106,283,208,154,111,166,121,36,26,10,43
"2011","Eastleigh 009B","E01022714",1213,150,41,109,308,199,127,85,159,101,26,20,6,58
"2011","Eastleigh 009C","E01022715",1177,124,32,92,295,204,106,87,162,108,31,19,12,60
"2011","Eastleigh 009D","E01022716",1213,118,29,89,256,213,99,93,201,126,36,20,16,71
"2011","Eastleigh 009E","E01022717",949,116,20,96,256,150,98,67,124,69,13,10,3,56
"2011","Eastleigh 009F","E01022718",1101,152,36,116,257,161,101,81,168,77,32,16,16,72
"2011","Eastleigh 009G","E01022719",1116,136,30,106,310,158,131,70,158,67,26,19,7,60
"2011","Eastleigh 010A","E01022653",1066,187,38,149,274,150,141,60,102,62,32,19,13,58
"2011","Eastleigh 010B","E01022691",1153,203,49,154,327,212,86,68,118,62,13,6,7,64
"2011","Eastleigh 010C","E01022692",2018,298,62,236,667,318,119,126,230,129,39,25,14,92
"2011","Eastleigh 010D","E01022693",1098,202,51,151,339,183,85,53,92,65,19,8,11,60
"2011","Eastleigh 010E","E01022694",1295,223,41,182,372,234,91,77,119,67,19,11,8,93
"2011","Eastleigh 011A","E01022652",1264,135,28,107,294,175,114,95,181,133,40,20,20,97
"2011","Eastleigh 011B","E01022695",958,72,14,58,199,157,95,84,158,113,13,5,8,67
"2011","Eastleigh 011C","E01022700",1098,119,20,99,223,151,112,89,178,111,47,35,12,68
"2011","Eastleigh 011D","E01022701",733,71,31,40,143,115,95,63,96,85,30,20,10,35
"2011","Eastleigh 011E","E01022703",1133,99,21,78,260,155,126,98,186,106,30,24,6,73
"2011","Eastleigh 012A","E01022651",1430,181,46,135,368,249,110,112,201,108,36,17,19,65
"2011","Eastleigh 012B","E01022696",1107,107,31,76,269,207,94,100,158,100,19,11,8,53
"2011","Eastleigh 012C","E01022697",1113,142,39,103,270,176,148,51,157,82,20,10,10,67
"2011","Eastleigh 012D","E01022698",1163,176,46,130,269,176,117,90,151,69,48,44,4,67
"2011","Eastleigh 012E","E01022699",1130,93,33,60,256,210,136,93,167,98,34,27,7,43
"2011","Eastleigh 012F","E01022702",993,155,38,117,265,137,90,67,139,40,17,8,9,83
"2011","Eastleigh 013A","E01022654",1045,121,31,90,250,157,91,98,144,100,30,21,9,54
"2011","Eastleigh 013B","E01022655",1022,40,11,29,134,106,104,89,220,156,85,51,34,88
"2011","Eastleigh 013C","E01022656",1103,114,37,77,237,162,123,81,160,109,47,39,8,70
"2011","Eastleigh 013D","E01022657",1243,163,45,118,293,201,121,99,162,95,37,23,14,72
"2011","Eastleigh 013E","E01022658",1250,220,54,166,377,168,154,74,108,75,22,13,9,52
"2011","Eastleigh 014A","E01022710",1433,171,45,126,360,179,146,127,168,162,61,40,21,59
"2011","Eastleigh 014B","E01022711",1216,72,18,54,222,164,121,103,225,174,52,38,14,83
"2011","Eastleigh 014C","E01022712",1233,163,36,127,292,202,101,95,165,121,15,6,9,79
"2011","Eastleigh 015A","E01022688",1678,325,85,240,525,185,204,102,149,86,26,12,14,76
"2011","Eastleigh 015B","E01022689",1156,181,40,141,353,167,122,66,112,78,13,10,3,64
"2011","Eastleigh 015C","E01022690",1381,145,35,110,330,165,162,109,189,153,39,23,16,89
"2011","Fareham 001A","E01022758",1115,140,38,102,265,174,94,71,154,105,51,37,14,61
"2011","Fareham 001B","E01022771",1166,216,52,164,398,189,94,65,71,44,13,7,6,76
"2011","Fareham 001C","E01022772",1590,349,84,265,497,230,121,93,120,65,23,12,11,92
"2011","Fareham 001D","E01022773",1163,188,50,138,364,159,139,65,100,65,21,15,6,62
"2011","Fareham 001E","E01022774",1409,233,63,170,440,184,165,93,94,76,27,20,7,97
"2011","Fareham 002A","E01022749",998,139,44,95,260,165,100,71,112,61,13,9,4,77
"2011","Fareham 002B","E01022753",933,116,36,80,259,150,73,70,104,79,14,6,8,68
"2011","Fareham 002C","E01022754",1282,168,42,126,397,191,127,91,121,85,31,15,16,71
"2011","Fareham 002D","E01022780",1114,185,40,145,331,175,95,76,103,70,26,18,8,53
"2011","Fareham 002E","E01022787",962,108,28,80,220,148,91,82,128,87,32,16,16,66
"2011","Fareham 002F","E01022788",944,118,32,86,218,158,87,70,121,83,20,9,11,69
"2011","Fareham 003A","E01022730",1084,107,30,77,240,201,102,78,160,105,22,17,5,69
"2011","Fareham 003B","E01022731",1036,102,32,70,276,174,75,84,159,90,18,10,8,58
"2011","Fareham 003C","E01022732",1076,61,22,39,157,98,101,101,210,189,71,48,23,88
"2011","Fareham 003D","E01022733",1219,139,41,98,298,217,90,87,170,99,38,22,16,81
"2011","Fareham 003E","E01022734",987,61,20,41,175,119,89,116,180,132,36,27,9,79
"2011","Fareham 004A","E01022720",1053,202,47,155,304,165,84,45,102,51,18,12,6,82
"2011","Fareham 004B","E01022725",920,187,50,137,263,140,57,55,83,39,35,34,1,61
"2011","Fareham 004C","E01022726",1007,163,37,126,297,151,88,59,120,58,21,17,4,50
"2011","Fareham 004D","E01022727",1102,114,25,89,312,179,68,83,140,91,25,18,7,90
"2011","Fareham 004E","E01022729",885,138,38,100,256,129,93,67,93,56,20,12,8,33
"2011","Fareham 004F","E01022743",1363,181,46,135,339,212,118,102,179,118,26,14,12,88
"2011","Fareham 005A","E01022750",1040,158,42,116,299,165,93,48,112,61,17,14,3,87
"2011","Fareham 005B","E01022751",1104,192,63,129,284,171,100,46,145,89,16,7,9,61
"2011","Fareham 005C","E01022752",1073,182,49,133,324,152,86,56,118,52,21,9,12,82
"2011","Fareham 005D","E01022757",1230,157,35,122,350,256,86,89,128,90,9,2,7,65
"2011","Fareham 005E","E01022790",1340,227,59,168,394,202,133,75,136,60,20,13,7,93
"2011","Fareham 006A","E01022755",1048,134,31,103,245,139,105,84,138,98,34,10,24,71
"2011","Fareham 006B","E01022756",986,152,39,113,239,177,88,70,125,55,10,5,5,70
"2011","Fareham 006C","E01022791",1539,223,59,164,389,179,141,88,129,87,21,15,6,282
"2011","Fareham 006D","E01022792",1120,144,37,107,295,138,124,74,159,89,24,15,9,73
"2011","Fareham 006E","E01022793",1277,256,75,181,390,195,134,48,98,44,16,12,4,96
"2011","Fareham 007A","E01022781",977,131,36,95,228,107,111,75,140,86,37,20,17,62
"2011","Fareham 007B","E01022782",1078,196,50,146,285,128,147,52,116,54,30,22,8,70
"2011","Fareham 007C","E01022785",1122,174,40,134,296,170,111,89,122,73,14,9,5,73
"2011","Fareham 007D","E01022786",1183,142,38,104,297,181,125,90,157,96,24,11,13,71
"2011","Fareham 007E","E01022789",1111,152,32,120,320,176,104,93,132,72,18,11,7,44
"2011","Fareham 008A","E01022721",1064,163,45,118,305,171,111,62,125,64,15,10,5,48
"2011","Fareham 008B","E01022722",1124,162,41,121,284,161,96,78,138,78,43,31,12,84
"2011","Fareham 008C","E01022723",1124,130,24,106,280,163,106,66,171,122,48,30,18,38
"2011","Fareham 008D","E01022724",1061,114,33,81,234,173,83,79,152,118,27,15,12,81
"2011","Fareham 008E","E01022737",1189,113,21,92,267,159,111,107,194,129,45,30,15,64
"2011","Fareham 008F","E01022766",980,179,46,133,276,141,99,65,101,42,12,6,6,65
"2011","Fareham 008G","E01022769",952,144,24,120,252,144,82,63,128,70,19,9,10,50
"2011","Fareham 009A","E01022740",1281,127,31,96,355,197,93,128,194,104,19,11,8,64
"2011","Fareham 009B","E01022741",904,125,42,83,269,130,58,68,111,64,27,19,8,52
"2011","Fareham 009C","E01022742",1240,135,22,113,308,209,102,93,212,108,24,19,5,49
"2011","Fareham 009D","E01022783",1105,170,54,116,324,178,91,72,109,63,28,15,13,70
"2011","Fareham 009E","E01022784",1031,139,28,111,305,147,73,62,131,77,24,20,4,73
"2011","Fareham 010A","E01022759",1119,115,26,89,258,164,100,97,165,123,27,15,12,70
"2011","Fareham 010B","E01022763",1159,159,39,120,279,209,130,79,130,81,21,12,9,71
"2011","Fareham 010C","E01022765",1205,110,39,71,274,181,154,87,175,146,24,17,7,54
"2011","Fareham 010D","E01022768",1073,114,29,85,247,177,92,79,177,103,26,13,13,58
"2011","Fareham 010E","E01022770",1270,155,46,109,315,201,121,103,178,105,21,10,11,71
"2011","Fareham 011A","E01022728",1242,116,18,98,279,172,89,104,217,143,48,28,20,74
"2011","Fareham 011B","E01022735",1107,98,23,75,248,182,92,97,189,110,31,18,13,60
"2011","Fareham 011C","E01022736",1148,85,20,65,195,160,118,124,227,147,38,27,11,54
"2011","Fareham 011D","E01022738",771,44,14,30,149,93,62,60,156,119,50,31,19,38
"2011","Fareham 011E","E01022739",1117,36,10,26,154,123,85,107,253,176,75,49,26,108
"2011","Fareham 012A","E01022760",1118,101,22,79,220,166,126,100,146,167,27,13,14,65
"2011","Fareham 012B","E01022761",1096,101,26,75,231,158,139,77,163,130,39,26,13,58
"2011","Fareham 012C","E01022762",1122,95,25,70,258,170,103,102,193,115,13,9,4,73
"2011","Fareham 012D","E01022764",1111,85,24,61,242,179,108,97,173,128,38,24,14,61
"2011","Fareham 012E","E01022767",895,109,24,85,212,159,63,72,123,77,16,6,10,64
"2011","Fareham 013B","E01022776",1176,199,59,140,331,193,95,63,125,61,19,11,8,90
"2011","Fareham 013C","E01022777",1088,100,29,71,247,166,121,66,166,107,42,32,10,73
"2011","Fareham 013D","E01022778",1049,113,27,86,262,171,92,87,160,86,19,10,9,59
"2011","Fareham 013F","E01032877",1529,205,65,140,392,234,164,104,187,122,30,17,13,91
"2011","Fareham 014A","E01022744",1006,171,53,118,283,144,83,64,102,64,18,15,3,77
"2011","Fareham 014B","E01022745",1069,212,66,146,346,143,99,48,83,51,12,8,4,75
"2011","Fareham 014C","E01022746",1093,209,110,99,298,178,99,57,123,58,18,12,6,53
"2011","Fareham 014D","E01022747",887,105,28,77,240,156,67,54,137,65,15,13,2,48
"2011","Fareham 014E","E01022748",1057,134,36,98,280,191,85,65,139,68,15,10,5,80
"2011","Gosport 001A","E01022800",1217,51,11,40,198,139,87,134,266,201,44,23,21,97
"2011","Gosport 001B","E01022801",1088,47,14,33,167,120,87,124,229,188,54,29,25,72
"2011","Gosport 001C","E01022802",1133,72,19,53,234,172,114,105,191,158,34,19,15,53
"2011","Gosport 001D","E01022803",1185,46,9,37,184,137,66,137,224,230,72,40,32,89
"2011","Gosport 001E","E01022836",1028,79,32,47,242,163,82,109,164,111,21,16,5,57
"2011","Gosport 002A","E01022804",1192,58,20,38,218,141,116,142,218,182,48,28,20,69
"2011","Gosport 002B","E01022805",1043,55,22,33,181,143,78,118,205,170,33,27,6,60
"2011","Gosport 002C","E01022834",963,54,19,35,167,148,76,108,181,165,35,19,16,29
"2011","Gosport 002D","E01022835",1082,57,15,42,218,143,86,108,195,171,34,19,15,70
"2011","Gosport 002E","E01022840",1190,56,16,40,150,119,87,114,259,249,72,49,23,84
"2011","Gosport 003A","E01022813",1027,78,26,52,246,136,79,109,178,111,17,14,3,73
"2011","Gosport 003B","E01022814",1255,65,22,43,287,187,104,121,211,164,44,30,14,72
"2011","Gosport 003C","E01022815",1143,62,24,38,256,224,78,100,187,151,21,13,8,64
"2011","Gosport 003D","E01022823",1167,80,24,56,248,177,115,125,196,139,30,12,18,57
"2011","Gosport 003E","E01022825",1080,88,31,57,250,166,101,108,153,122,23,11,12,69
"2011","Gosport 004A","E01022819",1125,51,18,33,216,136,80,106,219,187,58,26,32,72
"2011","Gosport 004B","E01022820",1157,55,21,34,194,144,63,113,234,168,74,40,34,112
"2011","Gosport 004E","E01022841",1032,58,21,37,212,147,52,107,175,155,48,29,19,78
"2011","Gosport 004F","E01022842",1114,59,28,31,294,166,74,96,182,127,44,26,18,72
"2011","Gosport 004G","E01032882",1385,39,13,26,205,175,88,134,251,257,105,65,40,131
"2011","Gosport 005A","E01022807",1165,54,22,32,200,171,86,140,234,165,53,26,27,62
"2011","Gosport 005B","E01022816",1124,57,23,34,206,171,81,116,195,183,27,16,11,88
"2011","Gosport 005C","E01022817",1320,77,24,53,225,182,111,139,238,201,63,38,25,84
"2011","Gosport 005D","E01022818",1052,43,9,34,167,117,69,117,203,202,61,37,24,73
"2011","Gosport 005E","E01022824",2106,238,71,167,563,297,157,193,274,195,82,40,42,107
"2011","Gosport 006A","E01022826",1185,139,36,103,319,204,82,96,172,83,24,13,11,66
"2011","Gosport 006C","E01022828",821,105,35,70,242,115,105,66,96,54,19,11,8,19
"2011","Gosport 006D","E01022829",1394,269,130,139,402,182,135,61,138,70,65,48,17,72
"2011","Gosport 006E","E01022830",997,114,25,89,287,168,106,79,110,72,18,7,11,43
"2011","Gosport 006F","E01032880",999,159,58,101,300,151,89,59,97,56,18,11,7,70
"2011","Gosport 006G","E01032881",1188,181,64,117,358,156,80,73,129,89,27,13,14,95
"2011","Gosport 006H","E01032883",924,71,22,49,199,134,103,78,139,104,39,24,15,57
"2011","Gosport 007A","E01022806",1089,57,16,41,221,144,83,111,212,154,43,30,13,64
"2011","Gosport 007D","E01022832",1213,82,26,56,256,185,92,124,221,142,37,17,20,74
"2011","Gosport 007E","E01022839",1056,54,10,44,179,136,67,88,216,191,57,36,21,68
"2011","Gosport 007F","E01032884",1551,82,30,52,327,233,113,186,281,218,39,23,16,72
"2011","Gosport 008A","E01022810",1152,85,11,74,233,139,106,126,199,134,59,33,26,71
"2011","Gosport 008B","E01022811",1734,165,44,121,410,248,115,156,261,207,78,41,37,94
"2011","Gosport 008C","E01022833",1335,51,13,38,195,148,109,144,267,256,91,56,35,74
"2011","Gosport 008D","E01022843",1061,46,12,34,177,117,74,82,209,200,97,65,32,59
"2011","Gosport 008F","E01032878",892,69,24,45,182,109,67,92,142,124,47,23,24,60
"2011","Gosport 008G","E01032879",947,77,31,46,166,107,85,102,155,160,63,41,22,32
"2011","Gosport 009A","E01022794",1016,209,84,125,331,141,91,42,73,37,34,24,10,58
"2011","Gosport 009B","E01022795",1110,134,53,81,254,188,108,87,158,114,19,9,10,48
"2011","Gosport 009C","E01022796",756,150,43,107,227,114,71,38,69,38,13,11,2,36
"2011","Gosport 009D","E01022837",1086,115,40,75,296,162,99,87,131,81,20,14,6,95
"2011","Gosport 009E","E01022838",894,105,29,76,257,158,59,58,119,57,14,9,5,67
"2011","Gosport 010A","E01022797",795,113,39,74,240,97,69,42,76,59,35,25,10,64
"2011","Gosport 010B","E01022798",927,76,27,49,243,141,70,73,124,82,66,56,10,52
"2011","Gosport 010C","E01022799",968,155,60,95,299,136,78,53,117,67,10,6,4,53
"2011","Gosport 010D","E01022812",946,82,29,53,189,141,82,109,157,114,25,14,11,47
"2011","Gosport 010E","E01022831",1041,84,28,56,254,140,89,96,162,107,29,15,14,80
"2011","Gosport 010F","E01022845",1049,80,19,61,214,152,103,94,183,128,36,25,11,59
"2011","Hart 001A","E01022890",1060,117,29,88,199,134,120,86,180,111,42,23,19,71
"2011","Hart 001B","E01022891",1311,198,55,143,387,208,125,70,135,81,21,14,7,86
"2011","Hart 001C","E01022892",1408,169,38,131,384,226,156,125,163,100,14,7,7,71
"2011","Hart 001D","E01022893",1173,162,43,119,326,195,120,79,125,72,24,9,15,70
"2011","Hart 001E","E01022894",1108,147,44,103,280,164,124,80,139,96,18,9,9,60
"2011","Hart 002A","E01022859",1192,225,60,165,352,146,186,55,94,45,22,15,7,67
"2011","Hart 002B","E01022895",1384,192,42,150,341,250,139,98,173,92,23,10,13,76
"2011","Hart 002C","E01022896",1245,169,31,138,335,232,99,97,141,65,20,9,11,87
"2011","Hart 002D","E01022897",1334,209,33,176,361,227,106,96,149,79,27,10,17,80
"2011","Hart 002E","E01022898",1161,164,39,125,328,204,113,68,139,63,11,4,7,71
"2011","Hart 003A","E01022846",944,199,65,134,266,160,77,42,65,56,29,24,5,50
"2011","Hart 003B","E01022847",1307,165,27,138,364,208,150,89,158,86,26,18,8,61
"2011","Hart 003C","E01022848",1140,124,24,100,258,175,110,99,183,95,32,13,19,64
"2011","Hart 003D","E01022874",1010,108,27,81,192,163,94,88,162,110,25,17,8,68
"2011","Hart 003E","E01022875",1055,82,15,67,180,155,95,103,182,124,55,32,23,79
"2011","Hart 003F","E01022876",1015,148,40,108,248,181,81,68,148,68,22,10,12,51
"2011","Hart 003G","E01022877",1056,141,30,111,262,153,140,74,130,75,25,19,6,56
"2011","Hart 004A","E01022858",804,148,45,103,228,85,126,43,55,61,9,5,4,49
"2011","Hart 004B","E01022878",1282,355,91,264,398,173,115,35,83,41,13,7,6,69
"2011","Hart 004C","E01022879",1180,221,67,154,338,117,159,57,119,90,34,20,14,45
"2011","Hart 004D","E01022880",1123,161,40,121,261,122,141,59,159,127,32,17,15,61
"2011","Hart 005A","E01022860",1261,299,72,227,388,175,82,52,99,61,37,20,17,68
"2011","Hart 005B","E01022862",1427,278,58,220,381,189,145,100,147,92,27,14,13,68
"2011","Hart 005D","E01022867",1174,258,41,217,338,192,92,73,93,46,24,15,9,58
"2011","Hart 005E","E01032852",1205,275,72,203,366,161,95,62,97,66,25,13,12,58
"2011","Hart 005F","E01032853",1206,344,74,270,392,169,83,40,70,33,20,12,8,55
"2011","Hart 005G","E01032854",1148,332,76,256,408,139,76,34,60,27,25,16,9,47
"2011","Hart 005H","E01032857",795,208,34,174,241,120,66,31,54,24,14,8,6,37
"2011","Hart 006A","E01022881",1675,302,58,244,453,217,168,110,183,103,34,19,15,105
"2011","Hart 006B","E01022882",1114,229,45,184,337,132,118,63,91,60,7,4,3,77
"2011","Hart 006C","E01022883",1037,251,45,206,319,127,77,47,83,32,17,9,8,84
"2011","Hart 006D","E01022884",1107,224,67,157,321,137,131,56,104,56,16,4,12,62
"2011","Hart 006E","E01022885",1122,264,51,213,308,162,99,58,90,45,17,7,10,79
"2011","Hart 007A","E01022861",1241,250,53,197,384,180,114,51,113,43,16,10,6,90
"2011","Hart 007B","E01022863",1080,222,49,173,304,176,104,55,106,45,13,11,2,55
"2011","Hart 007C","E01022865",1185,246,61,185,383,189,103,43,99,36,13,10,3,73
"2011","Hart 007D","E01022868",1226,275,54,221,395,181,111,39,104,43,17,14,3,61
"2011","Hart 007E","E01022870",1028,229,39,190,297,134,80,49,91,57,22,15,7,69
"2011","Hart 008A","E01022864",1010,183,42,141,252,158,93,60,111,73,29,16,13,51
"2011","Hart 008B","E01022871",1050,185,25,160,253,140,98,63,141,79,28,13,15,63
"2011","Hart 008C","E01022872",1256,214,36,178,366,180,132,90,111,67,23,13,10,73
"2011","Hart 008D","E01022873",1266,249,76,173,413,180,113,40,114,46,33,23,10,78
"2011","Hart 008E","E01022887",1123,213,65,148,316,122,155,47,75,54,86,80,6,55
"2011","Hart 009A","E01022849",1205,200,42,158,335,179,114,66,126,84,25,15,10,76
"2011","Hart 009B","E01022850",1090,199,51,148,282,171,106,73,125,57,25,19,6,52
"2011","Hart 009C","E01022851",1190,207,39,168,329,198,109,76,121,66,15,4,11,69
"2011","Hart 009D","E01022853",1219,239,53,186,303,183,131,82,136,61,7,0,7,77
"2011","Hart 009E","E01022869",1058,198,46,152,257,172,116,66,109,68,20,11,9,52
"2011","Hart 010A","E01022852",1352,298,65,233,400,221,113,57,125,51,12,4,8,75
"2011","Hart 010B","E01022854",1204,267,52,215,348,169,104,54,97,60,23,12,11,82
"2011","Hart 010C","E01022855",867,179,50,129,228,89,109,49,94,48,29,14,15,42
"2011","Hart 010D","E01022856",1075,223,70,153,313,129,148,42,86,55,15,12,3,64
"2011","Hart 010E","E01022857",948,148,79,69,289,160,56,57,98,49,22,16,6,69
"2011","Hart 011B","E01022888",1190,277,76,201,335,164,131,55,95,49,27,18,9,57
"2011","Hart 011C","E01022889",1045,164,41,123,267,118,122,89,106,109,23,11,12,47
"2011","Hart 011D","E01032855",917,162,47,115,267,85,112,42,66,44,12,4,8,127
"2011","Hart 011E","E01032856",1699,344,260,84,583,391,43,165,84,48,7,2,5,34
"2011","Havant 003A","E01022930",1242,103,31,72,240,209,131,120,191,148,33,20,13,67
"2011","Havant 003B","E01022931",1219,147,36,111,271,198,121,80,184,93,26,16,10,99
"2011","Havant 003C","E01022935",1045,99,25,74,218,156,110,88,187,105,23,13,10,59
"2011","Havant 003D","E01022975",1087,94,22,72,259,177,134,83,163,99,25,16,9,53
"2011","Havant 003E","E01022976",1102,109,27,82,213,138,119,96,180,131,55,38,17,61
"2011","Havant 004A","E01022922",1181,138,29,109,288,224,107,95,141,106,13,6,7,69
"2011","Havant 004B","E01022971",1128,133,34,99,267,211,131,68,159,71,24,10,14,64
"2011","Havant 004C","E01022972",1167,172,42,130,319,188,142,65,120,65,24,17,7,72
"2011","Havant 004D","E01022974",1102,188,59,129,315,172,107,53,116,66,17,6,11,68
"2011","Havant 005A","E01022959",999,56,17,39,131,91,96,84,221,177,58,34,24,85
"2011","Havant 005B","E01022962",1089,92,26,66,225,175,130,81,180,117,31,14,17,58
"2011","Havant 005C","E01022965",1045,60,15,45,161,119,83,89,197,165,83,50,33,88
"2011","Havant 005D","E01022973",1315,136,63,73,288,154,125,96,216,146,72,55,17,82
"2011","Havant 006A","E01022901",1169,44,17,27,124,131,116,132,245,213,99,44,55,65
"2011","Havant 006B","E01022902",1089,37,17,20,147,120,89,98,256,191,70,42,28,81
"2011","Havant 006C","E01022966",936,24,7,17,95,101,76,100,214,185,72,45,27,69
"2011","Havant 006D","E01022967",816,25,8,17,78,84,62,76,166,200,75,57,18,50
"2011","Havant 007A","E01022960",1045,66,14,52,186,142,101,94,182,135,59,38,21,80
"2011","Havant 007B","E01022961",1013,69,18,51,182,144,133,80,179,117,42,25,17,67
"2011","Havant 007C","E01022963",1070,136,34,102,257,165,89,85,164,80,22,14,8,72
"2011","Havant 007D","E01022964",971,53,15,38,157,128,78,77,208,149,60,40,20,61
"2011","Havant 008A","E01022903",1242,31,10,21,148,123,126,126,277,254,89,55,34,68
"2011","Havant 008B","E01022906",1024,33,11,22,127,92,87,104,261,183,55,33,22,82
"2011","Havant 008C","E01022968",977,24,10,14,115,83,72,85,235,207,69,47,22,87
"2011","Havant 008D","E01022969",1183,52,16,36,161,104,121,106,288,196,75,57,18,80
"2011","Havant 009A","E01022913",936,31,4,27,112,112,74,80,208,208,68,42,26,43
"2011","Havant 009B","E01022914",927,22,4,18,139,102,87,109,180,160,60,39,21,68
"2011","Havant 009C","E01022915",1044,38,16,22,113,119,78,99,227,206,101,65,36,63
"2011","Havant 009D","E01022916",1133,54,20,34,171,143,89,111,234,229,39,27,12,63
"2011","Havant 009E","E01022917",870,20,5,15,86,86,82,86,201,173,71,50,21,65
"2011","Havant 010A","E01022900",1293,42,11,31,158,125,104,117,279,301,93,56,37,74
"2011","Havant 010B","E01022904",1408,47,16,31,183,160,126,142,333,253,84,57,27,80
"2011","Havant 010C","E01022905",1205,31,8,23,116,115,96,118,292,239,134,83,51,64
"2011","Havant 010D","E01022908",1052,46,19,27,170,132,84,94,205,192,64,34,30,65
"2011","Havant 010E","E01022970",1251,48,13,35,159,114,115,136,250,241,110,67,43,78
"2011","Havant 011A","E01022947",1280,156,43,113,336,204,153,63,140,120,19,15,4,89
"2011","Havant 011B","E01022948",1187,136,35,101,268,190,126,79,168,105,33,28,5,82
"2011","Havant 011C","E01022949",1124,59,14,45,162,132,121,100,233,178,75,44,31,64
"2011","Havant 011D","E01022950",1085,142,39,103,264,165,114,73,134,96,24,8,16,73
"2011","Havant 011E","E01022951",1035,115,39,76,226,179,100,89,137,109,21,13,8,59
"2011","Havant 011F","E01022952",1074,115,29,86,240,175,92,87,184,109,22,13,9,50
"2011","Havant 013A","E01022924",1155,161,42,119,310,130,133,75,131,114,45,33,12,56
"2011","Havant 013B","E01022925",992,112,20,92,264,143,110,61,142,81,23,13,10,56
"2011","Havant 013C","E01022926",1041,209,59,150,298,150,111,58,80,46,28,17,11,61
"2011","Havant 013D","E01022927",1084,126,26,100,258,138,129,65,149,118,48,33,15,53
"2011","Havant 013E","E01022928",1133,248,52,196,383,151,96,47,80,36,22,17,5,70
"2011","Havant 013F","E01022929",1059,216,42,174,329,98,131,57,87,64,28,14,14,49
"2011","Havant 014A","E01022953",1483,151,26,125,316,200,140,125,238,150,91,58,33,72
"2011","Havant 014B","E01022954",1095,234,53,181,318,169,126,49,83,40,18,13,5,58
"2011","Havant 014C","E01022955",960,175,33,142,257,151,99,32,105,52,32,25,7,57
"2011","Havant 014D","E01022956",881,105,21,84,198,137,66,79,132,73,28,17,11,63
"2011","Havant 014E","E01022957",917,119,23,96,210,115,88,64,110,86,52,40,12,73
"2011","Havant 014F","E01022958",1055,204,43,161,288,171,110,51,101,53,10,4,6,67
"2011","Havant 015A","E01022937",1084,129,35,94,222,122,135,91,161,118,38,23,15,68
"2011","Havant 015B","E01022943",998,183,55,128,317,138,136,45,68,49,21,12,9,41
"2011","Havant 015C","E01022944",1009,164,54,110,260,118,161,58,103,69,22,13,9,54
"2011","Havant 015D","E01022946",1271,163,35,128,317,190,158,74,198,78,33,27,6,60
"2011","Havant 016A","E01022940",1122,123,30,93,256,145,162,72,174,91,34,18,16,65
"2011","Havant 016B","E01022942",1052,137,29,108,248,135,101,79,138,110,51,24,27,53
"2011","Havant 016C","E01022945",1608,177,48,129,384,227,208,100,248,147,40,22,18,77
"2011","Havant 017A","E01022936",1145,103,25,78,232,150,168,92,176,146,42,28,14,36
"2011","Havant 017B","E01022938",975,111,27,84,195,135,163,71,132,80,34,18,16,54
"2011","Havant 017C","E01022939",1169,97,25,72,259,149,159,86,211,117,35,23,12,56
"2011","Havant 017D","E01022941",1159,128,40,88,274,156,178,85,150,87,32,20,12,69
"2011","Havant 018A","E01022899",1002,43,10,33,138,109,87,80,207,195,50,36,14,93
"2011","Havant 018B","E01022907",1075,88,20,68,219,147,118,92,200,111,38,30,8,62
"2011","Havant 018C","E01022909",1144,166,50,116,306,172,108,80,117,93,25,14,11,77
"2011","Havant 018D","E01022910",1063,94,25,69,177,155,111,91,200,136,39,18,21,60
"2011","Havant 018E","E01022911",1077,102,24,78,234,138,120,84,177,130,29,17,12,63
"2011","Havant 018F","E01032605",975,103,35,68,232,174,107,73,122,68,32,20,12,64
"2011","Havant 019A","E01022919",1210,96,31,65,232,171,120,108,212,130,48,31,17,93
"2011","Havant 019B","E01022933",1165,31,14,17,133,112,125,105,239,214,118,61,57,88
"2011","Havant 019C","E01022934",1331,52,16,36,187,143,120,114,266,257,95,42,53,97
"2011","Havant 019D","E01032618",1103,99,18,81,248,168,99,100,181,115,24,18,6,69
"2011","Havant 020A","E01022918",1078,102,33,69,238,152,88,86,194,125,28,21,7,65
"2011","Havant 020B","E01022920",1136,127,31,96,249,171,131,90,164,116,31,20,11,57
"2011","Havant 020C","E01022921",1177,126,33,93,299,216,141,68,144,95,17,10,7,71
"2011","Havant 020D","E01032617",1104,148,43,105,254,183,106,81,144,83,20,11,9,85
"2011","New Forest 001A","E01023011",1075,142,36,106,284,108,197,61,113,99,27,16,11,44
"2011","New Forest 001B","E01023012",1017,152,41,111,269,128,179,63,95,66,12,5,7,53
"2011","New Forest 001C","E01023021",1052,137,38,99,279,153,143,70,128,61,18,13,5,63
"2011","New Forest 001D","E01023022",1214,132,40,92,270,145,165,103,184,128,30,19,11,57
"2011","New Forest 001E","E01023023",1209,120,33,87,265,161,153,82,180,127,38,19,19,83
"2011","New Forest 001F","E01023024",1094,146,46,100,285,155,150,58,150,80,18,8,10,52
"2011","New Forest 001G","E01023025",990,188,43,145,263,102,200,49,75,54,19,13,6,40
"2011","New Forest 002A","E01023076",1018,75,17,58,224,155,111,107,157,131,21,12,9,37
"2011","New Forest 002B","E01023082",1120,64,11,53,217,179,99,123,208,143,32,22,10,55
"2011","New Forest 002C","E01023083",1109,54,8,46,184,156,97,88,210,204,47,31,16,69
"2011","New Forest 002D","E01023088",1164,68,11,57,200,144,103,112,221,191,67,43,24,58
"2011","New Forest 003A","E01023073",1072,113,16,97,288,179,85,73,148,81,22,14,8,83
"2011","New Forest 003B","E01023080",974,72,12,60,196,154,84,89,165,120,36,29,7,58
"2011","New Forest 003C","E01023081",1444,134,22,112,401,220,129,87,208,120,64,51,13,81
"2011","New Forest 003D","E01023089",1162,121,24,97,247,203,98,105,180,122,34,17,17,52
"2011","New Forest 003E","E01023090",1416,148,31,117,349,231,121,136,187,123,34,15,19,87
"2011","New Forest 004A","E01023074",1009,72,16,56,208,143,80,89,178,142,45,34,11,52
"2011","New Forest 004B","E01023077",1087,53,10,43,216,148,100,93,192,172,53,33,20,60
"2011","New Forest 004C","E01023078",974,83,19,64,196,148,101,108,166,109,15,7,8,48
"2011","New Forest 004D","E01023079",1271,96,26,70,235,178,144,128,211,173,43,32,11,63
"2011","New Forest 004E","E01023085",1104,77,25,52,208,140,111,103,198,150,51,29,22,66
"2011","New Forest 005A","E01023072",1005,99,19,80,238,176,88,93,135,97,21,10,11,58
"2011","New Forest 005B","E01023075",857,76,26,50,174,146,70,69,152,90,24,16,8,56
"2011","New Forest 005C","E01023084",1102,119,27,92,233,175,87,123,165,112,15,10,5,73
"2011","New Forest 005D","E01023086",1076,74,18,56,172,163,116,104,182,165,36,23,13,64
"2011","New Forest 005E","E01023087",1139,167,30,137,296,200,82,95,133,79,14,5,9,73
"2011","New Forest 006A","E01022977",1042,176,37,139,286,149,117,69,115,57,15,10,5,58
"2011","New Forest 006B","E01022978",1117,163,35,128,312,153,164,65,107,77,19,15,4,57
"2011","New Forest 006C","E01022979",884,126,31,95,227,126,107,55,115,68,17,13,4,43
"2011","New Forest 006D","E01022980",1074,129,29,100,266,159,148,72,119,84,42,36,6,55
"2011","New Forest 007A","E01022992",868,134,29,105,206,128,166,48,77,59,13,11,2,37
"2011","New Forest 007B","E01022993",1002,215,56,159,244,96,187,47,78,51,46,43,3,38
"2011","New Forest 007C","E01023045",1139,203,44,159,351,155,139,45,104,67,19,12,7,56
"2011","New Forest 007D","E01023046",995,155,38,117,222,117,122,94,127,80,21,12,9,57
"2011","New Forest 008A","E01023007",840,68,17,51,172,123,85,86,127,107,29,20,9,43
"2011","New Forest 008B","E01023010",1132,72,22,50,240,168,94,94,205,158,34,15,19,67
"2011","New Forest 008C","E01023047",1015,106,29,77,275,192,70,90,110,82,25,16,9,65
"2011","New Forest 008D","E01023048",1018,108,28,80,264,163,72,100,131,85,26,18,8,69
"2011","New Forest 008E","E01023049",1274,176,60,116,374,204,73,101,143,121,26,14,12,56
"2011","New Forest 008F","E01023050",1308,129,33,96,361,204,101,100,152,127,57,37,20,77
"2011","New Forest 009A","E01023008",1050,140,33,107,301,153,100,96,117,78,28,22,6,37
"2011","New Forest 009B","E01023009",1151,151,32,119,300,188,100,119,147,73,22,11,11,51
"2011","New Forest 009C","E01023038",1058,119,30,89,282,192,64,117,132,86,17,6,11,49
"2011","New Forest 009D","E01023039",1007,99,29,70,239,183,85,89,154,85,26,13,13,47
"2011","New Forest 009E","E01023040",1035,128,31,97,269,197,93,98,127,71,15,7,8,37
"2011","New Forest 010A","E01023026",842,140,44,96,232,80,154,47,78,34,32,27,5,45
"2011","New Forest 010B","E01023062",1106,165,40,125,319,136,172,48,105,64,19,10,9,78
"2011","New Forest 010C","E01023064",993,103,26,77,229,161,128,72,142,75,20,12,8,63
"2011","New Forest 010D","E01023066",1143,141,35,106,283,182,161,66,132,95,20,10,10,63
"2011","New Forest 010E","E01023067",1051,145,34,111,254,135,160,69,146,66,26,16,10,50
"2011","New Forest 011A","E01023003",1198,149,38,111,304,199,100,112,143,91,30,15,15,70
"2011","New Forest 011B","E01023004",1344,122,41,81,306,230,110,145,203,122,36,21,15,70
"2011","New Forest 011C","E01023005",1088,111,28,83,291,192,98,120,122,89,12,7,5,53
"2011","New Forest 011D","E01023006",991,41,12,29,120,91,73,117,213,187,69,50,19,80
"2011","New Forest 011E","E01023028",1446,115,31,84,309,197,125,171,249,177,43,28,15,60
"2011","New Forest 011F","E01023037",1305,103,18,85,284,182,111,120,215,183,54,30,24,53
"2011","New Forest 012A","E01023065",1127,97,20,77,226,119,136,94,219,130,40,25,15,66
"2011","New Forest 012B","E01023068",939,54,9,45,151,109,114,87,185,132,44,34,10,63
"2011","New Forest 012C","E01023069",1137,100,21,79,247,160,116,103,194,117,28,20,8,72
"2011","New Forest 012D","E01023070",1144,126,25,101,301,133,169,68,150,105,35,23,12,57
"2011","New Forest 012E","E01023071",1035,104,25,79,249,127,171,79,143,88,33,22,11,41
"2011","New Forest 013A","E01023029",1088,23,7,16,125,126,85,111,218,231,108,66,42,61
"2011","New Forest 013B","E01023030",986,55,16,39,205,148,71,120,169,131,23,14,9,64
"2011","New Forest 013C","E01023032",970,80,17,63,179,147,95,123,163,108,25,15,10,50
"2011","New Forest 013D","E01023033",927,42,8,34,170,117,81,109,185,135,35,24,11,53
"2011","New Forest 014A","E01023013",1092,75,26,49,245,173,101,132,171,109,39,23,16,47
"2011","New Forest 014B","E01023014",1208,109,32,77,282,175,117,156,174,108,27,19,8,60
"2011","New Forest 014C","E01023015",1061,91,23,68,240,140,101,115,176,128,26,14,12,44
"2011","New Forest 014D","E01023016",1060,111,28,83,263,168,102,127,149,89,23,14,9,28
"2011","New Forest 014E","E01023027",1070,64,23,41,197,151,83,140,193,151,29,14,15,62
"2011","New Forest 014F","E01023031",950,54,16,38,175,143,71,119,180,128,26,12,14,54
"2011","New Forest 015A","E01022989",1215,168,40,128,317,141,162,82,149,87,40,27,13,69
"2011","New Forest 015B","E01022991",1528,243,62,181,409,186,291,79,130,89,36,24,12,65
"2011","New Forest 015C","E01022998",1260,269,57,212,379,135,155,69,94,55,35,25,10,69
"2011","New Forest 015D","E01023000",1208,205,47,158,317,111,166,100,133,93,21,7,14,62
"2011","New Forest 016A","E01022994",1148,177,32,145,350,172,137,60,115,66,16,6,10,55
"2011","New Forest 016B","E01022995",1019,156,26,130,249,149,122,68,123,74,18,15,3,60
"2011","New Forest 016C","E01022996",878,137,32,105,224,84,136,68,104,62,31,24,7,32
"2011","New Forest 016D","E01022997",983,191,51,140,248,98,179,45,95,50,21,17,4,56
"2011","New Forest 016E","E01023063",944,141,32,109,200,104,164,46,98,52,19,16,3,120
"2011","New Forest 017A","E01022990",1089,131,32,99,281,117,196,68,120,91,35,19,16,50
"2011","New Forest 017B","E01022999",1547,214,56,158,361,161,276,115,163,143,28,20,8,86
"2011","New Forest 017C","E01023041",1060,186,58,128,337,105,147,51,115,57,24,14,10,38
"2011","New Forest 017D","E01023042",980,134,32,102,249,89,161,79,131,86,25,16,9,26
"2011","New Forest 017E","E01023043",1168,187,50,137,343,157,147,55,126,64,19,15,4,70
"2011","New Forest 018A","E01022984",1066,135,42,93,270,149,181,44,113,62,26,24,2,86
"2011","New Forest 018B","E01022985",880,84,17,67,201,142,113,71,136,75,14,9,5,44
"2011","New Forest 018C","E01023020",1029,104,28,76,233,180,114,84,165,81,25,12,13,43
"2011","New Forest 018D","E01023034",1241,127,44,83,312,163,196,80,172,101,31,26,5,59
"2011","New Forest 018E","E01023035",1224,114,25,89,325,165,176,80,199,93,18,10,8,54
"2011","New Forest 018F","E01023036",1326,148,46,102,334,159,214,84,194,104,25,12,13,64
"2011","New Forest 019A","E01023001",1324,165,37,128,337,162,170,110,206,91,23,10,13,60
"2011","New Forest 019B","E01023002",1195,100,26,74,253,124,168,103,225,118,25,14,11,79
"2011","New Forest 019C","E01023058",1017,48,14,34,127,85,121,97,257,150,74,44,30,58
"2011","New Forest 019D","E01023060",1024,114,24,90,245,117,185,63,156,86,21,13,8,37
"2011","New Forest 019E","E01023061",1064,62,20,42,187,116,132,96,212,155,41,26,15,63
"2011","New Forest 020A","E01023017",1342,110,26,84,292,168,150,109,240,149,35,19,16,89
"2011","New Forest 020B","E01023018",978,71,19,52,174,127,92,86,212,115,63,49,14,38
"2011","New Forest 020C","E01023019",1067,51,22,29,206,122,115,96,228,155,35,22,13,59
"2011","New Forest 020D","E01023055",854,36,12,24,147,86,101,77,176,131,39,29,10,61
"2011","New Forest 021A","E01022986",1000,82,18,64,195,145,136,80,161,105,42,32,10,54
"2011","New Forest 021B","E01022988",1077,62,22,40,178,103,129,109,224,161,49,26,23,62
"2011","New Forest 021C","E01023054",1167,86,10,76,228,155,148,100,233,116,42,29,13,59
"2011","New Forest 021D","E01023056",880,54,13,41,214,131,111,58,168,83,36,19,17,25
"2011","New Forest 021E","E01023057",1086,73,23,50,187,146,117,102,241,120,37,29,8,63
"2011","New Forest 022A","E01022981",1248,152,35,117,328,185,143,87,186,102,15,11,4,50
"2011","New Forest 022B","E01022982",1240,140,37,103,323,204,160,72,198,85,32,16,16,26
"2011","New Forest 022C","E01022983",1120,109,29,80,283,170,165,66,183,90,9,4,5,45
"2011","New Forest 022D","E01022987",1229,171,51,120,318,231,168,58,141,74,31,19,12,37
"2011","New Forest 023A","E01023044",670,128,43,85,219,105,78,26,61,15,10,5,5,28
"2011","New Forest 023B","E01023051",1073,151,46,105,273,111,185,68,133,70,21,13,8,61
"2011","New Forest 023C","E01023052",1082,167,44,123,288,155,211,47,111,46,16,11,5,41
"2011","New Forest 023D","E01023053",1086,184,54,130,352,160,135,51,101,50,16,7,9,37
"2011","New Forest 023E","E01023059",1118,156,39,117,294,156,178,54,134,66,25,14,11,55
"2011","Rushmoor 001A","E01023099",1119,103,29,74,221,137,92,98,183,145,65,39,26,75
"2011","Rushmoor 001B","E01023104",1211,85,22,63,220,148,103,127,213,143,60,44,16,112
"2011","Rushmoor 001C","E01023106",1108,45,12,33,163,120,84,101,214,191,72,46,26,118
"2011","Rushmoor 001D","E01023121",1488,100,29,71,299,220,99,135,263,204,60,31,29,108
"2011","Rushmoor 002A","E01023105",1148,49,12,37,176,152,75,111,209,180,81,48,33,115
"2011","Rushmoor 002B","E01023119",949,30,5,25,82,112,47,84,215,181,82,57,25,116
"2011","Rushmoor 002C","E01023120",1308,51,15,36,164,161,86,130,253,230,103,71,32,130
"2011","Rushmoor 002D","E01023122",1128,59,13,46,163,142,55,91,242,170,90,74,16,116
"2011","Rushmoor 002E","E01023146",1038,64,15,49,164,132,69,93,167,148,81,55,26,120
"2011","Rushmoor 003A","E01023100",939,89,16,73,202,156,74,91,155,88,25,10,15,59
"2011","Rushmoor 003B","E01023101",996,111,20,91,239,185,95,78,144,77,14,5,9,53
"2011","Rushmoor 003C","E01023102",1068,129,20,109,230,175,108,103,156,84,30,19,11,53
"2011","Rushmoor 003D","E01023134",1401,163,45,118,325,257,113,120,196,103,33,21,12,91
"2011","Rushmoor 003E","E01023147",1111,107,36,71,230,188,92,102,182,105,28,20,8,77
"2011","Rushmoor 004A","E01023096",1587,312,59,253,438,252,106,96,165,83,57,40,17,78
"2011","Rushmoor 004B","E01023097",1080,217,56,161,335,174,83,47,101,39,12,10,2,72
"2011","Rushmoor 004C","E01023103",1238,194,41,153,346,203,92,78,134,83,25,15,10,83
"2011","Rushmoor 004D","E01023111",1296,260,43,217,350,218,122,74,116,49,37,29,8,70
"2011","Rushmoor 004E","E01023112",933,129,24,105,256,167,63,79,115,45,11,6,5,68
"2011","Rushmoor 005A","E01023092",1091,240,39,201,296,205,79,53,109,50,13,9,4,46
"2011","Rushmoor 005B","E01023093",1082,210,47,163,284,207,75,59,108,47,19,13,6,73
"2011","Rushmoor 005C","E01023132",1132,160,37,123,261,178,103,67,153,94,37,18,19,79
"2011","Rushmoor 005D","E01023133",1027,197,38,159,292,184,69,46,105,57,21,15,6,56
"2011","Rushmoor 005E","E01023135",1673,206,65,141,432,260,151,115,214,149,47,23,24,99
"2011","Rushmoor 006A","E01023091",1201,102,27,75,204,146,65,103,224,174,91,51,40,92
"2011","Rushmoor 006B","E01023094",1013,122,22,100,247,149,94,87,157,79,23,16,7,55
"2011","Rushmoor 006C","E01023095",1274,152,33,119,290,172,89,101,203,130,54,35,19,83
"2011","Rushmoor 006D","E01023098",1203,170,39,131,286,199,117,98,145,73,33,23,10,82
"2011","Rushmoor 006E","E01023148",1088,135,20,115,254,185,92,91,148,84,32,22,10,67
"2011","Rushmoor 006F","E01023149",932,104,23,81,227,178,89,66,122,79,17,11,6,50
"2011","Rushmoor 007A","E01023113",1188,177,40,137,297,184,114,70,129,81,54,45,9,82
"2011","Rushmoor 007B","E01023114",1053,165,28,137,293,170,91,72,118,68,22,12,10,54
"2011","Rushmoor 007C","E01023136",1296,238,118,120,324,172,93,82,141,102,42,20,22,102
"2011","Rushmoor 007D","E01023137",989,116,18,98,240,146,88,85,139,90,36,25,11,49
"2011","Rushmoor 007E","E01023138",1029,137,24,113,247,150,93,96,133,85,42,24,18,46
"2011","Rushmoor 007F","E01023139",885,92,16,76,230,125,85,71,117,81,36,25,11,48
"2011","Rushmoor 007G","E01023140",1115,79,27,52,302,168,55,102,161,115,63,35,28,70
"2011","Rushmoor 008A","E01023141",2505,178,129,49,793,820,47,216,187,143,66,40,26,55
"2011","Rushmoor 008B","E01023142",1529,83,25,58,314,213,59,140,272,172,181,144,37,95
"2011","Rushmoor 008C","E01023143",1301,92,44,48,390,205,63,90,191,112,57,41,16,101
"2011","Rushmoor 008D","E01023144",1326,93,19,74,202,147,83,113,247,187,113,89,24,141
"2011","Rushmoor 009A","E01023118",1328,102,20,82,259,177,115,105,245,152,58,47,11,115
"2011","Rushmoor 009B","E01023124",968,71,25,46,205,145,77,91,179,107,28,21,7,65
"2011","Rushmoor 009C","E01023125",1778,174,49,125,425,300,178,145,243,184,48,31,17,81
"2011","Rushmoor 009F","E01032858",1555,112,23,89,299,210,112,165,261,203,91,45,46,102
"2011","Rushmoor 010A","E01023128",1008,93,29,64,202,122,78,90,167,139,47,29,18,70
"2011","Rushmoor 010B","E01023129",1001,67,18,49,226,130,97,100,164,114,42,33,9,61
"2011","Rushmoor 010C","E01023130",1034,123,35,88,261,153,120,75,138,77,22,13,9,65
"2011","Rushmoor 010D","E01023131",968,124,39,85,217,139,122,61,110,102,20,9,11,73
"2011","Rushmoor 010E","E01023145",1578,110,25,85,315,214,123,153,264,189,105,76,29,105
"2011","Rushmoor 011A","E01023109",1153,105,24,81,259,182,122,107,165,117,33,17,16,63
"2011","Rushmoor 011B","E01023115",997,104,28,76,244,134,119,84,130,89,23,16,7,70
"2011","Rushmoor 011C","E01023116",1430,143,35,108,321,191,117,101,201,137,82,65,17,137
"2011","Rushmoor 011D","E01023117",1382,156,41,115,355,242,139,103,173,93,30,16,14,91
"2011","Rushmoor 012A","E01023107",1032,52,18,34,166,135,87,95,189,187,57,32,25,64
"2011","Rushmoor 012B","E01023108",959,43,11,32,123,95,70,99,220,212,46,27,19,51
"2011","Rushmoor 012C","E01023110",1294,94,24,70,218,164,107,136,219,197,48,24,24,111
"2011","Rushmoor 012D","E01023123",1109,88,28,60,197,157,134,107,177,149,28,17,11,72
"2011","Test Valley 001A","E01023165",1537,246,68,178,414,184,262,79,146,105,23,14,9,78
"2011","Test Valley 001B","E01023169",1485,184,50,134,383,266,119,110,200,114,28,22,6,81
"2011","Test Valley 001C","E01023181",1055,175,38,137,284,186,79,57,124,67,16,8,8,67
"2011","Test Valley 001D","E01023182",1193,140,39,101,298,222,94,83,163,106,22,17,5,65
"2011","Test Valley 002A","E01023153",1240,71,19,52,211,151,82,143,251,219,54,23,31,58
"2011","Test Valley 002B","E01023154",1202,61,16,45,164,150,66,125,252,218,64,35,29,102
"2011","Test Valley 002C","E01023156",985,27,6,21,96,115,41,97,239,224,72,46,26,74
"2011","Test Valley 002D","E01023157",1013,41,12,29,144,140,65,107,226,177,50,33,17,63
"2011","Test Valley 002E","E01023205",911,28,6,22,140,102,51,99,199,173,46,21,25,73
"2011","Test Valley 003A","E01023155",2030,257,87,170,425,262,138,153,289,256,142,118,24,108
"2011","Test Valley 003B","E01023201",1177,96,29,67,170,152,117,104,231,178,47,36,11,82
"2011","Test Valley 003C","E01023202",1304,84,26,58,244,164,108,113,252,223,55,41,14,61
"2011","Test Valley 003D","E01023215",1131,119,47,72,206,196,119,82,168,138,35,25,10,68
"2011","Test Valley 003E","E01023219",1076,87,28,59,200,179,97,89,203,140,27,15,12,54
"2011","Test Valley 004A","E01023179",1329,89,31,58,240,190,126,117,242,197,42,23,19,86
"2011","Test Valley 004B","E01023183",1017,81,23,58,196,149,99,90,169,133,43,25,18,57
"2011","Test Valley 004C","E01023190",881,125,34,91,248,139,83,41,112,73,15,10,5,45
"2011","Test Valley 004D","E01023203",1184,82,22,60,202,201,108,106,230,165,27,15,12,63
"2011","Test Valley 004E","E01023204",1268,109,30,79,238,160,97,127,247,194,44,28,16,52
"2011","Test Valley 005B","E01023180",1159,122,36,86,273,198,107,108,158,112,28,19,9,53
"2011","Test Valley 005C","E01023186",1246,138,39,99,275,204,117,95,191,136,21,8,13,69
"2011","Test Valley 005D","E01023189",1225,208,129,79,268,189,90,102,146,132,25,15,10,65
"2011","Test Valley 005E","E01023196",1230,216,71,145,278,161,174,72,136,106,23,16,7,64
"2011","Test Valley 005F","E01032870",1401,247,75,172,375,219,151,79,153,79,23,15,8,75
"2011","Test Valley 005G","E01032871",1111,144,50,94,268,166,144,78,146,76,30,16,14,59
"2011","Test Valley 006A","E01023187",1143,148,41,107,267,217,96,86,136,91,32,25,7,70
"2011","Test Valley 006B","E01023188",997,141,31,110,248,180,98,44,120,75,8,3,5,83
"2011","Test Valley 006C","E01023216",1345,143,38,105,279,180,114,133,223,159,46,22,24,68
"2011","Test Valley 006D","E01023217",1169,155,37,118,281,177,131,83,150,89,32,25,7,71
"2011","Test Valley 006E","E01023218",1096,137,40,97,269,202,94,90,141,78,21,12,9,64
"2011","Test Valley 007A","E01023159",1650,251,90,161,417,206,223,125,175,144,30,18,12,79
"2011","Test Valley 007B","E01023195",1602,328,186,142,454,228,139,93,157,105,28,14,14,70
"2011","Test Valley 007C","E01023197",1095,128,56,72,287,187,105,91,127,106,18,11,7,46
"2011","Test Valley 007D","E01023198",1073,175,64,111,292,126,151,66,115,91,20,14,6,37
"2011","Test Valley 008A","E01023160",1091,219,66,153,327,142,125,48,99,45,20,14,6,66
"2011","Test Valley 008B","E01023168",1112,219,70,149,287,129,156,81,107,58,19,7,12,56
"2011","Test Valley 008C","E01023178",1628,306,112,194,404,177,220,117,204,106,23,10,13,71
"2011","Test Valley 009A","E01023166",1095,188,43,145,265,119,214,62,106,74,20,13,7,47
"2011","Test Valley 009B","E01023167",1108,182,48,134,292,111,175,74,114,76,16,13,3,68
"2011","Test Valley 009C","E01023177",1589,261,60,201,402,170,268,88,177,109,28,18,10,86
"2011","Test Valley 009D","E01023184",1000,219,49,170,282,112,149,46,79,44,19,9,10,50
"2011","Test Valley 009E","E01023185",868,173,44,129,188,104,106,47,104,80,30,20,10,36
"2011","Test Valley 010A","E01023174",1335,153,36,117,274,195,120,123,210,147,25,14,11,88
"2011","Test Valley 010B","E01023175",1185,264,53,211,362,180,92,46,95,61,13,8,5,72
"2011","Test Valley 010C","E01023176",1110,148,38,110,267,138,92,69,175,146,17,12,5,58
"2011","Test Valley 010D","E01023207",1108,176,40,136,304,186,100,74,116,82,17,14,3,53
"2011","Test Valley 010E","E01023208",867,93,22,71,170,112,90,86,136,111,22,10,12,47
"2011","Test Valley 010F","E01023209",1052,149,26,123,279,164,93,62,127,82,11,7,4,85
"2011","Test Valley 011A","E01023150",1108,167,29,138,255,130,93,95,164,105,32,22,10,67
"2011","Test Valley 011B","E01023151",920,133,22,111,208,89,80,85,139,114,36,23,13,36
"2011","Test Valley 011C","E01023152",1101,161,27,134,292,142,116,50,142,108,32,21,11,58
"2011","Test Valley 011D","E01023206",835,100,16,84,166,121,70,56,124,89,47,40,7,62
"2011","Test Valley 012A","E01023158",1653,361,85,276,473,212,192,72,123,102,22,14,8,96
"2011","Test Valley 012B","E01023191",1363,181,35,146,362,221,99,88,204,124,14,6,8,70
"2011","Test Valley 012C","E01023192",1250,122,28,94,235,184,114,103,187,192,51,26,25,62
"2011","Test Valley 012D","E01023193",1167,155,41,114,296,159,132,79,138,114,22,13,9,72
"2011","Test Valley 012E","E01023194",1123,137,36,101,305,156,100,100,160,90,7,3,4,68
"2011","Test Valley 012F","E01023200",1138,215,40,175,342,154,113,44,109,68,18,12,6,75
"2011","Test Valley 013A","E01023162",1284,243,59,184,316,152,213,49,108,63,49,43,6,91
"2011","Test Valley 013B","E01023163",1245,239,57,182,343,156,169,71,113,70,19,11,8,65
"2011","Test Valley 013C","E01023164",1165,201,44,157,291,145,148,68,126,93,27,21,6,66
"2011","Test Valley 013D","E01023199",1264,180,38,142,291,134,138,100,161,104,35,22,13,121
"2011","Test Valley 014A","E01023210",1118,274,51,223,347,150,73,45,84,43,21,12,9,81
"2011","Test Valley 014B","E01023211",1308,317,41,276,409,183,81,59,100,49,22,12,10,88
"2011","Test Valley 014C","E01023212",1123,264,55,209,321,178,62,49,94,49,18,10,8,88
"2011","Test Valley 014D","E01023213",996,216,38,178,319,149,57,39,77,44,16,11,5,79
"2011","Test Valley 014E","E01023214",1016,194,29,165,294,175,72,44,119,43,12,5,7,63
"2011","Test Valley 015A","E01023170",1268,156,42,114,295,216,134,88,142,127,36,23,13,74
"2011","Test Valley 015B","E01023171",1225,242,53,189,343,145,157,53,88,70,29,23,6,98
"2011","Test Valley 015C","E01023172",1111,164,39,125,283,209,98,76,129,62,10,4,6,80
"2011","Test Valley 015D","E01023173",1163,175,33,142,310,200,95,71,141,87,12,9,3,72
"2011","Winchester 001A","E01023286",1013,179,37,142,251,134,118,53,130,63,23,19,4,62
"2011","Winchester 001B","E01023287",2077,412,115,297,671,301,168,93,177,86,32,12,20,137
"2011","Winchester 001C","E01023288",1017,228,63,165,303,116,136,52,73,51,19,11,8,39
"2011","Winchester 002A","E01023236",1363,297,77,220,389,134,203,58,113,89,20,14,6,60
"2011","Winchester 002B","E01023237",902,107,22,85,175,118,97,64,147,106,29,13,16,59
"2011","Winchester 002C","E01023238",1167,236,76,160,387,173,113,65,83,38,11,6,5,61
"2011","Winchester 002D","E01023239",1199,305,60,245,390,133,104,48,73,48,13,8,5,85
"2011","Winchester 003A","E01023240",1512,238,44,194,430,243,95,77,180,99,40,28,12,110
"2011","Winchester 003B","E01023241",901,208,63,145,290,107,78,21,76,49,15,7,8,57
"2011","Winchester 003C","E01023248",1154,272,50,222,384,176,81,22,81,31,22,16,6,85
"2011","Winchester 003D","E01023253",1054,243,47,196,299,146,79,57,80,71,17,11,6,62
"2011","Winchester 003E","E01023274",1374,247,43,204,298,99,125,57,103,61,16,11,5,368
"2011","Winchester 004A","E01023225",1640,294,79,215,466,132,263,91,158,75,26,15,11,135
"2011","Winchester 004B","E01023278",1119,171,42,129,316,144,140,79,128,63,23,13,10,55
"2011","Winchester 004C","E01023279",1086,209,45,164,322,129,126,50,104,59,14,4,10,73
"2011","Winchester 004D","E01023280",1090,183,38,145,273,99,173,54,126,91,22,14,8,69
"2011","Winchester 004E","E01023281",1162,169,39,130,290,132,140,88,146,101,35,23,12,61
"2011","Winchester 005A","E01023247",1037,239,51,188,337,131,72,32,84,47,22,17,5,73
"2011","Winchester 005B","E01023249",869,144,25,119,221,109,88,59,103,60,19,12,7,66
"2011","Winchester 005C","E01023250",1136,131,31,100,261,108,95,86,181,131,39,28,11,104
"2011","Winchester 005D","E01023268",943,286,44,242,285,91,63,23,51,33,7,3,4,104
"2011","Winchester 005E","E01023269",1902,291,47,244,384,116,76,27,60,47,19,16,3,882
"2011","Winchester 005F","E01023270",1184,219,26,193,277,78,139,74,89,146,53,40,13,109
"2011","Winchester 006A","E01023251",787,130,20,110,228,76,72,33,81,64,21,17,4,82
"2011","Winchester 006B","E01023255",1468,121,26,95,262,117,90,73,179,151,35,19,16,440
"2011","Winchester 006C","E01023256",1032,43,7,36,155,106,80,77,194,183,51,30,21,143
"2011","Winchester 006D","E01023257",1155,206,42,164,287,92,75,61,132,127,27,20,7,148
"2011","Winchester 006E","E01023258",1084,122,30,92,185,66,73,74,142,141,37,23,14,244
"2011","Winchester 007A","E01023252",1446,321,40,281,354,106,98,84,125,77,62,46,16,219
"2011","Winchester 007B","E01023254",1330,322,52,270,378,159,85,51,116,76,44,19,25,99
"2011","Winchester 007C","E01023263",988,246,51,195,320,78,57,32,47,25,27,16,11,156
"2011","Winchester 007D","E01023264",1276,214,47,167,379,71,72,43,70,37,17,12,5,373
"2011","Winchester 007E","E01023265",1301,296,49,247,369,120,126,46,98,70,18,7,11,158
"2011","Winchester 007F","E01023267",1027,229,35,194,287,80,75,49,63,40,12,8,4,192
"2011","Winchester 008A","E01023260",1306,40,10,30,106,67,65,67,168,131,41,26,15,621
"2011","Winchester 008B","E01023261",1262,55,8,47,112,89,79,99,195,147,37,24,13,449
"2011","Winchester 008C","E01023262",1225,54,15,39,112,107,65,69,179,116,40,22,18,483
"2011","Winchester 008D","E01023266",1163,222,40,182,239,78,85,43,69,38,39,26,13,350
"2011","Winchester 009A","E01023229",1401,328,66,262,387,141,205,51,99,55,36,26,10,99
"2011","Winchester 009B","E01023242",934,212,25,187,307,130,59,36,69,20,15,5,10,86
"2011","Winchester 009C","E01023243",1034,185,13,172,301,130,85,54,117,56,10,2,8,96
"2011","Winchester 009D","E01023244",1069,234,35,199,308,149,90,32,92,53,16,9,7,95
"2011","Winchester 009E","E01023259",1101,233,53,180,267,100,70,47,102,69,27,20,7,186
"2011","Winchester 010A","E01023226",1075,255,54,201,337,103,122,38,90,58,15,8,7,57
"2011","Winchester 010B","E01023227",1325,205,53,152,355,148,154,92,159,98,36,21,15,78
"2011","Winchester 010C","E01023228",1483,301,61,240,372,212,138,90,156,105,27,10,17,82
"2011","Winchester 010D","E01023230",1499,371,83,288,470,207,135,53,87,43,46,32,14,87
"2011","Winchester 010E","E01023246",1094,208,63,145,280,127,200,42,104,55,20,15,5,58
"2011","Winchester 011A","E01023235",1454,314,75,239,420,135,224,49,127,76,32,21,11,77
"2011","Winchester 011B","E01023275",1023,200,42,158,264,99,144,45,100,64,10,9,1,97
"2011","Winchester 011C","E01023276",1147,213,53,160,342,132,132,49,97,60,25,17,8,97
"2011","Winchester 011D","E01023277",945,212,44,168,235,118,164,40,54,50,16,8,8,56
"2011","Winchester 011E","E01023282",1355,245,60,185,352,129,260,54,132,76,32,19,13,75
"2011","Winchester 012A","E01023220",1489,240,49,191,399,217,156,108,165,109,25,16,9,70
"2011","Winchester 012B","E01023221",1186,164,51,113,273,138,148,103,175,111,32,17,15,42
"2011","Winchester 012C","E01023222",1103,220,51,169,350,130,139,53,91,45,20,13,7,55
"2011","Winchester 012D","E01023223",1055,136,29,107,204,118,147,70,158,126,30,15,15,66
"2011","Winchester 012E","E01023272",932,131,32,99,261,126,120,59,109,46,17,10,7,63
"2011","Winchester 012F","E01023273",1064,188,49,139,300,141,142,64,101,61,10,4,6,57
"2011","Winchester 013A","E01023245",1777,316,78,238,449,254,259,84,132,107,71,63,8,105
"2011","Winchester 013B","E01023271",847,142,34,108,176,117,130,52,95,73,19,11,8,43
"2011","Winchester 013D","E01023284",2050,348,80,268,605,266,192,130,208,128,73,57,16,100
"2011","Winchester 013E","E01023285",1029,110,36,74,217,119,145,89,145,128,29,25,4,47
"2011","Winchester 013F","E01032859",1252,218,51,167,416,180,125,61,106,58,16,9,7,72
"2011","Winchester 013G","E01032860",1113,220,39,181,328,186,73,75,80,62,28,12,16,61
"2011","Winchester 014A","E01023224",1111,169,89,80,275,189,135,68,116,59,41,33,8,59
"2011","Winchester 014B","E01023231",1295,267,93,174,338,213,169,51,124,56,15,8,7,62
"2011","Winchester 014C","E01023232",1365,210,51,159,372,175,179,80,160,70,32,27,5,87
"2011","Winchester 014D","E01023233",1013,190,65,125,259,167,109,54,107,50,10,8,2,67
"2011","Winchester 014E","E01023234",1124,119,28,91,276,174,119,68,162,112,30,19,11,64
"2011","Ashford 001B","E01023987",761,102,28,74,181,86,105,47,96,77,25,19,6,42
"2011","Ashford 001C","E01023988",1036,161,35,126,279,109,186,54,106,57,38,29,9,46
"2011","Ashford 001D","E01024040",773,126,18,108,199,76,85,51,91,78,29,15,14,38
"2011","Ashford 001E","E01024041",740,145,31,114,216,76,95,40,68,37,15,6,9,48
"2011","Ashford 001F","E01032810",1045,105,26,79,228,131,98,80,184,105,50,30,20,64
"2011","Ashford 001G","E01032812",1248,204,52,152,375,180,134,58,140,64,23,11,12,70
"2011","Ashford 002A","E01023985",827,119,34,85,184,115,158,37,83,70,26,21,5,35
"2011","Ashford 002B","E01023986",893,121,43,78,203,115,145,53,110,70,35,28,7,41
"2011","Ashford 002C","E01023989",846,117,41,76,225,113,140,52,71,54,11,9,2,63
"2011","Ashford 002D","E01023990",883,86,19,67,176,100,120,67,119,115,47,34,13,53
"2011","Ashford 002E","E01024033",1285,185,59,126,319,155,212,63,149,99,35,26,9,68
"2011","Ashford 002F","E01024035",773,124,32,92,211,102,135,30,67,47,19,14,5,38
"2011","Ashford 003A","E01023983",974,101,30,71,231,140,93,91,157,82,26,15,11,53
"2011","Ashford 003B","E01023999",1592,214,49,165,386,262,197,100,198,110,42,30,12,83
"2011","Ashford 003D","E01032811",1150,166,42,124,298,191,101,78,131,75,34,25,9,76
"2011","Ashford 003E","E01032822",990,110,26,84,220,143,99,61,146,107,21,11,10,83
"2011","Ashford 004A","E01023980",835,63,17,46,184,122,61,82,149,97,29,21,8,48
"2011","Ashford 004B","E01023981",874,93,28,65,173,128,79,75,136,93,33,26,7,64
"2011","Ashford 004C","E01023984",827,35,7,28,120,83,73,95,161,131,68,47,21,61
"2011","Ashford 004E","E01023992",1069,81,22,59,219,127,84,102,155,146,71,53,18,84
"2011","Ashford 004F","E01023993",1072,86,17,69,236,155,92,98,180,107,33,27,6,85
"2011","Ashford 004G","E01024021",971,94,19,75,197,145,70,102,148,104,44,20,24,67
"2011","Ashford 004H","E01024022",1045,100,20,80,204,168,79,106,151,118,40,30,10,79
"2011","Ashford 004I","E01032820",1141,137,37,100,304,183,118,85,140,78,36,16,20,60
"2011","Ashford 004J","E01032821",1178,163,47,116,310,198,93,93,123,78,28,15,13,92
"2011","Ashford 005A","E01023973",1120,41,9,32,140,129,74,130,240,209,89,62,27,68
"2011","Ashford 005B","E01024002",1043,67,21,46,169,156,83,110,196,145,49,27,22,68
"2011","Ashford 005C","E01024023",1737,155,38,117,341,262,122,163,289,213,71,38,33,121
"2011","Ashford 005D","E01024027",1255,82,22,60,264,135,92,107,182,150,72,45,27,171
"2011","Ashford 005E","E01024029",1697,116,37,79,303,207,143,171,318,252,83,53,30,104
"2011","Ashford 006A","E01023972",907,57,10,47,152,103,81,80,165,150,57,36,21,62
"2011","Ashford 006B","E01023995",905,57,17,40,207,161,77,90,163,77,18,6,12,55
"2011","Ashford 006C","E01023996",977,94,22,72,238,176,95,73,128,75,26,13,13,72
"2011","Ashford 006D","E01024003",1268,99,28,71,263,225,111,104,216,148,33,16,17,69
"2011","Ashford 006E","E01024004",1273,223,50,173,304,209,128,79,140,83,29,18,11,78
"2011","Ashford 006F","E01024005",1131,76,13,63,226,148,109,116,195,154,24,15,9,83
"2011","Ashford 007A","E01023974",944,31,9,22,105,98,78,104,227,176,59,37,22,66
"2011","Ashford 007B","E01023975",1154,30,12,18,133,126,81,130,241,221,93,66,27,99
"2011","Ashford 007C","E01023977",913,44,13,31,174,135,81,109,164,133,37,19,18,36
"2011","Ashford 007D","E01024016",1053,96,19,77,240,149,94,102,181,115,25,14,11,51
"2011","Ashford 007E","E01024017",1281,142,31,111,337,204,101,110,167,111,38,19,19,71
"2011","Ashford 007F","E01024028",1229,33,10,23,145,109,77,162,299,220,89,46,43,95
"2011","Ashford 008A","E01023976",1139,31,11,20,138,111,105,136,230,240,77,56,21,71
"2011","Ashford 008B","E01024019",982,40,7,33,122,86,57,85,206,202,97,65,32,87
"2011","Ashford 008C","E01024020",1232,24,7,17,118,115,78,115,296,251,102,69,33,133
"2011","Ashford 008E","E01032816",1339,141,37,104,333,207,122,117,170,133,35,23,12,81
"2011","Ashford 008F","E01032823",1223,47,14,33,215,149,95,118,256,187,92,72,20,64
"2011","Ashford 009A","E01024001",1112,51,14,37,170,139,108,119,237,167,64,44,20,57
"2011","Ashford 009B","E01024006",919,134,27,107,242,165,68,48,115,56,24,15,9,67
"2011","Ashford 009D","E01024008",1420,177,34,143,377,231,108,117,195,85,29,16,13,101
"2011","Ashford 009F","E01032815",708,60,18,42,132,83,66,55,116,101,52,35,17,43
"2011","Ashford 009G","E01032817",865,72,16,56,210,106,73,74,133,107,32,15,17,58
"2011","Ashford 009H","E01032818",1077,116,19,97,280,188,113,83,128,67,33,21,12,69
"2011","Ashford 009I","E01032819",1242,167,36,131,340,174,114,90,164,74,48,28,20,71
"2011","Ashford 009J","E01032824",1112,94,33,61,197,156,113,130,192,123,46,29,17,61
"2011","Ashford 010A","E01024013",1206,132,30,102,282,167,190,78,150,98,31,20,11,78
"2011","Ashford 010B","E01024014",1266,173,47,126,301,166,235,80,124,83,49,34,15,55
"2011","Ashford 010C","E01024015",1219,201,40,161,352,174,203,51,86,67,25,17,8,60
"2011","Ashford 010D","E01024034",1785,223,60,163,411,258,278,120,222,122,51,39,12,100
"2011","Ashford 011A","E01023978",922,113,23,90,236,110,190,35,88,72,21,15,6,57
"2011","Ashford 011B","E01023979",912,100,30,70,196,106,139,64,121,103,20,14,6,63
"2011","Ashford 011C","E01024032",1149,117,40,77,252,145,219,69,133,117,33,24,9,64
"2011","Ashford 011D","E01024036",972,139,37,102,252,120,195,45,85,66,24,16,8,46
"2011","Ashford 012B","E01024031",1072,132,36,96,229,130,209,58,136,89,37,31,6,52
"2011","Ashford 012C","E01024038",1355,147,42,105,300,158,232,87,169,115,76,64,12,71
"2011","Ashford 012D","E01024039",1095,133,47,86,250,162,169,84,106,87,30,20,10,74
"2011","Ashford 012E","E01032813",1310,167,37,130,346,201,124,109,162,105,26,9,17,70
"2011","Ashford 012F","E01032814",1320,177,37,140,327,167,159,107,157,113,42,30,12,71
"2011","Ashford 013A","E01024009",819,123,33,90,215,101,154,38,86,43,19,12,7,40
"2011","Ashford 013B","E01024010",914,79,25,54,219,104,170,53,133,92,19,11,8,45
"2011","Ashford 013C","E01024011",856,85,16,69,209,109,127,74,134,60,16,10,6,42
"2011","Ashford 013D","E01024012",756,62,20,42,179,92,112,60,135,62,19,13,6,35
"2011","Ashford 013E","E01024024",1472,201,55,146,393,188,202,89,177,100,47,26,21,75
"2011","Ashford 013F","E01024025",713,68,21,47,157,70,96,55,123,79,26,20,6,39
"2011","Ashford 014A","E01023997",1072,113,17,96,231,104,223,73,117,112,39,25,14,60
"2011","Ashford 014B","E01023998",830,86,26,60,186,79,204,55,98,72,16,11,5,34
"2011","Ashford 014C","E01024026",894,92,28,64,217,121,147,63,108,73,17,6,11,56
"2011","Ashford 014D","E01024037",1258,119,27,92,300,179,188,100,162,106,48,34,14,56
"2011","Canterbury 001A","E01024078",1172,54,15,39,190,121,156,93,250,155,90,46,44,63
"2011","Canterbury 001B","E01024080",936,52,10,42,148,90,132,78,181,112,83,63,20,60
"2011","Canterbury 001C","E01024081",1058,55,14,41,200,106,132,71,189,143,101,64,37,61
"2011","Canterbury 001D","E01024082",961,68,16,52,201,123,113,89,168,94,37,24,13,68
"2011","Canterbury 001E","E01024095",1079,84,18,66,261,136,136,71,175,99,51,39,12,66
"2011","Canterbury 002A","E01024094",1764,183,43,140,401,254,206,129,267,155,70,52,18,99
"2011","Canterbury 002B","E01024096",1215,97,22,75,277,178,153,105,178,114,47,38,9,66
"2011","Canterbury 002C","E01024097",1043,108,29,79,228,161,140,72,156,98,27,16,11,53
"2011","Canterbury 002D","E01024098",1074,102,29,73,249,184,142,77,167,80,18,15,3,55
"2011","Canterbury 003A","E01024064",1744,180,46,134,401,266,212,118,262,117,46,31,15,142
"2011","Canterbury 003B","E01024066",1096,37,15,22,153,96,122,96,261,184,61,40,21,86
"2011","Canterbury 003C","E01024079",1021,65,24,41,210,164,133,73,160,116,35,26,9,65
"2011","Canterbury 003D","E01024083",928,52,13,39,155,119,90,71,184,133,76,53,23,48
"2011","Canterbury 003E","E01024118",1252,69,27,42,216,155,161,102,248,147,68,49,19,86
"2011","Canterbury 004A","E01024059",1002,45,13,32,173,125,144,72,190,135,49,33,16,69
"2011","Canterbury 004B","E01024065",1421,76,17,59,251,197,178,121,283,172,47,35,12,96
"2011","Canterbury 004C","E01024117",1013,101,25,76,231,149,123,67,157,107,32,25,7,46
"2011","Canterbury 004D","E01024119",1051,69,14,55,163,129,105,75,217,149,67,40,27,77
"2011","Canterbury 004E","E01024120",1110,78,29,49,179,140,150,108,209,158,41,25,16,47
"2011","Canterbury 005A","E01024056",1383,227,66,161,383,223,179,66,137,48,24,13,11,96
"2011","Canterbury 005B","E01024057",1272,147,52,95,276,188,177,96,201,92,32,18,14,63
"2011","Canterbury 005C","E01024058",1175,97,28,69,275,172,138,82,182,123,28,14,14,78
"2011","Canterbury 005D","E01024114",1175,146,38,108,307,188,158,67,140,79,26,18,8,64
"2011","Canterbury 005E","E01024115",977,83,17,66,225,169,116,72,151,80,12,9,3,69
"2011","Canterbury 006A","E01024073",1415,112,23,89,284,224,150,109,261,136,41,21,20,98
"2011","Canterbury 006B","E01024074",1094,105,21,84,273,177,121,89,143,91,20,12,8,75
"2011","Canterbury 006C","E01024075",1187,89,26,63,272,169,128,93,183,116,80,69,11,57
"2011","Canterbury 006D","E01024076",1340,104,18,86,279,243,172,115,198,104,36,16,20,89
"2011","Canterbury 006E","E01024077",1056,115,26,89,266,134,143,65,133,96,24,14,10,80
"2011","Canterbury 007A","E01024055",1074,111,26,85,239,171,142,60,184,100,17,9,8,50
"2011","Canterbury 007B","E01024061",972,56,8,48,152,90,83,74,176,178,84,48,36,79
"2011","Canterbury 007C","E01024063",1106,113,31,82,238,165,128,87,161,114,37,25,12,63
"2011","Canterbury 007D","E01024071",1203,122,21,101,286,133,142,69,181,120,50,32,18,100
"2011","Canterbury 007E","E01024116",1004,155,23,132,312,122,150,44,77,49,21,16,5,74
"2011","Canterbury 008A","E01024060",1106,92,19,73,301,161,127,68,145,97,28,15,13,87
"2011","Canterbury 008B","E01024069",977,113,27,86,282,107,130,46,133,67,34,18,16,65
"2011","Canterbury 008C","E01024070",1038,148,33,115,284,119,165,57,97,72,32,13,19,64
"2011","Canterbury 008D","E01024072",991,94,18,76,283,97,155,68,125,69,33,13,20,67
"2011","Canterbury 008E","E01024106",1084,105,29,76,274,184,140,56,156,93,14,6,8,62
"2011","Canterbury 009A","E01024062",1142,121,32,89,295,142,139,70,151,93,42,30,12,89
"2011","Canterbury 009B","E01024105",1096,130,29,101,229,196,158,74,157,72,30,16,14,50
"2011","Canterbury 009C","E01024107",1074,105,22,83,268,168,131,71,139,92,27,16,11,73
"2011","Canterbury 009D","E01024108",820,52,14,38,155,94,101,68,145,114,58,45,13,33
"2011","Canterbury 009E","E01024109",1566,173,40,133,361,219,218,114,219,134,33,25,8,95
"2011","Canterbury 010A","E01024084",793,98,16,82,188,97,100,53,113,65,30,26,4,49
"2011","Canterbury 010B","E01024085",1129,184,38,146,301,119,193,48,127,53,21,14,7,83
"2011","Canterbury 010C","E01024086",1466,133,28,105,333,158,155,122,215,171,62,43,19,117
"2011","Canterbury 010D","E01024087",905,132,38,94,232,98,141,61,98,65,42,36,6,36
"2011","Canterbury 011A","E01024091",1036,48,6,42,134,80,83,74,181,159,92,67,25,185
"2011","Canterbury 011B","E01024110",943,74,18,56,188,118,135,68,160,116,24,19,5,60
"2011","Canterbury 011C","E01024111",1047,58,15,43,184,134,118,99,185,143,44,27,17,82
"2011","Canterbury 011D","E01024112",1178,94,22,72,240,188,115,114,188,146,24,16,8,69
"2011","Canterbury 011E","E01024113",925,108,22,86,234,127,104,56,129,69,30,13,17,68
"2011","Canterbury 012C","E01024067",815,120,29,91,219,98,109,40,79,53,16,13,3,81
"2011","Canterbury 012D","E01024068",1124,166,24,142,304,143,107,51,79,47,25,17,8,202
"2011","Canterbury 012E","E01024123",1278,198,34,164,316,125,70,55,78,37,20,13,7,379
"2011","Canterbury 012F","E01032809",5561,243,40,203,407,199,190,77,178,103,51,34,17,4113
"2011","Canterbury 013A","E01024099",1202,38,5,33,119,64,36,50,128,96,57,30,27,614
"2011","Canterbury 013B","E01024100",1325,109,11,98,134,69,43,33,80,54,16,11,5,787
"2011","Canterbury 013C","E01024101",1563,76,10,66,165,103,55,64,121,82,58,40,18,839
"2011","Canterbury 013D","E01024102",1441,142,19,123,229,115,81,39,105,74,37,26,11,619
"2011","Canterbury 013E","E01024103",1284,95,9,86,170,72,74,65,136,92,65,42,23,515
"2011","Canterbury 014A","E01024047",1065,52,33,19,183,136,24,61,155,148,87,61,26,219
"2011","Canterbury 014B","E01024049",1400,34,10,24,211,281,51,60,168,189,108,85,23,298
"2011","Canterbury 014C","E01024090",2072,85,10,75,156,87,76,73,191,168,114,90,24,1122
"2011","Canterbury 014D","E01024092",1296,38,4,34,142,74,54,76,138,120,62,37,25,592
"2011","Canterbury 014E","E01024093",1252,74,9,65,181,79,68,55,137,124,74,55,19,460
"2011","Canterbury 016A","E01024044",1614,247,20,227,404,107,90,55,110,60,42,31,11,499
"2011","Canterbury 016B","E01024045",1151,184,33,151,235,141,91,43,116,78,51,36,15,212
"2011","Canterbury 016C","E01024046",1406,277,43,234,374,145,100,37,109,47,34,26,8,283
"2011","Canterbury 016D","E01024048",1690,102,11,91,134,53,76,77,135,138,113,96,17,862
"2011","Canterbury 016E","E01024131",1209,255,34,221,311,103,80,39,87,49,61,53,8,224
"2011","Canterbury 017A","E01024052",1563,220,42,178,419,176,159,102,171,109,78,53,25,129
"2011","Canterbury 017B","E01024053",1342,209,47,162,372,178,152,85,136,72,30,16,14,108
"2011","Canterbury 017C","E01024054",1338,207,46,161,339,151,232,67,135,73,29,17,12,105
"2011","Canterbury 017D","E01024127",1158,143,35,108,317,136,129,78,165,98,31,23,8,61
"2011","Canterbury 018A","E01024042",1015,124,24,100,236,101,149,66,122,83,77,69,8,57
"2011","Canterbury 018B","E01024043",1008,168,38,130,302,134,135,49,75,38,39,33,6,68
"2011","Canterbury 018C","E01024088",1018,151,30,121,271,130,127,67,113,51,21,12,9,87
"2011","Canterbury 018D","E01024089",842,158,32,126,244,94,109,31,85,35,22,14,8,64
"2011","Canterbury 019A","E01024128",1194,73,9,64,207,106,94,88,197,163,96,69,27,170
"2011","Canterbury 019B","E01024129",1517,130,13,117,265,89,64,80,128,78,38,23,15,645
"2011","Canterbury 019C","E01024130",1917,262,44,218,437,173,130,97,218,143,58,40,18,399
"2011","Canterbury 020A","E01024104",1686,295,31,264,357,144,75,66,107,56,29,19,10,557
"2011","Canterbury 020B","E01024121",1223,152,15,137,282,90,61,47,84,37,30,24,6,440
"2011","Canterbury 020C","E01024122",993,69,12,57,169,81,70,45,137,89,41,26,15,292
"2011","Canterbury 020D","E01024124",1116,136,17,119,237,60,63,31,51,27,20,15,5,491
"2011","Canterbury 020E","E01024126",1079,29,5,24,125,72,58,92,186,153,80,56,24,284
"2011","Canterbury 020F","E01032807",1240,173,13,160,261,81,78,39,88,44,24,8,16,452
"2011","Canterbury 020G","E01032808",1181,148,13,135,236,87,61,51,115,60,52,32,20,371
"2011","Dartford 001A","E01024148",1112,33,6,27,157,113,97,95,238,193,124,71,53,62
"2011","Dartford 001B","E01024149",2019,134,26,108,410,351,123,163,327,273,108,67,41,130
"2011","Dartford 001C","E01024154",874,33,10,23,119,107,69,86,176,179,57,33,24,48
"2011","Dartford 001D","E01024155",948,32,11,21,140,115,75,83,187,159,80,50,30,77
"2011","Dartford 002A","E01024140",2047,325,56,269,593,369,172,132,181,129,57,28,29,89
"2011","Dartford 002B","E01024141",1164,108,25,83,261,198,115,87,164,109,51,36,15,71
"2011","Dartford 002C","E01024143",1789,316,77,239,556,292,175,97,165,91,33,17,16,64
"2011","Dartford 002D","E01024179",2066,142,30,112,407,296,196,189,347,244,116,60,56,129
"2011","Dartford 003A","E01024180",1124,71,17,54,250,189,85,97,150,190,42,21,21,50
"2011","Dartford 003B","E01024181",991,80,15,65,197,186,81,80,166,96,39,25,14,66
"2011","Dartford 003C","E01024182",1213,84,19,65,253,198,123,92,155,139,74,47,27,95
"2011","Dartford 003D","E01024183",992,105,33,72,229,180,115,61,120,82,34,20,14,66
"2011","Dartford 003E","E01024184",1420,137,30,107,377,261,117,110,171,98,51,26,25,98
"2011","Dartford 003F","E01024185",1493,187,49,138,364,253,117,122,187,112,57,33,24,94
"2011","Dartford 004A","E01024142",2064,213,45,168,509,316,174,174,303,206,79,45,34,90
"2011","Dartford 004B","E01024176",1134,52,12,40,188,164,92,119,209,194,67,45,22,49
"2011","Dartford 004C","E01024177",991,36,5,31,118,104,82,93,216,187,88,51,37,67
"2011","Dartford 004D","E01024178",1174,53,10,43,201,159,103,132,213,183,65,34,31,65
"2011","Dartford 005A","E01024156",1266,92,13,79,261,187,92,125,195,178,56,34,22,80
"2011","Dartford 005B","E01024161",1495,103,18,85,296,238,119,142,224,195,71,43,28,107
"2011","Dartford 005C","E01024162",1307,108,22,86,299,218,125,128,189,138,62,49,13,40
"2011","Dartford 005D","E01024163",1304,120,21,99,266,207,131,118,193,135,55,39,16,79
"2011","Dartford 005E","E01024164",1434,126,20,106,309,198,162,117,211,173,63,39,24,75
"2011","Dartford 006A","E01024169",1056,52,10,42,185,168,89,87,185,152,65,37,28,73
"2011","Dartford 006B","E01024170",1083,53,10,43,179,136,102,98,203,159,81,51,30,72
"2011","Dartford 006C","E01024171",1134,78,27,51,221,197,109,108,167,137,65,51,14,52
"2011","Dartford 006D","E01024172",1570,111,22,89,345,312,136,118,236,175,67,33,34,70
"2011","Dartford 007A","E01024144",1106,116,32,84,272,212,111,95,105,70,30,16,14,95
"2011","Dartford 007B","E01024145",1185,127,30,97,277,206,122,88,136,93,41,24,17,95
"2011","Dartford 007C","E01024146",1104,131,29,102,280,223,107,61,126,60,18,15,3,98
"2011","Dartford 007D","E01024147",1250,133,36,97,279,253,114,96,164,101,34,16,18,76
"2011","Dartford 007E","E01024186",953,87,21,66,232,197,95,67,129,78,21,10,11,47
"2011","Dartford 008A","E01024133",991,151,27,124,279,167,92,59,104,60,25,9,16,54
"2011","Dartford 008B","E01024136",1178,97,23,74,235,215,111,107,177,120,34,15,19,82
"2011","Dartford 008C","E01024137",1087,103,24,79,241,197,97,84,159,89,32,18,14,85
"2011","Dartford 008D","E01024138",1181,77,21,56,213,202,90,103,180,159,61,38,23,96
"2011","Dartford 008E","E01024139",1284,92,23,69,285,250,132,129,199,92,22,11,11,83
"2011","Dartford 009A","E01024165",1046,39,9,30,154,130,89,86,212,173,97,65,32,66
"2011","Dartford 009B","E01024166",1203,58,14,44,203,150,104,102,222,192,77,49,28,95
"2011","Dartford 009C","E01024167",1319,87,18,69,226,212,110,121,226,164,85,49,36,88
"2011","Dartford 009D","E01024168",903,52,12,40,163,141,83,80,152,109,44,24,20,79
"2011","Dartford 010A","E01024150",1020,119,34,85,248,210,120,43,124,56,19,15,4,81
"2011","Dartford 010B","E01024151",1002,98,30,68,249,202,135,70,113,58,21,16,5,56
"2011","Dartford 010C","E01024152",1858,235,65,170,411,341,232,101,213,130,68,42,26,127
"2011","Dartford 010D","E01024153",1016,106,20,86,248,193,156,51,109,62,26,20,6,65
"2011","Dartford 011A","E01024173",1247,108,38,70,282,243,178,81,159,91,42,26,16,63
"2011","Dartford 011B","E01024187",798,90,18,72,182,149,106,62,85,52,25,16,9,47
"2011","Dartford 011C","E01024188",871,120,41,79,227,157,91,56,99,53,17,12,5,51
"2011","Dartford 011D","E01024189",1127,109,37,72,276,195,148,75,134,74,39,20,19,77
"2011","Dartford 012A","E01024132",924,43,20,23,157,145,115,81,166,115,49,30,19,53
"2011","Dartford 012B","E01024134",1226,83,21,62,259,191,135,100,202,133,55,40,15,68
"2011","Dartford 012C","E01024135",991,56,15,41,170,120,129,78,175,148,60,34,26,55
"2011","Dartford 012D","E01024174",858,79,24,55,165,149,106,74,127,88,22,15,7,48
"2011","Dartford 012E","E01024175",968,77,18,59,214,191,111,83,138,67,32,18,14,55
"2011","Dartford 013A","E01024157",1233,158,45,113,321,208,169,78,128,87,18,11,7,66
"2011","Dartford 013B","E01024158",1061,106,27,79,217,191,101,97,159,81,35,22,13,74
"2011","Dartford 013C","E01024159",1194,170,55,115,319,237,155,54,103,64,16,8,8,76
"2011","Dartford 013D","E01024160",1040,168,45,123,276,190,142,48,90,42,12,7,5,72
"2011","Dover 001A","E01024206",1327,152,34,118,299,138,233,80,176,114,37,25,12,98
"2011","Dover 001B","E01024207",1319,200,36,164,334,154,205,84,140,97,44,33,11,61
"2011","Dover 001C","E01024208",1184,139,25,114,250,106,140,93,188,119,70,56,14,79
"2011","Dover 001D","E01024209",1253,190,38,152,301,142,193,74,156,90,32,17,15,75
"2011","Dover 002A","E01024202",1318,112,27,85,275,132,135,114,235,149,85,62,23,81
"2011","Dover 002B","E01024242",1272,189,46,143,299,139,207,83,133,74,48,42,6,100
"2011","Dover 002C","E01024243",1155,103,21,82,210,133,98,89,203,165,66,47,19,88
"2011","Dover 002D","E01024244",1287,225,31,194,355,141,180,75,137,83,29,19,10,62
"2011","Dover 002E","E01024245",1320,172,29,143,279,158,193,88,174,125,41,28,13,90
"2011","Dover 003A","E01024219",898,56,20,36,177,113,95,78,176,107,54,44,10,42
"2011","Dover 003B","E01024220",1118,85,25,60,246,160,120,101,194,97,57,48,9,58
"2011","Dover 003C","E01024221",1171,134,35,99,272,165,146,89,164,93,44,32,12,64
"2011","Dover 003D","E01024227",1087,67,12,55,252,130,121,89,196,117,42,25,17,73
"2011","Dover 003E","E01024229",1111,48,8,40,238,117,140,111,212,130,60,34,26,55
"2011","Dover 004A","E01024228",1169,121,34,87,288,112,178,76,164,102,66,43,23,62
"2011","Dover 004B","E01024230",1037,92,21,71,277,116,148,83,147,99,37,13,24,38
"2011","Dover 004C","E01024231",1189,90,28,62,256,141,174,93,206,104,59,26,33,66
"2011","Dover 004D","E01024252",1826,178,48,130,523,232,227,135,249,132,50,36,14,100
"2011","Dover 005A","E01024201",1134,126,29,97,233,130,172,88,153,131,44,27,17,57
"2011","Dover 005B","E01024217",1247,72,15,57,231,148,125,122,256,150,69,41,28,74
"2011","Dover 005C","E01024223",1132,46,11,35,179,132,109,108,275,154,48,31,17,81
"2011","Dover 005D","E01024225",1235,54,9,45,170,144,105,132,291,218,44,26,18,77
"2011","Dover 005E","E01024226",1028,46,10,36,172,137,83,101,217,157,41,27,14,74
"2011","Dover 006A","E01024190",1096,75,19,56,216,135,109,107,154,119,117,106,11,64
"2011","Dover 006B","E01024191",1274,47,15,32,194,140,100,143,279,201,72,49,23,98
"2011","Dover 006C","E01024192",1145,23,5,18,120,121,103,130,273,223,74,54,20,78
"2011","Dover 006D","E01024204",1124,90,19,71,229,137,113,95,193,131,68,49,19,68
"2011","Dover 007A","E01024218",884,36,8,28,138,114,67,97,177,125,69,39,30,61
"2011","Dover 007B","E01024222",1119,50,19,31,186,138,102,120,217,150,74,45,29,82
"2011","Dover 007C","E01024224",1135,65,24,41,248,164,118,113,190,128,36,28,8,73
"2011","Dover 007D","E01024250",1159,77,22,55,226,165,142,108,209,115,46,23,23,71
"2011","Dover 007E","E01024251",1082,104,26,78,255,157,119,77,166,104,35,20,15,65
"2011","Dover 008A","E01024200",1306,135,34,101,351,173,214,80,140,81,49,39,10,83
"2011","Dover 008B","E01024203",1198,167,47,120,339,139,172,79,141,80,24,16,8,57
"2011","Dover 008C","E01024205",1173,106,23,83,274,165,121,95,183,111,40,24,16,78
"2011","Dover 008D","E01024255",1149,108,28,80,258,186,105,112,192,108,21,16,5,59
"2011","Dover 009A","E01024232",1505,219,49,170,428,210,191,80,168,78,42,34,8,89
"2011","Dover 009B","E01024236",1181,127,34,93,302,185,173,87,140,90,22,19,3,55
"2011","Dover 009C","E01024237",1144,134,33,101,347,172,150,63,131,76,28,20,8,43
"2011","Dover 009D","E01024253",1228,161,40,121,347,181,153,76,142,69,34,22,12,65
"2011","Dover 010C","E01024233",1177,111,40,71,306,239,105,100,156,76,14,7,7,70
"2011","Dover 010D","E01024235",1110,78,22,56,313,208,123,87,147,75,27,22,5,52
"2011","Dover 010E","E01024254",1484,120,41,79,339,212,114,128,235,159,74,43,31,103
"2011","Dover 010F","E01024256",1069,44,10,34,236,209,103,94,210,88,24,17,7,61
"2011","Dover 010G","E01033210",1719,155,50,105,452,255,165,135,253,144,63,45,18,97
"2011","Dover 011A","E01024193",1121,23,4,19,150,120,62,87,292,201,108,75,33,78
"2011","Dover 011B","E01024194",1117,51,13,38,189,170,74,110,249,136,47,24,23,91
"2011","Dover 011C","E01024195",1034,39,15,24,155,144,92,83,217,139,78,47,31,87
"2011","Dover 011D","E01024196",1043,19,5,14,131,83,81,115,255,188,98,58,40,73
"2011","Dover 011E","E01024197",1164,41,15,26,181,139,76,130,282,201,48,31,17,66
"2011","Dover 011F","E01024240",1089,31,8,23,106,105,76,110,248,196,146,82,64,71
"2011","Dover 011G","E01024241",1467,38,13,25,207,188,94,151,323,231,120,70,50,115
"2011","Dover 011H","E01024248",1341,48,12,36,178,152,86,145,302,240,113,61,52,77
"2011","Dover 012B","E01024238",1270,85,34,51,279,157,98,73,147,114,93,70,23,224
"2011","Dover 012C","E01024239",1269,45,18,27,220,174,94,119,242,218,84,50,34,73
"2011","Dover 012D","E01024247",1468,87,20,67,242,183,127,131,244,202,165,122,43,87
"2011","Dover 012E","E01033209",819,72,20,52,198,107,102,63,116,89,29,19,10,43
"2011","Dover 012F","E01033211",808,35,9,26,154,100,66,58,167,133,65,42,23,30
"2011","Dover 013A","E01024214",1199,43,10,33,176,155,96,95,272,189,94,63,31,79
"2011","Dover 013B","E01024215",1222,46,9,37,174,121,80,119,244,203,108,60,48,127
"2011","Dover 013C","E01024216",1103,55,18,37,228,197,90,88,202,125,47,30,17,71
"2011","Dover 013D","E01024246",1460,58,13,45,223,173,106,143,320,238,118,60,58,81
"2011","Dover 013E","E01024249",1439,36,15,21,187,161,92,151,347,259,127,84,43,79
"2011","Dover 014A","E01024198",1792,150,51,99,399,251,269,152,260,180,50,32,18,81
"2011","Dover 014B","E01024212",1166,60,18,42,208,211,106,144,180,144,41,20,21,72
"2011","Dover 014C","E01024213",1052,55,18,37,230,214,82,103,182,119,17,7,10,50
"2011","Dover 014D","E01024234",1065,111,26,85,291,183,126,81,128,57,24,11,13,64
"2011","Gravesham 001A","E01024276",1872,133,36,97,359,245,174,166,286,284,97,69,28,128
"2011","Gravesham 001B","E01024277",1313,70,17,53,195,140,112,109,238,230,136,95,41,83
"2011","Gravesham 001C","E01024278",1325,39,12,27,152,132,101,91,262,284,181,99,82,83
"2011","Gravesham 001D","E01024279",1070,41,9,32,136,118,90,103,204,202,90,63,27,86
"2011","Gravesham 002A","E01024257",1546,84,11,73,227,140,145,99,226,273,212,143,69,140
"2011","Gravesham 002C","E01024290",1230,97,12,85,213,133,119,83,163,180,129,92,37,113
"2011","Gravesham 002D","E01024291",1282,66,12,54,215,131,100,92,198,269,126,87,39,85
"2011","Gravesham 002E","E01024295",1298,64,9,55,209,128,108,98,234,262,137,75,62,58
"2011","Gravesham 002F","E01032799",1195,60,9,51,190,114,94,85,196,246,128,93,35,82
"2011","Gravesham 002G","E01032800",919,90,10,80,231,106,87,56,132,140,56,35,21,21
"2011","Gravesham 003A","E01024258",1189,87,24,63,190,145,138,58,198,181,90,58,32,102
"2011","Gravesham 003B","E01024261",1563,135,40,95,331,255,147,143,284,137,42,22,20,89
"2011","Gravesham 003C","E01024293",1211,55,14,41,201,130,115,116,207,218,81,64,17,88
"2011","Gravesham 003D","E01024294",1525,81,18,63,241,177,121,127,265,234,156,113,43,123
"2011","Gravesham 003E","E01024296",2146,105,28,77,383,212,191,142,362,424,171,115,56,156
"2011","Gravesham 004A","E01024262",1242,77,19,58,224,140,110,107,244,186,75,44,31,79
"2011","Gravesham 004B","E01024263",1046,43,13,30,145,107,83,88,235,196,77,53,24,72
"2011","Gravesham 004C","E01024282",1183,63,16,47,197,149,96,123,208,210,49,38,11,88
"2011","Gravesham 004D","E01024283",945,55,16,39,154,117,99,84,167,129,60,40,20,80
"2011","Gravesham 004E","E01024284",1123,60,17,43,184,136,96,100,215,205,61,31,30,66
"2011","Gravesham 005A","E01024259",1136,131,29,102,305,172,103,78,164,79,28,21,7,76
"2011","Gravesham 005B","E01024260",1376,154,48,106,380,200,157,74,110,128,90,71,19,83
"2011","Gravesham 005C","E01024292",1213,123,28,95,261,126,140,66,149,173,71,54,17,104
"2011","Gravesham 005D","E01024313",1153,96,24,72,248,208,125,84,159,127,37,29,8,69
"2011","Gravesham 005E","E01024317",1201,127,27,100,289,143,113,89,190,120,44,30,14,86
"2011","Gravesham 005F","E01024318",1127,103,27,76,234,175,135,77,168,109,45,23,22,81
"2011","Gravesham 006A","E01024280",1198,80,21,59,202,155,92,76,214,163,119,87,32,97
"2011","Gravesham 006B","E01024281",1039,54,15,39,175,144,104,94,195,144,41,30,11,88
"2011","Gravesham 006C","E01024285",989,57,12,45,172,163,78,85,188,129,36,21,15,81
"2011","Gravesham 006D","E01024287",945,56,16,40,150,142,70,87,190,146,42,30,12,62
"2011","Gravesham 006E","E01024288",914,81,15,66,157,146,80,89,152,115,52,39,13,42
"2011","Gravesham 007A","E01024308",952,31,6,25,112,110,90,77,186,179,111,77,34,56
"2011","Gravesham 007B","E01024310",1070,51,11,40,184,138,96,100,212,152,77,55,22,60
"2011","Gravesham 007C","E01024311",889,51,16,35,109,106,80,82,164,134,82,53,29,81
"2011","Gravesham 007D","E01024314",951,70,22,48,166,137,99,94,185,97,36,25,11,67
"2011","Gravesham 007E","E01024315",1099,70,26,44,146,133,106,92,210,158,103,75,28,81
"2011","Gravesham 008A","E01024297",1148,93,22,71,241,211,105,104,204,100,27,19,8,63
"2011","Gravesham 008B","E01024298",1024,83,27,56,207,184,106,103,164,88,16,9,7,73
"2011","Gravesham 008C","E01024299",1038,73,20,53,186,195,103,91,193,103,32,17,15,62
"2011","Gravesham 008D","E01024309",893,35,11,24,136,110,72,96,155,139,87,52,35,63
"2011","Gravesham 008E","E01024312",942,45,13,32,157,118,94,97,189,118,55,39,16,69
"2011","Gravesham 009A","E01024264",1050,42,11,31,141,126,79,100,230,183,69,49,20,80
"2011","Gravesham 009B","E01024286",1247,118,28,90,222,207,108,112,221,155,33,24,9,71
"2011","Gravesham 009C","E01024316",1304,150,32,118,303,232,149,101,157,92,37,18,19,83
"2011","Gravesham 009D","E01024319",1101,99,30,69,222,152,97,77,177,110,66,51,15,101
"2011","Gravesham 010A","E01024265",928,123,34,89,224,143,153,52,87,54,23,13,10,69
"2011","Gravesham 010B","E01024266",820,61,15,46,163,114,93,81,126,81,47,27,20,54
"2011","Gravesham 010C","E01024267",1112,103,26,77,271,184,139,75,147,99,36,23,13,58
"2011","Gravesham 010D","E01024300",1073,102,25,77,253,205,134,78,117,92,25,15,10,67
"2011","Gravesham 010E","E01024301",906,137,37,100,207,150,120,59,76,42,22,12,10,93
"2011","Gravesham 011A","E01024303",1115,76,15,61,182,160,101,109,221,148,53,26,27,65
"2011","Gravesham 011B","E01024304",1097,47,14,33,192,165,95,110,223,147,42,28,14,76
"2011","Gravesham 011C","E01024305",1048,36,11,25,120,95,77,98,196,179,145,92,53,102
"2011","Gravesham 011D","E01024306",775,24,8,16,87,66,61,68,157,160,88,53,35,64
"2011","Gravesham 011E","E01024307",1001,52,11,41,175,133,92,89,172,150,76,57,19,62
"2011","Gravesham 012A","E01024268",1155,127,31,96,269,203,150,87,134,84,35,24,11,66
"2011","Gravesham 012B","E01024269",1361,151,45,106,326,262,155,107,176,88,20,16,4,76
"2011","Gravesham 012C","E01024270",1037,178,46,132,286,177,117,55,105,49,20,11,9,50
"2011","Gravesham 012D","E01024271",1019,135,26,109,223,167,122,60,121,89,33,21,12,69
"2011","Gravesham 012E","E01024272",1090,154,46,108,324,209,113,54,110,51,8,4,4,67
"2011","Gravesham 013A","E01024273",1169,164,42,122,269,163,215,63,102,68,42,31,11,83
"2011","Gravesham 013B","E01024274",1171,147,48,99,271,202,172,63,117,128,21,16,5,50
"2011","Gravesham 013C","E01024275",1028,115,26,89,253,176,122,78,127,79,19,15,4,59
"2011","Gravesham 013D","E01024302",1064,152,37,115,292,172,141,55,99,66,21,18,3,66
"2011","Maidstone 001A","E01024333",1024,94,17,77,232,175,98,91,141,101,30,18,12,62
"2011","Maidstone 001B","E01024334",771,113,25,88,209,151,55,60,75,59,11,6,5,38
"2011","Maidstone 001C","E01024335",1191,143,47,96,275,197,187,56,133,94,17,9,8,89
"2011","Maidstone 001D","E01024338",1095,170,46,124,312,215,102,76,92,58,19,12,7,51
"2011","Maidstone 001E","E01024347",1218,188,54,134,371,161,162,58,96,76,30,16,14,76
"2011","Maidstone 002A","E01024353",1352,164,44,120,379,214,145,83,137,121,28,24,4,81
"2011","Maidstone 002B","E01024354",1092,82,20,62,241,192,112,104,175,116,27,21,6,43
"2011","Maidstone 002C","E01024355",1460,158,40,118,398,226,152,84,176,122,45,28,17,99
"2011","Maidstone 002D","E01024385",1126,131,32,99,269,177,111,80,149,106,41,23,18,62
"2011","Maidstone 002E","E01024386",1216,212,53,159,340,215,121,53,82,91,22,14,8,80
"2011","Maidstone 003A","E01024320",866,105,29,76,229,158,72,63,108,65,8,2,6,58
"2011","Maidstone 003B","E01024321",1152,157,37,120,313,225,94,76,134,60,34,19,15,59
"2011","Maidstone 003C","E01024322",812,111,22,89,210,147,70,49,123,49,16,10,6,37
"2011","Maidstone 003D","E01024323",961,96,19,77,237,193,76,66,143,85,17,11,6,48
"2011","Maidstone 003E","E01024324",1009,109,26,83,270,191,89,73,128,79,14,5,9,56
"2011","Maidstone 003F","E01024341",1214,183,49,134,366,218,116,56,116,65,30,20,10,64
"2011","Maidstone 004A","E01024352",1339,96,17,79,291,175,130,103,214,183,64,44,20,83
"2011","Maidstone 004C","E01024382",1763,130,23,107,352,194,205,153,252,277,122,73,49,78
"2011","Maidstone 004D","E01024383",1802,143,47,96,439,361,99,135,214,244,80,57,23,87
"2011","Maidstone 004E","E01024384",1345,103,22,81,266,173,127,118,225,195,58,41,17,80
"2011","Maidstone 004F","E01033090",927,60,11,49,207,97,66,75,143,135,72,34,38,72
"2011","Maidstone 004G","E01033092",991,72,9,63,201,104,82,88,157,164,65,34,31,58
"2011","Maidstone 005A","E01024330",1152,197,44,153,367,218,104,51,95,55,10,5,5,55
"2011","Maidstone 005B","E01024336",1250,192,58,134,350,220,135,54,135,63,17,9,8,84
"2011","Maidstone 005C","E01024337",1080,159,58,101,310,198,87,60,128,53,15,8,7,70
"2011","Maidstone 005D","E01024348",1046,181,43,138,315,183,89,51,81,56,19,12,7,71
"2011","Maidstone 005E","E01024351",1122,136,28,108,251,196,105,73,164,99,28,13,15,70
"2011","Maidstone 006A","E01024339",1440,175,37,138,359,181,106,82,201,151,55,32,23,130
"2011","Maidstone 006B","E01024340",1719,228,34,194,460,253,155,112,196,154,46,26,20,115
"2011","Maidstone 006C","E01024356",1231,109,25,84,266,149,145,80,156,146,50,33,17,130
"2011","Maidstone 006E","E01024373",1372,139,38,101,308,197,118,109,188,172,55,33,22,86
"2011","Maidstone 006F","E01033087",1134,125,16,109,295,157,91,88,119,101,54,27,27,104
"2011","Maidstone 006G","E01033091",1331,94,18,76,329,200,94,101,167,179,44,11,33,123
"2011","Maidstone 007A","E01024326",1283,197,53,144,357,219,128,67,132,79,17,6,11,87
"2011","Maidstone 007B","E01024327",1198,122,31,91,292,242,120,76,155,97,30,16,14,64
"2011","Maidstone 007C","E01024328",1058,180,42,138,290,157,123,51,100,64,28,17,11,65
"2011","Maidstone 007D","E01024329",1062,177,45,132,304,181,124,38,97,51,16,11,5,74
"2011","Maidstone 007E","E01024349",1049,115,20,95,308,175,131,72,106,78,15,5,10,49
"2011","Maidstone 008A","E01024357",1261,96,17,79,258,175,121,105,178,163,61,36,25,104
"2011","Maidstone 008B","E01024358",1226,92,23,69,262,165,109,86,192,190,42,30,12,88
"2011","Maidstone 008C","E01024367",1019,97,20,77,236,124,100,66,159,106,41,32,9,90
"2011","Maidstone 008E","E01024369",1108,133,31,102,276,207,91,73,140,99,22,14,8,67
"2011","Maidstone 008F","E01033088",1065,159,38,121,342,174,82,64,92,63,24,16,8,65
"2011","Maidstone 008G","E01033089",1130,145,18,127,288,131,75,77,161,109,67,42,25,77
"2011","Maidstone 009A","E01024360",1141,98,22,76,277,186,104,75,167,135,30,19,11,69
"2011","Maidstone 009B","E01024372",1541,102,15,87,311,194,126,146,213,261,80,54,26,108
"2011","Maidstone 009C","E01024374",1191,57,10,47,157,104,111,82,233,209,130,88,42,108
"2011","Maidstone 009D","E01024401",1099,82,19,63,257,165,92,89,184,133,34,16,18,63
"2011","Maidstone 009E","E01024403",1331,125,25,100,321,222,125,111,174,152,43,25,18,58
"2011","Maidstone 010A","E01024371",1175,123,26,97,248,173,139,76,181,124,48,33,15,63
"2011","Maidstone 010B","E01024392",1174,64,16,48,169,159,112,83,230,204,69,52,17,84
"2011","Maidstone 010C","E01024393",1083,102,22,80,216,140,116,79,179,139,46,30,16,66
"2011","Maidstone 010D","E01024395",1043,32,7,25,135,110,95,93,220,200,68,48,20,90
"2011","Maidstone 010E","E01024396",1056,48,13,35,154,132,115,86,232,176,54,35,19,59
"2011","Maidstone 011A","E01024361",1190,105,37,68,237,161,135,119,179,168,33,23,10,53
"2011","Maidstone 011B","E01024362",1259,173,45,128,352,166,208,77,101,105,24,18,6,53
"2011","Maidstone 011C","E01024363",1524,179,61,118,383,191,228,100,177,123,70,50,20,73
"2011","Maidstone 011D","E01024387",1838,260,79,181,447,239,339,104,168,145,43,28,15,93
"2011","Maidstone 012A","E01024331",1025,136,40,96,266,170,141,57,107,65,28,14,14,55
"2011","Maidstone 012B","E01024394",1045,105,24,81,262,161,114,75,139,85,23,14,9,81
"2011","Maidstone 012C","E01024402",1058,150,43,107,319,178,130,62,96,43,18,14,4,62
"2011","Maidstone 012D","E01024404",1119,159,37,122,300,216,127,74,113,70,8,6,2,52
"2011","Maidstone 012E","E01024405",1490,178,42,136,368,259,157,106,179,129,35,24,11,79
"2011","Maidstone 013A","E01024389",1427,32,7,25,163,144,89,124,314,306,173,122,51,82
"2011","Maidstone 013B","E01024390",946,25,10,15,108,83,53,107,223,221,83,59,24,43
"2011","Maidstone 013C","E01024391",940,35,7,28,107,71,89,97,210,176,86,53,33,69
"2011","Maidstone 013D","E01024397",1018,31,8,23,93,95,100,95,228,234,80,56,24,62
"2011","Maidstone 013E","E01024398",1200,34,5,29,142,109,111,111,287,216,115,76,39,75
"2011","Maidstone 013F","E01024399",904,29,13,16,126,116,82,72,190,195,49,40,9,45
"2011","Maidstone 013G","E01024400",924,53,20,33,149,121,104,87,187,143,28,17,11,52
"2011","Maidstone 014A","E01024325",1663,199,53,146,459,286,181,105,201,125,24,17,7,83
"2011","Maidstone 014B","E01024346",936,126,30,96,240,155,153,42,86,58,26,17,9,50
"2011","Maidstone 014C","E01024377",1218,114,28,86,272,148,208,92,162,133,40,31,9,49
"2011","Maidstone 014D","E01024378",978,132,45,87,261,135,119,75,102,75,34,24,10,45
"2011","Maidstone 015A","E01024332",905,141,43,98,212,119,162,44,96,55,20,11,9,56
"2011","Maidstone 015B","E01024350",1057,122,30,92,268,173,121,73,117,81,24,11,13,78
"2011","Maidstone 015C","E01024375",1834,209,63,146,465,296,243,135,216,141,39,23,16,90
"2011","Maidstone 015D","E01024388",2105,190,54,136,488,308,206,176,333,209,72,47,25,123
"2011","Maidstone 015E","E01024410",1157,132,43,89,245,166,190,80,145,111,41,35,6,47
"2011","Maidstone 016A","E01024342",1198,145,25,120,253,162,119,106,169,148,33,22,11,63
"2011","Maidstone 016B","E01024343",1037,117,36,81,277,161,131,55,114,83,29,21,8,70
"2011","Maidstone 016C","E01024344",1018,101,38,63,248,194,97,79,124,112,14,11,3,49
"2011","Maidstone 016D","E01024376",1712,229,66,163,457,266,224,96,200,120,32,19,13,88
"2011","Maidstone 017A","E01024364",1162,151,31,120,267,159,177,58,150,103,46,39,7,51
"2011","Maidstone 017B","E01024365",1269,179,55,124,345,203,156,73,136,99,22,6,16,56
"2011","Maidstone 017C","E01024366",1366,195,43,152,324,189,228,74,139,95,56,44,12,66
"2011","Maidstone 017D","E01024411",948,104,25,79,248,96,130,62,83,70,36,25,11,119
"2011","Maidstone 018A","E01024345",1140,166,39,127,306,131,167,72,118,86,36,24,12,58
"2011","Maidstone 018B","E01024379",1278,171,47,124,317,133,263,53,121,77,52,35,17,91
"2011","Maidstone 018C","E01024380",1215,161,30,131,318,153,217,61,129,86,22,9,13,68
"2011","Maidstone 018D","E01024381",977,111,26,85,230,114,91,72,144,129,41,26,15,45
"2011","Maidstone 019A","E01024406",1014,135,38,97,246,147,135,59,131,88,27,21,6,46
"2011","Maidstone 019B","E01024407",1123,130,38,92,297,173,157,60,125,71,44,38,6,66
"2011","Maidstone 019C","E01024408",1072,131,40,91,247,188,113,75,143,107,9,7,2,59
"2011","Maidstone 019D","E01024409",1046,118,28,90,251,129,138,78,152,104,25,17,8,51
"2011","Sevenoaks 001A","E01024445",989,144,29,115,228,191,102,68,112,68,14,10,4,62
"2011","Sevenoaks 001B","E01024446",1120,112,36,76,291,225,124,81,115,66,18,13,5,88
"2011","Sevenoaks 001C","E01024447",951,71,10,61,220,158,122,77,136,74,34,21,13,59
"2011","Sevenoaks 001D","E01024472",1029,100,30,70,194,173,137,78,123,98,49,35,14,77
"2011","Sevenoaks 001E","E01024479",1103,123,32,91,247,223,106,70,166,90,21,13,8,57
"2011","Sevenoaks 002A","E01024476",1054,39,11,28,146,130,85,89,215,185,90,60,30,75
"2011","Sevenoaks 002B","E01024477",1004,45,16,29,152,120,87,81,195,176,75,46,29,73
"2011","Sevenoaks 002C","E01024478",1023,75,14,61,199,191,118,96,143,119,36,21,15,46
"2011","Sevenoaks 002D","E01024480",1133,61,16,45,204,171,104,92,214,155,68,35,33,64
"2011","Sevenoaks 002E","E01024481",1135,59,19,40,171,161,128,105,217,180,46,25,21,68
"2011","Sevenoaks 002F","E01024482",1087,57,18,39,187,150,108,109,216,144,60,35,25,56
"2011","Sevenoaks 003A","E01024421",1393,168,36,132,315,212,183,101,164,132,40,25,15,78
"2011","Sevenoaks 003B","E01024473",1184,108,16,92,246,210,127,115,173,92,28,18,10,85
"2011","Sevenoaks 003C","E01024474",955,97,26,71,222,191,90,68,126,78,22,11,11,61
"2011","Sevenoaks 003D","E01024475",1101,95,19,76,223,226,119,82,143,88,43,22,21,82
"2011","Sevenoaks 004A","E01024441",1094,173,58,115,296,199,127,57,113,48,20,13,7,61
"2011","Sevenoaks 004B","E01024442",1117,187,58,129,285,189,174,53,91,51,29,17,12,58
"2011","Sevenoaks 004C","E01024443",995,155,44,111,278,186,98,56,109,45,16,12,4,52
"2011","Sevenoaks 004D","E01024444",942,81,26,55,185,122,114,80,151,121,31,18,13,57
"2011","Sevenoaks 005A","E01024431",1286,236,59,177,376,212,154,56,106,68,18,12,6,60
"2011","Sevenoaks 005B","E01024432",1089,135,36,99,231,180,135,73,154,100,25,17,8,56
"2011","Sevenoaks 005C","E01024433",983,142,36,106,296,139,138,59,82,61,16,12,4,50
"2011","Sevenoaks 005D","E01024434",1444,142,44,98,323,241,187,97,208,143,29,17,12,74
"2011","Sevenoaks 007A","E01024435",1156,122,33,89,249,202,192,73,124,84,39,28,11,71
"2011","Sevenoaks 007B","E01024436",1151,88,32,56,239,205,167,77,159,131,38,22,16,47
"2011","Sevenoaks 007C","E01024437",1164,110,30,80,258,165,180,89,158,110,32,18,14,62
"2011","Sevenoaks 007D","E01024438",1104,103,28,75,223,208,161,95,121,109,23,12,11,61
"2011","Sevenoaks 008A","E01024422",1333,184,40,144,311,192,168,85,173,119,35,18,17,66
"2011","Sevenoaks 008B","E01024423",1216,238,38,200,328,168,117,66,120,82,30,16,14,67
"2011","Sevenoaks 008C","E01024439",1143,144,31,113,256,194,204,70,122,63,23,17,6,67
"2011","Sevenoaks 008D","E01024440",1391,226,72,154,384,210,241,69,107,64,23,14,9,67
"2011","Sevenoaks 008E","E01024452",977,175,48,127,284,119,144,35,83,63,29,21,8,45
"2011","Sevenoaks 009A","E01024448",845,95,13,82,200,135,115,58,105,80,22,15,7,35
"2011","Sevenoaks 009B","E01024449",1015,177,42,135,293,159,111,48,93,58,14,8,6,62
"2011","Sevenoaks 009C","E01024450",1085,161,40,121,286,155,151,50,113,64,27,16,11,78
"2011","Sevenoaks 009D","E01024453",1080,266,74,192,343,151,105,39,63,31,13,5,8,69
"2011","Sevenoaks 009E","E01024454",1057,164,36,128,266,155,131,57,132,84,23,16,7,45
"2011","Sevenoaks 010A","E01024457",814,117,32,85,201,101,107,42,100,81,27,17,10,38
"2011","Sevenoaks 010B","E01024460",1137,127,23,104,269,123,134,70,176,127,41,25,16,70
"2011","Sevenoaks 010C","E01024461",1699,420,79,341,519,222,159,51,118,70,45,29,16,95
"2011","Sevenoaks 010D","E01024465",1063,104,22,82,235,148,119,82,166,136,26,16,10,47
"2011","Sevenoaks 010E","E01024466",950,114,28,86,226,114,101,50,117,122,37,20,17,69
"2011","Sevenoaks 010F","E01024468",1039,239,41,198,320,122,101,45,71,59,26,18,8,56
"2011","Sevenoaks 011A","E01024416",1127,259,57,202,345,166,116,31,82,48,25,16,9,55
"2011","Sevenoaks 011B","E01024418",920,202,61,141,273,138,91,30,78,29,10,7,3,69
"2011","Sevenoaks 011C","E01024424",877,262,50,212,305,122,54,17,30,17,10,5,5,60
"2011","Sevenoaks 011D","E01024463",1018,279,68,211,309,132,98,21,63,23,18,7,11,75
"2011","Sevenoaks 011E","E01024464",1127,302,87,215,351,160,77,22,74,27,22,17,5,92
"2011","Sevenoaks 011F","E01024467",1137,248,54,194,337,169,119,49,86,40,15,11,4,74
"2011","Sevenoaks 012A","E01024458",1038,260,77,183,275,135,131,23,45,24,20,15,5,125
"2011","Sevenoaks 012B","E01024459",1105,233,64,169,318,124,149,45,81,47,20,13,7,88
"2011","Sevenoaks 012C","E01024462",1161,276,64,212,301,146,107,41,92,69,26,16,10,103
"2011","Sevenoaks 012D","E01024469",1201,316,63,253,385,123,101,50,81,39,28,22,6,78
"2011","Sevenoaks 012E","E01024470",1004,301,72,229,341,119,56,35,46,39,10,6,4,57
"2011","Sevenoaks 012F","E01024471",1156,244,54,190,302,101,79,45,61,37,26,14,12,261
"2011","Sevenoaks 013A","E01024417",1119,164,43,121,287,132,172,65,121,90,32,19,13,56
"2011","Sevenoaks 013B","E01024419",1282,269,75,194,390,141,215,51,88,42,18,9,9,68
"2011","Sevenoaks 013C","E01024483",1177,188,48,140,348,147,139,64,112,65,25,10,15,89
"2011","Sevenoaks 013D","E01024484",892,179,63,116,289,107,136,40,62,26,16,10,6,37
"2011","Sevenoaks 013E","E01024485",1177,147,37,110,237,168,150,76,169,116,54,26,28,60
"2011","Sevenoaks 014A","E01024425",1090,134,32,102,246,175,148,75,142,90,37,26,11,43
"2011","Sevenoaks 014B","E01024426",1341,193,47,146,360,219,199,75,130,78,21,10,11,66
"2011","Sevenoaks 014C","E01024427",920,68,21,47,165,113,93,80,181,124,42,22,20,54
"2011","Sevenoaks 014D","E01024428",925,118,23,95,166,169,107,61,136,101,30,9,21,37
"2011","Sevenoaks 014E","E01024429",1098,94,23,71,235,145,109,93,178,122,52,34,18,70
"2011","Sevenoaks 014F","E01024430",1040,137,32,105,270,129,177,39,114,68,71,63,8,35
"2011","Sevenoaks 015A","E01024420",1520,249,57,192,413,185,269,61,135,88,41,26,15,79
"2011","Sevenoaks 015B","E01024451",1598,290,68,222,433,190,195,80,159,112,24,17,7,115
"2011","Sevenoaks 015C","E01024455",861,164,46,118,255,90,153,25,72,42,13,7,6,47
"2011","Sevenoaks 015D","E01024456",890,152,43,109,241,110,135,37,71,63,22,15,7,59
"2011","Sevenoaks 016A","E01024413",1219,97,26,71,253,221,158,84,189,112,47,24,23,58
"2011","Sevenoaks 016B","E01024414",1179,107,29,78,267,225,126,92,156,97,32,21,11,77
"2011","Sevenoaks 016C","E01024415",1060,175,40,135,330,171,120,47,88,49,12,5,7,68
"2011","Sevenoaks 016D","E01032619",1209,142,39,103,332,226,140,70,113,86,27,16,11,73
"2011","Shepway 001A","E01024490",1559,243,70,173,430,183,265,75,142,93,22,18,4,106
"2011","Shepway 001B","E01024544",1054,74,31,43,220,168,161,83,153,92,40,31,9,63
"2011","Shepway 001C","E01024545",1088,170,47,123,266,157,218,68,92,40,10,7,3,67
"2011","Shepway 001D","E01024547",938,107,25,82,250,159,114,52,114,64,28,11,17,50
"2011","Shepway 002A","E01024492",1118,48,10,38,172,178,82,100,214,170,48,31,17,106
"2011","Shepway 002B","E01024541",1730,118,24,94,381,226,168,129,280,161,122,80,42,145
"2011","Shepway 002C","E01024542",1468,152,40,112,373,235,131,126,204,123,40,25,15,84
"2011","Shepway 002E","E01033213",1244,155,54,101,326,181,116,81,143,93,56,34,22,93
"2011","Shepway 002F","E01033214",1219,128,44,84,338,197,142,95,138,71,30,16,14,80
"2011","Shepway 003A","E01024496",1070,27,6,21,167,134,85,99,234,166,82,57,25,76
"2011","Shepway 003B","E01024497",1160,61,18,43,194,148,123,98,224,160,69,40,29,83
"2011","Shepway 003C","E01024498",1143,35,9,26,141,94,101,115,231,215,112,81,31,99
"2011","Shepway 003D","E01024503",1207,63,19,44,234,156,128,119,222,151,49,27,22,85
"2011","Shepway 003E","E01024518",1274,87,19,68,272,198,139,112,190,134,39,26,13,103
"2011","Shepway 004A","E01024499",1159,46,5,41,192,136,83,107,227,176,92,64,28,100
"2011","Shepway 004B","E01024500",850,31,11,20,140,98,69,67,162,149,53,25,28,81
"2011","Shepway 004C","E01024501",1053,39,8,31,163,133,104,92,194,148,90,44,46,90
"2011","Shepway 004D","E01024502",1004,46,7,39,166,116,111,94,196,152,67,43,24,56
"2011","Shepway 004E","E01024505",1291,54,19,35,256,149,125,113,214,181,115,77,38,84
"2011","Shepway 005A","E01024491",1089,59,22,37,173,135,108,89,208,137,59,39,20,121
"2011","Shepway 005B","E01024493",1023,43,14,29,166,123,88,91,201,148,71,46,25,92
"2011","Shepway 005C","E01024494",1201,50,20,30,190,167,102,100,239,171,48,33,15,134
"2011","Shepway 005D","E01024495",1284,65,29,36,251,176,95,100,216,171,111,90,21,99
"2011","Shepway 005E","E01024520",1019,62,18,44,197,155,100,87,194,125,39,26,13,60
"2011","Shepway 005F","E01024528",937,57,27,30,219,132,80,60,160,110,50,31,19,69
"2011","Shepway 006A","E01024511",984,137,34,103,302,156,121,35,85,26,39,31,8,83
"2011","Shepway 006B","E01024512",1251,70,17,53,249,186,114,108,228,140,41,27,14,115
"2011","Shepway 006C","E01024513",1174,98,27,71,269,194,121,79,154,102,50,31,19,107
"2011","Shepway 006D","E01024514",978,98,24,74,215,157,90,73,137,85,40,22,18,83
"2011","Shepway 006E","E01024515",1068,91,29,62,245,201,97,68,167,97,33,23,10,69
"2011","Shepway 006F","E01024516",1025,106,27,79,237,163,103,68,144,75,41,25,16,88
"2011","Shepway 006G","E01024519",1286,179,80,99,321,329,158,66,93,60,29,21,8,51
"2011","Shepway 006H","E01024521",1275,146,43,103,347,191,161,88,142,83,51,38,13,66
"2011","Shepway 008A","E01024523",1062,191,49,142,331,182,109,43,94,38,20,16,4,54
"2011","Shepway 008B","E01024526",1070,151,49,102,316,156,164,62,100,42,22,14,8,57
"2011","Shepway 008C","E01024527",914,145,36,109,284,151,107,39,83,35,19,12,7,51
"2011","Shepway 008D","E01024550",1491,198,45,153,442,199,229,74,144,99,41,35,6,65
"2011","Shepway 009A","E01024489",1299,90,26,64,251,226,171,102,210,164,35,24,11,50
"2011","Shepway 009B","E01024530",1080,77,19,58,256,157,120,81,162,117,33,21,12,77
"2011","Shepway 009C","E01024536",1482,179,51,128,373,234,197,100,156,93,63,49,14,87
"2011","Shepway 009D","E01024546",1184,117,36,81,294,153,171,80,164,89,59,47,12,57
"2011","Shepway 010A","E01024522",965,108,26,82,249,136,112,68,142,76,40,23,17,34
"2011","Shepway 010B","E01024524",958,67,17,50,183,134,104,88,154,121,61,38,23,46
"2011","Shepway 010C","E01024525",1050,132,28,104,267,123,143,64,130,80,48,31,17,63
"2011","Shepway 010D","E01024529",1017,37,9,28,166,142,108,95,235,150,49,35,14,35
"2011","Shepway 010E","E01024531",1009,73,16,57,218,158,101,74,178,113,29,15,14,65
"2011","Shepway 011A","E01024486",1473,74,23,51,239,213,170,128,278,181,110,85,25,80
"2011","Shepway 011B","E01024487",963,40,14,26,163,137,129,91,163,117,75,59,16,48
"2011","Shepway 011C","E01024488",913,34,10,24,150,138,102,81,198,146,25,18,7,39
"2011","Shepway 011D","E01024548",905,73,20,53,170,90,165,72,144,112,36,26,10,43
"2011","Shepway 011E","E01024549",836,72,22,50,168,109,169,56,121,85,27,20,7,29
"2011","Shepway 012A","E01024537",1267,107,29,78,235,171,186,98,212,118,75,59,16,65
"2011","Shepway 012B","E01024538",1268,137,31,106,307,181,135,85,212,106,43,33,10,62
"2011","Shepway 012C","E01024539",1405,72,18,54,256,186,142,129,289,160,93,61,32,78
"2011","Shepway 012D","E01024540",1137,83,23,60,234,173,153,99,165,103,60,47,13,67
"2011","Shepway 013A","E01024532",1091,56,16,40,202,125,141,107,211,150,51,31,20,48
"2011","Shepway 013B","E01024533",871,44,17,27,153,114,130,80,150,122,34,22,12,44
"2011","Shepway 013C","E01024534",1053,35,4,31,152,120,86,130,210,183,65,39,26,72
"2011","Shepway 013D","E01024535",1720,105,43,62,282,205,191,166,332,240,124,82,42,75
"2011","Shepway 014A","E01024504",1564,45,10,35,179,134,128,163,319,256,218,111,107,122
"2011","Shepway 014B","E01024507",1476,43,11,32,224,131,141,130,268,261,183,119,64,95
"2011","Shepway 014C","E01033212",1206,63,18,45,216,123,101,125,212,176,120,61,59,70
"2011","Shepway 014D","E01033215",871,54,15,39,180,99,115,49,134,134,66,26,40,40
"2011","Shepway 015A","E01024508",1453,114,29,85,323,164,155,138,223,142,129,78,51,65
"2011","Shepway 015B","E01024509",1122,124,36,88,231,132,122,80,177,108,91,38,53,57
"2011","Shepway 015C","E01024510",1248,133,37,96,329,174,133,82,159,101,75,53,22,62
"2011","Shepway 015D","E01024517",1292,109,23,86,271,176,137,95,172,110,112,85,27,110
"2011","Swale 001A","E01024609",850,27,10,17,90,76,73,70,156,196,113,85,28,49
"2011","Swale 001B","E01024610",1096,31,9,22,144,106,104,108,184,218,139,93,46,62
"2011","Swale 001C","E01024611",1056,28,9,19,119,102,81,88,220,227,128,85,43,63
"2011","Swale 001D","E01024612",1090,38,12,26,118,112,87,103,225,229,99,58,41,79
"2011","Swale 002A","E01024613",1016,33,8,25,121,104,103,90,168,224,116,81,35,57
"2011","Swale 002B","E01024614",1019,23,8,15,82,88,71,88,243,213,150,108,42,61
"2011","Swale 002C","E01024615",1003,22,10,12,70,88,90,84,222,241,131,93,38,55
"2011","Swale 002D","E01024616",1146,27,8,19,129,141,85,94,236,263,106,76,30,65
"2011","Swale 003A","E01024585",985,48,17,31,125,113,102,93,173,179,86,66,20,66
"2011","Swale 003B","E01024587",1112,67,23,44,190,150,172,113,156,144,62,35,27,58
"2011","Swale 003C","E01024588",1150,81,36,45,250,195,185,99,126,110,48,44,4,56
"2011","Swale 003D","E01024589",1214,95,36,59,244,199,164,102,144,161,42,36,6,63
"2011","Swale 004A","E01024595",1092,74,31,43,170,155,128,105,186,175,35,24,11,64
"2011","Swale 004B","E01024598",1138,68,23,45,216,184,124,97,167,157,65,46,19,60
"2011","Swale 004D","E01024619",1071,76,24,52,174,164,96,120,173,152,39,25,14,77
"2011","Swale 004E","E01024621",804,24,11,13,91,85,71,77,160,140,99,73,26,57
"2011","Swale 004F","E01032653",1117,68,19,49,192,199,110,98,185,145,60,35,25,60
"2011","Swale 004G","E01032654",1355,92,37,55,306,241,139,133,167,139,63,39,24,75
"2011","Swale 005A","E01024594",1016,42,20,22,175,137,103,116,160,180,39,28,11,64
"2011","Swale 005B","E01024596",1144,38,14,24,177,148,118,125,174,216,82,55,27,66
"2011","Swale 005C","E01024597",1032,31,11,20,118,94,91,103,203,227,109,76,33,56
"2011","Swale 005D","E01024620",976,58,19,39,152,141,145,98,143,147,48,37,11,44
"2011","Swale 006A","E01024580",1240,47,21,26,159,137,176,110,224,225,118,80,38,44
"2011","Swale 006B","E01024581",997,48,22,26,145,139,113,87,150,171,90,67,23,54
"2011","Swale 006C","E01024586",1210,62,21,41,188,187,216,107,184,148,48,33,15,70
"2011","Swale 006D","E01024618",2571,89,37,52,323,216,410,222,326,519,364,292,72,102
"2011","Swale 007B","E01024576",1255,105,31,74,280,211,107,117,194,135,41,20,21,65
"2011","Swale 007C","E01024577",996,72,19,53,193,162,106,71,144,128,45,25,20,75
"2011","Swale 007D","E01024578",1228,109,28,81,251,214,103,90,182,152,50,27,23,77
"2011","Swale 007E","E01024579",1969,138,48,90,399,257,186,132,326,293,129,93,36,109
"2011","Swale 007F","E01024583",1165,63,17,46,183,165,96,100,198,212,62,42,20,86
"2011","Swale 007G","E01032655",1134,114,26,88,311,208,112,109,127,74,23,11,12,56
"2011","Swale 007H","E01032656",1074,93,27,66,242,217,100,82,135,117,34,20,14,54
"2011","Swale 008A","E01024570",1270,135,37,98,253,174,170,87,155,134,76,56,20,86
"2011","Swale 008B","E01024571",1175,136,26,110,255,198,129,84,166,116,31,16,15,60
"2011","Swale 008C","E01024572",876,107,23,84,229,145,109,48,71,71,40,31,9,56
"2011","Swale 008D","E01024573",946,103,31,72,213,168,111,66,108,84,22,12,10,71
"2011","Swale 008E","E01024575",891,99,26,73,203,151,108,71,105,80,16,9,7,58
"2011","Swale 009A","E01024554",1828,199,48,151,425,316,207,135,230,148,74,45,29,94
"2011","Swale 009B","E01024561",1010,64,18,46,181,132,107,87,192,137,52,37,15,58
"2011","Swale 009C","E01024567",1929,135,28,107,385,310,171,161,291,229,139,93,46,108
"2011","Swale 009D","E01024568",2002,209,59,150,470,338,205,150,240,203,70,51,19,117
"2011","Swale 009E","E01024582",1150,65,24,41,180,141,119,126,224,179,48,34,14,68
"2011","Swale 010A","E01024559",946,69,21,48,183,129,75,89,164,138,51,33,18,48
"2011","Swale 010B","E01024584",1177,27,12,15,129,120,99,110,229,259,121,85,36,83
"2011","Swale 010C","E01024590",1087,24,6,18,120,92,69,103,210,243,172,109,63,54
"2011","Swale 010D","E01024599",1366,52,14,38,188,179,130,137,293,232,81,45,36,74
"2011","Swale 010E","E01024608",1233,66,19,47,194,191,111,121,223,167,78,52,26,82
"2011","Swale 011A","E01024591",1315,65,22,43,224,191,107,119,215,260,64,44,20,70
"2011","Swale 011B","E01024592",938,53,16,37,164,181,83,100,157,131,22,14,8,47
"2011","Swale 011C","E01024593",992,45,12,33,158,135,65,113,175,175,53,34,19,73
"2011","Swale 011D","E01024600",1077,42,12,30,129,137,74,110,212,229,70,49,21,74
"2011","Swale 011E","E01024601",1201,91,27,64,224,168,98,102,199,204,47,30,17,68
"2011","Swale 012A","E01024560",902,39,8,31,154,134,91,75,156,138,56,36,20,59
"2011","Swale 012B","E01024562",1080,68,21,47,188,190,123,102,170,126,45,31,14,68
"2011","Swale 012C","E01024569",1273,118,36,82,261,229,121,104,180,146,46,31,15,68
"2011","Swale 012D","E01024630",1145,91,32,59,201,195,125,119,173,136,32,22,10,73
"2011","Swale 012E","E01024632",1144,105,31,74,288,179,108,102,168,100,23,14,9,71
"2011","Swale 013A","E01024606",988,100,27,73,240,170,86,52,120,97,48,39,9,75
"2011","Swale 013C","E01024628",1075,157,48,109,259,145,164,66,106,73,38,29,9,67
"2011","Swale 013D","E01024629",851,113,33,80,186,158,107,48,100,83,13,5,8,43
"2011","Swale 013E","E01024631",1199,150,46,104,328,216,132,67,127,73,18,11,7,88
"2011","Swale 013F","E01032735",1167,150,35,115,306,236,101,75,114,77,20,13,7,88
"2011","Swale 013G","E01032737",1069,139,35,104,277,174,104,69,118,77,38,28,10,73
"2011","Swale 014A","E01024564",745,72,20,52,167,110,73,40,124,105,13,9,4,41
"2011","Swale 014B","E01024603",940,107,20,87,273,108,84,66,122,93,34,22,12,53
"2011","Swale 014C","E01024604",822,38,9,29,140,100,85,65,148,140,58,31,27,48
"2011","Swale 014D","E01024605",986,68,15,53,228,160,113,73,155,129,15,11,4,45
"2011","Swale 014E","E01024626",1099,149,35,114,341,135,102,73,119,92,27,16,11,61
"2011","Swale 014F","E01024627",1334,78,20,58,234,124,137,86,244,249,104,77,27,78
"2011","Swale 015A","E01024551",1639,130,25,105,371,211,132,144,292,203,65,43,22,91
"2011","Swale 015B","E01024552",1317,79,27,52,223,128,104,134,245,251,74,54,20,79
"2011","Swale 015C","E01024553",1416,197,35,162,433,137,179,75,154,134,45,29,16,62
"2011","Swale 015D","E01024563",1107,56,12,44,147,95,88,93,179,242,136,90,46,71
"2011","Swale 015E","E01024602",1065,112,22,90,293,125,123,66,132,110,38,25,13,66
"2011","Swale 015F","E01024625",1365,182,35,147,374,225,112,99,164,107,25,14,11,77
"2011","Swale 016A","E01024565",958,127,36,91,228,120,156,51,107,84,38,33,5,47
"2011","Swale 016B","E01024566",1075,161,46,115,260,115,162,73,113,82,44,31,13,65
"2011","Swale 016C","E01024622",1254,128,35,93,287,144,203,56,166,130,77,52,25,63
"2011","Swale 016D","E01024623",1382,81,20,61,257,182,150,113,252,192,74,48,26,81
"2011","Swale 016E","E01024624",1317,107,29,78,282,154,181,112,166,144,90,61,29,81
"2011","Swale 017A","E01024555",988,142,33,109,275,103,141,66,114,79,18,11,7,50
"2011","Swale 017B","E01024556",872,124,31,93,205,87,114,68,111,90,18,16,2,55
"2011","Swale 017C","E01024557",1090,146,33,113,239,131,115,79,165,106,45,28,17,64
"2011","Swale 017D","E01024558",1213,152,40,112,310,153,189,75,117,118,18,13,5,81
"2011","Thanet 001A","E01024657",1572,42,12,30,150,84,151,103,288,346,310,190,120,98
"2011","Thanet 001B","E01024658",1417,49,11,38,172,133,146,114,260,273,177,110,67,93
"2011","Thanet 001C","E01024659",1036,42,7,35,173,87,134,89,188,134,115,72,43,74
"2011","Thanet 001D","E01024660",1212,30,8,22,138,79,137,85,222,235,194,124,70,92
"2011","Thanet 001E","E01024678",1441,57,15,42,186,104,128,109,300,263,236,148,88,58
"2011","Thanet 002A","E01024653",1072,88,20,68,219,171,140,79,154,107,37,24,13,77
"2011","Thanet 002B","E01024654",1001,81,24,57,206,171,127,65,152,105,39,30,9,55
"2011","Thanet 002C","E01024655",1015,78,17,61,217,165,168,71,146,71,35,26,9,64
"2011","Thanet 002D","E01024656",1183,95,26,69,289,152,174,75,174,82,69,41,28,73
"2011","Thanet 002E","E01024675",1548,187,51,136,433,200,247,68,170,82,41,25,16,120
"2011","Thanet 003A","E01024676",1242,30,10,20,154,84,122,81,253,221,215,150,65,82
"2011","Thanet 003B","E01024677",1195,38,10,28,184,133,104,86,233,180,107,55,52,130
"2011","Thanet 003C","E01024695",879,37,7,30,135,123,88,96,163,118,52,35,17,67
"2011","Thanet 003D","E01024697",846,31,7,24,124,87,91,75,176,106,83,51,32,73
"2011","Thanet 003E","E01024710",904,44,10,34,155,83,126,57,146,119,113,53,60,61
"2011","Thanet 004A","E01024661",1069,49,10,39,169,110,101,88,213,151,105,65,40,83
"2011","Thanet 004B","E01024664",1029,50,15,35,189,121,91,83,213,136,78,45,33,68
"2011","Thanet 004C","E01024665",1038,60,28,32,224,154,105,87,171,120,57,35,22,60
"2011","Thanet 004D","E01024694",1247,136,9,127,213,144,123,112,204,147,62,38,24,106
"2011","Thanet 004E","E01024696",962,50,12,38,177,130,122,83,180,120,44,29,15,56
"2011","Thanet 005A","E01024672",1008,42,9,33,120,113,114,85,201,155,105,78,27,73
"2011","Thanet 005B","E01024673",1254,67,16,51,228,169,182,99,227,139,62,35,27,81
"2011","Thanet 005C","E01024674",1173,81,34,47,258,169,173,97,144,116,42,30,12,93
"2011","Thanet 005D","E01024711",1048,87,21,66,246,145,169,60,136,61,51,35,16,93
"2011","Thanet 005E","E01024712",1125,96,22,74,249,152,155,77,176,100,46,29,17,74
"2011","Thanet 006A","E01024633",1067,43,12,31,168,121,110,81,219,163,77,54,23,85
"2011","Thanet 006B","E01024634",968,40,13,27,171,110,89,59,193,144,72,38,34,90
"2011","Thanet 006C","E01024662",1082,66,21,45,159,139,132,90,203,158,73,49,24,62
"2011","Thanet 006D","E01024663",1035,22,8,14,97,87,90,101,230,174,145,97,48,89
"2011","Thanet 006E","E01024666",1112,33,15,18,122,112,112,102,222,194,142,82,60,73
"2011","Thanet 007A","E01024641",1027,47,18,29,168,156,109,73,209,142,60,31,29,63
"2011","Thanet 007B","E01024713",1155,67,18,49,194,118,135,100,242,170,59,41,18,70
"2011","Thanet 007C","E01024714",1012,100,30,70,201,129,147,52,152,90,83,68,15,58
"2011","Thanet 007D","E01024715",1336,92,21,71,278,165,176,95,247,114,97,53,44,72
"2011","Thanet 007E","E01024716",1423,98,35,63,283,202,158,109,252,152,60,36,24,109
"2011","Thanet 008A","E01024636",1383,145,29,116,342,215,188,92,210,103,39,25,14,49
"2011","Thanet 008B","E01024637",1138,141,40,101,285,191,173,55,114,64,50,37,13,65
"2011","Thanet 008C","E01024638",1064,89,23,66,237,152,154,71,177,92,41,27,14,51
"2011","Thanet 008D","E01024639",1140,89,23,66,240,171,129,95,183,114,58,37,21,61
"2011","Thanet 008E","E01024640",1083,65,20,45,197,163,155,90,202,107,54,37,17,50
"2011","Thanet 009A","E01024635",1144,125,33,92,261,165,152,82,152,90,35,23,12,82
"2011","Thanet 009B","E01024642",994,126,34,92,268,124,131,56,119,56,55,42,13,59
"2011","Thanet 009C","E01024644",902,106,34,72,236,160,109,57,115,59,15,11,4,45
"2011","Thanet 009D","E01024692",1121,66,20,46,277,179,121,71,181,94,50,25,25,82
"2011","Thanet 009E","E01024693",956,118,23,95,231,147,130,49,129,57,34,13,21,61
"2011","Thanet 010A","E01024643",924,78,15,63,233,104,135,39,131,94,47,18,29,63
"2011","Thanet 010B","E01024705",924,91,23,68,205,98,144,59,124,73,55,37,18,75
"2011","Thanet 010C","E01024706",1026,109,20,89,255,148,129,64,130,83,28,13,15,80
"2011","Thanet 010D","E01024707",943,101,21,80,291,123,119,46,118,46,38,27,11,61
"2011","Thanet 010E","E01024708",1092,143,35,108,301,173,118,44,111,58,51,37,14,93
"2011","Thanet 011A","E01024686",1177,47,21,26,192,148,125,116,237,174,57,40,17,81
"2011","Thanet 011B","E01024688",1122,40,10,30,157,132,143,122,234,159,70,53,17,65
"2011","Thanet 011C","E01024689",878,75,17,58,179,137,91,73,154,68,27,21,6,74
"2011","Thanet 011D","E01024690",1004,76,19,57,191,145,112,75,176,113,34,19,15,82
"2011","Thanet 011E","E01024691",956,58,22,36,162,135,85,74,148,106,30,22,8,158
"2011","Thanet 012A","E01024669",1215,60,11,49,200,194,126,94,229,138,73,37,36,101
"2011","Thanet 012B","E01024698",1047,66,11,55,232,136,122,93,168,104,54,30,24,72
"2011","Thanet 012C","E01024699",1258,30,5,25,171,121,122,126,294,189,103,61,42,102
"2011","Thanet 012D","E01024700",1258,72,21,51,278,201,129,123,198,121,40,19,21,96
"2011","Thanet 012E","E01024709",971,98,23,75,228,143,134,55,137,94,32,24,8,50
"2011","Thanet 013A","E01024682",1178,31,9,22,156,110,65,86,271,225,147,106,41,87
"2011","Thanet 013B","E01024683",1149,21,9,12,133,93,74,78,264,246,137,93,44,103
"2011","Thanet 013C","E01024684",1125,27,8,19,164,150,97,120,240,180,71,41,30,76
"2011","Thanet 013D","E01024685",1289,49,16,33,200,131,132,113,268,204,100,69,31,92
"2011","Thanet 013E","E01024687",1031,30,9,21,114,84,93,91,232,200,106,73,33,81
"2011","Thanet 014A","E01024701",1546,137,45,92,347,195,259,112,213,165,37,19,18,81
"2011","Thanet 014B","E01024702",892,61,17,44,176,114,121,73,170,105,25,11,14,47
"2011","Thanet 014C","E01024703",1258,122,32,90,335,160,202,91,134,103,36,17,19,75
"2011","Thanet 014D","E01024704",1189,105,25,80,273,180,162,78,177,123,21,13,8,70
"2011","Thanet 015A","E01024645",1079,72,15,57,177,131,117,78,220,133,60,31,29,91
"2011","Thanet 015B","E01024647",1166,87,17,70,237,132,136,88,188,119,81,55,26,98
"2011","Thanet 015C","E01024668",919,33,11,22,153,92,77,76,146,129,55,34,21,158
"2011","Thanet 015D","E01024670",1087,42,11,31,191,122,114,90,176,160,99,55,44,93
"2011","Thanet 015E","E01024681",1243,66,15,51,243,171,121,93,232,156,69,47,22,92
"2011","Thanet 016A","E01024646",1372,102,24,78,277,150,159,92,229,168,100,69,31,95
"2011","Thanet 016B","E01024648",1081,74,14,60,213,111,116,93,189,137,81,40,41,67
"2011","Thanet 016C","E01024649",1313,102,10,92,292,156,147,76,195,146,107,59,48,92
"2011","Thanet 016D","E01024667",1327,61,13,48,193,92,150,121,240,246,159,94,65,65
"2011","Thanet 016E","E01024671",1236,89,17,72,211,124,147,108,206,160,94,49,45,97
"2011","Thanet 017A","E01024650",1095,91,21,70,262,149,153,83,147,101,39,27,12,70
"2011","Thanet 017B","E01024651",1046,92,22,70,253,141,113,66,157,100,61,41,20,63
"2011","Thanet 017C","E01024652",1350,129,34,95,358,164,171,105,194,117,33,20,13,79
"2011","Thanet 017D","E01024679",894,40,14,26,170,144,81,87,176,119,25,19,6,52
"2011","Thanet 017E","E01024680",1134,85,25,60,232,158,134,100,208,123,23,13,10,71
"2011","Tonbridge and Malling 001A","E01024719",1497,192,56,136,342,243,176,98,157,150,47,26,21,92
"2011","Tonbridge and Malling 001B","E01024720",1026,123,38,85,275,182,109,66,128,63,23,13,10,57
"2011","Tonbridge and Malling 001C","E01024721",967,138,28,110,249,166,129,64,78,62,13,7,6,68
"2011","Tonbridge and Malling 001D","E01024722",1040,124,24,100,269,185,97,69,117,78,23,8,15,78
"2011","Tonbridge and Malling 001E","E01024727",2026,204,57,147,521,298,233,141,243,190,86,64,22,110
"2011","Tonbridge and Malling 001F","E01024728",1212,124,28,96,252,197,131,124,150,143,33,20,13,58
"2011","Tonbridge and Malling 002C","E01024771",1344,70,13,57,234,202,116,124,218,228,78,51,27,74
"2011","Tonbridge and Malling 002D","E01024772",1250,92,29,63,267,200,132,103,195,164,38,25,13,59
"2011","Tonbridge and Malling 002E","E01024773",1304,98,24,74,260,220,139,125,195,184,23,13,10,60
"2011","Tonbridge and Malling 002F","E01024774",1846,138,32,106,377,292,191,187,260,242,68,38,30,91
"2011","Tonbridge and Malling 002G","E01032830",1769,70,20,50,260,235,154,162,327,350,97,72,25,114
"2011","Tonbridge and Malling 003A","E01024741",1045,61,16,45,144,114,63,93,218,208,75,56,19,69
"2011","Tonbridge and Malling 003B","E01024761",1624,199,57,142,421,268,168,98,184,151,31,21,10,104
"2011","Tonbridge and Malling 003C","E01024762",1586,154,35,119,363,276,136,140,241,161,33,19,14,82
"2011","Tonbridge and Malling 003D","E01024763",1029,69,20,49,200,175,88,87,187,137,24,18,6,62
"2011","Tonbridge and Malling 003E","E01024764",929,75,21,54,166,159,91,88,153,122,21,12,9,54
"2011","Tonbridge and Malling 003F","E01024765",1066,92,28,64,227,204,101,92,148,117,19,12,7,66
"2011","Tonbridge and Malling 003G","E01024782",977,134,47,87,243,202,86,58,100,58,17,11,6,79
"2011","Tonbridge and Malling 003H","E01024785",1075,112,31,81,278,207,105,71,114,117,15,5,10,56
"2011","Tonbridge and Malling 005A","E01024717",1080,78,19,59,194,126,108,73,203,170,51,32,19,77
"2011","Tonbridge and Malling 005B","E01024718",1018,120,31,89,230,201,100,82,119,92,10,4,6,64
"2011","Tonbridge and Malling 005C","E01024735",1144,103,32,71,268,197,100,95,183,115,22,13,9,61
"2011","Tonbridge and Malling 005D","E01024736",1212,102,29,73,276,194,125,98,183,134,49,31,18,51
"2011","Tonbridge and Malling 005E","E01024737",1674,148,30,118,382,265,149,144,247,198,63,32,31,78
"2011","Tonbridge and Malling 006A","E01024723",1117,247,41,206,315,126,157,45,95,51,24,19,5,57
"2011","Tonbridge and Malling 006B","E01024724",1353,249,57,192,392,190,181,37,109,68,33,21,12,94
"2011","Tonbridge and Malling 006C","E01024725",1133,147,33,114,297,201,144,67,115,63,26,12,14,73
"2011","Tonbridge and Malling 006D","E01024726",1219,129,29,100,260,183,149,91,162,134,33,20,13,78
"2011","Tonbridge and Malling 006E","E01024755",1444,334,99,235,433,196,165,41,109,41,31,22,9,94
"2011","Tonbridge and Malling 006F","E01024786",1285,137,29,108,303,187,194,81,138,130,47,36,11,68
"2011","Tonbridge and Malling 007A","E01024746",801,154,49,105,198,97,117,36,79,53,19,10,9,48
"2011","Tonbridge and Malling 007C","E01024760",1081,195,61,134,289,182,106,42,82,83,28,16,12,74
"2011","Tonbridge and Malling 007D","E01024781",1485,236,71,165,408,244,184,70,135,88,34,23,11,86
"2011","Tonbridge and Malling 007E","E01032825",1049,155,46,109,301,151,85,64,109,85,31,19,12,68
"2011","Tonbridge and Malling 007F","E01032826",1078,266,75,191,343,161,109,47,53,39,12,9,3,48
"2011","Tonbridge and Malling 007G","E01032827",1121,248,60,188,366,164,112,37,67,49,20,12,8,58
"2011","Tonbridge and Malling 007H","E01032828",847,197,50,147,261,127,83,36,50,29,12,10,2,52
"2011","Tonbridge and Malling 008A","E01024743",1318,105,18,87,274,195,149,126,211,138,45,23,22,75
"2011","Tonbridge and Malling 008B","E01024744",1531,188,53,135,364,220,225,84,192,116,32,20,12,110
"2011","Tonbridge and Malling 008C","E01024745",1367,220,53,167,359,183,165,50,105,79,18,13,5,188
"2011","Tonbridge and Malling 008D","E01024747",1097,80,24,56,207,115,110,99,213,159,42,27,15,72
"2011","Tonbridge and Malling 009A","E01024730",868,86,23,63,183,141,85,76,137,77,23,15,8,60
"2011","Tonbridge and Malling 009B","E01024731",849,123,31,92,200,153,67,50,115,55,31,25,6,55
"2011","Tonbridge and Malling 009C","E01024775",1082,46,12,34,149,124,100,105,234,179,87,52,35,58
"2011","Tonbridge and Malling 009D","E01024776",900,52,18,34,137,113,87,73,175,155,39,25,14,69
"2011","Tonbridge and Malling 009E","E01024777",890,63,13,50,172,135,67,74,154,129,37,25,12,59
"2011","Tonbridge and Malling 010A","E01024734",1118,133,39,94,293,200,113,79,134,83,19,13,6,64
"2011","Tonbridge and Malling 010B","E01024752",1114,183,37,146,303,189,139,57,98,54,14,8,6,77
"2011","Tonbridge and Malling 010C","E01024753",1127,200,34,166,289,171,108,62,112,70,33,22,11,82
"2011","Tonbridge and Malling 010D","E01024754",1210,205,55,150,355,160,171,55,85,61,35,27,8,83
"2011","Tonbridge and Malling 011A","E01024729",1196,164,38,126,256,175,114,72,168,103,54,35,19,90
"2011","Tonbridge and Malling 011B","E01024748",1028,177,37,140,268,208,110,46,89,43,17,10,7,70
"2011","Tonbridge and Malling 011C","E01024749",993,66,19,47,177,152,93,83,190,132,41,22,19,59
"2011","Tonbridge and Malling 011D","E01024750",1008,112,22,90,214,172,114,64,150,99,29,18,11,54
"2011","Tonbridge and Malling 011E","E01024751",1010,140,35,105,285,173,110,50,125,50,17,11,6,60
"2011","Tonbridge and Malling 012A","E01024732",1359,174,34,140,346,133,92,69,119,97,31,18,13,298
"2011","Tonbridge and Malling 012B","E01024733",1223,201,47,154,367,179,111,53,117,84,21,14,7,90
"2011","Tonbridge and Malling 012C","E01024756",1168,114,38,76,240,166,101,100,180,149,35,22,13,83
"2011","Tonbridge and Malling 012D","E01024766",1526,181,40,141,380,231,147,99,214,145,37,16,21,92
"2011","Tonbridge and Malling 012E","E01024767",1075,78,18,60,204,133,91,84,183,162,50,31,19,90
"2011","Tonbridge and Malling 012F","E01024768",1187,211,44,167,367,148,117,51,119,60,34,19,15,80
"2011","Tonbridge and Malling 013A","E01024757",1174,162,34,128,319,148,110,75,164,92,31,21,10,73
"2011","Tonbridge and Malling 013B","E01024758",1164,155,34,121,284,185,107,77,150,100,28,15,13,78
"2011","Tonbridge and Malling 013C","E01024778",1174,201,42,159,328,178,79,66,151,73,21,12,9,77
"2011","Tonbridge and Malling 013D","E01024779",1367,208,48,160,310,202,122,91,158,119,59,42,17,98
"2011","Tonbridge and Malling 013E","E01024780",1156,151,42,109,267,181,100,65,162,104,40,27,13,86
"2011","Tonbridge and Malling 014A","E01024740",1351,209,57,152,365,194,152,85,117,103,44,31,13,82
"2011","Tonbridge and Malling 014B","E01024742",1193,112,33,79,212,154,96,111,215,161,69,41,28,63
"2011","Tonbridge and Malling 014C","E01024783",1184,166,45,121,288,133,153,89,134,99,54,37,17,68
"2011","Tonbridge and Malling 014D","E01024784",988,132,37,95,302,131,132,55,77,66,29,20,9,64
"2011","Tonbridge and Malling 014E","E01032620",1688,237,69,168,481,215,293,83,150,98,39,30,9,92
"2011","Tonbridge and Malling 014F","E01032829",999,151,45,106,249,137,154,59,98,82,20,14,6,49
"2011","Tunbridge Wells 001A","E01024798",1775,179,51,128,449,259,246,141,202,161,43,28,15,95
"2011","Tunbridge Wells 001B","E01024811",914,111,34,77,228,153,78,68,104,79,17,10,7,76
"2011","Tunbridge Wells 001C","E01024812",911,113,32,81,195,138,107,79,114,62,39,26,13,64
"2011","Tunbridge Wells 001D","E01024813",1235,125,20,105,273,170,108,116,211,142,32,18,14,58
"2011","Tunbridge Wells 001E","E01024814",956,79,13,66,207,166,91,79,143,99,23,8,15,69
"2011","Tunbridge Wells 001F","E01024815",980,67,10,57,186,147,101,92,170,124,40,26,14,53
"2011","Tunbridge Wells 001G","E01024816",974,146,32,114,232,168,74,63,125,75,21,10,11,70
"2011","Tunbridge Wells 002A","E01024837",1330,184,44,140,381,187,136,60,145,78,30,15,15,129
"2011","Tunbridge Wells 002B","E01024844",1203,110,27,83,309,167,132,68,180,118,48,33,15,71
"2011","Tunbridge Wells 002C","E01024846",1176,94,29,65,265,173,118,106,195,123,18,11,7,84
"2011","Tunbridge Wells 002D","E01024849",1189,178,33,145,312,149,137,67,144,81,26,14,12,95
"2011","Tunbridge Wells 002E","E01024850",935,199,47,152,290,148,93,32,59,18,18,13,5,78
"2011","Tunbridge Wells 003A","E01024836",1263,121,21,100,283,178,121,94,203,144,41,21,20,78
"2011","Tunbridge Wells 003B","E01024839",1276,154,28,126,313,203,132,91,181,119,26,20,6,57
"2011","Tunbridge Wells 003C","E01024845",926,114,29,85,261,113,81,47,126,69,35,21,14,80
"2011","Tunbridge Wells 003D","E01024847",1191,109,19,90,271,181,134,81,172,148,42,21,21,53
"2011","Tunbridge Wells 003E","E01024848",849,109,36,73,247,105,88,34,101,67,35,26,9,63
"2011","Tunbridge Wells 004A","E01024793",1246,196,55,141,325,159,194,58,121,83,26,15,11,84
"2011","Tunbridge Wells 004B","E01024825",1045,152,43,109,290,160,118,44,104,48,21,12,9,108
"2011","Tunbridge Wells 004C","E01024826",1075,156,46,110,302,160,130,51,122,69,23,15,8,62
"2011","Tunbridge Wells 004D","E01024827",1124,121,28,93,280,187,134,60,130,100,45,37,8,67
"2011","Tunbridge Wells 004E","E01024828",1089,126,32,94,271,148,139,65,163,93,30,16,14,54
"2011","Tunbridge Wells 005A","E01024840",1351,66,19,47,204,141,108,116,271,214,136,80,56,95
"2011","Tunbridge Wells 005B","E01024841",1364,76,22,54,220,168,116,113,309,201,74,38,36,87
"2011","Tunbridge Wells 005C","E01024842",1145,107,26,81,220,144,105,84,218,148,51,37,14,68
"2011","Tunbridge Wells 005D","E01024843",1070,82,16,66,207,130,107,89,179,132,68,38,30,76
"2011","Tunbridge Wells 006A","E01024829",1187,139,25,114,299,185,145,75,164,82,26,13,13,72
"2011","Tunbridge Wells 006B","E01024851",1168,235,75,160,354,150,136,48,97,52,20,17,3,76
"2011","Tunbridge Wells 006C","E01024852",922,196,45,151,316,144,87,20,55,20,9,5,4,75
"2011","Tunbridge Wells 006D","E01024853",947,200,49,151,281,126,96,21,88,34,18,15,3,83
"2011","Tunbridge Wells 006E","E01024854",1123,240,55,185,318,128,138,41,90,51,24,13,11,93
"2011","Tunbridge Wells 007A","E01024799",1438,284,62,222,453,198,135,64,111,78,39,22,17,76
"2011","Tunbridge Wells 007B","E01024800",1155,265,47,218,371,159,120,35,60,30,14,6,8,101
"2011","Tunbridge Wells 007C","E01024835",1556,242,36,206,510,193,135,76,148,104,30,12,18,118
"2011","Tunbridge Wells 007D","E01024838",1233,237,48,189,398,148,102,48,118,67,21,10,11,94
"2011","Tunbridge Wells 008A","E01024801",2157,344,57,287,632,274,206,139,223,170,66,43,23,103
"2011","Tunbridge Wells 008B","E01024802",1678,269,33,236,449,219,163,116,200,138,28,15,13,96
"2011","Tunbridge Wells 008C","E01024823",1390,248,56,192,433,181,141,71,135,64,33,17,16,84
"2011","Tunbridge Wells 008D","E01024833",1846,226,38,188,453,236,153,133,259,217,78,51,27,91
"2011","Tunbridge Wells 009A","E01024821",1353,256,51,205,440,180,142,54,135,83,23,16,7,40
"2011","Tunbridge Wells 009B","E01024822",1352,219,48,171,368,190,139,39,137,57,91,79,12,112
"2011","Tunbridge Wells 009C","E01024824",1075,145,41,104,343,180,121,45,90,62,19,15,4,70
"2011","Tunbridge Wells 009D","E01024832",1187,188,34,154,369,167,104,71,118,81,22,14,8,67
"2011","Tunbridge Wells 009E","E01024834",1666,250,53,197,502,242,164,87,216,96,44,30,14,65
"2011","Tunbridge Wells 010A","E01024795",1010,55,11,44,156,101,108,89,218,136,64,43,21,83
"2011","Tunbridge Wells 010B","E01024796",1019,142,30,112,231,129,118,55,148,81,49,33,16,66
"2011","Tunbridge Wells 010C","E01024830",1298,96,14,82,275,143,134,114,210,165,49,29,20,112
"2011","Tunbridge Wells 010D","E01024831",1039,92,27,65,210,128,134,75,153,125,55,34,21,67
"2011","Tunbridge Wells 011A","E01024792",1363,280,89,191,386,144,222,53,109,53,26,21,5,90
"2011","Tunbridge Wells 011B","E01024794",1172,158,46,112,306,152,175,51,132,100,28,19,9,70
"2011","Tunbridge Wells 011C","E01024804",1050,191,51,140,293,112,143,56,77,63,23,18,5,92
"2011","Tunbridge Wells 011D","E01024805",1196,207,50,157,336,123,187,61,103,76,27,12,15,76
"2011","Tunbridge Wells 011E","E01024806",1305,147,45,102,291,108,208,69,143,145,51,33,18,143
"2011","Tunbridge Wells 012A","E01024797",1232,216,46,170,383,171,138,56,128,53,20,11,9,67
"2011","Tunbridge Wells 012B","E01024817",1266,282,69,213,454,172,105,29,89,43,19,6,13,73
"2011","Tunbridge Wells 012C","E01024818",1199,249,56,193,353,159,152,43,108,48,18,14,4,69
"2011","Tunbridge Wells 012D","E01024819",1342,284,42,242,455,155,152,60,81,65,17,3,14,73
"2011","Tunbridge Wells 012E","E01024820",1150,253,48,205,410,144,115,36,70,29,14,8,6,79
"2011","Tunbridge Wells 013A","E01024787",897,129,35,94,238,92,160,54,92,52,17,14,3,63
"2011","Tunbridge Wells 013B","E01024788",1040,82,22,60,197,97,128,88,178,156,41,24,17,73
"2011","Tunbridge Wells 013C","E01024790",833,61,15,46,177,72,104,39,110,87,23,17,6,160
"2011","Tunbridge Wells 013D","E01024791",925,118,28,90,256,109,123,37,110,60,34,24,10,78
"2011","Tunbridge Wells 013E","E01024803",1581,234,75,159,441,177,263,68,159,100,36,26,10,103
"2011","Tunbridge Wells 014A","E01024789",1583,199,46,153,387,147,257,59,115,93,41,31,10,285
"2011","Tunbridge Wells 014B","E01024807",1080,95,20,75,230,103,160,93,158,142,39,24,15,60
"2011","Tunbridge Wells 014C","E01024808",1157,134,30,104,300,160,175,84,121,95,26,14,12,62
"2011","Tunbridge Wells 014D","E01024809",1075,132,32,100,251,128,224,50,113,83,21,11,10,73
"2011","Tunbridge Wells 014E","E01024810",1215,149,41,108,323,149,196,48,133,71,50,40,10,96
"2011","Cherwell 001A","E01028479",950,185,42,143,253,131,142,50,83,62,11,7,4,33
"2011","Cherwell 001B","E01028480",1047,169,45,124,274,135,173,55,104,86,11,7,4,40
"2011","Cherwell 001C","E01028508",798,139,43,96,233,96,121,33,61,55,16,7,9,44
"2011","Cherwell 001D","E01028509",1124,196,50,146,314,137,178,53,109,67,14,8,6,56
"2011","Cherwell 002A","E01028441",1771,170,30,140,340,240,125,147,339,254,59,36,23,97
"2011","Cherwell 002C","E01028443",1100,81,22,59,223,167,79,101,219,144,30,24,6,56
"2011","Cherwell 002D","E01028444",1170,76,17,59,184,207,88,108,239,163,30,18,12,75
"2011","Cherwell 002E","E01032943",1149,166,37,129,325,153,93,84,161,86,25,14,11,56
"2011","Cherwell 002F","E01032944",1053,90,18,72,207,159,77,102,205,147,19,9,10,47
"2011","Cherwell 003A","E01028445",1023,39,11,28,127,94,72,98,261,189,69,51,18,74
"2011","Cherwell 003B","E01028446",1097,65,21,44,165,148,90,99,223,190,58,45,13,59
"2011","Cherwell 003C","E01028447",942,46,9,37,162,111,67,96,196,151,52,37,15,61
"2011","Cherwell 003D","E01028448",1055,59,18,41,166,119,72,72,229,203,68,51,17,67
"2011","Cherwell 004A","E01028435",1228,88,18,70,232,122,91,95,246,203,86,60,26,65
"2011","Cherwell 004C","E01028437",1144,82,24,58,185,146,110,104,202,197,56,35,21,62
"2011","Cherwell 004D","E01028438",1283,140,36,104,244,149,104,115,219,191,51,31,20,70
"2011","Cherwell 004E","E01028439",1067,124,37,87,244,156,73,92,174,114,29,19,10,61
"2011","Cherwell 004F","E01028440",1237,93,13,80,242,144,91,102,256,191,58,36,22,60
"2011","Cherwell 004G","E01032941",997,44,11,33,140,88,72,106,212,193,61,50,11,81
"2011","Cherwell 004H","E01032942",1108,120,18,102,236,159,53,94,178,153,63,44,19,52
"2011","Cherwell 005A","E01028449",924,25,9,16,108,95,56,89,229,211,57,42,15,54
"2011","Cherwell 005B","E01028450",1022,23,8,15,110,86,72,82,262,217,91,54,37,79
"2011","Cherwell 005C","E01028451",946,59,14,45,128,119,84,86,219,161,39,31,8,51
"2011","Cherwell 005D","E01028452",956,50,12,38,126,89,89,88,211,166,60,42,18,77
"2011","Cherwell 005E","E01028453",949,34,8,26,109,97,54,94,232,200,57,31,26,72
"2011","Cherwell 005F","E01028454",1055,33,11,22,99,89,73,92,245,252,87,65,22,85
"2011","Cherwell 006A","E01028430",1140,124,19,105,290,126,102,72,185,123,49,41,8,69
"2011","Cherwell 006B","E01028431",1088,115,19,96,226,151,125,82,176,121,23,19,4,69
"2011","Cherwell 006C","E01028432",1127,112,26,86,243,162,117,92,194,113,27,18,9,67
"2011","Cherwell 006D","E01028433",1181,91,30,61,233,192,121,98,220,129,29,14,15,68
"2011","Cherwell 006E","E01028434",1064,116,26,90,245,148,104,65,133,85,17,9,8,151
"2011","Cherwell 007A","E01028426",1024,76,23,53,190,191,94,94,158,126,18,8,10,77
"2011","Cherwell 007B","E01028427",1166,120,19,101,270,155,67,81,216,156,27,16,11,74
"2011","Cherwell 007C","E01028428",1089,73,14,59,241,195,99,91,178,127,25,12,13,60
"2011","Cherwell 007D","E01028429",735,74,24,50,176,120,54,53,119,80,17,13,4,42
"2011","Cherwell 008A","E01028422",1108,175,42,133,293,145,140,75,124,86,17,7,10,53
"2011","Cherwell 008B","E01028423",1021,146,43,103,340,137,140,50,81,65,18,11,7,44
"2011","Cherwell 008C","E01028475",1562,178,59,119,385,230,192,117,197,117,31,17,14,115
"2011","Cherwell 008D","E01028476",1723,287,71,216,489,235,184,78,131,82,15,9,6,222
"2011","Cherwell 009A","E01028474",1154,135,27,108,269,147,171,82,147,127,25,14,11,51
"2011","Cherwell 009B","E01028485",915,138,32,106,251,110,125,55,99,64,14,11,3,59
"2011","Cherwell 009C","E01028486",955,183,44,139,269,89,194,32,72,55,13,9,4,48
"2011","Cherwell 009D","E01028503",859,140,35,105,228,112,136,41,92,64,12,7,5,34
"2011","Cherwell 009E","E01028504",1114,207,50,157,304,131,162,41,75,56,23,11,12,115
"2011","Cherwell 010A","E01028481",986,168,40,128,288,106,119,49,98,85,24,16,8,49
"2011","Cherwell 010B","E01028482",872,163,37,126,276,122,118,42,58,40,2,2,0,51
"2011","Cherwell 010C","E01028505",1314,144,31,113,288,143,145,105,197,172,24,14,10,96
"2011","Cherwell 010D","E01028506",1303,254,63,191,360,132,197,56,122,96,24,22,2,62
"2011","Cherwell 010E","E01028507",1062,217,48,169,303,129,150,42,95,48,18,14,4,60
"2011","Cherwell 011A","E01028425",1630,167,89,78,489,406,90,103,177,109,30,20,10,59
"2011","Cherwell 011B","E01028477",1100,150,42,108,313,145,140,75,117,81,26,16,10,53
"2011","Cherwell 011C","E01028478",961,121,48,73,274,152,58,64,114,77,36,25,11,65
"2011","Cherwell 011D","E01028483",925,172,44,128,269,85,164,47,70,58,14,12,2,46
"2011","Cherwell 011E","E01028484",822,134,31,103,218,95,130,51,78,57,16,9,7,43
"2011","Cherwell 011F","E01028499",1143,160,55,105,296,156,153,81,128,98,17,11,6,54
"2011","Cherwell 012A","E01028459",1139,124,35,89,305,196,84,104,152,110,16,11,5,48
"2011","Cherwell 012B","E01028460",1454,266,81,185,453,223,118,73,142,76,22,11,11,81
"2011","Cherwell 012C","E01028461",1321,179,35,144,360,215,79,87,174,129,21,11,10,77
"2011","Cherwell 012D","E01028462",1181,149,38,111,315,195,71,83,143,127,29,15,14,69
"2011","Cherwell 013A","E01028455",1105,113,32,81,239,185,84,94,175,131,17,9,8,67
"2011","Cherwell 013B","E01028456",1060,90,30,60,220,129,77,103,179,177,30,22,8,55
"2011","Cherwell 013C","E01028457",1078,89,24,65,233,185,82,101,170,120,21,13,8,77
"2011","Cherwell 013D","E01028458",1151,82,24,58,221,140,64,120,215,216,27,15,12,66
"2011","Cherwell 013E","E01028467",1168,94,20,74,278,171,98,111,194,151,18,11,7,53
"2011","Cherwell 014A","E01028466",1199,65,11,54,198,146,75,138,247,213,55,31,24,62
"2011","Cherwell 014B","E01028469",1116,112,36,76,248,193,93,99,173,114,19,9,10,65
"2011","Cherwell 014C","E01028470",1263,107,26,81,268,192,108,138,175,184,40,26,14,51
"2011","Cherwell 014D","E01028471",959,63,10,53,162,118,40,108,216,161,33,15,18,58
"2011","Cherwell 014E","E01028472",984,73,20,53,212,159,79,83,173,142,18,13,5,45
"2011","Cherwell 014F","E01028473",1185,105,34,71,296,198,82,115,161,129,24,13,11,75
"2011","Cherwell 015A","E01028463",1824,290,69,221,534,259,109,171,197,156,25,12,13,83
"2011","Cherwell 015B","E01028464",1058,158,40,118,323,157,69,85,109,104,13,6,7,40
"2011","Cherwell 015C","E01028465",1019,167,49,118,305,168,76,69,101,62,14,9,5,57
"2011","Cherwell 015D","E01028468",1267,165,38,127,293,136,113,130,196,135,51,35,16,48
"2011","Cherwell 016A","E01028424",1144,227,64,163,335,138,137,59,113,66,15,10,5,54
"2011","Cherwell 016B","E01028497",1003,201,42,159,274,117,132,56,77,77,12,8,4,57
"2011","Cherwell 016C","E01028498",1180,151,39,112,273,135,138,86,152,135,33,16,17,77
"2011","Cherwell 016D","E01028500",1796,110,33,77,288,150,280,161,227,324,204,179,25,52
"2011","Cherwell 016E","E01028501",914,226,45,181,242,112,118,29,67,43,23,18,5,54
"2011","Cherwell 016F","E01028502",875,208,36,172,229,99,128,38,66,48,14,10,4,45
"2011","Cherwell 017A","E01028487",967,125,20,105,218,165,68,73,139,87,32,21,11,60
"2011","Cherwell 017B","E01028489",1013,182,44,138,314,154,80,57,99,51,14,9,5,62
"2011","Cherwell 017C","E01028490",862,88,15,73,179,132,72,68,140,107,35,23,12,41
"2011","Cherwell 017D","E01028491",1072,142,27,115,286,149,88,70,148,93,19,17,2,77
"2011","Cherwell 017E","E01028494",846,77,10,67,137,108,64,89,145,137,38,26,12,51
"2011","Cherwell 018A","E01028492",1077,122,27,95,248,172,103,99,134,98,26,16,10,75
"2011","Cherwell 018B","E01028493",988,84,21,63,179,141,81,89,176,142,31,17,14,65
"2011","Cherwell 018C","E01028495",972,126,16,110,210,159,68,89,132,96,24,20,4,68
"2011","Cherwell 018D","E01028496",990,92,22,70,203,117,83,98,166,130,36,27,9,65
"2011","Cherwell 019A","E01028488",1286,149,16,133,259,170,70,126,149,141,104,89,15,118
"2011","Cherwell 019B","E01028510",1156,194,42,152,268,171,120,81,138,89,27,23,4,68
"2011","Cherwell 019C","E01028511",1152,159,34,125,251,188,99,96,160,97,23,12,11,79
"2011","Cherwell 019D","E01028512",1107,126,24,102,259,200,100,82,139,116,23,10,13,62
"2011","Oxford 001A","E01028594",1133,313,46,267,327,98,108,33,79,47,21,9,12,107
"2011","Oxford 001B","E01028595",1017,208,35,173,280,101,96,54,106,89,23,14,9,60
"2011","Oxford 001C","E01028596",1057,362,40,322,287,100,71,28,62,41,17,8,9,89
"2011","Oxford 001D","E01028597",1029,212,26,186,241,85,88,61,109,91,38,24,14,104
"2011","Oxford 002C","E01028591",907,316,26,290,299,71,49,14,26,13,14,9,5,105
"2011","Oxford 002D","E01028592",1061,252,19,233,309,57,48,14,32,10,17,14,3,322
"2011","Oxford 002F","E01032554",1481,516,65,451,451,110,90,25,64,31,40,28,12,154
"2011","Oxford 002G","E01032555",1558,268,30,238,321,131,88,78,151,138,88,59,29,295
"2011","Oxford 003A","E01028565",970,377,33,344,263,66,70,15,17,22,19,12,7,121
"2011","Oxford 003B","E01028583",1119,259,20,239,178,46,39,9,29,20,25,23,2,514
"2011","Oxford 003C","E01028584",1908,705,79,626,499,140,113,36,75,63,62,49,13,215
"2011","Oxford 003D","E01028585",1229,250,31,219,172,42,41,15,32,19,12,7,5,646
"2011","Oxford 004A","E01028560",1079,205,14,191,239,109,72,72,146,113,40,28,12,83
"2011","Oxford 004B","E01028561",1129,213,20,193,271,138,82,77,132,79,36,26,10,101
"2011","Oxford 004C","E01028562",1169,181,15,166,258,122,65,63,144,122,44,28,16,170
"2011","Oxford 004D","E01028563",1131,289,21,268,276,111,66,47,83,53,29,22,7,177
"2011","Oxford 005A","E01028513",1575,144,17,127,287,166,78,91,273,241,107,64,43,188
"2011","Oxford 005B","E01028514",1009,53,7,46,148,96,74,86,187,201,69,50,19,95
"2011","Oxford 005C","E01028516",1272,180,16,164,272,137,81,81,181,133,72,46,26,135
"2011","Oxford 005D","E01028538",1031,97,14,83,193,138,57,79,169,150,43,26,17,105
"2011","Oxford 006A","E01028534",744,221,15,206,186,75,53,14,47,21,20,15,5,107
"2011","Oxford 006B","E01028535",1283,326,27,299,345,125,61,32,66,47,34,21,13,247
"2011","Oxford 006C","E01028536",1060,243,23,220,263,109,47,30,70,48,49,32,17,201
"2011","Oxford 006D","E01028537",1278,326,15,311,376,113,45,22,58,39,27,15,12,272
"2011","Oxford 006E","E01028539",1413,236,19,217,293,137,88,77,145,103,63,44,19,271
"2011","Oxford 006F","E01028540",2388,266,22,244,255,91,65,31,71,46,32,27,5,1531
"2011","Oxford 007A","E01028515",1265,226,30,196,307,151,104,68,155,88,57,40,17,109
"2011","Oxford 007B","E01028571",1210,299,35,264,277,117,78,65,115,70,40,26,14,149
"2011","Oxford 007C","E01028572",1230,217,40,177,314,169,81,82,133,115,21,14,7,98
"2011","Oxford 007D","E01028573",1248,298,42,256,359,117,77,55,79,56,35,20,15,172
"2011","Oxford 007E","E01028574",1002,148,13,135,236,106,68,65,108,102,49,35,14,120
"2011","Oxford 008A","E01028521",8148,446,19,427,265,75,63,74,102,46,55,34,21,7022
"2011","Oxford 008B","E01028522",3288,285,24,261,153,60,59,58,124,118,97,53,44,2334
"2011","Oxford 008E","E01033282",3786,697,65,632,497,157,120,46,98,62,64,40,24,2045
"2011","Oxford 009A","E01028548",1325,330,34,296,360,112,78,57,99,64,41,32,9,184
"2011","Oxford 009B","E01028549",1359,350,24,326,340,98,67,48,123,57,35,21,14,241
"2011","Oxford 009C","E01028550",1212,286,24,262,241,75,64,35,68,53,27,15,12,363
"2011","Oxford 009D","E01028551",1890,290,19,271,217,70,53,33,62,36,35,30,5,1094
"2011","Oxford 010A","E01028523",1171,194,14,180,289,103,47,43,105,77,55,41,14,258
"2011","Oxford 010B","E01028524",1054,81,5,76,174,103,56,80,197,156,94,57,37,113
"2011","Oxford 010C","E01028525",1423,101,14,87,205,131,73,74,193,184,94,64,30,368
"2011","Oxford 010D","E01028526",2121,150,14,136,170,79,46,43,116,84,47,27,20,1386
"2011","Oxford 011A","E01028579",1488,176,12,164,224,93,45,40,81,61,51,41,10,717
"2011","Oxford 011B","E01028580",1323,182,19,163,219,84,59,37,72,46,56,32,24,568
"2011","Oxford 011C","E01028581",1281,220,23,197,242,68,55,21,50,30,39,29,10,556
"2011","Oxford 011D","E01028582",1193,126,11,115,204,80,59,33,71,56,52,43,9,512
"2011","Oxford 011E","E01028586",1528,278,21,257,248,80,65,37,68,56,55,38,17,641
"2011","Oxford 011F","E01028587",1737,236,11,225,299,100,61,54,91,92,89,69,20,715
"2011","Oxford 011G","E01028588",1499,171,11,160,172,47,43,32,55,33,29,22,7,917
"2011","Oxford 012A","E01028541",1171,271,13,258,328,91,63,38,80,55,28,12,16,217
"2011","Oxford 012B","E01028542",1461,277,18,259,323,155,83,106,160,122,66,49,17,169
"2011","Oxford 012C","E01028543",1024,246,18,228,206,95,46,43,80,90,60,42,18,158
"2011","Oxford 012D","E01028544",1046,273,15,258,251,79,35,18,44,27,36,18,18,283
"2011","Oxford 013A","E01028531",1837,296,35,261,430,179,102,79,147,85,42,29,13,477
"2011","Oxford 013B","E01028532",2130,276,28,248,376,167,113,112,252,196,147,123,24,491
"2011","Oxford 013C","E01028533",1674,207,23,184,331,166,85,107,209,180,138,114,24,251
"2011","Oxford 013D","E01028556",1378,171,27,144,327,164,66,94,194,137,91,72,19,134
"2011","Oxford 013E","E01028557",1618,119,17,102,212,163,120,99,245,200,94,64,30,366
"2011","Oxford 013F","E01028558",1280,142,24,118,223,149,107,93,190,183,70,54,16,123
"2011","Oxford 013G","E01028559",1344,188,30,158,293,150,83,94,205,128,56,43,13,147
"2011","Oxford 014A","E01028545",1337,336,29,307,347,105,75,32,65,47,41,33,8,289
"2011","Oxford 014B","E01028546",1417,142,15,127,270,123,80,92,209,190,140,110,30,171
"2011","Oxford 014C","E01028547",1813,338,25,313,431,122,85,42,108,101,74,55,19,512
"2011","Oxford 015A","E01028527",1258,194,32,162,306,123,91,80,167,139,61,49,12,97
"2011","Oxford 015B","E01028528",1148,126,21,105,212,110,82,88,170,161,67,55,12,132
"2011","Oxford 015C","E01028529",1113,82,10,72,186,112,79,84,207,189,92,66,26,82
"2011","Oxford 015D","E01028530",1239,99,16,83,198,118,92,96,231,191,81,63,18,133
"2011","Oxford 015E","E01028575",1148,274,37,237,279,107,91,48,114,86,53,38,15,96
"2011","Oxford 015F","E01028578",1161,205,18,187,267,150,94,74,147,101,36,25,11,87
"2011","Oxford 016A","E01028552",1160,88,25,63,196,136,78,91,225,186,83,60,23,77
"2011","Oxford 016B","E01028553",1394,243,35,208,321,144,69,70,171,148,150,116,34,78
"2011","Oxford 016C","E01028554",1016,129,26,103,210,120,72,66,141,144,56,44,12,78
"2011","Oxford 016D","E01028555",1200,132,22,110,242,182,79,100,191,156,33,25,8,85
"2011","Oxford 016E","E01028576",978,47,6,41,106,71,64,65,219,167,147,100,47,92
"2011","Oxford 016F","E01028577",1367,78,11,67,185,142,87,113,262,253,121,88,33,126
"2011","Oxford 017A","E01028517",934,55,15,40,137,108,46,74,207,170,81,55,26,56
"2011","Oxford 017B","E01028518",1114,35,14,21,140,107,54,91,262,240,105,73,32,80
"2011","Oxford 017C","E01028519",1001,30,12,18,107,93,57,81,222,222,84,59,25,105
"2011","Oxford 017D","E01028567",1238,63,9,54,147,128,76,108,269,243,71,48,23,133
"2011","Oxford 018A","E01028520",1124,30,12,18,113,103,53,82,281,244,115,79,36,103
"2011","Oxford 018B","E01028568",1032,36,8,28,108,98,62,79,255,217,102,58,44,75
"2011","Oxford 018C","E01028569",1134,59,13,46,169,140,68,76,236,174,97,56,41,115
"2011","Oxford 018D","E01028570",1337,150,25,125,316,190,68,93,206,168,58,29,29,88
"2011","South Oxfordshire 001A","E01028666",1155,152,35,117,311,162,130,97,136,91,16,10,6,60
"2011","South Oxfordshire 001B","E01028667",1037,160,30,130,300,164,97,67,110,59,17,10,7,63
"2011","South Oxfordshire 001C","E01028668",1014,143,35,108,272,158,105,68,112,77,17,11,6,62
"2011","South Oxfordshire 001D","E01028669",968,121,23,98,278,137,90,82,112,92,13,6,7,43
"2011","South Oxfordshire 002A","E01028638",1038,219,28,191,269,104,136,43,105,82,15,11,4,65
"2011","South Oxfordshire 002B","E01028639",1053,191,34,157,239,105,99,58,87,63,27,14,13,184
"2011","South Oxfordshire 002C","E01028640",1080,154,28,126,226,142,129,69,117,94,33,19,14,116
"2011","South Oxfordshire 002D","E01028683",1029,133,27,106,229,146,142,93,105,110,12,8,4,59
"2011","South Oxfordshire 003A","E01028670",1013,203,61,142,300,149,109,49,71,55,20,9,11,57
"2011","South Oxfordshire 003B","E01028671",932,116,19,97,245,88,94,68,114,132,36,25,11,39
"2011","South Oxfordshire 003C","E01028672",1202,195,56,139,364,185,128,70,113,63,13,8,5,71
"2011","South Oxfordshire 003D","E01028673",928,128,31,97,250,119,91,51,101,103,27,9,18,58
"2011","South Oxfordshire 004A","E01028646",849,136,27,109,189,85,148,57,85,80,25,17,8,44
"2011","South Oxfordshire 004B","E01028647",1187,226,61,165,344,138,173,55,89,68,18,11,7,76
"2011","South Oxfordshire 004C","E01028681",967,172,38,134,267,131,115,55,79,60,17,8,9,71
"2011","South Oxfordshire 004D","E01028682",855,109,20,89,168,115,96,71,130,101,23,18,5,42
"2011","South Oxfordshire 004E","E01028684",1072,217,38,179,285,152,114,73,83,62,18,14,4,68
"2011","South Oxfordshire 005A","E01028598",1782,315,94,221,476,213,323,85,153,101,24,16,8,92
"2011","South Oxfordshire 005B","E01028613",1072,138,36,102,289,160,126,80,124,78,7,5,2,70
"2011","South Oxfordshire 005C","E01028614",1115,137,42,95,243,158,150,92,149,112,27,14,13,47
"2011","South Oxfordshire 005D","E01028615",1129,162,41,121,314,171,171,52,113,77,15,9,6,54
"2011","South Oxfordshire 005E","E01028616",1076,130,27,103,274,170,134,77,126,100,26,20,6,39
"2011","South Oxfordshire 006A","E01028604",1090,46,7,39,186,112,85,118,232,210,57,34,23,44
"2011","South Oxfordshire 006B","E01028605",1107,107,14,93,169,128,108,95,210,189,38,24,14,63
"2011","South Oxfordshire 006C","E01028607",982,164,43,121,259,113,121,63,94,104,15,10,5,49
"2011","South Oxfordshire 006D","E01028641",909,164,31,133,221,110,94,67,113,78,15,13,2,47
"2011","South Oxfordshire 006E","E01028657",968,186,38,148,242,98,84,67,111,103,38,24,14,39
"2011","South Oxfordshire 006F","E01028658",937,199,46,153,258,94,119,42,83,62,23,19,4,57
"2011","South Oxfordshire 007A","E01028600",1062,189,55,134,266,154,130,61,95,85,19,7,12,63
"2011","South Oxfordshire 007B","E01028603",864,141,33,108,236,99,154,40,80,60,10,9,1,44
"2011","South Oxfordshire 007C","E01028606",1222,270,50,220,329,127,151,65,108,75,19,11,8,78
"2011","South Oxfordshire 007D","E01028609",961,146,29,117,254,149,87,74,108,69,22,16,6,52
"2011","South Oxfordshire 007E","E01028610",1156,145,44,101,252,176,131,92,149,123,22,16,6,66
"2011","South Oxfordshire 008A","E01028678",1120,221,68,153,314,116,201,40,86,59,32,21,11,51
"2011","South Oxfordshire 008B","E01028679",1576,284,76,208,399,154,235,72,183,131,43,28,15,75
"2011","South Oxfordshire 008C","E01028680",1196,218,54,164,361,122,167,62,123,73,17,11,6,53
"2011","South Oxfordshire 009A","E01028625",1445,276,51,225,396,224,69,102,146,160,23,9,14,49
"2011","South Oxfordshire 009B","E01028626",1239,245,51,194,329,178,86,79,135,104,15,6,9,68
"2011","South Oxfordshire 009C","E01028627",1095,189,36,153,259,183,58,99,123,115,18,4,14,51
"2011","South Oxfordshire 009D","E01028628",1112,218,48,170,276,183,64,67,101,96,24,11,13,83
"2011","South Oxfordshire 009E","E01028629",1114,166,21,145,273,176,65,82,152,112,29,14,15,59
"2011","South Oxfordshire 010A","E01028621",993,81,35,46,196,127,64,95,155,182,44,23,21,49
"2011","South Oxfordshire 010B","E01028622",898,103,17,86,184,156,73,69,136,107,17,10,7,53
"2011","South Oxfordshire 010C","E01028623",1209,142,21,121,288,162,106,103,146,152,35,19,16,75
"2011","South Oxfordshire 010D","E01028624",1016,145,27,118,227,154,83,77,132,117,28,20,8,53
"2011","South Oxfordshire 011A","E01028599",1021,182,58,124,287,141,145,44,93,67,19,13,6,43
"2011","South Oxfordshire 011B","E01028601",1560,301,189,112,435,333,101,193,66,74,9,4,5,48
"2011","South Oxfordshire 011C","E01028602",1019,172,105,67,360,177,44,98,90,31,8,2,6,39
"2011","South Oxfordshire 011D","E01028620",2127,328,85,243,539,257,288,133,197,198,84,61,23,103
"2011","South Oxfordshire 012A","E01028608",859,194,48,146,234,95,82,40,81,58,14,6,8,61
"2011","South Oxfordshire 012B","E01028617",1288,288,68,220,358,147,136,69,118,73,29,18,11,70
"2011","South Oxfordshire 012C","E01028674",949,191,44,147,276,132,89,48,107,55,24,19,5,27
"2011","South Oxfordshire 012D","E01028675",879,114,21,93,176,101,69,78,136,127,31,23,8,47
"2011","South Oxfordshire 012E","E01028676",1448,179,21,158,351,178,131,100,211,153,68,39,29,77
"2011","South Oxfordshire 012F","E01028677",1046,183,31,152,286,118,116,71,83,103,38,22,16,48
"2011","South Oxfordshire 013A","E01028630",1227,192,26,166,282,174,66,97,147,165,37,18,19,67
"2011","South Oxfordshire 013B","E01028631",824,104,15,89,156,114,58,66,136,117,26,16,10,47
"2011","South Oxfordshire 013C","E01028632",1076,109,20,89,184,108,64,101,178,200,53,37,16,79
"2011","South Oxfordshire 013D","E01028633",1142,143,16,127,228,140,64,105,170,187,47,23,24,58
"2011","South Oxfordshire 014A","E01028634",937,107,21,86,179,145,93,86,125,127,17,6,11,58
"2011","South Oxfordshire 014B","E01028635",1099,79,12,67,175,147,88,108,177,226,52,38,14,47
"2011","South Oxfordshire 014C","E01028636",838,79,15,64,151,109,64,72,131,135,44,33,11,53
"2011","South Oxfordshire 014D","E01028637",1167,135,27,108,239,178,101,106,175,151,23,11,12,59
"2011","South Oxfordshire 015A","E01028618",1295,271,50,221,388,148,147,60,115,93,28,17,11,45
"2011","South Oxfordshire 015B","E01028619",1312,220,41,179,334,152,114,109,161,117,38,24,14,67
"2011","South Oxfordshire 015C","E01028644",1127,222,49,173,319,157,148,51,86,75,18,10,8,51
"2011","South Oxfordshire 015D","E01028648",816,147,25,122,214,111,104,31,75,80,15,8,7,39
"2011","South Oxfordshire 015E","E01028649",1139,223,50,173,314,118,143,48,108,90,25,14,11,70
"2011","South Oxfordshire 016A","E01028650",1358,248,47,201,399,159,137,71,144,81,42,30,12,77
"2011","South Oxfordshire 016B","E01028651",1113,141,39,102,233,108,143,83,184,139,42,25,17,40
"2011","South Oxfordshire 016C","E01028652",1425,312,66,246,453,158,181,60,119,66,26,17,9,50
"2011","South Oxfordshire 017A","E01028653",979,157,32,125,286,99,119,60,115,78,26,22,4,39
"2011","South Oxfordshire 017B","E01028654",1108,242,56,186,297,123,121,35,109,72,31,18,13,78
"2011","South Oxfordshire 017C","E01028655",1274,327,62,265,367,121,151,57,110,56,26,13,13,59
"2011","South Oxfordshire 017D","E01028656",869,221,55,166,277,106,106,18,50,18,22,14,8,51
"2011","South Oxfordshire 018A","E01028611",832,180,48,132,246,90,136,37,51,44,10,5,5,38
"2011","South Oxfordshire 018B","E01028642",883,192,53,139,250,110,123,39,77,35,9,6,3,48
"2011","South Oxfordshire 018C","E01028643",967,227,50,177,287,96,128,33,72,50,23,13,10,51
"2011","South Oxfordshire 018D","E01028645",933,223,60,163,299,114,104,31,73,27,10,6,4,52
"2011","South Oxfordshire 018E","E01028685",890,158,27,131,240,125,115,55,83,49,17,12,5,48
"2011","South Oxfordshire 018F","E01028686",984,111,31,80,284,109,115,64,75,71,24,16,8,131
"2011","South Oxfordshire 019A","E01028612",889,173,44,129,277,90,166,35,62,34,15,10,5,37
"2011","South Oxfordshire 019B","E01028660",1248,263,69,194,371,114,199,51,92,79,23,7,16,56
"2011","South Oxfordshire 019C","E01028661",1198,271,89,182,345,104,131,33,77,28,23,16,7,186
"2011","South Oxfordshire 019D","E01028662",932,243,70,173,297,95,142,25,39,28,17,10,7,46
"2011","South Oxfordshire 020A","E01028659",1163,264,62,202,334,151,158,62,70,33,28,22,6,63
"2011","South Oxfordshire 020B","E01028663",1046,135,34,101,273,150,139,63,127,70,38,23,15,51
"2011","South Oxfordshire 020C","E01028664",873,161,37,124,239,135,114,34,86,54,9,4,5,41
"2011","South Oxfordshire 020D","E01028665",909,180,34,146,277,129,102,44,74,35,14,9,5,54
"2011","Vale of White Horse 001A","E01028708",1291,213,35,178,322,159,136,74,152,115,33,22,11,87
"2011","Vale of White Horse 001B","E01028709",1210,279,47,232,316,166,109,52,111,55,14,10,4,108
"2011","Vale of White Horse 001C","E01028710",1170,312,54,258,359,123,106,49,88,28,23,15,8,82
"2011","Vale of White Horse 001D","E01028711",1161,229,35,194,335,146,147,56,103,65,22,15,7,58
"2011","Vale of White Horse 002A","E01028733",903,218,40,178,252,120,82,47,58,37,20,12,8,69
"2011","Vale of White Horse 002B","E01028734",1087,223,29,194,258,153,118,73,99,82,21,12,9,60
"2011","Vale of White Horse 002C","E01028735",1165,143,25,118,248,186,102,71,158,157,32,21,11,68
"2011","Vale of White Horse 002D","E01028740",1109,209,26,183,284,154,105,67,123,74,24,19,5,69
"2011","Vale of White Horse 002E","E01028741",1176,183,33,150,282,110,86,44,94,48,12,7,5,317
"2011","Vale of White Horse 002F","E01028742",1126,230,21,209,306,120,105,60,117,79,32,23,9,77
"2011","Vale of White Horse 003A","E01028738",1648,162,91,71,501,398,60,186,88,146,38,27,11,69
"2011","Vale of White Horse 003B","E01028739",1220,204,60,144,375,145,117,64,137,97,27,20,7,54
"2011","Vale of White Horse 003C","E01028743",1054,81,14,67,262,71,49,56,93,80,13,7,6,349
"2011","Vale of White Horse 003D","E01028744",926,129,26,103,239,126,84,69,97,99,23,10,13,60
"2011","Vale of White Horse 003E","E01028750",1044,105,26,79,238,129,98,88,155,145,25,20,5,61
"2011","Vale of White Horse 003F","E01028751",1079,267,54,213,323,96,121,43,88,45,24,19,5,72
"2011","Vale of White Horse 003G","E01028752",1201,209,46,163,311,163,136,91,120,83,25,17,8,63
"2011","Vale of White Horse 004A","E01028693",1177,279,53,226,345,169,90,66,84,58,16,7,9,70
"2011","Vale of White Horse 004B","E01028694",1161,217,42,175,330,208,79,70,99,60,12,8,4,86
"2011","Vale of White Horse 004C","E01028701",1115,156,15,141,311,158,83,82,120,112,26,11,15,67
"2011","Vale of White Horse 004D","E01028705",997,187,35,152,261,167,92,60,81,80,13,9,4,56
"2011","Vale of White Horse 004E","E01028706",1192,185,36,149,309,188,106,90,132,99,8,4,4,75
"2011","Vale of White Horse 004F","E01028707",1191,176,39,137,306,215,80,99,120,95,18,10,8,82
"2011","Vale of White Horse 005A","E01028688",944,146,24,122,270,141,64,81,98,70,28,17,11,46
"2011","Vale of White Horse 005B","E01028689",1124,152,31,121,261,168,77,103,132,126,32,15,17,73
"2011","Vale of White Horse 005C","E01028695",1124,164,28,136,261,182,98,90,135,115,13,6,7,66
"2011","Vale of White Horse 005D","E01028699",1135,228,37,191,347,152,104,49,93,56,15,9,6,91
"2011","Vale of White Horse 006B","E01028696",973,203,32,171,295,117,58,29,63,50,22,18,4,136
"2011","Vale of White Horse 006C","E01028697",1062,138,17,121,223,125,75,88,146,155,50,28,22,62
"2011","Vale of White Horse 006D","E01028698",1146,258,33,225,365,149,58,51,117,81,20,11,9,47
"2011","Vale of White Horse 006E","E01028700",1096,117,16,101,195,156,80,94,194,155,39,22,17,66
"2011","Vale of White Horse 006F","E01028703",1270,199,30,169,338,161,82,95,162,114,49,34,15,70
"2011","Vale of White Horse 006G","E01033305",1008,247,25,222,298,123,47,55,106,67,23,9,14,42
"2011","Vale of White Horse 006H","E01033306",1185,230,39,191,321,126,101,64,142,98,36,19,17,67
"2011","Vale of White Horse 007A","E01028726",1633,334,87,247,493,174,224,70,137,96,31,23,8,74
"2011","Vale of White Horse 007B","E01028736",1717,330,77,253,458,238,173,112,163,104,36,22,14,103
"2011","Vale of White Horse 007C","E01028737",1707,385,89,296,506,194,224,64,127,94,31,25,6,82
"2011","Vale of White Horse 008A","E01028690",1222,173,34,139,277,171,89,105,158,155,39,29,10,55
"2011","Vale of White Horse 008B","E01028691",1028,88,15,73,180,146,68,111,180,177,23,14,9,55
"2011","Vale of White Horse 008C","E01028692",933,47,10,37,106,90,77,86,189,224,57,43,14,57
"2011","Vale of White Horse 008D","E01028702",993,125,24,101,213,167,90,82,118,115,23,13,10,60
"2011","Vale of White Horse 008E","E01028704",1302,237,43,194,318,138,91,75,171,154,42,27,15,76
"2011","Vale of White Horse 009A","E01028716",1351,191,35,156,337,168,120,99,160,146,53,28,25,77
"2011","Vale of White Horse 009B","E01028717",1138,152,38,114,277,99,143,59,170,120,45,29,16,73
"2011","Vale of White Horse 009C","E01028718",1072,97,20,77,213,101,121,96,160,187,42,27,15,55
"2011","Vale of White Horse 009D","E01028719",1184,210,55,155,300,138,131,73,160,102,15,12,3,55
"2011","Vale of White Horse 009E","E01028749",1718,280,65,215,429,229,205,123,197,153,33,14,19,69
"2011","Vale of White Horse 010A","E01028714",1662,248,63,185,385,225,200,111,205,178,30,17,13,80
"2011","Vale of White Horse 010B","E01028731",903,123,31,92,185,121,117,66,87,128,22,15,7,54
"2011","Vale of White Horse 010C","E01028732",921,153,26,127,218,109,104,51,92,98,59,48,11,37
"2011","Vale of White Horse 010D","E01028753",1009,116,22,94,202,138,99,77,134,154,36,18,18,53
"2011","Vale of White Horse 010E","E01028754",987,212,43,169,272,112,143,33,72,68,16,9,7,59
"2011","Vale of White Horse 011A","E01028721",1012,150,32,118,243,165,72,104,115,91,11,3,8,61
"2011","Vale of White Horse 011B","E01028722",1162,161,32,129,298,170,97,90,145,112,26,16,10,63
"2011","Vale of White Horse 011C","E01028723",1006,148,29,119,210,150,87,66,127,128,34,24,10,56
"2011","Vale of White Horse 011D","E01028724",996,138,32,106,236,149,90,81,129,105,13,9,4,55
"2011","Vale of White Horse 011E","E01028725",1118,118,29,89,225,163,77,104,188,148,34,17,17,61
"2011","Vale of White Horse 014A","E01028755",1149,186,43,143,293,152,103,86,140,95,24,16,8,70
"2011","Vale of White Horse 014B","E01028756",1712,303,46,257,475,224,134,121,203,140,39,23,16,73
"2011","Vale of White Horse 014C","E01028758",1064,145,20,125,255,162,80,71,156,94,25,15,10,76
"2011","Vale of White Horse 014D","E01028759",1140,130,16,114,244,126,100,92,183,170,30,17,13,65
"2011","Vale of White Horse 014E","E01028760",927,123,26,97,227,125,90,67,131,97,19,15,4,48
"2011","Vale of White Horse 014F","E01028761",986,182,37,145,265,137,73,65,121,63,17,11,6,63
"2011","Vale of White Horse 015A","E01028712",1435,297,70,227,401,198,165,70,114,85,38,23,15,67
"2011","Vale of White Horse 015B","E01028727",1165,233,49,184,358,145,119,59,92,68,21,11,10,70
"2011","Vale of White Horse 015C","E01028728",821,150,30,120,193,107,62,49,89,94,32,18,14,45
"2011","Vale of White Horse 015D","E01028729",782,199,39,160,208,96,52,50,59,66,13,4,9,39
"2011","Vale of White Horse 015E","E01028730",1173,253,59,194,355,140,139,55,77,75,20,13,7,59
"2011","Vale of White Horse 015F","E01028757",988,151,29,122,236,111,82,56,148,120,31,15,16,53
"2011","Vale of White Horse 016E","E01028713",1788,319,86,233,484,196,254,92,161,155,39,28,11,88
"2011","Vale of White Horse 016F","E01028715",982,180,46,134,272,104,142,41,107,67,13,9,4,56
"2011","Vale of White Horse 016G","E01028720",1595,266,50,216,396,179,233,83,173,163,28,16,12,74
"2011","Vale of White Horse 016A","E01028745",1001,298,167,131,256,130,87,44,67,43,11,2,9,65
"2011","Vale of White Horse 016B","E01028746",916,163,45,118,225,119,130,45,90,70,20,14,6,54
"2011","Vale of White Horse 016C","E01028747",861,284,183,101,225,82,80,34,47,41,19,10,9,49
"2011","Vale of White Horse 016D","E01028748",748,195,126,69,154,82,62,43,64,62,17,13,4,69
"2011","West Oxfordshire 001A","E01028780",1459,213,45,168,398,165,187,113,163,118,33,24,9,69
"2011","West Oxfordshire 001B","E01028781",894,38,10,28,108,71,95,84,208,208,31,21,10,51
"2011","West Oxfordshire 001C","E01028782",1130,154,37,117,279,155,156,75,139,99,15,11,4,58
"2011","West Oxfordshire 001D","E01028783",1123,120,21,99,270,130,125,84,167,120,28,16,12,79
"2011","West Oxfordshire 002A","E01028795",1146,183,49,134,300,108,204,48,127,101,21,15,6,54
"2011","West Oxfordshire 002B","E01028796",912,127,30,97,223,84,141,49,114,73,15,9,6,86
"2011","West Oxfordshire 002C","E01028797",800,139,46,93,223,87,122,41,84,55,9,6,3,40
"2011","West Oxfordshire 002D","E01028806",1463,250,48,202,375,171,187,101,156,143,16,9,7,64
"2011","West Oxfordshire 003A","E01028763",1374,236,66,170,412,132,215,67,143,85,26,18,8,58
"2011","West Oxfordshire 003B","E01028776",1401,235,61,174,400,154,210,72,141,97,22,15,7,70
"2011","West Oxfordshire 003C","E01028798",1404,185,52,133,382,157,226,75,165,123,28,16,12,63
"2011","West Oxfordshire 004B","E01028804",900,179,39,140,266,115,112,50,59,57,21,10,11,41
"2011","West Oxfordshire 004D","E01028823",891,197,27,170,260,89,90,55,99,52,11,5,6,38
"2011","West Oxfordshire 004E","E01028824",1057,172,24,148,265,129,102,88,127,96,17,9,8,61
"2011","West Oxfordshire 004F","E01028825",811,215,35,180,232,80,73,53,65,44,16,6,10,33
"2011","West Oxfordshire 004G","E01032954",1940,318,53,265,473,222,251,150,215,150,30,20,10,131
"2011","West Oxfordshire 005A","E01028777",800,166,31,135,264,68,105,41,63,25,16,10,6,52
"2011","West Oxfordshire 005B","E01028778",1043,149,22,127,265,138,125,70,127,96,26,15,11,47
"2011","West Oxfordshire 005C","E01028779",821,125,29,96,210,87,112,54,88,86,24,16,8,35
"2011","West Oxfordshire 005D","E01028799",1429,197,37,160,382,203,179,87,148,122,25,15,10,86
"2011","West Oxfordshire 006A","E01028788",1174,258,51,207,313,136,139,74,100,81,21,12,9,52
"2011","West Oxfordshire 006B","E01028789",1054,171,46,125,272,172,115,56,127,73,8,2,6,60
"2011","West Oxfordshire 006C","E01028790",862,120,20,100,196,106,102,56,105,99,17,8,9,61
"2011","West Oxfordshire 006D","E01028791",1129,183,45,138,354,158,133,71,107,55,7,5,2,61
"2011","West Oxfordshire 007A","E01028784",1577,208,51,157,372,228,202,124,166,156,32,22,10,89
"2011","West Oxfordshire 007B","E01028792",782,141,29,112,197,93,139,44,72,59,12,5,7,25
"2011","West Oxfordshire 007C","E01028793",1108,152,46,106,282,112,168,65,118,120,25,13,12,66
"2011","West Oxfordshire 007D","E01028794",1050,124,44,80,224,135,165,76,122,133,20,16,4,51
"2011","West Oxfordshire 008A","E01028810",1051,110,24,86,293,159,65,110,142,93,10,5,5,69
"2011","West Oxfordshire 008B","E01028811",985,96,30,66,202,110,103,91,158,129,41,23,18,55
"2011","West Oxfordshire 008D","E01028813",934,69,15,54,178,107,90,83,157,159,24,18,6,67
"2011","West Oxfordshire 008E","E01028814",1054,141,26,115,256,132,107,82,152,111,15,13,2,58
"2011","West Oxfordshire 008F","E01028815",961,154,43,111,257,145,97,75,100,66,9,6,3,58
"2011","West Oxfordshire 008G","E01032947",1301,213,47,166,373,178,110,96,132,110,35,18,17,54
"2011","West Oxfordshire 008H","E01032948",1317,255,53,202,409,164,116,77,117,92,24,16,8,63
"2011","West Oxfordshire 008I","E01032952",1017,177,43,134,291,146,84,71,93,77,27,19,8,51
"2011","West Oxfordshire 009A","E01028809",879,31,10,21,129,96,93,77,187,187,38,22,16,41
"2011","West Oxfordshire 009B","E01028820",1005,158,40,118,279,170,75,76,93,82,11,5,6,61
"2011","West Oxfordshire 009C","E01028821",1108,145,34,111,242,160,80,97,156,132,33,23,10,63
"2011","West Oxfordshire 009D","E01028822",1094,144,32,112,250,154,98,77,175,125,9,3,6,62
"2011","West Oxfordshire 010A","E01028807",1617,222,38,184,419,204,137,117,191,186,61,41,20,80
"2011","West Oxfordshire 010B","E01028808",1245,142,27,115,284,151,128,88,180,156,48,30,18,68
"2011","West Oxfordshire 010C","E01028816",1038,67,20,47,195,122,88,101,198,184,31,21,10,52
"2011","West Oxfordshire 010D","E01028817",1113,111,22,89,227,174,90,92,179,142,29,19,10,69
"2011","West Oxfordshire 010E","E01028818",1203,143,35,108,302,128,124,88,190,127,44,28,16,57
"2011","West Oxfordshire 010F","E01028819",1091,84,20,64,180,133,85,95,212,184,47,28,19,71
"2011","West Oxfordshire 011A","E01028785",1142,146,30,116,269,156,120,85,147,140,17,14,3,62
"2011","West Oxfordshire 011B","E01028786",925,120,25,95,202,144,94,72,138,85,19,12,7,51
"2011","West Oxfordshire 011C","E01028787",932,103,33,70,203,110,126,69,128,117,29,18,11,47
"2011","West Oxfordshire 011D","E01028800",935,153,24,129,233,111,119,65,94,87,20,13,7,53
"2011","West Oxfordshire 012A","E01028762",1311,233,60,173,351,111,220,68,129,101,30,17,13,68
"2011","West Oxfordshire 012B","E01028766",1440,227,53,174,356,181,205,114,166,112,20,12,8,59
"2011","West Oxfordshire 012C","E01028767",1300,201,50,151,330,145,214,80,124,102,28,15,13,76
"2011","West Oxfordshire 013D","E01028772",1313,125,56,69,315,214,95,148,191,158,14,7,7,53
"2011","West Oxfordshire 013E","E01032949",1101,135,45,90,300,160,66,98,163,96,16,5,11,67
"2011","West Oxfordshire 013F","E01032950",1272,192,62,130,355,212,78,118,138,101,17,10,7,61
"2011","West Oxfordshire 013G","E01032951",1380,115,44,71,373,204,76,154,190,149,32,14,18,87
"2011","West Oxfordshire 013H","E01032953",1599,192,109,83,438,271,85,162,218,121,43,25,18,69
"2011","West Oxfordshire 014A","E01028771",1086,76,25,51,219,157,73,110,205,150,32,22,10,64
"2011","West Oxfordshire 014B","E01028773",1016,96,40,56,208,145,81,98,164,135,34,22,12,55
"2011","West Oxfordshire 014C","E01028774",2149,235,180,55,572,617,61,265,176,112,27,14,13,84
"2011","West Oxfordshire 014D","E01028775",1019,80,28,52,230,144,100,110,156,109,18,13,5,72
"2011","West Oxfordshire 015A","E01028764",1268,209,47,162,358,163,161,72,136,83,30,15,15,56
"2011","West Oxfordshire 015B","E01028765",1380,183,44,139,313,153,171,99,181,182,31,16,15,67
"2011","West Oxfordshire 015C","E01028801",1002,181,55,126,247,100,135,54,102,114,24,19,5,45
"2011","West Oxfordshire 015D","E01028802",1046,185,52,133,306,124,131,65,97,69,14,10,4,55
"2011","Elmbridge 001A","E01030330",1145,167,37,130,324,176,125,62,128,46,40,22,18,77
"2011","Elmbridge 001B","E01030331",1160,187,46,141,319,163,133,71,128,72,22,14,8,65
"2011","Elmbridge 001C","E01030332",1029,108,30,78,225,139,135,75,130,106,38,22,16,73
"2011","Elmbridge 001D","E01030333",1068,151,29,122,314,135,141,55,120,53,27,19,8,72
"2011","Elmbridge 002A","E01030326",1258,271,66,205,434,116,175,37,79,40,28,17,11,78
"2011","Elmbridge 002B","E01030327",1157,234,62,172,377,123,169,32,75,43,21,17,4,83
"2011","Elmbridge 002C","E01030328",1174,277,69,208,421,135,142,24,65,24,22,14,8,64
"2011","Elmbridge 002D","E01030329",1069,208,45,163,390,126,132,35,59,36,17,7,10,66
"2011","Elmbridge 003A","E01030334",1074,102,25,77,253,157,127,74,143,89,43,30,13,86
"2011","Elmbridge 003B","E01030335",1323,171,46,125,342,200,149,80,165,99,38,20,18,79
"2011","Elmbridge 003C","E01030336",1347,121,26,95,284,202,153,121,192,152,50,31,19,72
"2011","Elmbridge 003D","E01030337",1135,116,33,83,237,157,130,71,192,122,49,40,9,61
"2011","Elmbridge 004A","E01030361",1449,204,41,163,347,220,184,88,186,111,47,27,20,62
"2011","Elmbridge 004B","E01030362",867,76,13,63,159,123,124,66,120,92,46,31,15,61
"2011","Elmbridge 004C","E01030363",1361,174,39,135,319,185,161,89,168,139,55,29,26,71
"2011","Elmbridge 004D","E01030364",1172,128,31,97,266,181,109,90,172,122,47,30,17,57
"2011","Elmbridge 005A","E01030350",1172,294,52,242,433,129,119,32,55,26,17,11,6,67
"2011","Elmbridge 005B","E01030351",1081,246,53,193,356,136,124,41,63,45,14,7,7,56
"2011","Elmbridge 005C","E01030352",1042,232,58,174,382,114,97,25,61,28,20,10,10,83
"2011","Elmbridge 005D","E01030353",1046,270,53,217,369,114,88,23,69,21,25,16,9,67
"2011","Elmbridge 006A","E01030322",1312,387,87,300,398,140,113,36,67,38,36,25,11,97
"2011","Elmbridge 006B","E01030323",974,247,67,180,309,106,92,26,56,28,32,22,10,78
"2011","Elmbridge 006C","E01030324",1117,215,47,168,376,134,122,44,97,46,17,7,10,66
"2011","Elmbridge 006D","E01030325",1087,209,41,168,304,138,146,44,86,41,28,21,7,91
"2011","Elmbridge 007A","E01030357",1130,228,55,173,345,139,148,60,88,55,19,9,10,48
"2011","Elmbridge 007B","E01030358",1047,183,52,131,297,155,117,55,104,58,26,12,14,52
"2011","Elmbridge 007C","E01030359",1645,355,76,279,475,247,148,84,142,73,44,24,20,77
"2011","Elmbridge 007D","E01030360",1140,242,66,176,336,181,103,42,81,43,25,18,7,87
"2011","Elmbridge 008A","E01030354",1063,102,24,78,232,127,79,79,160,126,67,40,27,91
"2011","Elmbridge 008B","E01030355",996,165,41,124,282,180,95,57,111,51,13,7,6,42
"2011","Elmbridge 008C","E01030356",925,150,29,121,248,139,94,70,107,46,19,16,3,52
"2011","Elmbridge 008D","E01030365",1115,220,47,173,316,175,101,59,82,47,32,18,14,83
"2011","Elmbridge 008E","E01030368",1115,258,58,200,336,161,104,42,85,45,33,23,10,51
"2011","Elmbridge 009A","E01030319",1181,276,61,215,391,129,124,34,61,25,37,27,10,104
"2011","Elmbridge 009B","E01030320",1157,253,51,202,336,150,115,41,85,48,27,19,8,102
"2011","Elmbridge 009C","E01030321",1060,248,56,192,320,124,129,35,69,28,16,13,3,91
"2011","Elmbridge 009D","E01030369",1531,438,105,333,476,180,161,29,69,23,39,24,15,116
"2011","Elmbridge 009E","E01030370",1110,306,71,235,374,107,118,24,44,26,24,14,10,87
"2011","Elmbridge 010A","E01030313",1109,196,38,158,319,148,137,49,104,70,25,18,7,61
"2011","Elmbridge 010B","E01030314",1067,277,81,196,351,129,110,27,71,29,14,9,5,59
"2011","Elmbridge 010C","E01030366",1356,301,61,240,404,204,124,53,87,63,35,16,19,85
"2011","Elmbridge 010D","E01030367",1154,281,77,204,309,176,103,39,86,47,39,26,13,74
"2011","Elmbridge 011A","E01030338",1120,308,73,235,374,136,107,19,54,26,24,16,8,72
"2011","Elmbridge 011B","E01030339",1018,189,49,140,356,107,124,38,73,51,33,15,18,47
"2011","Elmbridge 011C","E01030340",1009,250,63,187,313,133,114,28,65,21,18,8,10,67
"2011","Elmbridge 011D","E01030341",1247,345,91,254,421,163,105,31,59,29,24,13,11,70
"2011","Elmbridge 012A","E01030371",1107,177,30,147,281,126,102,67,149,87,46,22,24,72
"2011","Elmbridge 012B","E01030372",853,221,69,152,284,90,80,27,64,17,14,9,5,56
"2011","Elmbridge 012C","E01030373",1099,241,58,183,309,128,121,30,117,67,31,16,15,55
"2011","Elmbridge 012D","E01030374",1172,266,60,206,371,146,132,40,95,47,19,8,11,56
"2011","Elmbridge 012E","E01030375",1239,284,59,225,462,131,121,40,70,42,26,16,10,63
"2011","Elmbridge 012F","E01030376",926,272,83,189,289,99,90,16,53,22,24,18,6,61
"2011","Elmbridge 013A","E01030307",1169,339,82,257,375,116,145,20,51,30,29,18,11,64
"2011","Elmbridge 013B","E01030308",1108,275,84,191,385,122,121,23,56,35,21,17,4,70
"2011","Elmbridge 013C","E01030309",1054,242,70,172,335,131,137,19,56,23,32,23,9,79
"2011","Elmbridge 013D","E01030310",1343,215,49,166,346,139,144,86,134,117,78,52,26,84
"2011","Elmbridge 014A","E01030311",1067,115,19,96,236,136,166,75,131,93,45,23,22,70
"2011","Elmbridge 014B","E01030312",980,122,25,97,209,118,104,87,133,109,34,20,14,64
"2011","Elmbridge 014C","E01030315",1143,182,42,140,299,152,152,68,99,81,26,15,11,84
"2011","Elmbridge 014D","E01030316",1127,259,66,193,320,155,149,38,71,29,19,11,8,87
"2011","Elmbridge 014E","E01030317",1197,162,29,133,314,158,161,88,123,87,42,28,14,62
"2011","Elmbridge 014F","E01030318",869,165,62,103,213,111,114,21,83,53,33,29,4,76
"2011","Elmbridge 015A","E01030296",1217,322,83,239,394,124,138,23,68,30,27,20,7,91
"2011","Elmbridge 015B","E01030297",1503,365,93,272,473,169,140,46,89,27,90,76,14,104
"2011","Elmbridge 015C","E01030298",1030,213,45,168,288,129,124,53,83,48,33,24,9,59
"2011","Elmbridge 015D","E01030299",1158,234,60,174,321,153,130,43,105,65,32,20,12,75
"2011","Elmbridge 016A","E01030346",1053,227,81,146,323,119,112,43,79,47,41,33,8,62
"2011","Elmbridge 016B","E01030347",1194,275,71,204,358,126,128,56,82,61,34,18,16,74
"2011","Elmbridge 016C","E01030348",1190,346,89,257,383,129,118,27,50,17,25,16,9,95
"2011","Elmbridge 016D","E01030349",1160,293,87,206,394,121,145,27,51,33,37,29,8,59
"2011","Elmbridge 017A","E01030300",1132,173,52,121,291,133,126,69,131,93,54,37,17,62
"2011","Elmbridge 017B","E01030301",1019,238,67,171,280,118,124,32,66,40,47,39,8,74
"2011","Elmbridge 017C","E01030302",1090,197,54,143,321,151,168,41,77,51,22,10,12,62
"2011","Elmbridge 017D","E01030304",1190,92,22,70,284,152,128,79,212,116,69,46,23,58
"2011","Elmbridge 017E","E01030305",1072,275,95,180,350,101,107,21,42,21,35,26,9,120
"2011","Elmbridge 017F","E01030306",1020,213,63,150,296,96,103,35,58,35,25,21,4,159
"2011","Elmbridge 018A","E01030303",1187,317,111,206,403,121,131,19,52,23,39,26,13,82
"2011","Elmbridge 018B","E01030342",1094,294,111,183,354,117,120,20,43,28,28,20,8,90
"2011","Elmbridge 018C","E01030343",1169,279,56,223,353,124,152,34,71,43,30,24,6,83
"2011","Elmbridge 018D","E01030344",1040,314,103,211,318,105,97,16,41,19,33,26,7,97
"2011","Elmbridge 018E","E01030345",1142,280,71,209,342,124,143,26,75,39,33,14,19,80
"2011","Epsom and Ewell 001A","E01030386",1104,196,49,147,306,182,134,48,84,33,26,21,5,95
"2011","Epsom and Ewell 001B","E01030387",1234,156,28,128,281,248,140,64,126,84,41,28,13,94
"2011","Epsom and Ewell 001C","E01030388",971,151,33,118,253,173,109,49,91,46,37,27,10,62
"2011","Epsom and Ewell 001D","E01030389",1097,154,25,129,301,196,116,62,95,45,39,32,7,89
"2011","Epsom and Ewell 001E","E01030393",1401,162,39,123,346,253,202,87,157,77,36,29,7,81
"2011","Epsom and Ewell 002A","E01030394",1278,139,35,104,312,224,156,83,132,93,39,21,18,100
"2011","Epsom and Ewell 002B","E01030399",1528,128,35,93,354,262,154,126,213,145,61,37,24,85
"2011","Epsom and Ewell 002C","E01030400",1129,72,15,57,187,146,106,102,177,162,84,57,27,93
"2011","Epsom and Ewell 002D","E01030414",958,87,24,63,206,161,99,66,121,98,48,35,13,72
"2011","Epsom and Ewell 003A","E01030377",1653,258,58,200,447,312,206,87,139,87,30,18,12,87
"2011","Epsom and Ewell 003B","E01030378",1149,157,40,117,313,231,139,49,130,42,23,18,5,65
"2011","Epsom and Ewell 003C","E01030406",1195,162,41,121,316,177,130,92,110,70,39,17,22,99
"2011","Epsom and Ewell 003D","E01030407",1014,152,33,119,293,212,108,49,88,28,20,18,2,64
"2011","Epsom and Ewell 003E","E01030408",1318,207,50,157,342,257,157,57,121,54,23,12,11,100
"2011","Epsom and Ewell 004A","E01030395",1245,173,39,134,303,231,155,60,150,86,17,5,12,70
"2011","Epsom and Ewell 004B","E01030413",1466,207,40,167,372,257,139,82,163,101,49,32,17,96
"2011","Epsom and Ewell 004C","E01030415",1200,164,35,129,290,240,155,56,96,76,31,11,20,92
"2011","Epsom and Ewell 004D","E01030416",978,116,28,88,264,178,135,38,100,65,17,11,6,65
"2011","Epsom and Ewell 005A","E01030383",1887,192,53,139,392,228,141,138,260,230,166,135,31,140
"2011","Epsom and Ewell 005B","E01030384",1917,297,62,235,518,254,159,97,198,166,78,58,20,150
"2011","Epsom and Ewell 005C","E01030401",1783,299,71,228,487,305,181,89,153,117,45,27,18,107
"2011","Epsom and Ewell 005D","E01030402",928,171,32,139,263,131,94,27,75,43,60,48,12,64
"2011","Epsom and Ewell 007A","E01030385",1192,88,22,66,231,146,104,85,186,155,57,34,23,140
"2011","Epsom and Ewell 007B","E01030391",1360,204,41,163,398,213,133,59,137,53,37,23,14,126
"2011","Epsom and Ewell 007C","E01030403",1057,216,37,179,317,157,103,41,87,48,15,8,7,73
"2011","Epsom and Ewell 007D","E01030404",1104,236,45,191,350,167,97,39,83,35,18,10,8,79
"2011","Epsom and Ewell 007E","E01030409",1134,121,22,99,277,129,92,59,140,56,32,23,9,228
"2011","Epsom and Ewell 007F","E01030410",1070,172,32,140,270,137,75,49,95,66,32,24,8,174
"2011","Epsom and Ewell 008A","E01030381",986,244,52,192,278,130,92,33,74,45,26,19,7,64
"2011","Epsom and Ewell 008B","E01030411",1656,244,48,196,435,177,111,59,144,84,88,67,21,314
"2011","Epsom and Ewell 008C","E01030412",1390,260,35,225,429,160,104,78,122,70,34,25,9,133
"2011","Epsom and Ewell 008D","E01030419",1162,264,59,205,367,162,85,39,81,35,31,23,8,98
"2011","Epsom and Ewell 009A","E01030379",1111,187,43,144,315,127,72,28,54,28,32,20,12,268
"2011","Epsom and Ewell 009B","E01030380",965,210,52,158,317,128,95,25,59,39,20,13,7,72
"2011","Epsom and Ewell 009C","E01030405",1167,181,45,136,326,183,128,66,117,64,29,20,9,73
"2011","Epsom and Ewell 009D","E01030417",925,256,69,187,301,120,89,21,41,22,14,10,4,61
"2011","Epsom and Ewell 009E","E01030418",1095,184,28,156,300,176,138,56,92,56,19,15,4,74
"2011","Epsom and Ewell 009F","E01030420",850,113,29,84,206,111,72,48,116,44,34,19,15,106
"2011","Epsom and Ewell 010A","E01030382",1039,233,32,201,331,149,84,34,73,28,18,14,4,89
"2011","Epsom and Ewell 010B","E01030390",1291,194,38,156,345,205,154,73,159,69,30,21,9,62
"2011","Epsom and Ewell 010C","E01030392",1334,235,46,189,401,197,166,56,107,60,21,12,9,91
"2011","Epsom and Ewell 010D","E01030396",1273,274,58,216,384,169,167,37,78,31,29,18,11,104
"2011","Epsom and Ewell 010E","E01030398",1266,283,62,221,388,178,125,48,81,29,21,13,8,113
"2011","Epsom and Ewell 010F","E01032624",1310,279,55,224,384,215,153,37,84,30,29,21,8,99
"2011","Guildford 001A","E01030440",1123,240,55,185,321,157,161,36,80,48,22,12,10,58
"2011","Guildford 001B","E01030458",905,192,42,150,265,95,126,63,77,38,15,12,3,34
"2011","Guildford 001C","E01030459",1065,104,22,82,245,133,130,64,126,111,108,102,6,44
"2011","Guildford 001D","E01030475",919,179,40,139,268,133,130,34,70,36,16,10,6,53
"2011","Guildford 001E","E01030476",900,177,42,135,280,138,97,31,81,32,14,9,5,50
"2011","Guildford 001F","E01030477",1172,192,49,143,294,152,170,57,139,86,28,12,16,54
"2011","Guildford 002A","E01030465",1037,166,42,124,253,143,147,54,111,87,23,15,8,53
"2011","Guildford 002B","E01030466",1141,174,32,142,299,181,144,65,128,85,28,18,10,37
"2011","Guildford 002C","E01030473",1241,281,81,200,386,133,145,54,88,50,18,10,8,86
"2011","Guildford 002D","E01030474",1463,145,104,41,532,378,43,75,113,60,31,23,8,86
"2011","Guildford 003A","E01030441",883,195,45,150,261,125,133,23,55,31,13,9,4,47
"2011","Guildford 003B","E01030442",1054,295,98,197,341,145,102,20,41,22,5,5,0,83
"2011","Guildford 003C","E01030443",890,225,47,178,260,126,111,31,41,19,21,12,9,56
"2011","Guildford 003D","E01030444",1042,233,47,186,324,129,132,39,76,32,16,8,8,61
"2011","Guildford 003E","E01030445",950,217,82,135,292,105,97,42,67,39,25,16,9,66
"2011","Guildford 003F","E01030446",974,199,60,139,295,116,122,33,52,32,23,15,8,102
"2011","Guildford 003G","E01030447",962,147,29,118,252,143,129,49,103,55,15,8,7,69
"2011","Guildford 004A","E01030426",1104,158,42,116,306,160,85,59,153,89,46,33,13,48
"2011","Guildford 004B","E01030427",1106,182,46,136,347,151,105,63,112,73,17,11,6,56
"2011","Guildford 004C","E01030428",858,138,28,110,233,138,99,60,75,59,13,8,5,43
"2011","Guildford 004D","E01030429",1149,166,29,137,291,222,82,85,152,84,25,14,11,42
"2011","Guildford 004E","E01030430",1114,182,36,146,334,175,115,62,111,63,19,14,5,53
"2011","Guildford 005A","E01030499",1086,159,30,129,289,174,137,69,124,59,17,11,6,58
"2011","Guildford 005B","E01030500",1176,195,32,163,297,177,110,60,126,60,22,13,9,129
"2011","Guildford 005C","E01030501",1222,230,39,191,370,159,138,49,121,45,27,15,12,83
"2011","Guildford 005D","E01030502",930,115,23,92,229,100,138,59,103,63,17,10,7,106
"2011","Guildford 005E","E01030503",1061,98,14,84,223,122,122,79,132,133,45,31,14,107
"2011","Guildford 005F","E01030504",780,139,27,112,222,142,87,29,82,28,9,5,4,42
"2011","Guildford 006A","E01030485",1370,220,35,185,331,154,86,91,164,99,31,18,13,194
"2011","Guildford 006B","E01030487",1285,193,39,154,306,138,104,67,124,74,21,18,3,258
"2011","Guildford 006C","E01030488",1737,236,41,195,366,199,114,91,168,101,43,23,20,419
"2011","Guildford 006D","E01030489",1825,342,66,276,514,244,159,113,153,99,48,31,17,153
"2011","Guildford 007A","E01030481",1259,96,17,79,249,155,142,117,178,168,36,24,12,118
"2011","Guildford 007B","E01030482",1063,112,22,90,217,115,105,81,159,112,54,39,15,108
"2011","Guildford 007C","E01030483",1005,63,10,53,134,127,87,89,181,184,58,33,25,82
"2011","Guildford 007D","E01030484",1286,163,15,148,284,131,114,85,197,163,43,26,17,106
"2011","Guildford 008A","E01030434",1237,267,53,214,402,169,91,49,93,61,28,15,13,77
"2011","Guildford 008B","E01030435",1201,219,45,174,342,177,107,48,106,55,50,41,9,97
"2011","Guildford 008C","E01030462",1180,255,44,211,362,146,92,46,106,58,21,10,11,94
"2011","Guildford 008D","E01030463",1154,267,45,222,317,154,83,49,124,51,26,13,13,83
"2011","Guildford 008E","E01030464",1133,129,14,115,202,154,95,86,191,136,41,20,21,99
"2011","Guildford 009A","E01030486",1246,183,38,145,316,180,121,61,147,79,27,14,13,132
"2011","Guildford 009B","E01030493",992,76,11,65,160,108,76,88,151,123,36,22,14,174
"2011","Guildford 009C","E01030495",1450,165,25,140,261,151,90,72,141,87,31,18,13,452
"2011","Guildford 009D","E01030498",1084,143,26,117,296,143,90,57,109,45,15,10,5,186
"2011","Guildford 010A","E01030424",1056,97,23,74,227,170,116,92,149,123,29,16,13,53
"2011","Guildford 010B","E01030431",1087,156,31,125,246,175,129,85,123,94,26,17,9,53
"2011","Guildford 010C","E01030432",1117,100,21,79,256,152,121,91,180,124,55,36,19,38
"2011","Guildford 010D","E01030433",1238,113,29,84,269,161,127,110,191,155,47,27,20,65
"2011","Guildford 011A","E01030436",1616,410,64,346,493,238,97,54,114,52,29,14,15,129
"2011","Guildford 011B","E01030437",1245,388,76,312,368,144,107,23,63,26,26,18,8,100
"2011","Guildford 011C","E01030439",1194,329,48,281,345,172,78,25,71,29,27,20,7,118
"2011","Guildford 011D","E01030460",1054,272,61,211,334,128,97,34,62,37,22,13,9,68
"2011","Guildford 011E","E01030461",1094,285,58,227,350,143,93,35,70,25,17,13,4,76
"2011","Guildford 012A","E01030470",2658,245,25,220,286,136,68,60,107,56,32,18,14,1668
"2011","Guildford 012B","E01030494",1205,67,10,57,189,142,83,88,174,172,57,33,24,233
"2011","Guildford 012C","E01030496",1215,68,7,61,167,113,85,81,177,161,58,41,17,305
"2011","Guildford 012D","E01030497",1196,68,10,58,174,111,85,94,202,179,64,45,19,219
"2011","Guildford 013A","E01030438",1173,312,55,257,341,126,98,50,70,42,28,14,14,106
"2011","Guildford 013B","E01030450",1947,403,61,342,503,194,121,129,134,104,50,25,25,309
"2011","Guildford 013C","E01030451",1568,288,37,251,396,151,128,78,140,104,68,32,36,215
"2011","Guildford 013D","E01030453",1197,320,48,272,359,124,92,45,68,43,37,26,11,109
"2011","Guildford 013E","E01030455",1301,318,59,259,392,111,93,59,99,49,44,27,17,136
"2011","Guildford 013F","E01030457",1352,273,29,244,377,123,70,73,130,79,73,44,29,154
"2011","Guildford 014A","E01030421",1124,179,46,133,304,195,142,67,96,60,23,14,9,58
"2011","Guildford 014B","E01030422",1118,119,31,88,292,155,134,75,141,119,33,21,12,50
"2011","Guildford 014C","E01030423",1226,138,35,103,324,172,142,81,147,130,30,13,17,62
"2011","Guildford 014D","E01030425",1212,156,37,119,331,216,116,71,144,80,30,19,11,68
"2011","Guildford 015A","E01030452",1690,328,44,284,386,135,83,75,102,67,35,16,19,479
"2011","Guildford 015B","E01030467",1171,305,49,256,361,131,84,43,70,38,17,11,6,122
"2011","Guildford 015C","E01030468",3262,163,17,146,183,59,43,35,67,43,39,24,15,2630
"2011","Guildford 015D","E01030469",1039,206,26,180,227,104,64,40,102,71,35,20,15,190
"2011","Guildford 016A","E01030448",1124,352,52,300,365,113,87,29,51,13,16,11,5,98
"2011","Guildford 016B","E01030449",975,229,32,197,238,94,67,41,94,46,43,23,20,123
"2011","Guildford 016C","E01030454",1214,330,66,264,416,113,90,35,61,36,29,13,16,104
"2011","Guildford 016D","E01030456",1001,311,64,247,334,92,74,23,62,14,14,8,6,77
"2011","Guildford 017A","E01030471",880,222,52,170,238,99,132,44,58,31,11,9,2,45
"2011","Guildford 017B","E01030472",900,218,53,165,264,83,119,32,81,44,22,15,7,37
"2011","Guildford 017C","E01030478",1319,251,64,187,374,121,155,56,124,71,38,27,11,129
"2011","Guildford 017D","E01030479",1249,190,29,161,348,162,135,70,144,90,43,17,26,67
"2011","Guildford 017E","E01030480",1231,318,67,251,402,150,108,46,87,47,16,9,7,57
"2011","Guildford 018A","E01030490",1154,218,56,162,330,118,179,56,97,65,18,12,6,73
"2011","Guildford 018B","E01030491",1345,229,74,155,336,140,228,78,123,76,43,24,19,92
"2011","Guildford 018C","E01030492",1493,332,85,247,464,180,213,48,85,48,27,15,12,96
"2011","Mole Valley 001A","E01030506",960,186,42,144,302,154,92,27,71,42,17,12,5,69
"2011","Mole Valley 001B","E01030508",936,202,50,152,304,121,91,32,46,21,9,6,3,110
"2011","Mole Valley 001C","E01030509",746,131,31,100,227,118,78,38,68,30,15,6,9,41
"2011","Mole Valley 001D","E01030513",961,155,39,116,267,159,89,52,93,46,18,5,13,82
"2011","Mole Valley 001E","E01030514",973,160,36,124,313,149,111,44,94,41,14,9,5,47
"2011","Mole Valley 002A","E01030505",1118,174,36,138,283,174,131,52,130,68,50,35,15,56
"2011","Mole Valley 002B","E01030507",873,189,46,143,272,144,90,26,63,20,17,13,4,52
"2011","Mole Valley 002C","E01030511",1012,229,52,177,328,160,114,20,46,25,30,20,10,60
"2011","Mole Valley 002D","E01030512",1063,227,49,178,351,154,109,27,62,37,33,26,7,63
"2011","Mole Valley 003A","E01030548",1386,175,39,136,346,164,142,102,167,136,77,64,13,77
"2011","Mole Valley 003B","E01030549",1406,204,39,165,386,200,146,86,160,122,41,29,12,61
"2011","Mole Valley 003C","E01030550",1296,194,34,160,388,156,114,82,164,105,43,22,21,50
"2011","Mole Valley 003D","E01030551",1160,74,15,59,208,159,129,105,217,143,55,39,16,70
"2011","Mole Valley 004A","E01030510",1120,221,54,167,341,175,131,28,85,35,29,17,12,75
"2011","Mole Valley 004B","E01030552",1013,161,30,131,296,142,86,57,103,53,16,11,5,99
"2011","Mole Valley 004C","E01030553",1256,227,50,177,378,151,147,43,102,58,78,73,5,72
"2011","Mole Valley 004D","E01030554",787,185,54,131,252,104,90,25,39,18,14,10,4,60
"2011","Mole Valley 005A","E01030539",1285,163,36,127,327,186,154,87,137,97,47,30,17,87
"2011","Mole Valley 005B","E01030540",1437,337,95,242,442,196,181,26,91,40,25,16,9,99
"2011","Mole Valley 005C","E01030541",958,208,54,154,305,134,95,42,68,20,14,7,7,72
"2011","Mole Valley 005D","E01030542",880,144,37,107,205,158,123,45,93,39,13,6,7,60
"2011","Mole Valley 005E","E01030543",1083,162,47,115,304,181,141,49,93,47,15,7,8,91
"2011","Mole Valley 006A","E01030516",845,153,29,124,255,110,77,41,89,59,21,10,11,40
"2011","Mole Valley 006B","E01030517",1107,239,56,183,337,173,120,31,86,44,17,7,10,60
"2011","Mole Valley 006C","E01030518",907,186,45,141,269,157,93,35,68,26,11,7,4,62
"2011","Mole Valley 006D","E01030519",1076,169,37,132,271,155,142,49,122,58,31,17,14,79
"2011","Mole Valley 007A","E01030520",965,126,30,96,228,147,142,51,115,78,28,15,13,50
"2011","Mole Valley 007B","E01030521",1179,190,43,147,348,166,143,50,78,72,53,41,12,79
"2011","Mole Valley 007C","E01030522",882,191,45,146,286,137,96,28,59,25,16,9,7,44
"2011","Mole Valley 007D","E01030523",805,155,40,115,242,128,83,21,76,43,14,10,4,43
"2011","Mole Valley 008A","E01030524",1498,169,51,118,353,223,226,92,202,145,40,21,19,48
"2011","Mole Valley 008B","E01030525",1092,183,43,140,327,152,163,60,71,53,13,8,5,70
"2011","Mole Valley 008C","E01030526",918,140,20,120,246,145,126,50,89,47,14,8,6,61
"2011","Mole Valley 008D","E01030527",1146,217,41,176,319,148,184,42,104,50,21,17,4,61
"2011","Mole Valley 009A","E01030532",1110,188,41,147,364,169,109,42,107,49,21,9,12,61
"2011","Mole Valley 009B","E01030533",973,193,39,154,276,147,102,36,70,52,13,8,5,84
"2011","Mole Valley 009C","E01030534",891,133,25,108,261,115,110,50,112,52,30,23,7,28
"2011","Mole Valley 009D","E01030556",1442,292,65,227,456,176,144,46,99,38,20,8,12,171
"2011","Mole Valley 010A","E01030535",1296,232,43,189,380,173,136,85,125,65,29,12,17,71
"2011","Mole Valley 010B","E01030536",1273,269,69,200,396,165,118,57,101,58,33,19,14,76
"2011","Mole Valley 010C","E01030537",1181,281,59,222,366,149,111,45,91,43,25,15,10,70
"2011","Mole Valley 010D","E01030538",1203,178,35,143,306,136,165,79,137,87,45,20,25,70
"2011","Mole Valley 011A","E01030544",1129,165,46,119,294,193,203,66,99,42,15,11,4,52
"2011","Mole Valley 011B","E01030545",1184,145,27,118,320,218,147,91,116,78,26,14,12,43
"2011","Mole Valley 011C","E01030546",1186,123,28,95,280,183,138,86,156,112,40,22,18,68
"2011","Mole Valley 011D","E01030547",1142,52,6,46,177,159,136,97,225,155,61,29,32,80
"2011","Mole Valley 012A","E01030529",1228,167,49,118,317,171,187,65,134,92,27,13,14,68
"2011","Mole Valley 012B","E01030555",1269,234,55,179,366,150,223,69,84,59,14,9,5,70
"2011","Mole Valley 012C","E01030557",1405,259,68,191,369,173,260,69,98,77,31,20,11,69
"2011","Mole Valley 012D","E01030558",1550,271,71,200,445,222,218,70,129,92,31,20,11,72
"2011","Mole Valley 013A","E01030515",1392,166,36,130,320,203,208,110,165,114,27,10,17,79
"2011","Mole Valley 013B","E01030528",1052,155,40,115,297,138,184,55,98,54,18,10,8,53
"2011","Mole Valley 013C","E01030530",937,171,41,130,256,112,163,37,76,42,18,9,9,62
"2011","Mole Valley 013D","E01030531",1806,199,54,145,418,256,301,101,194,140,93,78,15,104
"2011","Reigate and Banstead 001A","E01030603",1106,192,52,140,321,179,143,41,85,38,32,27,5,75
"2011","Reigate and Banstead 001B","E01030604",1108,161,33,128,308,191,147,53,112,57,19,10,9,60
"2011","Reigate and Banstead 001C","E01030605",1023,155,30,125,258,146,135,64,89,58,27,15,12,91
"2011","Reigate and Banstead 001D","E01030607",1313,264,50,214,393,190,154,38,96,41,34,21,13,103
"2011","Reigate and Banstead 002A","E01030559",869,143,35,108,249,136,108,28,70,47,36,29,7,52
"2011","Reigate and Banstead 002B","E01030560",1028,167,37,130,252,211,128,54,102,58,25,16,9,31
"2011","Reigate and Banstead 002C","E01030561",896,155,31,124,258,165,95,37,85,39,22,19,3,40
"2011","Reigate and Banstead 002D","E01030562",961,102,25,77,267,171,107,54,110,74,18,9,9,58
"2011","Reigate and Banstead 002E","E01030563",1699,152,41,111,306,182,240,109,172,196,267,247,20,75
"2011","Reigate and Banstead 002F","E01030564",981,136,23,113,277,172,118,36,100,50,30,23,7,62
"2011","Reigate and Banstead 003A","E01030606",944,194,42,152,255,144,123,43,70,22,22,10,12,71
"2011","Reigate and Banstead 003B","E01030641",1114,191,60,131,307,159,158,63,86,57,23,18,5,70
"2011","Reigate and Banstead 003C","E01030642",1101,185,49,136,291,176,132,50,119,55,29,13,16,64
"2011","Reigate and Banstead 003D","E01030644",955,133,38,95,237,150,156,51,104,45,14,6,8,65
"2011","Reigate and Banstead 004A","E01030565",1007,140,42,98,283,153,150,42,94,66,32,23,9,47
"2011","Reigate and Banstead 004B","E01030566",1099,129,39,90,303,204,146,58,107,66,20,11,9,66
"2011","Reigate and Banstead 004C","E01030567",1195,264,71,193,313,150,169,60,88,49,25,20,5,77
"2011","Reigate and Banstead 004D","E01030568",1144,208,48,160,291,208,146,47,90,42,31,21,10,81
"2011","Reigate and Banstead 004E","E01030569",1936,299,70,229,547,311,246,93,171,91,57,37,20,121
"2011","Reigate and Banstead 005A","E01030608",968,77,23,54,176,159,96,73,165,115,52,37,15,55
"2011","Reigate and Banstead 005B","E01030609",1018,87,21,66,195,141,123,63,181,107,49,36,13,72
"2011","Reigate and Banstead 005C","E01030640",1120,107,25,82,219,169,128,84,191,126,48,21,27,48
"2011","Reigate and Banstead 005D","E01030643",949,127,32,95,228,153,106,57,123,72,43,26,17,40
"2011","Reigate and Banstead 006A","E01030635",1092,203,55,148,343,159,137,45,84,41,23,20,3,57
"2011","Reigate and Banstead 006B","E01030636",909,164,40,124,257,136,98,26,67,42,26,17,9,93
"2011","Reigate and Banstead 006C","E01030637",918,174,38,136,296,134,132,28,53,20,14,10,4,67
"2011","Reigate and Banstead 006D","E01030638",1098,230,48,182,299,163,153,39,78,41,16,13,3,79
"2011","Reigate and Banstead 006E","E01030639",989,172,51,121,280,124,157,39,89,40,26,15,11,62
"2011","Reigate and Banstead 007A","E01030589",1282,268,100,168,367,168,216,27,94,25,27,19,8,90
"2011","Reigate and Banstead 007B","E01030590",1384,202,50,152,406,217,215,65,121,49,35,25,10,74
"2011","Reigate and Banstead 007C","E01030591",985,144,44,100,238,143,175,54,95,48,31,20,11,57
"2011","Reigate and Banstead 007D","E01030592",1398,217,55,162,369,213,212,82,132,67,38,29,9,68
"2011","Reigate and Banstead 008A","E01030599",1110,58,11,47,183,189,100,91,180,140,86,54,32,83
"2011","Reigate and Banstead 008B","E01030600",1081,132,36,96,251,172,109,71,125,103,38,21,17,80
"2011","Reigate and Banstead 008C","E01030601",1095,84,20,64,220,170,94,95,191,119,50,37,13,72
"2011","Reigate and Banstead 008D","E01030602",1295,207,40,167,341,251,141,68,128,60,44,30,14,55
"2011","Reigate and Banstead 009A","E01030598",1160,215,47,168,345,156,160,46,87,50,36,26,10,65
"2011","Reigate and Banstead 009B","E01030623",1452,342,85,257,497,195,121,55,87,37,45,31,14,73
"2011","Reigate and Banstead 009C","E01030624",857,237,54,183,311,91,77,28,38,21,18,15,3,36
"2011","Reigate and Banstead 009D","E01030625",1027,240,58,182,325,115,89,35,46,19,17,17,0,141
"2011","Reigate and Banstead 009E","E01030626",734,210,48,162,242,85,75,15,33,25,7,4,3,42
"2011","Reigate and Banstead 009F","E01030627",1204,276,51,225,422,172,97,38,84,36,24,13,11,55
"2011","Reigate and Banstead 010A","E01030615",1156,130,15,115,221,133,102,78,199,117,83,50,33,93
"2011","Reigate and Banstead 010B","E01030616",1099,239,45,194,337,179,89,39,74,35,21,14,7,86
"2011","Reigate and Banstead 010C","E01030617",1211,223,29,194,357,194,97,54,104,78,35,19,16,69
"2011","Reigate and Banstead 010D","E01030618",1377,163,33,130,350,214,111,91,175,98,61,34,27,114
"2011","Reigate and Banstead 010E","E01030619",1022,104,20,84,186,118,77,77,181,135,71,42,29,73
"2011","Reigate and Banstead 010F","E01030622",1402,309,48,261,430,195,131,51,109,56,55,40,15,66
"2011","Reigate and Banstead 011A","E01030610",917,111,18,93,212,155,61,75,119,87,35,21,14,62
"2011","Reigate and Banstead 011B","E01030611",1993,362,80,282,647,295,147,109,163,99,57,37,20,114
"2011","Reigate and Banstead 011C","E01030612",1996,417,62,355,621,340,129,86,166,87,67,46,21,83
"2011","Reigate and Banstead 011D","E01030613",1491,274,32,242,415,221,133,101,157,89,34,20,14,67
"2011","Reigate and Banstead 011E","E01030614",1210,219,37,182,394,191,103,55,104,42,32,22,10,70
"2011","Reigate and Banstead 012A","E01030593",1038,243,48,195,319,129,92,40,97,43,21,15,6,54
"2011","Reigate and Banstead 012B","E01030596",1042,274,59,215,376,113,98,13,48,20,40,32,8,60
"2011","Reigate and Banstead 012C","E01030597",1098,247,40,207,387,136,114,38,81,29,17,9,8,49
"2011","Reigate and Banstead 012D","E01030620",1235,277,63,214,397,166,117,66,73,52,23,15,8,64
"2011","Reigate and Banstead 012E","E01030621",1012,211,47,164,318,130,86,20,102,63,24,13,11,58
"2011","Reigate and Banstead 013A","E01030594",1205,177,42,135,312,156,140,61,146,103,33,25,8,77
"2011","Reigate and Banstead 013B","E01030595",1028,169,23,146,282,155,129,36,102,58,18,8,10,79
"2011","Reigate and Banstead 013C","E01030630",1134,204,46,158,299,161,99,54,131,79,38,26,12,69
"2011","Reigate and Banstead 013D","E01030631",1052,98,21,77,267,150,120,69,149,106,37,27,10,56
"2011","Reigate and Banstead 014A","E01030570",1195,96,27,69,298,183,145,108,145,111,38,25,13,71
"2011","Reigate and Banstead 014B","E01030571",1159,128,32,96,258,215,106,100,146,105,33,22,11,68
"2011","Reigate and Banstead 014C","E01030572",1615,250,38,212,468,218,126,80,189,136,62,38,24,86
"2011","Reigate and Banstead 014D","E01030573",1235,185,39,146,331,177,120,70,140,81,52,38,14,79
"2011","Reigate and Banstead 014E","E01030574",1343,196,34,162,394,196,135,71,141,89,50,31,19,71
"2011","Reigate and Banstead 015A","E01030628",1092,151,33,118,281,194,144,43,110,70,35,29,6,64
"2011","Reigate and Banstead 015B","E01030629",896,135,39,96,231,122,110,60,98,71,31,22,9,38
"2011","Reigate and Banstead 015C","E01030632",982,136,33,103,296,177,110,51,94,46,23,15,8,49
"2011","Reigate and Banstead 015D","E01030633",970,111,22,89,205,159,95,60,151,93,40,20,20,56
"2011","Reigate and Banstead 015E","E01030634",984,73,18,55,199,149,92,86,164,118,54,24,30,49
"2011","Reigate and Banstead 016A","E01030584",1216,127,26,101,345,222,131,89,145,64,19,9,10,74
"2011","Reigate and Banstead 016B","E01030585",1227,157,40,117,332,237,101,87,160,70,25,12,13,58
"2011","Reigate and Banstead 016C","E01030586",1229,115,28,87,266,207,127,115,161,110,48,29,19,80
"2011","Reigate and Banstead 016D","E01030587",1049,80,24,56,243,191,118,85,151,94,18,10,8,69
"2011","Reigate and Banstead 016E","E01030588",1062,65,20,45,195,130,88,102,200,157,61,42,19,64
"2011","Reigate and Banstead 017A","E01030580",1431,175,38,137,401,268,112,121,159,100,32,17,15,63
"2011","Reigate and Banstead 017B","E01030581",958,148,39,109,261,210,94,49,87,47,8,5,3,54
"2011","Reigate and Banstead 017C","E01030582",935,128,19,109,280,181,79,63,92,45,15,6,9,52
"2011","Reigate and Banstead 017D","E01030583",1109,151,40,111,287,194,145,66,104,58,31,26,5,73
"2011","Reigate and Banstead 018A","E01030575",1603,187,25,162,409,261,142,157,197,127,52,33,19,71
"2011","Reigate and Banstead 018B","E01030576",1280,142,32,110,302,212,129,101,188,102,42,32,10,62
"2011","Reigate and Banstead 018C","E01030577",1256,142,26,116,304,203,128,100,198,93,25,13,12,63
"2011","Reigate and Banstead 018D","E01030578",1063,79,22,57,188,164,111,100,179,115,51,29,22,76
"2011","Reigate and Banstead 018E","E01030579",962,103,20,83,206,176,94,69,141,79,64,57,7,30
"2011","Runnymede 001A","E01030667",1107,149,25,124,231,141,76,67,122,87,42,23,19,192
"2011","Runnymede 001B","E01030668",1376,228,38,190,340,145,88,70,75,69,33,24,9,328
"2011","Runnymede 001C","E01030669",1277,157,31,126,252,125,66,65,89,47,19,12,7,457
"2011","Runnymede 001D","E01030670",1201,176,30,146,218,114,49,37,54,36,20,11,9,497
"2011","Runnymede 002A","E01030671",2691,128,29,99,179,74,58,32,40,25,28,20,8,2127
"2011","Runnymede 002B","E01030672",1904,332,88,244,386,160,109,55,79,35,38,33,5,710
"2011","Runnymede 002C","E01030673",748,126,38,88,202,91,93,49,57,29,21,14,7,80
"2011","Runnymede 002D","E01030674",1046,110,24,86,209,98,79,57,99,82,30,21,9,282
"2011","Runnymede 002E","E01030675",1077,157,35,122,186,97,56,36,87,68,30,21,9,360
"2011","Runnymede 002F","E01030676",1073,39,8,31,94,68,59,52,104,82,48,31,17,527
"2011","Runnymede 003A","E01030663",1096,93,24,69,204,182,87,81,179,147,52,31,21,71
"2011","Runnymede 003B","E01030664",1197,120,18,102,240,174,75,82,204,148,66,40,26,88
"2011","Runnymede 003C","E01030665",1129,157,32,125,267,186,106,83,129,85,37,26,11,79
"2011","Runnymede 003D","E01030666",1314,216,43,173,347,201,109,101,136,107,34,18,16,63
"2011","Runnymede 003E","E01030687",907,126,40,86,248,150,103,58,94,59,12,7,5,57
"2011","Runnymede 003F","E01030688",1081,120,31,89,231,199,115,85,148,96,35,17,18,52
"2011","Runnymede 004A","E01030656",1153,106,19,87,255,156,139,94,147,122,61,37,24,73
"2011","Runnymede 004B","E01030658",1025,127,33,94,259,128,116,75,143,124,26,17,9,27
"2011","Runnymede 004C","E01030685",1069,142,34,108,265,168,126,51,91,57,17,12,5,152
"2011","Runnymede 004D","E01030686",1085,182,35,147,272,185,168,51,81,55,30,15,15,61
"2011","Runnymede 005A","E01030689",1034,216,62,154,302,121,114,65,67,52,22,12,10,75
"2011","Runnymede 005B","E01030690",1193,268,81,187,358,152,119,46,84,49,44,41,3,73
"2011","Runnymede 005C","E01030691",1083,246,80,166,321,133,122,38,72,39,37,22,15,75
"2011","Runnymede 005D","E01030692",888,225,94,131,228,87,120,44,53,35,31,26,5,65
"2011","Runnymede 006A","E01030652",1193,145,37,108,335,160,143,80,124,111,38,28,10,57
"2011","Runnymede 006B","E01030653",1037,112,27,85,241,151,109,71,143,94,60,38,22,56
"2011","Runnymede 006C","E01030654",1083,146,38,108,297,184,123,74,116,83,25,16,9,35
"2011","Runnymede 006D","E01030657",1072,99,21,78,236,134,77,76,164,162,74,45,29,50
"2011","Runnymede 006E","E01030659",1178,155,37,118,331,187,137,81,103,85,37,30,7,62
"2011","Runnymede 007A","E01030647",1176,150,40,110,253,170,153,93,171,108,26,15,11,52
"2011","Runnymede 007B","E01030648",1149,132,33,99,308,182,136,79,120,85,37,26,11,70
"2011","Runnymede 007C","E01030649",1206,153,40,113,292,183,142,78,163,107,45,21,24,43
"2011","Runnymede 007D","E01030650",916,84,19,65,185,123,81,62,157,131,46,24,22,47
"2011","Runnymede 007E","E01030651",1009,134,31,103,252,182,107,64,122,81,19,11,8,48
"2011","Runnymede 007F","E01030655",1190,174,51,123,364,172,123,79,116,62,24,13,11,76
"2011","Runnymede 007G","E01030662",1060,129,34,95,254,158,130,83,114,86,27,19,8,79
"2011","Runnymede 008A","E01030677",1197,167,47,120,380,135,153,59,121,78,29,23,6,75
"2011","Runnymede 008B","E01030678",970,132,29,103,277,134,96,61,117,57,43,34,9,53
"2011","Runnymede 008C","E01030679",906,147,51,96,278,115,116,51,69,57,30,21,9,43
"2011","Runnymede 008D","E01030680",1090,174,47,127,305,194,126,65,82,38,25,14,11,81
"2011","Runnymede 009A","E01030645",1309,119,27,92,269,185,133,93,226,131,78,45,33,75
"2011","Runnymede 009B","E01030646",1553,210,45,165,447,232,163,127,185,86,35,15,20,68
"2011","Runnymede 009C","E01030660",1528,196,47,149,360,263,180,123,175,112,20,12,8,99
"2011","Runnymede 009D","E01030661",1186,151,35,116,317,198,146,76,133,76,25,21,4,64
"2011","Runnymede 009E","E01030684",1115,118,30,88,227,213,121,97,152,108,34,20,14,45
"2011","Runnymede 010A","E01030681",1167,144,29,115,277,168,149,74,147,104,45,26,19,59
"2011","Runnymede 010B","E01030682",961,136,40,96,238,146,120,80,100,61,20,11,9,60
"2011","Runnymede 010C","E01030683",1017,134,29,105,261,169,115,81,112,63,25,14,11,57
"2011","Runnymede 010D","E01030693",857,123,40,83,222,142,91,52,106,53,19,7,12,49
"2011","Runnymede 010E","E01030694",978,106,25,81,215,151,119,72,122,97,23,13,10,73
"2011","Runnymede 010F","E01030695",920,190,51,139,264,152,111,30,65,38,11,7,4,59
"2011","Runnymede 010G","E01030696",1016,133,38,95,214,171,116,86,135,75,25,18,7,61
"2011","Spelthorne 001A","E01030743",1150,91,27,64,232,237,101,103,151,131,42,22,20,62
"2011","Spelthorne 001B","E01030744",1238,66,10,56,239,210,87,145,180,186,60,37,23,65
"2011","Spelthorne 001C","E01030745",1143,55,9,46,198,186,78,109,198,157,77,53,24,85
"2011","Spelthorne 001D","E01030747",1081,68,20,48,201,243,120,113,122,112,47,34,13,55
"2011","Spelthorne 002A","E01030709",1106,90,19,71,238,214,85,97,141,119,58,33,25,64
"2011","Spelthorne 002B","E01030710",1193,71,14,57,222,195,89,128,191,157,70,55,15,70
"2011","Spelthorne 002C","E01030711",1245,73,15,58,236,216,103,107,188,194,68,49,19,60
"2011","Spelthorne 002D","E01030746",1114,67,17,50,191,193,78,119,176,165,61,51,10,64
"2011","Spelthorne 003A","E01030707",1228,122,29,93,317,225,105,134,141,90,33,24,9,61
"2011","Spelthorne 003B","E01030708",1217,133,31,102,285,227,101,94,150,110,40,23,17,77
"2011","Spelthorne 003C","E01030712",1010,137,29,108,259,191,90,69,108,57,29,19,10,70
"2011","Spelthorne 003D","E01030713",927,109,30,79,246,179,70,57,122,63,15,4,11,66
"2011","Spelthorne 003E","E01030714",1153,120,32,88,258,208,88,88,138,117,70,53,17,66
"2011","Spelthorne 003F","E01030715",1128,110,28,82,303,230,110,97,116,61,28,19,9,73
"2011","Spelthorne 003G","E01030716",1121,151,39,112,305,221,100,78,123,67,21,17,4,55
"2011","Spelthorne 004A","E01030734",1157,177,39,138,313,192,109,82,118,72,30,22,8,64
"2011","Spelthorne 004B","E01030735",1175,225,41,184,348,185,102,73,94,72,27,16,11,49
"2011","Spelthorne 004C","E01030736",1473,344,39,305,393,216,95,90,130,80,59,41,18,66
"2011","Spelthorne 004D","E01030737",1097,167,32,135,319,169,94,78,113,66,32,20,12,59
"2011","Spelthorne 004E","E01030738",1126,194,36,158,304,185,81,69,108,77,48,32,16,60
"2011","Spelthorne 005A","E01030701",1087,103,40,63,239,239,90,102,117,91,37,17,20,69
"2011","Spelthorne 005B","E01030702",803,74,19,55,161,133,77,70,112,85,33,21,12,58
"2011","Spelthorne 005C","E01030703",1119,119,26,93,269,233,114,102,116,74,37,29,8,55
"2011","Spelthorne 005D","E01030704",1046,122,31,91,275,194,106,77,126,68,22,15,7,56
"2011","Spelthorne 005E","E01030705",1191,123,32,91,292,245,113,107,123,100,41,26,15,47
"2011","Spelthorne 005F","E01030706",1069,108,29,79,250,231,97,79,145,85,26,15,11,48
"2011","Spelthorne 006A","E01030697",1156,104,26,78,260,242,110,97,135,108,26,15,11,74
"2011","Spelthorne 006B","E01030698",1190,118,23,95,261,235,117,102,145,112,30,16,14,70
"2011","Spelthorne 006C","E01030699",1069,103,26,77,203,193,95,91,155,120,48,26,22,61
"2011","Spelthorne 006D","E01030700",1292,124,22,102,291,271,133,100,162,112,45,21,24,54
"2011","Spelthorne 006E","E01030725",1339,156,22,134,301,253,110,115,155,130,49,30,19,70
"2011","Spelthorne 007A","E01030729",1133,142,32,110,277,194,118,83,149,86,25,14,11,59
"2011","Spelthorne 007B","E01030739",1127,93,21,72,210,171,100,94,185,146,64,44,20,64
"2011","Spelthorne 007C","E01030740",1237,90,19,71,221,221,120,138,175,132,64,44,20,76
"2011","Spelthorne 007D","E01030741",1326,154,32,122,331,243,106,90,167,101,49,29,20,85
"2011","Spelthorne 008A","E01030748",1263,115,30,85,280,237,131,96,158,110,42,30,12,94
"2011","Spelthorne 008B","E01030749",1058,83,19,64,205,185,117,85,165,119,35,24,11,64
"2011","Spelthorne 008C","E01030750",1169,101,21,80,272,180,99,74,163,141,49,27,22,90
"2011","Spelthorne 008D","E01030751",1192,147,29,118,292,201,93,84,143,104,47,26,21,81
"2011","Spelthorne 008E","E01030752",1149,108,22,86,194,176,106,81,176,156,80,53,27,72
"2011","Spelthorne 009A","E01030726",1217,155,32,123,344,219,131,76,150,67,8,6,2,67
"2011","Spelthorne 009B","E01030727",1376,258,40,218,397,244,135,71,112,75,19,10,9,65
"2011","Spelthorne 009C","E01030728",1226,208,43,165,361,242,120,72,105,42,24,19,5,52
"2011","Spelthorne 009D","E01030742",1377,174,32,142,330,265,138,113,156,95,38,23,15,68
"2011","Spelthorne 010A","E01030753",1234,239,42,197,375,190,143,65,81,47,23,12,11,71
"2011","Spelthorne 010B","E01030754",1073,195,39,156,345,168,124,42,79,41,26,13,13,53
"2011","Spelthorne 010C","E01030755",1367,155,35,120,372,224,126,103,158,111,51,34,17,67
"2011","Spelthorne 010D","E01030756",1232,210,50,160,380,178,151,72,103,51,23,12,11,64
"2011","Spelthorne 011A","E01030717",1192,101,25,76,266,235,108,101,151,130,35,21,14,65
"2011","Spelthorne 011B","E01030718",977,125,33,92,268,175,84,53,107,83,24,17,7,58
"2011","Spelthorne 011C","E01030719",1080,128,24,104,268,182,108,71,129,87,40,25,15,67
"2011","Spelthorne 011D","E01030720",1098,142,29,113,296,189,116,63,114,74,25,12,13,79
"2011","Spelthorne 012A","E01030721",1079,136,34,102,281,173,127,69,104,87,43,23,20,59
"2011","Spelthorne 012B","E01030722",1182,137,34,103,314,257,138,75,117,63,23,14,9,58
"2011","Spelthorne 012C","E01030723",1176,127,31,96,288,216,145,94,146,70,23,14,9,67
"2011","Spelthorne 012D","E01030724",1088,94,22,72,264,177,122,75,149,108,38,25,13,61
"2011","Spelthorne 013A","E01030730",1268,209,62,147,380,191,174,66,113,59,22,17,5,54
"2011","Spelthorne 013B","E01030731",1333,191,51,140,347,238,161,72,131,85,23,17,6,85
"2011","Spelthorne 013C","E01030732",1116,177,45,132,307,201,136,55,106,69,22,14,8,43
"2011","Spelthorne 013D","E01030733",1128,169,36,133,320,190,138,62,109,69,25,12,13,46
"2011","Surrey Heath 001A","E01030763",918,203,63,140,266,105,131,45,76,40,14,11,3,38
"2011","Surrey Heath 001B","E01030764",889,183,50,133,275,117,138,26,45,27,24,21,3,54
"2011","Surrey Heath 001C","E01030765",975,137,32,105,209,148,129,69,120,89,27,16,11,47
"2011","Surrey Heath 001D","E01030809",1036,188,58,130,305,159,126,52,86,49,31,18,13,40
"2011","Surrey Heath 001E","E01030810",1032,246,76,170,344,136,107,38,59,28,18,8,10,56
"2011","Surrey Heath 001F","E01030811",1067,267,76,191,353,148,103,32,60,27,18,12,6,59
"2011","Surrey Heath 002A","E01030757",1225,244,49,195,361,195,113,77,99,60,19,3,16,57
"2011","Surrey Heath 002B","E01030758",820,113,26,87,231,155,91,57,80,43,20,12,8,30
"2011","Surrey Heath 002C","E01030759",1089,129,34,95,257,134,99,107,137,133,42,21,21,51
"2011","Surrey Heath 002D","E01030760",939,171,35,136,272,158,106,61,72,43,14,8,6,42
"2011","Surrey Heath 003A","E01030778",1349,264,63,201,385,218,133,72,114,58,12,6,6,93
"2011","Surrey Heath 003B","E01030779",1244,240,69,171,365,215,140,61,88,56,19,11,8,60
"2011","Surrey Heath 003C","E01030780",1207,248,58,190,362,194,140,42,90,35,17,9,8,79
"2011","Surrey Heath 003D","E01030781",1129,151,41,110,280,179,160,73,126,80,23,14,9,57
"2011","Surrey Heath 004A","E01030786",1253,108,31,77,260,158,105,129,196,148,77,59,18,72
"2011","Surrey Heath 004B","E01030787",981,89,27,62,167,125,96,97,188,113,41,25,16,65
"2011","Surrey Heath 004C","E01030788",956,53,12,41,147,108,87,80,167,165,71,42,29,78
"2011","Surrey Heath 004D","E01030801",1211,253,118,135,316,135,96,68,122,91,50,37,13,80
"2011","Surrey Heath 004E","E01030802",1229,236,62,174,320,185,123,65,120,64,45,32,13,71
"2011","Surrey Heath 005A","E01030796",972,222,59,163,304,148,97,37,52,28,18,12,6,66
"2011","Surrey Heath 005B","E01030797",1039,200,55,145,327,161,121,45,65,28,13,8,5,79
"2011","Surrey Heath 005C","E01030798",1068,242,68,174,351,147,91,32,74,25,26,14,12,80
"2011","Surrey Heath 005D","E01030799",1028,239,55,184,327,156,111,22,58,12,17,13,4,86
"2011","Surrey Heath 005E","E01030800",1155,262,65,197,341,153,92,63,92,43,42,28,14,67
"2011","Surrey Heath 006A","E01030761",1615,191,52,139,347,179,226,116,168,157,139,122,17,92
"2011","Surrey Heath 006B","E01030762",1411,239,59,180,388,235,163,82,135,68,24,8,16,77
"2011","Surrey Heath 006C","E01030806",1138,228,49,179,325,166,125,38,104,48,8,7,1,96
"2011","Surrey Heath 006D","E01030807",1019,186,46,140,267,144,115,44,77,61,20,12,8,105
"2011","Surrey Heath 006E","E01030808",1134,218,65,153,308,192,110,59,105,65,16,8,8,61
"2011","Surrey Heath 007A","E01030774",1015,192,49,143,328,138,98,52,80,26,25,21,4,76
"2011","Surrey Heath 007B","E01030775",1064,223,50,173,346,151,89,45,102,23,16,11,5,69
"2011","Surrey Heath 007C","E01030776",1223,243,51,192,361,188,110,63,115,53,13,9,4,77
"2011","Surrey Heath 007D","E01030777",1172,205,44,161,317,191,105,77,121,64,25,17,8,67
"2011","Surrey Heath 008A","E01030793",1120,97,21,76,197,123,97,116,208,138,67,44,23,77
"2011","Surrey Heath 008B","E01030794",1179,155,23,132,274,162,144,82,166,84,55,43,12,57
"2011","Surrey Heath 008C","E01030795",1474,247,62,185,458,204,136,65,143,103,44,33,11,74
"2011","Surrey Heath 008D","E01030803",1300,160,38,122,282,175,138,91,197,110,68,44,24,79
"2011","Surrey Heath 008E","E01030804",1274,241,65,176,395,190,136,50,107,47,35,27,8,73
"2011","Surrey Heath 008F","E01030805",1168,118,28,90,220,147,99,81,177,149,74,51,23,103
"2011","Surrey Heath 009A","E01030789",1096,229,69,160,305,169,142,47,75,30,16,8,8,83
"2011","Surrey Heath 009B","E01030790",1200,200,38,162,358,178,104,84,116,56,22,13,9,82
"2011","Surrey Heath 009C","E01030791",1237,184,34,150,350,243,107,73,130,63,19,10,9,68
"2011","Surrey Heath 009D","E01030792",998,210,50,160,329,163,80,36,66,30,16,9,7,68
"2011","Surrey Heath 010A","E01030766",1195,170,39,131,315,170,105,77,161,81,43,26,17,73
"2011","Surrey Heath 010B","E01030767",1113,112,16,96,224,193,92,87,172,117,44,29,15,72
"2011","Surrey Heath 010C","E01030768",1007,158,29,129,245,121,94,79,144,60,33,18,15,73
"2011","Surrey Heath 010D","E01030769",1161,233,40,193,309,219,83,60,99,45,19,8,11,94
"2011","Surrey Heath 011A","E01030770",1130,186,51,135,332,197,98,75,96,49,24,12,12,73
"2011","Surrey Heath 011B","E01030771",986,180,41,139,307,169,84,53,78,35,14,9,5,66
"2011","Surrey Heath 011C","E01030772",1087,137,30,107,253,173,98,86,144,89,29,20,9,78
"2011","Surrey Heath 011D","E01030773",1069,167,43,124,328,192,95,56,103,63,11,6,5,54
"2011","Surrey Heath 012A","E01030782",1140,143,43,100,279,165,129,89,146,82,28,17,11,79
"2011","Surrey Heath 012B","E01030783",1188,216,62,154,304,185,128,78,124,66,16,7,9,71
"2011","Surrey Heath 012C","E01030784",1749,293,114,179,535,334,104,104,149,91,49,27,22,90
"2011","Surrey Heath 012D","E01030785",1092,123,35,88,263,154,138,82,150,97,32,22,10,53
"2011","Tandridge 002A","E01030855",1402,290,71,219,449,229,167,39,80,32,29,20,9,87
"2011","Tandridge 002B","E01030856",1054,113,35,78,285,183,135,70,131,56,26,17,9,55
"2011","Tandridge 002C","E01030859",1476,201,45,156,420,292,139,79,157,83,36,23,13,69
"2011","Tandridge 002D","E01030860",1529,211,49,162,383,281,166,108,174,96,46,23,23,64
"2011","Tandridge 003A","E01030844",1305,164,34,130,363,232,138,80,140,51,50,40,10,87
"2011","Tandridge 003B","E01030845",906,80,15,65,232,142,100,65,149,58,22,12,10,58
"2011","Tandridge 003C","E01030846",1062,141,43,98,271,170,131,54,112,70,28,13,15,85
"2011","Tandridge 003D","E01030857",1542,171,45,126,388,236,172,93,200,118,69,38,31,95
"2011","Tandridge 003E","E01030858",1584,170,31,139,405,269,132,108,185,121,81,67,14,113
"2011","Tandridge 004A","E01030828",1016,211,45,166,308,130,111,20,46,20,18,12,6,152
"2011","Tandridge 004B","E01030829",1034,168,41,127,308,182,108,35,105,39,41,25,16,48
"2011","Tandridge 004C","E01030830",941,181,38,143,283,171,67,43,80,47,15,9,6,54
"2011","Tandridge 004D","E01030850",1517,201,37,164,441,245,146,105,153,104,58,28,30,64
"2011","Tandridge 004E","E01030851",1527,187,36,151,390,251,161,92,166,117,64,40,24,99
"2011","Tandridge 004F","E01030861",1502,296,76,220,443,183,197,35,82,38,27,10,17,201
"2011","Tandridge 005A","E01030820",1237,211,59,152,358,219,177,39,83,38,31,25,6,81
"2011","Tandridge 005B","E01030847",1091,172,46,126,307,160,118,37,104,51,60,56,4,82
"2011","Tandridge 005C","E01030848",1543,168,46,122,374,241,190,100,191,112,56,33,23,111
"2011","Tandridge 006A","E01030831",1602,404,92,312,487,209,181,44,95,43,28,18,10,111
"2011","Tandridge 006B","E01030832",941,153,41,112,312,112,142,39,81,31,18,12,6,53
"2011","Tandridge 006C","E01030836",1015,197,41,156,285,129,109,41,109,53,18,8,10,74
"2011","Tandridge 006D","E01030837",986,144,46,98,266,159,125,48,111,43,18,10,8,72
"2011","Tandridge 006E","E01030838",942,149,37,112,267,132,130,67,89,36,27,19,8,45
"2011","Tandridge 006F","E01030839",970,236,59,177,314,129,88,30,63,18,24,17,7,68
"2011","Tandridge 007A","E01030840",1019,129,27,102,206,164,107,81,140,89,33,18,15,70
"2011","Tandridge 007B","E01030841",861,231,52,179,283,109,69,17,52,26,16,10,6,58
"2011","Tandridge 007C","E01030842",1279,142,40,102,284,166,152,110,169,125,47,23,24,84
"2011","Tandridge 007D","E01030843",1088,103,27,76,242,148,158,76,147,109,33,20,13,72
"2011","Tandridge 008A","E01030812",1142,166,44,122,281,160,158,68,123,87,39,23,16,60
"2011","Tandridge 008B","E01030813",1151,170,43,127,353,172,151,66,104,41,27,15,12,67
"2011","Tandridge 008C","E01030814",920,154,37,117,256,108,137,46,80,36,42,33,9,61
"2011","Tandridge 008D","E01030815",1065,193,56,137,295,156,119,54,94,57,36,23,13,61
"2011","Tandridge 009A","E01030824",992,76,21,55,207,169,113,78,142,106,55,37,18,46
"2011","Tandridge 009B","E01030825",984,164,50,114,309,149,122,49,81,48,9,5,4,53
"2011","Tandridge 009C","E01030826",1020,111,25,86,265,154,111,79,126,74,31,21,10,69
"2011","Tandridge 009D","E01030827",1157,162,46,116,294,170,199,55,112,68,36,22,14,61
"2011","Tandridge 010A","E01030821",1710,237,70,167,390,176,160,92,328,111,31,21,10,185
"2011","Tandridge 010B","E01030822",1307,257,67,190,353,207,196,51,91,64,22,14,8,66
"2011","Tandridge 010C","E01030833",871,135,34,101,245,132,112,49,99,51,19,9,10,29
"2011","Tandridge 010D","E01030834",1028,120,34,86,226,143,140,62,149,99,42,32,10,47
"2011","Tandridge 010E","E01030835",1066,168,36,132,298,173,133,51,100,65,17,13,4,61
"2011","Tandridge 011A","E01030816",1169,156,55,101,287,171,194,60,118,69,39,26,13,75
"2011","Tandridge 011B","E01030817",1039,170,43,127,281,164,143,61,88,56,17,9,8,59
"2011","Tandridge 011C","E01030818",898,100,21,79,172,162,94,85,132,72,29,16,13,52
"2011","Tandridge 011D","E01030819",1134,143,44,99,267,162,169,91,115,71,73,55,18,43
"2011","Tandridge 011E","E01030823",1547,255,82,173,469,227,223,63,127,65,29,20,9,89
"2011","Tandridge 012A","E01030852",1387,160,47,113,336,198,206,89,175,104,46,33,13,73
"2011","Tandridge 012B","E01030853",1195,122,37,85,301,215,168,71,138,72,30,20,10,78
"2011","Tandridge 012C","E01030854",1329,173,40,133,337,247,168,67,136,85,26,14,12,90
"2011","Tandridge 012D","E01032571",1375,193,57,136,389,193,216,74,127,83,30,20,10,70
"2011","Waverley 001A","E01030890",1082,173,37,136,285,134,99,81,135,95,27,20,7,53
"2011","Waverley 001B","E01030902",956,143,33,110,288,139,122,55,99,58,17,13,4,35
"2011","Waverley 001C","E01030903",1165,181,39,142,306,173,135,71,138,78,20,10,10,63
"2011","Waverley 001D","E01030904",983,127,25,102,236,155,117,72,122,82,27,17,10,45
"2011","Waverley 002A","E01030891",1145,233,48,185,354,164,129,55,93,37,16,6,10,64
"2011","Waverley 002B","E01030892",951,155,34,121,272,132,117,39,103,57,12,8,4,64
"2011","Waverley 002C","E01030899",1191,234,57,177,341,174,126,57,117,50,15,6,9,77
"2011","Waverley 002D","E01030900",903,157,31,126,223,151,98,46,108,57,20,10,10,43
"2011","Waverley 002E","E01030901",1012,51,10,41,161,102,88,97,201,137,63,35,28,112
"2011","Waverley 003A","E01030884",1130,184,39,145,273,117,100,67,136,85,32,16,16,136
"2011","Waverley 003B","E01030885",1072,140,30,110,204,60,93,26,40,51,27,18,9,431
"2011","Waverley 003C","E01030886",906,158,28,130,258,110,116,40,86,47,15,7,8,76
"2011","Waverley 003D","E01030893",1385,270,61,209,381,156,98,73,136,78,66,46,20,127
"2011","Waverley 003E","E01030895",1110,161,27,134,272,90,98,47,118,80,34,26,8,210
"2011","Waverley 004A","E01030881",924,225,59,166,310,118,104,21,50,22,14,11,3,60
"2011","Waverley 004B","E01030883",908,223,61,162,284,103,96,23,57,20,32,27,5,70
"2011","Waverley 004C","E01030888",1037,257,53,204,338,138,81,37,69,32,24,16,8,61
"2011","Waverley 004D","E01030894",1099,263,71,192,363,137,128,33,54,21,27,13,14,73
"2011","Waverley 005A","E01030911",1111,161,31,130,277,142,116,64,160,111,29,16,13,51
"2011","Waverley 005B","E01030912",941,70,17,53,182,122,104,93,175,107,29,17,12,59
"2011","Waverley 005C","E01030913",892,82,15,67,153,131,95,75,160,110,37,17,20,49
"2011","Waverley 005D","E01030920",1102,148,29,119,292,151,124,86,140,90,20,12,8,51
"2011","Waverley 005E","E01030921",1172,173,35,138,316,116,143,84,151,101,34,16,18,54
"2011","Waverley 006A","E01030882",916,213,36,177,298,126,120,22,47,31,14,9,5,45
"2011","Waverley 006B","E01030887",903,206,46,160,285,90,105,29,65,37,15,9,6,71
"2011","Waverley 006C","E01030889",993,155,33,122,245,110,100,55,128,71,45,33,12,84
"2011","Waverley 006D","E01030896",862,78,14,64,212,124,88,71,116,89,37,24,13,47
"2011","Waverley 006E","E01030897",946,158,36,122,294,118,116,39,83,38,17,10,7,83
"2011","Waverley 007A","E01030916",1281,275,36,239,398,144,133,70,120,62,32,18,14,47
"2011","Waverley 007B","E01030917",857,217,29,188,302,94,75,54,53,23,12,6,6,27
"2011","Waverley 007C","E01030918",809,180,26,154,257,90,92,42,63,32,23,15,8,30
"2011","Waverley 007D","E01030919",1326,231,47,184,350,117,90,40,40,27,11,8,3,420
"2011","Waverley 007E","E01030922",1075,227,32,195,324,159,101,56,92,59,13,4,9,44
"2011","Waverley 008A","E01030863",1300,308,79,229,370,153,170,39,88,38,31,17,14,103
"2011","Waverley 008B","E01030865",1073,171,45,126,243,116,130,47,126,85,37,22,15,118
"2011","Waverley 008C","E01030866",1082,254,55,199,353,127,127,34,87,35,15,11,4,50
"2011","Waverley 008D","E01030940",1200,256,68,188,328,134,201,48,94,52,24,16,8,63
"2011","Waverley 009A","E01030898",1095,257,57,200,359,127,121,39,63,31,17,9,8,81
"2011","Waverley 009B","E01030905",1131,134,27,107,263,143,134,80,140,107,42,26,16,88
"2011","Waverley 009C","E01030906",1192,246,56,190,351,143,142,47,108,36,29,8,21,90
"2011","Waverley 009D","E01030907",856,206,35,171,249,111,87,26,54,19,13,6,7,91
"2011","Waverley 010A","E01030914",972,122,18,104,213,109,75,55,155,96,96,85,11,51
"2011","Waverley 010B","E01030915",1160,178,38,140,301,149,110,68,165,101,18,10,8,70
"2011","Waverley 010C","E01030923",1014,245,55,190,356,119,101,29,67,26,17,11,6,54
"2011","Waverley 010D","E01030924",904,221,44,177,306,124,76,23,60,27,9,2,7,58
"2011","Waverley 010E","E01030925",1123,295,73,222,384,158,75,28,65,33,20,7,13,65
"2011","Waverley 011A","E01030877",813,121,36,85,197,76,128,63,82,72,27,15,12,47
"2011","Waverley 011B","E01030878",1085,206,41,165,298,141,163,55,89,53,10,5,5,70
"2011","Waverley 011C","E01030937",1133,163,43,120,295,152,146,71,132,82,16,7,9,76
"2011","Waverley 011D","E01030938",904,118,24,94,211,135,104,60,120,68,38,21,17,50
"2011","Waverley 011E","E01030939",832,165,32,133,252,101,93,38,72,43,13,7,6,55
"2011","Waverley 012A","E01030864",1057,214,62,152,286,112,170,51,69,50,35,30,5,70
"2011","Waverley 012B","E01030879",800,172,38,134,237,89,143,34,51,33,8,4,4,33
"2011","Waverley 012C","E01030941",1049,229,46,183,310,98,93,34,52,40,19,16,3,174
"2011","Waverley 012D","E01030942",1018,219,53,166,309,124,140,35,69,42,7,4,3,73
"2011","Waverley 012E","E01030943",896,103,18,85,184,112,131,71,109,105,25,9,16,56
"2011","Waverley 013A","E01030870",1164,214,51,163,378,158,98,53,119,47,23,13,10,74
"2011","Waverley 013B","E01030871",1219,130,35,95,306,155,169,86,172,103,26,12,14,72
"2011","Waverley 013C","E01030872",1191,118,26,92,234,163,145,90,198,156,35,25,10,52
"2011","Waverley 013D","E01030873",992,152,35,117,271,121,140,56,109,66,16,10,6,61
"2011","Waverley 013E","E01030874",1144,148,38,110,300,111,112,42,73,59,19,13,6,280
"2011","Waverley 013F","E01030875",957,120,20,100,228,119,113,84,134,99,13,4,9,47
"2011","Waverley 013G","E01030876",891,184,47,137,260,139,102,23,93,40,8,7,1,42
"2011","Waverley 015A","E01030862",1184,173,43,130,272,135,266,66,114,80,31,21,10,47
"2011","Waverley 015B","E01030867",1022,166,40,126,278,118,202,50,89,53,22,17,5,44
"2011","Waverley 015C","E01030868",929,178,34,144,267,111,113,35,99,50,10,5,5,66
"2011","Waverley 015D","E01030869",859,130,34,96,206,104,157,54,91,49,22,16,6,46
"2011","Waverley 015E","E01030880",1647,250,62,188,426,164,196,65,101,85,23,19,4,337
"2011","Waverley 016A","E01030930",1032,271,75,196,345,105,127,28,60,29,19,9,10,48
"2011","Waverley 016B","E01030931",1137,245,62,183,374,148,127,39,88,34,32,11,21,50
"2011","Waverley 016C","E01030932",1046,168,38,130,291,113,135,45,114,88,17,8,9,75
"2011","Waverley 016D","E01030933",1180,213,48,165,326,147,117,65,142,79,32,20,12,59
"2011","Waverley 017A","E01030926",1061,202,45,157,308,141,117,46,95,55,38,25,13,59
"2011","Waverley 017B","E01030927",967,105,23,82,235,114,151,75,137,79,22,16,6,49
"2011","Waverley 017C","E01030928",1244,181,41,140,336,143,144,71,152,101,39,26,13,77
"2011","Waverley 017D","E01030929",980,188,38,150,292,100,110,42,83,45,34,24,10,86
"2011","Waverley 018A","E01030908",1195,246,62,184,348,125,171,55,68,35,61,59,2,86
"2011","Waverley 018B","E01030909",885,195,48,147,246,81,132,32,76,46,15,14,1,62
"2011","Waverley 018C","E01030910",857,174,41,133,245,96,142,28,62,33,23,14,9,54
"2011","Waverley 018D","E01030934",1033,188,54,134,304,132,101,64,98,57,27,14,13,62
"2011","Waverley 018E","E01030935",950,179,45,134,305,110,104,44,70,41,34,26,8,63
"2011","Waverley 018F","E01032626",1017,196,45,151,285,150,114,64,94,46,16,8,8,52
"2011","Woking 001A","E01030946",950,88,20,68,189,130,100,89,152,118,38,21,17,46
"2011","Woking 001B","E01030947",1054,112,35,77,230,190,140,59,151,68,34,25,9,70
"2011","Woking 001C","E01030948",1134,135,25,110,316,217,129,73,114,79,19,12,7,52
"2011","Woking 001D","E01030949",1236,144,28,116,290,193,145,116,165,92,43,30,13,48
"2011","Woking 001E","E01030950",1127,159,30,129,288,190,101,100,131,71,36,18,18,51
"2011","Woking 002A","E01030996",1080,273,62,211,361,161,86,25,63,21,23,13,10,67
"2011","Woking 002B","E01030998",1290,344,94,250,418,186,116,29,65,29,21,13,8,82
"2011","Woking 002C","E01031002",1224,315,84,231,386,182,106,33,65,38,31,18,13,68
"2011","Woking 002D","E01031003",1213,333,132,201,376,177,115,30,74,19,22,11,11,67
"2011","Woking 002E","E01031004",1523,258,64,194,445,231,146,107,139,94,44,30,14,59
"2011","Woking 003A","E01030963",1067,279,71,208,334,148,94,29,61,28,24,15,9,70
"2011","Woking 003B","E01030964",1332,341,90,251,428,162,117,42,94,41,45,28,17,62
"2011","Woking 003C","E01030965",1060,254,70,184,335,130,114,26,72,26,20,11,9,83
"2011","Woking 003D","E01030966",993,220,41,179,286,131,86,37,86,49,25,20,5,73
"2011","Woking 003E","E01030967",1113,266,57,209,341,145,112,49,81,43,14,10,4,62
"2011","Woking 003F","E01030968",940,185,39,146,254,126,73,40,111,48,42,30,12,61
"2011","Woking 004A","E01030980",1296,105,7,98,203,123,108,74,225,125,165,146,19,168
"2011","Woking 004B","E01030981",1154,58,9,49,118,116,173,75,168,151,168,145,23,127
"2011","Woking 004C","E01030982",1363,137,20,117,211,135,158,97,206,168,123,99,24,128
"2011","Woking 004D","E01030983",1389,173,17,156,247,125,113,89,206,156,160,130,30,120
"2011","Woking 004E","E01030984",1367,88,20,68,225,156,139,88,258,166,132,107,25,115
"2011","Woking 004F","E01030985",1109,52,9,43,139,102,125,96,218,170,113,76,37,94
"2011","Woking 005A","E01030951",1005,126,26,100,265,167,87,68,130,78,26,17,9,58
"2011","Woking 005B","E01030952",987,57,11,46,126,107,109,95,184,131,103,73,30,75
"2011","Woking 005C","E01030953",1127,191,32,159,303,179,85,86,122,62,32,21,11,67
"2011","Woking 005D","E01030956",1044,87,10,77,248,188,99,72,159,76,46,25,21,69
"2011","Woking 005E","E01030957",954,88,14,74,204,139,79,83,177,91,38,22,16,55
"2011","Woking 005F","E01030958",1151,154,32,122,306,193,79,93,155,65,27,18,9,79
"2011","Woking 005G","E01030959",742,104,14,90,192,157,52,49,85,50,16,9,7,37
"2011","Woking 006A","E01030988",1478,363,57,306,429,165,111,64,116,73,59,43,16,98
"2011","Woking 006B","E01030989",1222,247,48,199,326,155,117,46,113,49,72,50,22,97
"2011","Woking 006C","E01030990",1028,273,80,193,340,127,93,24,37,29,24,14,10,81
"2011","Woking 006D","E01030997",1078,211,44,167,310,144,142,48,105,48,14,5,9,56
"2011","Woking 007A","E01030974",1189,114,22,92,280,168,117,98,178,118,48,25,23,68
"2011","Woking 007B","E01030975",1044,145,45,100,264,151,121,79,124,74,24,16,8,62
"2011","Woking 007C","E01030976",1121,144,35,109,327,182,112,73,125,78,9,6,3,71
"2011","Woking 007D","E01030977",1314,196,45,151,343,207,112,69,158,95,66,48,18,68
"2011","Woking 007E","E01030979",1547,308,61,247,448,213,110,89,147,82,46,28,18,104
"2011","Woking 008A","E01030954",1744,367,55,312,430,221,143,107,194,100,60,28,32,122
"2011","Woking 008B","E01030969",1027,246,51,195,299,127,94,57,73,42,28,18,10,61
"2011","Woking 008C","E01030970",1054,206,46,160,288,156,104,40,98,62,32,21,11,68
"2011","Woking 008D","E01030991",1428,352,60,292,429,196,79,71,131,70,43,26,17,57
"2011","Woking 008E","E01030993",1927,486,69,417,567,203,115,93,180,100,93,59,34,90
"2011","Woking 009A","E01030960",1310,158,40,118,393,200,112,101,163,88,27,12,15,68
"2011","Woking 009B","E01030961",1334,189,37,152,327,223,141,87,173,74,28,13,15,92
"2011","Woking 009C","E01030962",1303,123,20,103,274,201,136,107,214,120,59,29,30,69
"2011","Woking 009D","E01031000",1145,259,58,201,361,152,107,37,86,47,37,30,7,59
"2011","Woking 010A","E01030955",1069,223,39,184,284,179,96,49,112,48,24,18,6,54
"2011","Woking 010B","E01030992",1249,349,68,281,375,165,84,34,81,56,24,18,6,81
"2011","Woking 010C","E01030999",968,289,83,206,300,101,101,18,41,19,26,20,6,73
"2011","Woking 010D","E01031001",1244,283,60,223,376,172,114,54,106,45,27,14,13,67
"2011","Woking 011A","E01030971",1347,125,26,99,267,164,151,116,226,123,62,34,28,113
"2011","Woking 011B","E01030972",1305,153,35,118,330,191,134,73,168,86,65,42,23,105
"2011","Woking 011C","E01030973",1284,171,31,140,312,162,148,89,169,112,51,35,16,70
"2011","Woking 011D","E01030994",1284,180,45,135,335,186,124,76,171,108,39,19,20,65
"2011","Woking 011E","E01030995",998,136,27,109,213,120,109,72,142,103,41,25,16,62
"2011","Woking 012A","E01030944",1006,253,63,190,286,127,108,34,66,32,30,24,6,70
"2011","Woking 012B","E01030945",826,154,36,118,263,105,95,46,69,39,15,8,7,40
"2011","Woking 012C","E01030978",1066,184,36,148,316,130,104,47,108,58,40,32,8,79
"2011","Woking 012D","E01030986",744,167,32,135,207,107,82,38,64,21,8,5,3,50
"2011","Woking 012E","E01030987",1015,252,61,191,293,112,144,26,72,22,21,14,7,73
"2011","Adur 001A","E01031349",989,82,14,68,212,159,134,79,154,79,30,24,6,60
"2011","Adur 001B","E01031350",892,38,11,27,146,140,119,81,160,107,46,30,16,55
"2011","Adur 001C","E01031351",1075,89,24,65,212,168,138,88,190,89,40,26,14,61
"2011","Adur 001D","E01031352",1035,82,24,58,212,176,126,68,180,110,34,20,14,47
"2011","Adur 001E","E01031370",995,63,19,44,195,153,111,100,178,116,34,22,12,45
"2011","Adur 001F","E01031374",1083,101,26,75,268,177,157,75,134,79,31,15,16,61
"2011","Adur 002A","E01031338",874,96,20,76,215,159,112,67,96,72,15,9,6,42
"2011","Adur 002B","E01031339",875,105,28,77,266,177,74,53,102,46,8,6,2,44
"2011","Adur 002C","E01031340",1088,157,25,132,288,205,139,59,113,57,7,4,3,63
"2011","Adur 002D","E01031365",1046,127,23,104,289,153,103,82,143,73,18,8,10,58
"2011","Adur 002E","E01031367",952,156,42,114,285,189,116,43,62,48,7,3,4,46
"2011","Adur 003A","E01031345",1116,85,27,58,233,179,158,108,173,112,22,16,6,46
"2011","Adur 003B","E01031353",983,116,20,96,264,104,93,42,108,48,11,4,7,197
"2011","Adur 003C","E01031354",908,82,23,59,213,168,98,86,123,90,15,9,6,33
"2011","Adur 003D","E01031355",1147,82,22,60,222,176,116,117,205,114,37,20,17,78
"2011","Adur 003E","E01031359",1002,76,17,59,194,167,125,92,162,94,23,14,9,69
"2011","Adur 004A","E01031347",1154,80,17,63,208,156,124,76,190,148,78,43,35,94
"2011","Adur 004B","E01031348",1152,52,7,45,208,140,134,95,253,139,55,32,23,76
"2011","Adur 004C","E01031366",976,46,14,32,186,99,110,94,192,136,47,35,12,66
"2011","Adur 004D","E01031371",862,42,17,25,137,118,113,65,182,119,50,36,14,36
"2011","Adur 004E","E01031372",846,47,13,34,140,115,69,75,172,115,48,36,12,65
"2011","Adur 004F","E01031373",1053,106,33,73,244,184,108,68,172,88,31,20,11,52
"2011","Adur 004G","E01031375",1034,98,14,84,294,171,98,66,143,81,34,17,17,49
"2011","Adur 005A","E01031356",1694,268,61,207,506,240,253,91,147,71,31,14,17,87
"2011","Adur 005B","E01031357",1634,218,53,165,496,200,246,86,178,96,41,15,26,73
"2011","Adur 005C","E01031364",1134,148,32,116,309,158,126,63,147,90,48,17,31,45
"2011","Adur 005D","E01031368",903,111,27,84,241,132,123,53,98,64,20,9,11,61
"2011","Adur 005E","E01031369",866,137,32,105,253,138,100,37,86,42,19,11,8,54
"2011","Adur 006A","E01031344",1011,54,19,35,177,152,130,90,175,128,49,32,17,56
"2011","Adur 006B","E01031346",1018,70,24,46,201,177,113,86,191,105,33,22,11,42
"2011","Adur 006C","E01031361",1068,55,16,39,168,160,104,85,220,136,78,55,23,62
"2011","Adur 006D","E01031362",932,91,19,72,200,152,105,82,131,89,24,8,16,58
"2011","Adur 006E","E01031363",1145,81,15,66,204,185,131,98,224,140,36,19,17,46
"2011","Adur 007A","E01031358",1059,38,11,27,181,139,97,95,224,135,65,46,19,85
"2011","Adur 007B","E01031360",1119,76,24,52,207,161,113,82,225,150,40,28,12,65
"2011","Adur 007C","E01031376",911,61,17,44,199,136,124,73,146,99,33,24,9,40
"2011","Adur 007D","E01031378",976,57,9,48,198,150,150,87,160,118,21,14,7,35
"2011","Adur 008A","E01031341",938,52,12,40,141,131,94,94,182,137,47,27,20,60
"2011","Adur 008B","E01031342",1126,66,22,44,227,188,134,100,209,125,37,27,10,40
"2011","Adur 008C","E01031343",991,69,20,49,218,177,115,87,161,100,19,9,10,45
"2011","Adur 008D","E01031377",1119,97,25,72,215,168,133,83,184,138,59,33,26,42
"2011","Adur 008E","E01031379",1079,58,19,39,220,191,133,101,207,98,23,15,8,48
"2011","Arun 001A","E01031390",941,136,40,96,199,109,136,70,112,98,25,16,9,56
"2011","Arun 001B","E01031391",1091,169,41,128,320,137,196,40,100,63,16,8,8,50
"2011","Arun 001C","E01031392",1074,178,50,128,319,90,178,74,113,55,20,13,7,47
"2011","Arun 001D","E01031465",1027,154,39,115,269,110,164,57,105,70,29,21,8,69
"2011","Arun 002A","E01031386",1066,74,21,53,212,155,149,86,176,119,44,28,16,51
"2011","Arun 002B","E01031387",1093,111,37,74,241,163,129,81,166,124,25,15,10,53
"2011","Arun 002C","E01031425",984,165,50,115,290,144,142,49,76,47,19,15,4,52
"2011","Arun 002D","E01031426",879,110,28,82,210,111,148,66,109,70,20,12,8,35
"2011","Arun 003A","E01031393",1257,171,43,128,313,173,183,82,140,80,32,25,7,83
"2011","Arun 003B","E01031394",1237,105,26,79,281,169,123,96,220,125,43,25,18,75
"2011","Arun 003C","E01031395",1114,124,28,96,268,167,151,75,139,93,34,25,9,63
"2011","Arun 003D","E01031396",1365,154,34,120,323,210,196,76,191,110,29,15,14,76
"2011","Arun 003E","E01031397",1226,153,38,115,335,163,199,73,122,82,27,19,8,72
"2011","Arun 003F","E01031466",989,160,46,114,278,114,136,57,90,53,42,32,10,59
"2011","Arun 004A","E01031427",942,34,12,22,119,105,85,87,225,177,59,37,22,51
"2011","Arun 004B","E01031429",993,27,4,23,115,95,97,97,242,192,72,45,27,56
"2011","Arun 004C","E01031430",1023,38,11,27,141,116,104,101,268,170,43,27,16,42
"2011","Arun 004D","E01031467",1278,86,27,59,249,167,129,100,236,181,57,41,16,73
"2011","Arun 004E","E01031468",1694,123,40,83,331,242,201,181,268,193,62,35,27,93
"2011","Arun 005A","E01031388",1842,229,62,167,454,285,219,132,241,132,38,24,14,112
"2011","Arun 005B","E01031389",1483,257,73,184,423,248,167,74,161,58,24,17,7,71
"2011","Arun 005C","E01031414",1048,64,17,47,222,172,111,88,176,135,31,20,11,49
"2011","Arun 005D","E01031415",949,77,21,56,201,164,125,77,131,79,38,24,14,57
"2011","Arun 005E","E01031459",1246,84,26,58,235,147,112,95,250,174,59,42,17,90
"2011","Arun 006A","E01031470",1466,142,36,106,319,183,205,122,212,157,66,45,21,60
"2011","Arun 006B","E01031471",969,100,33,67,218,136,111,85,149,96,19,8,11,55
"2011","Arun 006C","E01031472",1102,116,29,87,251,132,142,86,168,101,49,32,17,57
"2011","Arun 006D","E01031473",860,52,13,39,130,93,108,69,186,129,47,32,15,46
"2011","Arun 007A","E01031407",1139,125,36,89,278,192,98,72,163,91,33,10,23,87
"2011","Arun 007B","E01031408",1430,109,31,78,315,242,144,123,240,148,49,22,27,60
"2011","Arun 007C","E01031410",945,46,15,31,187,154,87,101,182,102,32,14,18,54
"2011","Arun 007D","E01031462",1038,64,25,39,192,146,106,101,223,114,38,23,15,54
"2011","Arun 007E","E01031463",1084,129,39,90,298,194,106,73,139,60,29,18,11,56
"2011","Arun 007F","E01031464",1009,86,21,65,215,176,120,93,157,92,30,23,7,40
"2011","Arun 008A","E01031412",975,197,62,135,282,146,130,33,77,40,20,14,6,50
"2011","Arun 008B","E01031422",979,141,35,106,289,174,123,52,104,39,18,9,9,39
"2011","Arun 008C","E01031423",1128,121,27,94,265,212,172,59,157,61,17,8,9,64
"2011","Arun 008D","E01031424",865,100,25,75,238,150,118,50,116,52,18,10,8,23
"2011","Arun 009A","E01031398",1074,87,20,67,260,153,100,82,182,104,31,19,12,75
"2011","Arun 009B","E01031399",1171,79,24,55,266,210,135,91,186,116,25,12,13,63
"2011","Arun 009C","E01031409",992,42,11,31,147,114,126,102,202,145,50,30,20,64
"2011","Arun 009D","E01031455",970,74,26,48,171,140,106,66,172,119,57,40,17,65
"2011","Arun 009E","E01031461",1201,119,32,87,305,189,143,105,174,97,23,12,11,46
"2011","Arun 009F","E01031469",1194,60,17,43,190,173,153,107,234,164,54,33,21,59
"2011","Arun 010A","E01031411",900,174,52,122,241,157,116,39,90,32,22,16,6,29
"2011","Arun 010B","E01031413",854,99,18,81,233,151,129,37,110,49,16,8,8,30
"2011","Arun 010C","E01031457",1047,127,26,101,272,173,129,66,153,69,20,10,10,38
"2011","Arun 010D","E01031458",1172,184,52,132,332,227,149,48,119,53,22,15,7,38
"2011","Arun 010E","E01031460",1079,135,31,104,255,188,126,73,156,72,42,31,11,32
"2011","Arun 011A","E01031400",1192,105,27,78,271,128,127,117,202,151,44,29,15,47
"2011","Arun 011B","E01031428",1160,53,14,39,202,125,112,109,258,183,51,26,25,67
"2011","Arun 011C","E01031454",1641,119,44,75,264,165,168,165,284,271,106,60,46,99
"2011","Arun 011D","E01031456",1291,71,16,55,222,129,118,105,254,204,110,77,33,78
"2011","Arun 012A","E01031401",1106,67,17,50,215,143,155,90,214,129,35,19,16,58
"2011","Arun 012B","E01031402",1208,84,22,62,210,197,137,107,226,167,25,16,9,55
"2011","Arun 012C","E01031403",1023,47,11,36,178,136,118,96,212,134,46,26,20,56
"2011","Arun 012D","E01031405",983,57,21,36,163,138,103,104,217,123,23,13,10,55
"2011","Arun 012E","E01031406",961,49,20,29,165,123,107,89,218,122,22,9,13,66
"2011","Arun 013A","E01031417",1139,82,26,56,250,172,158,98,185,94,36,20,16,64
"2011","Arun 013B","E01031438",1141,107,40,67,243,165,139,82,187,109,40,26,14,69
"2011","Arun 013C","E01031439",1263,185,52,133,342,181,147,64,161,84,32,22,10,67
"2011","Arun 013D","E01031440",1114,122,44,78,230,177,180,80,148,93,44,28,16,40
"2011","Arun 014A","E01031404",845,20,10,10,96,78,94,62,207,164,60,41,19,64
"2011","Arun 014B","E01031433",1057,71,19,52,179,133,113,77,181,138,50,19,31,115
"2011","Arun 014C","E01031434",1220,58,15,43,199,139,121,98,246,180,58,33,25,121
"2011","Arun 014D","E01031441",1162,42,15,27,167,130,117,123,249,191,69,45,24,74
"2011","Arun 014E","E01031442",1162,67,26,41,176,125,141,115,224,162,52,34,18,100
"2011","Arun 015A","E01031416",1149,169,43,126,315,182,149,56,102,56,41,35,6,79
"2011","Arun 015B","E01031418",1201,106,28,78,317,180,181,67,179,76,21,10,11,74
"2011","Arun 015C","E01031419",1123,117,38,79,277,128,194,70,171,71,28,18,10,67
"2011","Arun 015D","E01031420",1085,120,37,83,283,183,148,48,147,63,27,17,10,66
"2011","Arun 015E","E01031421",1167,117,39,78,272,192,150,84,167,74,26,9,17,85
"2011","Arun 016A","E01031443",981,26,15,11,142,108,143,58,239,146,53,34,19,66
"2011","Arun 016B","E01031444",1213,60,19,41,201,130,111,100,249,182,76,44,32,104
"2011","Arun 016C","E01031450",918,32,9,23,124,107,105,72,207,142,58,35,23,71
"2011","Arun 016D","E01031451",1044,46,21,25,158,104,122,72,223,165,98,68,30,56
"2011","Arun 016E","E01031452",1040,80,27,53,210,100,143,62,181,120,64,43,21,80
"2011","Arun 017A","E01031431",1353,40,12,28,214,84,44,176,275,270,22,12,10,228
"2011","Arun 017B","E01031432",1469,61,16,45,209,120,130,163,334,227,116,78,38,109
"2011","Arun 017C","E01031435",1247,88,29,59,270,153,148,102,197,122,84,59,25,83
"2011","Arun 017D","E01031436",1380,49,10,39,187,147,127,121,321,269,81,46,35,78
"2011","Arun 017E","E01031437",1479,90,21,69,278,164,167,147,267,204,92,70,22,70
"2011","Arun 017F","E01031453",1164,57,15,42,196,103,114,81,249,211,76,63,13,77
"2011","Arun 018A","E01031380",1091,161,49,112,320,174,160,52,99,51,22,18,4,52
"2011","Arun 018B","E01031381",1039,117,38,79,263,173,135,64,126,81,34,18,16,46
"2011","Arun 018C","E01031382",1169,87,25,62,246,169,171,105,202,121,29,14,15,39
"2011","Arun 018D","E01031383",1082,158,48,110,307,176,157,46,120,52,23,13,10,43
"2011","Arun 018E","E01031384",1164,134,38,96,274,215,145,67,165,79,25,11,14,60
"2011","Arun 019A","E01031385",1027,65,15,50,186,159,131,88,185,141,29,17,12,43
"2011","Arun 019B","E01031445",1059,66,21,45,207,166,144,76,182,140,36,22,14,42
"2011","Arun 019C","E01031446",926,61,19,42,219,156,112,69,156,103,17,7,10,33
"2011","Arun 019D","E01031447",1066,74,19,55,220,177,156,81,188,109,26,14,12,35
"2011","Arun 019E","E01031448",1133,82,23,59,244,170,188,95,165,111,34,17,17,44
"2011","Arun 019F","E01031449",1150,85,30,55,196,196,146,103,182,125,36,19,17,81
"2011","Chichester 001A","E01031502",1077,252,66,186,328,130,150,38,80,32,21,12,9,46
"2011","Chichester 001B","E01031503",1098,152,34,118,284,125,172,63,111,76,54,48,6,61
"2011","Chichester 001C","E01031504",1436,215,51,164,374,182,234,72,162,91,40,24,16,66
"2011","Chichester 001D","E01031519",1021,152,45,107,226,115,206,48,113,84,36,24,12,41
"2011","Chichester 002A","E01031517",1308,214,61,153,343,176,242,57,115,69,24,14,10,68
"2011","Chichester 002B","E01031518",1106,225,56,169,312,136,177,41,79,59,27,14,13,50
"2011","Chichester 002C","E01031544",922,138,42,96,205,111,201,46,74,79,16,10,6,52
"2011","Chichester 002D","E01031545",864,122,38,84,227,89,173,49,83,60,21,15,6,40
"2011","Chichester 003A","E01031508",1451,239,63,176,389,163,256,80,124,92,30,19,11,78
"2011","Chichester 003B","E01031520",914,158,41,117,242,84,150,39,95,66,20,13,7,60
"2011","Chichester 003C","E01031521",834,175,55,120,253,94,137,45,53,31,18,11,7,28
"2011","Chichester 003D","E01031536",832,105,26,79,214,89,168,41,94,52,32,18,14,37
"2011","Chichester 004A","E01031497",941,139,37,102,222,130,143,57,108,72,25,14,11,45
"2011","Chichester 004C","E01031511",999,123,36,87,264,133,175,69,125,54,20,12,8,36
"2011","Chichester 004D","E01031512",1375,109,28,81,243,122,189,129,246,192,69,39,30,76
"2011","Chichester 004F","E01032717",1771,223,63,160,444,207,325,116,211,135,33,13,20,77
"2011","Chichester 005A","E01031478",817,142,46,96,225,74,149,35,49,43,15,10,5,85
"2011","Chichester 005B","E01031479",759,123,24,99,203,87,148,38,72,34,12,10,2,42
"2011","Chichester 005C","E01031498",793,103,35,68,215,80,138,47,78,57,23,15,8,52
"2011","Chichester 005D","E01031514",1116,153,40,113,277,125,206,64,135,81,31,20,11,44
"2011","Chichester 005E","E01031515",1130,80,20,60,199,115,195,84,210,158,38,25,13,51
"2011","Chichester 005F","E01031516",1068,170,36,134,291,118,196,45,116,66,19,13,6,47
"2011","Chichester 006A","E01031477",1589,197,55,142,400,150,263,101,193,111,60,39,21,114
"2011","Chichester 006B","E01031485",1010,218,48,170,308,148,79,38,86,35,11,5,6,87
"2011","Chichester 006C","E01031487",1054,223,53,170,289,122,80,37,92,35,29,22,7,147
"2011","Chichester 006D","E01031509",1739,232,53,179,412,189,210,118,237,170,54,29,25,117
"2011","Chichester 007A","E01031506",906,181,38,143,243,86,141,42,85,50,23,14,9,55
"2011","Chichester 007B","E01031507",1027,197,61,136,276,119,182,49,82,40,19,18,1,63
"2011","Chichester 007C","E01031531",927,132,24,108,247,130,98,68,126,64,13,9,4,49
"2011","Chichester 007D","E01031533",796,67,17,50,172,96,89,67,128,107,27,13,14,43
"2011","Chichester 007E","E01031543",1656,244,51,193,420,195,223,111,213,111,47,27,20,92
"2011","Chichester 008A","E01031482",1170,83,18,65,228,132,80,83,213,137,54,33,21,160
"2011","Chichester 008B","E01031483",1804,126,28,98,323,176,110,136,322,224,84,50,34,303
"2011","Chichester 008C","E01031486",1404,165,27,138,329,138,95,59,106,52,16,11,5,444
"2011","Chichester 008D","E01031488",1473,171,26,145,252,151,83,68,189,100,38,28,10,421
"2011","Chichester 008E","E01031494",1090,50,15,35,180,126,83,99,221,165,55,39,16,111
"2011","Chichester 008F","E01031495",1118,149,25,124,286,142,87,57,148,78,18,14,4,153
"2011","Chichester 009A","E01031475",920,167,40,127,255,93,159,65,80,39,17,10,7,45
"2011","Chichester 009B","E01031476",1015,220,57,163,319,119,138,37,73,31,25,14,11,53
"2011","Chichester 009C","E01031532",1198,158,91,67,402,315,48,65,82,65,25,18,7,38
"2011","Chichester 009D","E01031534",1234,199,44,155,358,163,138,71,130,83,37,18,19,55
"2011","Chichester 009E","E01031535",1098,142,45,97,304,105,165,72,122,100,31,21,10,57
"2011","Chichester 010A","E01031480",1042,89,13,76,253,118,85,93,168,96,34,21,13,106
"2011","Chichester 010B","E01031481",1156,146,38,108,274,140,123,76,135,110,36,22,14,116
"2011","Chichester 010C","E01031484",1342,135,27,108,313,140,115,100,189,115,47,31,16,188
"2011","Chichester 010D","E01031490",1304,184,43,141,324,136,104,66,122,65,41,27,14,262
"2011","Chichester 010E","E01031491",1356,177,24,153,361,149,135,79,178,91,45,21,24,141
"2011","Chichester 011A","E01031474",1023,138,23,115,268,122,131,61,126,101,25,18,7,51
"2011","Chichester 011B","E01031493",1167,197,42,155,292,120,126,62,128,94,33,22,11,115
"2011","Chichester 011C","E01031496",1573,245,64,181,461,225,151,74,180,111,34,18,16,92
"2011","Chichester 011D","E01031505",1612,267,57,210,447,215,204,75,175,94,31,17,14,104
"2011","Chichester 012A","E01031489",1117,152,37,115,278,126,120,69,145,76,16,11,5,135
"2011","Chichester 012B","E01031492",1068,48,8,40,161,91,106,83,204,175,60,41,19,140
"2011","Chichester 012C","E01031513",1599,241,64,177,408,213,216,92,194,124,33,18,15,78
"2011","Chichester 012D","E01031530",930,93,15,78,189,111,137,62,137,98,34,18,16,69
"2011","Chichester 012E","E01031538",1113,107,32,75,253,133,138,84,146,109,48,25,23,95
"2011","Chichester 012F","E01031539",818,78,27,51,219,101,97,57,120,73,21,12,9,52
"2011","Chichester 013A","E01031499",1304,110,29,81,293,170,203,94,192,134,31,15,16,77
"2011","Chichester 013B","E01031500",1344,137,50,87,292,167,243,109,161,122,39,22,17,74
"2011","Chichester 013C","E01031501",936,81,26,55,180,124,170,65,160,83,23,15,8,50
"2011","Chichester 013D","E01031529",856,122,41,81,223,76,174,49,92,49,25,15,10,46
"2011","Chichester 013E","E01031540",924,144,45,99,268,110,171,29,79,64,23,14,9,36
"2011","Chichester 013F","E01031541",876,89,22,67,196,139,164,47,126,68,16,8,8,31
"2011","Chichester 013G","E01031542",1251,203,47,156,339,145,219,60,120,65,31,16,15,69
"2011","Chichester 014A","E01031522",1340,89,34,55,238,156,181,122,251,179,47,27,20,77
"2011","Chichester 014B","E01031523",1106,61,18,43,198,159,141,107,219,120,39,24,15,62
"2011","Chichester 014C","E01031524",1036,73,21,52,203,117,152,84,208,152,22,15,7,25
"2011","Chichester 014D","E01031525",1003,72,28,44,173,138,127,100,198,131,18,8,10,46
"2011","Chichester 014E","E01031526",920,76,20,56,195,121,136,77,144,95,34,26,8,42
"2011","Chichester 014F","E01031527",1075,87,24,63,217,171,130,81,185,107,49,29,20,48
"2011","Chichester 014G","E01031528",986,88,25,63,208,108,179,92,147,86,28,17,11,50
"2011","Crawley 001A","E01031573",1121,53,12,41,155,154,97,90,210,169,98,76,22,95
"2011","Crawley 001B","E01031574",1299,103,24,79,247,207,102,108,195,166,79,63,16,92
"2011","Crawley 001C","E01031575",1365,63,8,55,197,159,98,118,243,238,149,115,34,100
"2011","Crawley 001D","E01031576",1090,48,3,45,143,134,74,99,245,161,102,74,28,84
"2011","Crawley 001E","E01031577",998,69,12,57,117,111,76,84,201,147,93,75,18,100
"2011","Crawley 002A","E01031586",1271,131,22,109,267,229,125,106,190,113,49,25,24,61
"2011","Crawley 002B","E01031587",1301,195,38,157,321,260,136,86,119,74,29,19,10,81
"2011","Crawley 002C","E01031588",1081,134,31,103,279,182,111,80,133,61,32,22,10,69
"2011","Crawley 002D","E01031590",1236,153,43,110,317,295,91,75,152,65,16,13,3,72
"2011","Crawley 002E","E01031593",1076,166,29,137,299,221,66,78,115,57,18,11,7,56
"2011","Crawley 003A","E01031570",979,76,19,57,195,164,89,80,158,121,39,20,19,57
"2011","Crawley 003B","E01031571",1122,86,21,65,211,192,93,105,181,147,45,22,23,62
"2011","Crawley 003C","E01031572",996,65,16,49,180,189,69,82,175,116,56,37,19,64
"2011","Crawley 003D","E01031609",1130,61,19,42,186,197,101,111,202,141,56,40,16,75
"2011","Crawley 003E","E01031610",1245,90,12,78,253,216,69,136,191,132,86,61,25,72
"2011","Crawley 004A","E01031583",1550,130,17,113,278,267,95,155,271,183,89,60,29,82
"2011","Crawley 004B","E01031584",1193,87,14,73,172,196,91,115,247,136,64,45,19,85
"2011","Crawley 004C","E01031585",1228,87,10,77,205,193,103,112,219,135,81,61,20,93
"2011","Crawley 004D","E01031601",871,71,13,58,161,147,79,79,139,99,38,32,6,58
"2011","Crawley 004F","E01032835",1161,159,18,141,294,250,52,111,140,92,41,25,16,22
"2011","Crawley 004G","E01032836",1192,119,21,98,232,200,97,92,192,126,68,45,23,66
"2011","Crawley 005A","E01031589",1252,159,27,132,248,232,100,112,187,86,47,36,11,81
"2011","Crawley 005B","E01031591",1319,163,25,138,267,207,94,127,215,113,41,23,18,92
"2011","Crawley 005C","E01031594",984,89,22,67,196,165,103,81,167,92,37,26,11,54
"2011","Crawley 005D","E01031600",998,118,18,100,212,177,100,81,139,85,35,19,16,51
"2011","Crawley 005E","E01031603",1096,135,26,109,204,194,98,97,130,94,59,37,22,85
"2011","Crawley 006A","E01031564",1087,88,23,65,233,198,94,92,168,105,41,23,18,68
"2011","Crawley 006B","E01031565",1488,86,26,60,263,226,125,139,293,194,58,40,18,104
"2011","Crawley 006C","E01031566",1181,111,20,91,256,210,92,115,177,120,38,22,16,62
"2011","Crawley 006D","E01031567",973,96,22,74,206,170,93,84,122,97,48,36,12,57
"2011","Crawley 006E","E01031568",1059,85,15,70,239,205,64,108,168,113,33,17,16,44
"2011","Crawley 007A","E01031596",1290,88,17,71,239,202,96,128,232,151,68,41,27,86
"2011","Crawley 007B","E01031597",1104,116,13,103,243,206,93,74,157,103,39,31,8,73
"2011","Crawley 007C","E01031598",1215,121,25,96,241,207,73,109,178,139,92,61,31,55
"2011","Crawley 007D","E01031599",1315,110,24,86,286,250,77,112,191,159,54,35,19,76
"2011","Crawley 007E","E01031608",1357,112,21,91,279,216,90,100,212,179,79,49,30,90
"2011","Crawley 008A","E01031578",1352,235,47,188,362,293,83,74,155,48,29,13,16,73
"2011","Crawley 008B","E01031580",1650,283,50,233,496,329,113,88,156,74,28,13,15,83
"2011","Crawley 008C","E01031581",1251,222,48,174,385,255,88,65,117,36,16,6,10,67
"2011","Crawley 008D","E01031592",1523,350,74,276,410,265,145,71,122,55,19,9,10,86
"2011","Crawley 009A","E01031560",1071,108,25,83,201,219,88,83,157,110,50,30,20,55
"2011","Crawley 009B","E01031561",1069,109,28,81,220,221,95,101,149,84,32,21,11,58
"2011","Crawley 009C","E01031562",916,61,10,51,165,150,73,69,164,131,50,28,22,53
"2011","Crawley 009D","E01031563",923,90,13,77,230,194,60,61,119,68,24,16,8,77
"2011","Crawley 009E","E01031579",1182,146,31,115,329,206,75,93,143,87,39,20,19,64
"2011","Crawley 009F","E01031582",1360,203,49,154,442,282,66,79,151,71,24,14,10,42
"2011","Crawley 010A","E01031547",1002,50,15,35,182,165,67,97,176,154,48,30,18,63
"2011","Crawley 010B","E01031548",1188,48,14,34,159,153,70,135,242,222,86,41,45,73
"2011","Crawley 010C","E01031549",1080,45,7,38,177,163,72,100,219,162,53,31,22,89
"2011","Crawley 010D","E01031550",1105,45,10,35,162,162,75,115,216,172,65,36,29,93
"2011","Crawley 010E","E01031569",1140,51,11,40,195,199,73,99,235,168,68,37,31,52
"2011","Crawley 011A","E01031595",1191,77,9,68,216,150,102,124,243,141,55,38,17,83
"2011","Crawley 011B","E01031604",1107,71,20,51,202,195,104,78,219,145,35,23,12,58
"2011","Crawley 011C","E01031605",1058,71,18,53,198,163,83,96,186,138,55,39,16,68
"2011","Crawley 011D","E01031606",1020,67,14,53,175,166,85,93,197,145,38,19,19,54
"2011","Crawley 011E","E01031607",975,62,13,49,188,169,88,98,159,107,47,22,25,57
"2011","Crawley 012A","E01031546",1087,51,12,39,175,116,72,114,234,160,65,40,25,100
"2011","Crawley 012B","E01031551",1141,55,11,44,163,140,81,119,232,188,67,40,27,96
"2011","Crawley 012C","E01031553",1098,34,7,27,144,168,82,96,214,169,83,54,29,108
"2011","Crawley 012D","E01031554",1312,86,17,69,230,194,94,126,247,187,75,52,23,73
"2011","Crawley 012E","E01031555",1119,43,6,37,149,142,70,99,235,183,94,70,24,104
"2011","Crawley 013A","E01031552",1413,88,21,67,224,225,97,110,264,230,99,65,34,76
"2011","Crawley 013B","E01031556",1200,86,25,61,209,189,102,91,222,141,74,35,39,86
"2011","Crawley 013C","E01031557",1410,119,23,96,350,257,110,141,199,156,48,27,21,30
"2011","Crawley 013D","E01031558",1103,30,8,22,138,113,59,94,241,216,133,82,51,79
"2011","Crawley 013E","E01031559",1079,47,11,36,185,156,75,105,203,164,77,51,26,67
"2011","Horsham 001A","E01031670",1174,168,34,134,317,174,71,86,170,82,44,24,20,62
"2011","Horsham 001B","E01031671",1263,147,35,112,315,203,96,104,174,109,58,27,31,57
"2011","Horsham 001C","E01031673",1167,107,35,72,263,194,114,91,168,113,62,42,20,55
"2011","Horsham 001D","E01031676",2004,324,88,236,532,277,335,105,189,114,26,18,8,102
"2011","Horsham 002A","E01031644",1066,182,28,154,283,199,73,61,127,54,20,11,9,67
"2011","Horsham 002B","E01031645",1069,246,49,197,330,155,77,49,71,43,11,7,4,87
"2011","Horsham 002C","E01031646",1137,210,43,167,328,192,87,65,82,61,17,7,10,95
"2011","Horsham 002D","E01031647",875,141,27,114,232,130,64,59,94,82,20,9,11,53
"2011","Horsham 002E","E01031649",865,120,25,95,227,164,62,65,113,56,13,4,9,45
"2011","Horsham 002F","E01031650",960,176,51,125,257,175,91,41,82,41,15,6,9,82
"2011","Horsham 002G","E01031666",1157,188,29,159,325,230,97,82,120,43,14,11,3,58
"2011","Horsham 002H","E01031668",1054,136,18,118,246,194,81,90,149,88,16,8,8,54
"2011","Horsham 003A","E01031620",1173,118,26,92,265,167,126,107,173,111,38,21,17,68
"2011","Horsham 003B","E01031648",1210,207,31,176,325,184,75,81,149,105,29,18,11,55
"2011","Horsham 003C","E01031651",1185,170,38,132,298,191,102,77,149,91,40,25,15,67
"2011","Horsham 003D","E01031658",1500,246,61,185,365,190,214,79,163,91,72,53,19,80
"2011","Horsham 003E","E01031689",1114,209,45,164,294,181,95,68,105,65,21,7,14,76
"2011","Horsham 004A","E01031654",1100,180,34,146,323,169,74,82,126,43,24,18,6,79
"2011","Horsham 004B","E01031655",1082,157,33,124,315,135,111,83,127,71,24,14,10,59
"2011","Horsham 004C","E01031667",1133,128,29,99,256,178,108,91,164,123,26,10,16,59
"2011","Horsham 004D","E01031669",1128,129,25,104,253,161,98,101,155,121,44,23,21,66
"2011","Horsham 004E","E01031672",1272,232,41,191,367,234,64,76,123,77,40,23,17,59
"2011","Horsham 005A","E01031657",1512,216,62,154,363,162,185,73,174,108,142,126,16,89
"2011","Horsham 005B","E01031659",1104,173,39,134,280,146,173,53,110,61,21,16,5,87
"2011","Horsham 005C","E01031674",983,163,48,115,282,118,158,34,66,40,14,9,5,108
"2011","Horsham 005D","E01031675",996,191,55,136,251,133,165,38,86,65,23,13,10,44
"2011","Horsham 006A","E01031636",1510,211,37,174,356,194,113,122,245,125,74,46,28,70
"2011","Horsham 006B","E01031652",1203,106,24,82,221,135,86,111,215,174,68,40,28,87
"2011","Horsham 006C","E01031653",1240,193,27,166,379,162,95,89,134,76,48,21,27,64
"2011","Horsham 006D","E01031656",1246,160,38,122,320,161,110,94,169,119,41,27,14,72
"2011","Horsham 006E","E01031688",915,127,22,105,225,125,84,67,132,78,31,19,12,46
"2011","Horsham 006F","E01031691",1158,185,36,149,343,191,96,72,138,70,13,8,5,50
"2011","Horsham 007A","E01031619",1162,136,34,102,283,188,127,80,154,92,21,3,18,81
"2011","Horsham 007B","E01031637",1342,160,34,126,282,191,119,112,211,144,49,25,24,74
"2011","Horsham 007C","E01031638",1336,196,40,156,368,233,137,93,161,76,17,6,11,55
"2011","Horsham 007D","E01031690",1046,170,33,137,297,181,117,53,117,38,17,10,7,56
"2011","Horsham 008A","E01031639",1352,235,54,181,397,221,127,75,126,64,35,19,16,72
"2011","Horsham 008B","E01031640",1314,287,64,223,385,213,132,41,105,42,15,9,6,94
"2011","Horsham 008C","E01031660",895,215,52,163,241,118,131,45,61,26,14,8,6,44
"2011","Horsham 008D","E01031661",1199,214,61,153,344,165,151,82,97,69,20,14,6,57
"2011","Horsham 008E","E01031679",1224,159,31,128,327,114,103,57,56,29,14,9,5,365
"2011","Horsham 009A","E01031677",1059,103,29,74,221,150,114,89,181,113,30,13,17,58
"2011","Horsham 009B","E01031678",1180,180,43,137,336,206,104,61,134,56,15,9,6,88
"2011","Horsham 009C","E01031680",1011,183,52,131,306,178,90,31,85,55,7,5,2,76
"2011","Horsham 009D","E01031681",1055,159,40,119,266,174,90,75,130,76,18,11,7,67
"2011","Horsham 009E","E01031682",878,113,27,86,234,165,78,59,96,56,17,7,10,60
"2011","Horsham 009F","E01031683",1109,125,26,99,247,198,116,101,153,87,19,8,11,63
"2011","Horsham 010A","E01031611",1230,183,52,131,321,134,243,60,120,75,33,24,9,61
"2011","Horsham 010B","E01031612",1522,233,54,179,403,237,160,91,195,128,16,7,9,59
"2011","Horsham 010C","E01031613",1477,231,47,184,404,190,202,91,150,110,23,13,10,76
"2011","Horsham 010D","E01031614",1354,154,35,119,325,176,177,83,211,107,50,24,26,71
"2011","Horsham 010E","E01031615",1084,161,31,130,286,189,116,52,126,71,26,10,16,57
"2011","Horsham 011A","E01031632",1169,215,56,159,315,137,221,61,86,53,28,17,11,53
"2011","Horsham 011B","E01031633",962,149,45,104,233,111,163,53,97,77,26,15,11,53
"2011","Horsham 011C","E01031634",891,137,31,106,219,111,123,83,95,53,18,6,12,52
"2011","Horsham 011D","E01031635",1066,121,30,91,267,154,149,74,123,87,25,16,9,66
"2011","Horsham 012A","E01031621",1215,312,83,229,372,190,136,45,71,35,19,14,5,35
"2011","Horsham 012B","E01031623",1276,227,71,156,371,156,228,53,106,60,13,7,6,62
"2011","Horsham 012C","E01031627",1373,231,62,169,398,201,174,66,128,63,30,12,18,82
"2011","Horsham 012D","E01031664",1176,196,43,153,316,138,237,46,93,60,26,17,9,64
"2011","Horsham 013A","E01031626",1053,190,45,145,300,102,167,50,107,72,34,22,12,31
"2011","Horsham 013B","E01031630",1172,174,49,125,273,153,176,84,149,90,27,19,8,46
"2011","Horsham 013C","E01031631",1047,120,33,87,217,135,141,62,163,145,34,21,13,30
"2011","Horsham 013D","E01031662",1107,164,40,124,275,152,136,78,133,81,35,15,20,53
"2011","Horsham 013E","E01031663",1298,131,38,93,257,152,165,107,220,158,35,18,17,73
"2011","Horsham 013F","E01031665",900,137,33,104,234,106,136,53,97,73,28,17,11,36
"2011","Horsham 014A","E01031618",1011,175,44,131,268,117,173,51,84,63,22,16,6,58
"2011","Horsham 014B","E01031641",1071,177,33,144,308,138,177,45,102,49,12,8,4,63
"2011","Horsham 014C","E01031642",1309,205,48,157,307,171,211,74,144,77,41,26,15,79
"2011","Horsham 014D","E01031643",1085,80,28,52,261,121,136,80,185,118,43,26,17,61
"2011","Horsham 014E","E01031687",1222,128,29,99,260,133,168,78,166,107,37,22,15,145
"2011","Horsham 015A","E01031622",1200,198,56,142,320,154,192,66,124,65,17,11,6,64
"2011","Horsham 015B","E01031624",1134,170,38,132,313,119,161,67,119,99,27,16,11,59
"2011","Horsham 015C","E01031625",1068,162,35,127,302,166,126,71,102,56,11,7,4,72
"2011","Horsham 015D","E01031628",934,118,29,89,236,109,128,62,98,88,37,26,11,58
"2011","Horsham 015E","E01031629",1067,214,56,158,318,132,154,39,86,57,24,17,7,43
"2011","Horsham 016A","E01031616",1178,125,26,99,267,151,182,91,146,114,26,11,15,76
"2011","Horsham 016B","E01031617",1755,265,74,191,462,243,257,108,169,100,30,18,12,121
"2011","Horsham 016C","E01031684",1053,207,50,157,326,152,109,52,103,31,12,8,4,61
"2011","Horsham 016D","E01031685",1151,204,45,159,348,148,176,61,85,42,27,14,13,60
"2011","Horsham 016E","E01031686",991,162,34,128,300,129,125,38,120,44,11,8,3,62
"2011","Mid Sussex 001A","E01031731",1388,91,27,64,262,183,160,147,233,181,51,30,21,80
"2011","Mid Sussex 001B","E01031732",1296,136,39,97,300,206,137,100,178,132,32,16,16,75
"2011","Mid Sussex 001C","E01031733",1279,137,32,105,316,205,148,74,188,91,39,23,16,81
"2011","Mid Sussex 001D","E01031734",1261,160,49,111,329,183,133,72,158,105,22,9,13,99
"2011","Mid Sussex 001E","E01031741",1238,167,32,135,354,166,161,69,149,84,38,19,19,50
"2011","Mid Sussex 001F","E01031742",1278,175,32,143,362,159,142,85,156,118,25,13,12,56
"2011","Mid Sussex 001G","E01031743",1258,128,21,107,266,164,124,113,223,133,52,24,28,55
"2011","Mid Sussex 002A","E01031718",1396,173,51,122,376,209,156,120,157,87,30,20,10,88
"2011","Mid Sussex 002B","E01031719",1296,197,42,155,335,213,152,84,156,62,20,9,11,77
"2011","Mid Sussex 002C","E01031720",1023,179,48,131,259,164,110,65,100,50,35,23,12,61
"2011","Mid Sussex 002D","E01031722",1011,125,22,103,232,105,117,68,79,65,25,18,7,195
"2011","Mid Sussex 003A","E01031695",1088,136,29,107,331,170,145,64,106,44,18,12,6,74
"2011","Mid Sussex 003B","E01031696",964,119,19,100,259,136,138,64,102,60,25,8,17,61
"2011","Mid Sussex 003C","E01031729",1384,217,52,165,391,257,134,68,138,70,27,11,16,82
"2011","Mid Sussex 003D","E01031730",1389,171,44,127,368,217,135,120,182,100,18,9,9,78
"2011","Mid Sussex 003E","E01031735",1309,180,36,144,388,248,135,67,154,46,17,9,8,74
"2011","Mid Sussex 004A","E01031736",1217,228,60,168,334,167,147,61,119,55,35,26,9,71
"2011","Mid Sussex 004B","E01031737",1108,142,40,102,302,166,135,64,142,72,16,9,7,69
"2011","Mid Sussex 004C","E01031738",852,141,29,112,242,157,94,42,73,35,8,8,0,60
"2011","Mid Sussex 004D","E01031739",1319,191,48,143,380,234,124,76,153,68,17,9,8,76
"2011","Mid Sussex 004E","E01031740",962,134,37,97,274,162,109,70,93,42,16,13,3,62
"2011","Mid Sussex 005A","E01031721",1056,111,32,79,252,171,147,84,141,95,18,11,7,37
"2011","Mid Sussex 005B","E01031723",1086,181,53,128,325,163,135,62,107,37,25,17,8,51
"2011","Mid Sussex 005C","E01031724",1063,142,24,118,284,194,94,79,131,56,12,9,3,71
"2011","Mid Sussex 005D","E01031725",1090,142,37,105,297,204,131,77,122,58,12,6,6,47
"2011","Mid Sussex 006A","E01031694",1392,205,44,161,323,153,143,85,134,84,33,16,17,232
"2011","Mid Sussex 006B","E01031764",1007,168,37,131,295,131,126,52,112,57,19,14,5,47
"2011","Mid Sussex 006C","E01031765",1158,182,53,129,316,153,167,60,102,61,44,37,7,73
"2011","Mid Sussex 006D","E01031766",1619,247,58,189,457,193,245,92,161,98,38,28,10,88
"2011","Mid Sussex 007A","E01031692",1535,218,50,168,403,224,177,100,180,121,32,21,11,80
"2011","Mid Sussex 007B","E01031693",1282,261,74,187,352,157,164,70,116,74,23,18,5,65
"2011","Mid Sussex 007C","E01031697",873,184,50,134,261,94,136,35,61,44,20,13,7,38
"2011","Mid Sussex 007D","E01031727",1224,247,61,186,342,141,198,40,103,46,26,13,13,81
"2011","Mid Sussex 008A","E01031758",1070,179,38,141,304,189,83,48,132,52,15,11,4,68
"2011","Mid Sussex 008B","E01031760",1270,260,54,206,415,205,83,58,111,46,17,5,12,75
"2011","Mid Sussex 008C","E01031772",1114,170,44,126,335,140,108,70,138,69,24,18,6,60
"2011","Mid Sussex 008D","E01031773",1332,293,69,224,464,204,112,38,89,38,23,18,5,71
"2011","Mid Sussex 008E","E01031774",1108,217,47,170,402,165,97,45,74,38,18,10,8,52
"2011","Mid Sussex 008F","E01031775",1150,261,63,198,369,195,98,28,97,28,18,12,6,56
"2011","Mid Sussex 009A","E01031751",1972,294,52,242,557,289,185,153,234,119,43,22,21,98
"2011","Mid Sussex 009B","E01031759",1210,238,50,188,373,211,78,65,105,48,21,10,11,71
"2011","Mid Sussex 009C","E01031761",1533,260,44,216,418,238,128,90,194,99,35,22,13,71
"2011","Mid Sussex 009E","E01032837",845,177,36,141,286,121,62,25,72,34,22,16,6,46
"2011","Mid Sussex 009F","E01032838",984,215,46,169,298,172,82,51,77,37,14,9,5,38
"2011","Mid Sussex 009G","E01032839",872,201,34,167,262,165,51,44,68,20,14,8,6,47
"2011","Mid Sussex 010A","E01031752",976,44,8,36,163,97,91,88,232,136,64,41,23,61
"2011","Mid Sussex 010B","E01031753",963,160,36,124,265,156,76,50,125,53,17,9,8,61
"2011","Mid Sussex 010C","E01031754",1149,120,24,96,340,190,97,89,131,82,22,13,9,78
"2011","Mid Sussex 010D","E01031755",939,108,22,86,270,166,86,55,116,72,22,16,6,44
"2011","Mid Sussex 010E","E01031757",1112,81,20,61,272,203,122,80,173,115,27,16,11,39
"2011","Mid Sussex 011A","E01031726",1041,159,38,121,295,147,106,51,118,70,26,7,19,69
"2011","Mid Sussex 011B","E01031728",1399,282,70,212,423,187,188,48,96,48,19,9,10,108
"2011","Mid Sussex 011C","E01031749",1071,146,36,110,345,197,90,45,111,63,22,15,7,52
"2011","Mid Sussex 011D","E01031750",1083,96,21,75,236,163,106,87,192,109,36,28,8,58
"2011","Mid Sussex 011E","E01031756",1374,282,72,210,414,196,141,56,132,62,20,13,7,71
"2011","Mid Sussex 011F","E01031763",1242,293,53,240,390,214,71,42,94,31,25,14,11,82
"2011","Mid Sussex 012A","E01031699",1258,179,48,131,362,238,98,92,138,51,15,10,5,85
"2011","Mid Sussex 012B","E01031700",1219,183,49,134,367,219,99,61,116,66,14,7,7,94
"2011","Mid Sussex 012C","E01031701",1335,155,33,122,325,199,136,107,203,101,39,27,12,70
"2011","Mid Sussex 012D","E01031714",1034,92,31,61,217,178,97,79,172,105,27,19,8,67
"2011","Mid Sussex 013A","E01031704",1253,159,41,118,318,240,123,88,176,68,29,13,16,52
"2011","Mid Sussex 013B","E01031706",1243,124,25,99,307,196,134,87,189,96,31,20,11,79
"2011","Mid Sussex 013C","E01031711",1279,157,36,121,307,207,138,93,178,92,26,15,11,81
"2011","Mid Sussex 013D","E01031712",1049,94,26,68,212,148,99,104,164,125,38,24,14,65
"2011","Mid Sussex 013E","E01031713",1035,121,28,93,264,206,103,82,134,65,7,5,2,53
"2011","Mid Sussex 014A","E01031705",1166,90,18,72,250,150,106,86,210,164,45,25,20,65
"2011","Mid Sussex 014B","E01031707",1156,122,35,87,267,193,99,101,166,82,54,45,9,72
"2011","Mid Sussex 014C","E01031708",1247,142,26,116,276,194,109,101,191,119,50,34,16,65
"2011","Mid Sussex 014D","E01031709",1177,142,36,106,263,166,93,97,192,115,39,28,11,70
"2011","Mid Sussex 014E","E01031716",842,50,8,42,150,105,82,75,181,124,34,22,12,41
"2011","Mid Sussex 014F","E01031717",1015,111,17,94,237,159,121,83,148,73,33,24,9,50
"2011","Mid Sussex 015A","E01031702",1083,174,50,124,322,210,92,52,96,40,16,10,6,81
"2011","Mid Sussex 015B","E01031703",1187,203,51,152,331,227,85,48,96,56,16,9,7,125
"2011","Mid Sussex 015C","E01031710",1003,106,25,81,213,171,120,86,141,86,24,15,9,56
"2011","Mid Sussex 015D","E01031715",1120,202,53,149,315,196,107,76,111,39,13,6,7,61
"2011","Mid Sussex 016A","E01031698",1197,215,44,171,315,140,214,58,93,56,15,8,7,91
"2011","Mid Sussex 016B","E01031767",1080,131,31,100,319,130,130,44,95,49,58,52,6,124
"2011","Mid Sussex 016C","E01031769",1223,189,38,151,370,168,174,60,114,74,29,22,7,45
"2011","Mid Sussex 016D","E01031770",1199,207,40,167,338,127,234,54,90,63,25,8,17,61
"2011","Mid Sussex 016E","E01031771",1112,152,32,120,272,135,143,77,131,104,33,18,15,65
"2011","Mid Sussex 017A","E01031744",1050,161,38,123,321,175,116,52,104,53,12,9,3,56
"2011","Mid Sussex 017B","E01031745",1203,187,32,155,350,221,125,59,133,59,15,9,6,54
"2011","Mid Sussex 017C","E01031746",1154,140,42,98,299,158,127,61,162,95,33,22,11,79
"2011","Mid Sussex 017D","E01031747",948,161,32,129,283,156,103,49,90,46,16,10,6,44
"2011","Mid Sussex 017E","E01031748",874,148,23,125,281,114,109,30,87,48,5,3,2,52
"2011","Mid Sussex 017F","E01031768",1001,207,55,152,330,158,104,42,56,34,17,12,5,53
"2011","Worthing 001A","E01031793",952,104,25,79,211,191,125,64,137,64,15,8,7,41
"2011","Worthing 001B","E01031820",1162,183,43,140,301,211,164,55,109,61,15,10,5,63
"2011","Worthing 001C","E01031821",1164,132,30,102,278,179,170,70,161,92,23,15,8,59
"2011","Worthing 001D","E01031828",952,173,46,127,290,160,113,35,88,31,15,7,8,47
"2011","Worthing 001E","E01031829",1113,148,31,117,285,190,141,61,139,70,16,8,8,63
"2011","Worthing 002A","E01031822",1100,167,37,130,291,200,132,59,126,45,10,6,4,70
"2011","Worthing 002B","E01031825",1154,113,29,84,271,205,142,95,169,95,22,14,8,42
"2011","Worthing 002C","E01031826",994,83,25,58,209,155,97,92,179,97,27,14,13,55
"2011","Worthing 002D","E01031827",1022,92,19,73,225,181,119,86,159,78,39,26,13,43
"2011","Worthing 002E","E01031839",1233,138,33,105,298,202,120,100,169,86,40,30,10,80
"2011","Worthing 003A","E01031792",959,106,23,83,184,171,107,57,151,99,36,22,14,48
"2011","Worthing 003B","E01031794",917,72,27,45,185,126,121,85,171,79,28,19,9,50
"2011","Worthing 003C","E01031795",1079,75,19,56,199,192,111,79,209,106,49,35,14,59
"2011","Worthing 003D","E01031818",1538,108,33,75,278,251,128,130,296,149,83,57,26,115
"2011","Worthing 003E","E01031830",1106,81,15,66,205,160,115,83,190,137,54,36,18,81
"2011","Worthing 004A","E01031778",1108,146,31,115,269,181,120,60,144,71,53,45,8,64
"2011","Worthing 004B","E01031797",933,126,26,100,254,157,103,62,108,41,14,6,8,68
"2011","Worthing 004C","E01031800",1049,136,29,107,268,188,128,64,131,53,12,5,7,69
"2011","Worthing 004D","E01031823",1010,174,47,127,273,154,145,48,98,30,20,19,1,68
"2011","Worthing 004E","E01031824",981,141,29,112,290,158,110,45,98,46,16,8,8,77
"2011","Worthing 005A","E01031776",1144,121,30,91,286,196,113,87,162,97,25,13,12,57
"2011","Worthing 005B","E01031777",1209,89,12,77,233,204,144,111,185,120,36,21,15,87
"2011","Worthing 005C","E01031780",1116,84,18,66,238,200,119,103,165,98,18,13,5,91
"2011","Worthing 005D","E01031781",1168,109,28,81,256,191,118,95,181,113,31,18,13,74
"2011","Worthing 005E","E01031798",1165,126,27,99,275,147,136,59,168,112,49,27,22,93
"2011","Worthing 006A","E01031783",1025,56,13,43,162,119,91,78,238,135,71,48,23,75
"2011","Worthing 006B","E01031785",1053,84,25,59,200,182,121,80,195,104,31,18,13,56
"2011","Worthing 006C","E01031786",1103,45,9,36,199,189,111,108,209,144,40,22,18,58
"2011","Worthing 006D","E01031817",1209,140,23,117,258,187,122,84,181,95,51,34,17,91
"2011","Worthing 006E","E01031819",898,45,14,31,124,124,93,77,155,133,81,51,30,66
"2011","Worthing 007A","E01031782",1160,111,33,78,242,211,136,90,167,111,30,20,10,62
"2011","Worthing 007B","E01031784",1291,116,37,79,248,236,137,111,212,108,42,25,17,81
"2011","Worthing 007C","E01031836",1203,92,30,62,231,169,138,100,222,134,52,27,25,65
"2011","Worthing 007D","E01031838",1129,146,32,114,287,177,122,79,133,78,33,15,18,74
"2011","Worthing 007E","E01031840",1239,124,29,95,276,248,116,94,197,94,33,16,17,57
"2011","Worthing 008A","E01031791",1500,105,25,80,314,204,132,102,278,168,99,54,45,98
"2011","Worthing 008B","E01031796",1140,100,16,84,264,169,117,83,185,93,51,27,24,78
"2011","Worthing 008C","E01031799",1104,84,18,66,250,144,128,83,148,112,56,38,18,99
"2011","Worthing 008D","E01031801",1279,142,32,110,323,171,104,86,197,89,55,28,27,112
"2011","Worthing 008E","E01031837",1412,146,35,111,373,199,149,89,190,125,38,21,17,103
"2011","Worthing 009A","E01031779",898,38,11,27,121,123,77,84,198,138,59,44,15,60
"2011","Worthing 009B","E01031831",1158,100,24,76,289,161,118,80,163,110,68,46,22,69
"2011","Worthing 009C","E01031832",1202,95,25,70,268,182,137,89,209,139,41,25,16,42
"2011","Worthing 009D","E01031833",1182,113,22,91,254,151,134,100,182,118,71,54,17,59
"2011","Worthing 009E","E01031834",1165,86,19,67,247,156,107,91,238,131,33,23,10,76
"2011","Worthing 010A","E01031790",1303,130,26,104,277,175,123,82,227,141,87,67,20,61
"2011","Worthing 010B","E01031807",1069,144,30,114,265,176,109,52,150,71,51,35,16,51
"2011","Worthing 010C","E01031809",1158,140,24,116,322,194,114,65,154,88,32,16,16,49
"2011","Worthing 010D","E01031810",1175,117,28,89,322,186,113,85,181,64,35,18,17,72
"2011","Worthing 010E","E01031811",1007,96,21,75,235,175,91,59,132,73,107,91,16,39
"2011","Worthing 011A","E01031787",1435,134,24,110,364,180,136,100,231,133,73,42,31,84
"2011","Worthing 011B","E01031788",1509,115,28,87,371,216,132,105,240,152,64,40,24,114
"2011","Worthing 011C","E01031789",1512,174,42,132,360,201,156,113,209,111,96,60,36,92
"2011","Worthing 011D","E01031808",1124,79,15,64,262,127,88,99,182,136,91,62,29,60
"2011","Worthing 011E","E01031835",1456,157,23,134,368,185,186,96,184,122,65,43,22,93
"2011","Worthing 012A","E01031812",1049,148,38,110,294,186,113,46,120,58,27,19,8,57
"2011","Worthing 012B","E01031813",1252,155,32,123,333,206,120,68,187,67,38,24,14,78
"2011","Worthing 012C","E01031814",1123,157,46,111,316,204,115,53,109,71,18,11,7,80
"2011","Worthing 012D","E01031815",1058,149,40,109,325,186,107,61,96,54,28,12,16,52
"2011","Worthing 012E","E01031816",1122,133,32,101,324,191,126,67,140,47,21,15,6,73
"2011","Worthing 013A","E01031802",1008,106,26,80,238,205,125,68,152,60,22,14,8,32
"2011","Worthing 013B","E01031803",1041,192,37,155,284,179,147,36,80,35,19,11,8,69
"2011","Worthing 013C","E01031804",1095,165,45,120,316,194,109,45,126,58,23,15,8,59
"2011","Worthing 013D","E01031805",1023,139,45,94,298,182,135,55,107,47,16,10,6,44
"2011","Worthing 013E","E01031806",1141,90,19,71,211,188,107,90,187,140,49,29,20,79
"2011","Bath and North East Somerset 001A","E01014399",1200,108,22,86,255,200,142,93,180,115,32,19,13,75
"2011","Bath and North East Somerset 001B","E01014400",1397,175,32,143,338,196,151,93,195,117,42,22,20,90
"2011","Bath and North East Somerset 001C","E01014401",1145,76,24,52,184,156,109,79,226,180,54,37,17,81
"2011","Bath and North East Somerset 002A","E01014402",1216,77,10,67,226,198,125,101,240,156,28,15,13,65
"2011","Bath and North East Somerset 002B","E01014403",1092,110,21,89,252,151,109,80,173,118,32,28,4,67
"2011","Bath and North East Somerset 002C","E01014404",1117,70,14,56,211,170,105,81,226,145,42,26,16,67
"2011","Bath and North East Somerset 003A","E01014395",904,142,30,112,263,181,84,31,82,40,16,10,6,65
"2011","Bath and North East Somerset 003B","E01014396",963,124,19,105,239,153,87,57,132,77,25,19,6,69
"2011","Bath and North East Somerset 003C","E01014397",906,132,23,109,258,165,86,36,82,44,17,8,9,86
"2011","Bath and North East Somerset 003D","E01014398",1020,130,22,108,259,184,99,57,140,57,15,5,10,79
"2011","Bath and North East Somerset 004A","E01014409",1130,144,29,115,298,118,123,70,140,118,29,13,16,90
"2011","Bath and North East Somerset 004B","E01014410",1244,192,24,168,396,148,117,55,138,71,23,10,13,104
"2011","Bath and North East Somerset 004C","E01014411",1525,300,63,237,457,174,179,69,122,79,33,15,18,112
"2011","Bath and North East Somerset 005A","E01014477",1032,165,40,125,299,144,104,51,99,51,27,13,14,92
"2011","Bath and North East Somerset 005B","E01014478",816,68,14,54,163,102,73,69,122,113,27,15,12,79
"2011","Bath and North East Somerset 005C","E01014479",932,242,53,189,254,131,92,24,54,44,10,9,1,81
"2011","Bath and North East Somerset 005D","E01014480",873,98,17,81,235,82,89,67,124,85,25,17,8,68
"2011","Bath and North East Somerset 006A","E01014465",1141,222,30,192,360,111,105,47,100,42,29,17,12,125
"2011","Bath and North East Somerset 006B","E01014466",975,160,12,148,220,81,80,61,118,74,56,22,34,125
"2011","Bath and North East Somerset 006C","E01014467",1321,234,58,176,390,135,129,78,120,52,26,13,13,157
"2011","Bath and North East Somerset 006D","E01014468",1269,212,35,177,341,113,83,68,91,52,28,14,14,281
"2011","Bath and North East Somerset 007A","E01014370",1442,185,24,161,323,105,92,77,153,109,43,24,19,355
"2011","Bath and North East Somerset 007B","E01014371",1510,321,62,259,356,125,149,68,102,73,37,25,12,279
"2011","Bath and North East Somerset 007C","E01014372",1776,348,47,301,482,130,144,75,114,90,85,48,37,308
"2011","Bath and North East Somerset 007D","E01014412",1121,273,36,237,325,102,111,32,68,35,12,4,8,163
"2011","Bath and North East Somerset 007E","E01014413",1071,252,46,206,321,99,108,25,48,18,19,13,6,181
"2011","Bath and North East Somerset 007F","E01014414",1305,226,41,185,288,112,106,62,115,77,50,27,23,269
"2011","Bath and North East Somerset 008A","E01014427",1052,150,26,124,304,87,78,45,101,64,18,8,10,205
"2011","Bath and North East Somerset 008B","E01014428",1002,252,53,199,272,100,82,37,75,36,24,17,7,124
"2011","Bath and North East Somerset 008C","E01014429",1112,202,29,173,318,120,102,41,100,73,13,4,9,143
"2011","Bath and North East Somerset 008D","E01014430",1027,175,29,146,304,152,77,41,117,64,15,10,5,82
"2011","Bath and North East Somerset 009A","E01014405",1572,261,40,221,441,138,125,67,106,56,26,18,8,352
"2011","Bath and North East Somerset 009C","E01014407",1076,119,18,101,197,67,56,58,113,89,34,22,12,343
"2011","Bath and North East Somerset 009E","E01033080",1940,293,59,234,452,142,172,82,153,121,59,43,16,466
"2011","Bath and North East Somerset 010A","E01014373",1106,163,39,124,242,107,165,58,166,90,35,25,10,80
"2011","Bath and North East Somerset 010B","E01014374",948,172,39,133,252,122,116,50,94,64,35,21,14,43
"2011","Bath and North East Somerset 010C","E01014375",935,191,52,139,260,85,180,36,69,30,28,19,9,56
"2011","Bath and North East Somerset 010D","E01014376",1058,246,59,187,327,134,140,28,76,34,14,8,6,59
"2011","Bath and North East Somerset 010E","E01014377",941,225,48,177,270,125,109,27,67,38,13,6,7,67
"2011","Bath and North East Somerset 010G","E01033078",1337,262,60,202,400,122,188,43,83,32,15,12,3,192
"2011","Bath and North East Somerset 010H","E01033079",842,139,26,113,259,69,154,27,75,52,17,11,6,50
"2011","Bath and North East Somerset 011A","E01014461",855,53,11,42,153,87,49,66,157,150,38,26,12,102
"2011","Bath and North East Somerset 011B","E01014462",1024,33,8,25,136,90,70,92,217,192,88,50,38,106
"2011","Bath and North East Somerset 011C","E01014463",1001,34,10,24,110,120,75,83,192,194,116,96,20,77
"2011","Bath and North East Somerset 011D","E01014464",954,51,8,43,131,99,73,62,187,160,87,54,33,104
"2011","Bath and North East Somerset 012A","E01014380",2943,198,40,158,226,75,92,21,47,31,14,11,3,2239
"2011","Bath and North East Somerset 012B","E01014381",1071,229,39,190,248,66,104,22,72,21,20,17,3,289
"2011","Bath and North East Somerset 012C","E01014481",1275,188,25,163,262,81,47,31,65,45,16,11,5,540
"2011","Bath and North East Somerset 012D","E01014482",923,250,37,213,276,64,113,14,34,15,12,8,4,145
"2011","Bath and North East Somerset 012E","E01014483",1194,206,42,164,258,91,91,33,86,59,30,13,17,340
"2011","Bath and North East Somerset 012F","E01014484",1366,140,14,126,243,83,61,55,79,60,17,8,9,628
"2011","Bath and North East Somerset 013A","E01014473",1359,124,19,105,216,100,73,49,99,65,25,14,11,608
"2011","Bath and North East Somerset 013B","E01014474",982,72,11,61,153,95,80,43,145,95,23,16,7,276
"2011","Bath and North East Somerset 013C","E01014475",1944,118,14,104,211,88,77,61,126,81,19,12,7,1163
"2011","Bath and North East Somerset 013D","E01014476",1195,100,17,83,194,113,71,60,109,61,20,10,10,467
"2011","Bath and North East Somerset 014A","E01014435",1394,72,12,60,157,77,36,52,86,58,12,7,5,844
"2011","Bath and North East Somerset 014B","E01014436",1256,124,18,106,207,86,65,47,119,72,24,19,5,512
"2011","Bath and North East Somerset 014C","E01014437",1020,93,13,80,187,123,99,67,188,93,35,27,8,135
"2011","Bath and North East Somerset 014D","E01014438",987,59,9,50,161,108,76,66,148,120,34,25,9,215
"2011","Bath and North East Somerset 015A","E01014455",944,69,8,61,181,133,75,76,152,144,35,19,16,79
"2011","Bath and North East Somerset 015B","E01014456",1114,101,23,78,222,140,91,79,180,131,29,21,8,141
"2011","Bath and North East Somerset 015C","E01014457",1050,95,16,79,231,180,96,65,168,99,24,12,12,92
"2011","Bath and North East Somerset 015D","E01014458",937,41,7,34,109,79,68,80,190,190,65,43,22,115
"2011","Bath and North East Somerset 016A","E01014391",1072,157,35,122,292,140,153,58,125,65,24,16,8,58
"2011","Bath and North East Somerset 016B","E01014392",779,120,24,96,190,86,133,38,91,58,10,4,6,53
"2011","Bath and North East Somerset 016C","E01014452",1003,146,24,122,243,147,132,63,115,79,16,12,4,62
"2011","Bath and North East Somerset 016D","E01014453",875,146,29,117,264,124,104,37,72,47,12,10,2,69
"2011","Bath and North East Somerset 016E","E01014454",996,172,35,137,328,175,84,45,84,36,10,6,4,62
"2011","Bath and North East Somerset 016F","E01014459",1032,111,26,85,217,117,118,80,149,126,63,51,12,51
"2011","Bath and North East Somerset 016G","E01014460",874,116,24,92,222,135,108,57,101,83,9,6,3,43
"2011","Bath and North East Somerset 017A","E01014415",1498,346,43,303,445,126,130,43,105,40,25,14,11,238
"2011","Bath and North East Somerset 017B","E01014416",1176,241,67,174,353,123,106,37,104,71,13,8,5,128
"2011","Bath and North East Somerset 017C","E01014417",1306,275,43,232,396,148,118,40,86,60,32,23,9,151
"2011","Bath and North East Somerset 018A","E01014387",855,129,25,104,220,90,71,47,67,60,23,15,8,148
"2011","Bath and North East Somerset 018B","E01014388",886,184,29,155,255,107,103,28,66,27,24,14,10,92
"2011","Bath and North East Somerset 018C","E01014389",953,135,33,102,237,107,106,30,93,66,16,10,6,163
"2011","Bath and North East Somerset 018D","E01014390",1070,44,6,38,140,124,93,72,233,189,87,58,29,88
"2011","Bath and North East Somerset 019A","E01014431",929,86,13,73,161,122,87,77,149,117,23,16,7,107
"2011","Bath and North East Somerset 019B","E01014432",940,73,10,63,196,108,82,69,143,102,37,25,12,130
"2011","Bath and North East Somerset 019C","E01014433",952,87,19,68,204,128,92,61,156,86,50,31,19,88
"2011","Bath and North East Somerset 019D","E01014434",1396,159,21,138,346,200,136,101,194,108,25,17,8,127
"2011","Bath and North East Somerset 020A","E01014385",995,134,27,107,259,130,163,38,113,59,32,23,9,67
"2011","Bath and North East Somerset 020B","E01014386",850,102,27,75,179,125,114,70,121,74,9,7,2,56
"2011","Bath and North East Somerset 020C","E01014419",885,89,22,67,208,106,120,59,123,94,14,8,6,72
"2011","Bath and North East Somerset 020D","E01014446",852,101,24,77,192,104,144,58,105,70,11,4,7,67
"2011","Bath and North East Somerset 020E","E01014447",982,78,22,56,211,166,124,76,155,81,24,19,5,67
"2011","Bath and North East Somerset 021A","E01014382",1728,305,49,256,459,190,313,53,186,97,22,16,6,103
"2011","Bath and North East Somerset 021B","E01014383",757,151,29,122,207,84,115,30,68,47,8,5,3,47
"2011","Bath and North East Somerset 021C","E01014384",958,135,27,108,250,106,125,55,116,64,25,17,8,82
"2011","Bath and North East Somerset 021D","E01014418",1033,194,44,150,262,115,167,35,99,84,19,15,4,58
"2011","Bath and North East Somerset 022A","E01014379",1900,220,53,167,368,171,242,74,169,117,46,25,21,493
"2011","Bath and North East Somerset 022B","E01014442",1268,138,32,106,310,183,104,111,204,123,27,16,11,68
"2011","Bath and North East Somerset 022C","E01014443",1175,135,23,112,274,169,151,76,161,102,19,8,11,88
"2011","Bath and North East Somerset 022D","E01014444",1099,139,31,108,264,142,139,70,146,112,24,16,8,63
"2011","Bath and North East Somerset 022E","E01014445",1142,62,17,45,161,135,118,107,228,193,61,38,23,77
"2011","Bath and North East Somerset 023A","E01014393",950,110,18,92,254,141,112,45,130,86,22,16,6,50
"2011","Bath and North East Somerset 023B","E01014394",1224,133,30,103,294,150,160,95,158,139,33,20,13,62
"2011","Bath and North East Somerset 023C","E01014439",1188,65,20,45,179,152,108,114,262,217,43,35,8,48
"2011","Bath and North East Somerset 023D","E01014440",1428,140,31,109,294,204,125,132,237,176,30,12,18,90
"2011","Bath and North East Somerset 023E","E01014441",1189,112,29,83,252,165,126,94,190,163,23,14,9,64
"2011","Bath and North East Somerset 024A","E01014448",1116,63,19,44,185,132,125,99,222,170,60,36,24,60
"2011","Bath and North East Somerset 024B","E01014449",1039,89,20,69,219,130,103,92,183,119,35,18,17,69
"2011","Bath and North East Somerset 024C","E01014450",934,59,22,37,153,96,73,86,191,160,48,26,22,68
"2011","Bath and North East Somerset 024D","E01014451",952,78,12,66,183,125,78,92,177,123,32,17,15,64
"2011","Bath and North East Somerset 025A","E01014420",1156,94,23,71,209,168,120,116,222,144,25,16,9,58
"2011","Bath and North East Somerset 025B","E01014421",1030,112,32,80,211,167,90,93,147,108,18,11,7,84
"2011","Bath and North East Somerset 025C","E01014422",1076,118,30,88,215,180,111,115,156,97,18,12,6,66
"2011","Bath and North East Somerset 025D","E01014423",997,83,16,67,205,128,94,92,171,127,33,20,13,64
"2011","Bath and North East Somerset 026A","E01014469",852,38,10,28,124,73,73,106,177,181,30,18,12,50
"2011","Bath and North East Somerset 026B","E01014470",1192,74,24,50,190,160,89,147,257,186,25,13,12,64
"2011","Bath and North East Somerset 026C","E01014471",1171,78,20,58,206,128,92,130,224,210,45,28,17,58
"2011","Bath and North East Somerset 026D","E01014472",1013,75,20,55,181,158,87,104,183,142,21,16,5,62
"2011","Bath and North East Somerset 027A","E01014424",1257,117,41,76,259,189,105,110,208,170,31,27,4,68
"2011","Bath and North East Somerset 027B","E01014425",1433,107,22,85,262,216,142,135,248,180,48,38,10,95
"2011","Bath and North East Somerset 027C","E01014426",958,53,20,33,148,116,93,95,198,159,34,16,18,62
"2011","Bournemouth 001A","E01015301",1041,82,24,58,183,160,142,84,195,107,39,31,8,49
"2011","Bournemouth 001B","E01015303",1081,65,18,47,166,140,127,116,213,151,41,29,12,62
"2011","Bournemouth 001C","E01015305",1050,36,8,28,163,129,119,89,209,156,64,43,21,85
"2011","Bournemouth 001D","E01015306",1170,58,23,35,146,135,133,102,247,189,74,48,26,86
"2011","Bournemouth 002A","E01015302",1331,83,26,57,227,195,133,130,239,191,55,31,24,78
"2011","Bournemouth 002B","E01015304",1150,47,16,31,158,136,122,113,251,197,67,40,27,59
"2011","Bournemouth 002C","E01015308",1252,67,11,56,201,171,124,120,251,193,47,35,12,78
"2011","Bournemouth 002D","E01015311",949,53,17,36,175,163,132,85,183,102,21,11,10,35
"2011","Bournemouth 003A","E01015332",1074,98,29,69,241,156,157,81,165,81,19,10,9,76
"2011","Bournemouth 003B","E01015333",1108,98,22,76,255,196,129,95,171,91,10,6,4,63
"2011","Bournemouth 003C","E01015334",1062,77,18,59,197,155,127,84,198,130,29,21,8,65
"2011","Bournemouth 003D","E01015335",1211,127,34,93,249,190,152,83,202,86,35,18,17,87
"2011","Bournemouth 003E","E01015337",1253,100,24,76,249,167,140,99,212,129,34,21,13,123
"2011","Bournemouth 004A","E01015343",1050,80,15,65,207,145,150,83,166,102,41,31,10,76
"2011","Bournemouth 004B","E01015349",1049,92,18,74,236,177,125,77,167,84,34,26,8,57
"2011","Bournemouth 004C","E01015351",1082,117,22,95,271,201,103,82,169,63,21,9,12,55
"2011","Bournemouth 004D","E01015352",1062,85,14,71,248,173,98,109,173,96,22,11,11,58
"2011","Bournemouth 004E","E01015353",808,82,23,59,206,123,96,61,109,66,20,16,4,45
"2011","Bournemouth 004F","E01015354",1220,101,22,79,278,210,136,74,202,117,27,19,8,75
"2011","Bournemouth 005A","E01015307",975,30,6,24,118,108,85,91,197,209,64,40,24,73
"2011","Bournemouth 005B","E01015309",1013,29,2,27,110,103,87,77,255,208,71,46,25,73
"2011","Bournemouth 005C","E01015312",825,25,2,23,107,86,100,78,165,142,49,25,24,73
"2011","Bournemouth 005D","E01015313",959,25,9,16,102,71,81,95,207,189,84,58,26,105
"2011","Bournemouth 005E","E01015359",1195,61,17,44,184,154,122,103,236,181,54,36,18,100
"2011","Bournemouth 006A","E01015320",1260,133,27,106,264,194,161,83,159,91,34,19,15,141
"2011","Bournemouth 006B","E01015323",1135,107,25,82,274,183,148,61,150,73,24,13,11,115
"2011","Bournemouth 006C","E01015324",1142,90,10,80,272,173,141,66,161,94,36,19,17,109
"2011","Bournemouth 006D","E01015325",1212,125,29,96,288,202,149,68,174,88,23,17,6,95
"2011","Bournemouth 006E","E01015350",977,97,22,75,233,157,130,77,133,71,21,16,5,58
"2011","Bournemouth 007A","E01015310",1130,41,11,30,166,127,122,103,242,172,63,37,26,94
"2011","Bournemouth 007B","E01015336",1216,70,21,49,214,181,150,114,210,141,32,11,21,104
"2011","Bournemouth 007C","E01015355",1232,77,19,58,233,163,143,98,212,152,35,26,9,119
"2011","Bournemouth 007D","E01015357",1147,59,23,36,181,153,122,89,220,160,40,34,6,123
"2011","Bournemouth 007E","E01015358",1427,81,27,54,240,190,138,99,201,119,57,45,12,302
"2011","Bournemouth 008A","E01015338",1208,54,15,39,188,134,132,82,264,188,81,55,26,85
"2011","Bournemouth 008B","E01015339",1127,84,20,64,220,143,119,86,216,123,63,33,30,73
"2011","Bournemouth 008C","E01015340",1107,118,30,88,244,166,176,75,161,91,30,20,10,46
"2011","Bournemouth 008D","E01015341",1013,40,15,25,166,111,96,79,226,138,79,52,27,78
"2011","Bournemouth 009A","E01015321",1403,79,12,67,212,144,137,91,204,131,55,33,22,350
"2011","Bournemouth 009B","E01015356",1353,102,33,69,248,182,126,76,162,74,39,26,13,344
"2011","Bournemouth 009C","E01015374",1963,103,17,86,209,125,131,95,211,123,74,45,29,892
"2011","Bournemouth 009D","E01015375",1605,68,10,58,166,113,92,75,164,109,41,24,17,777
"2011","Bournemouth 009E","E01015377",1294,79,15,64,226,131,108,87,170,119,45,30,15,329
"2011","Bournemouth 010A","E01015322",1216,116,21,95,274,177,166,81,163,108,43,29,14,88
"2011","Bournemouth 010B","E01015330",1281,178,31,147,303,154,172,70,166,80,44,24,20,114
"2011","Bournemouth 010C","E01015342",1147,188,34,154,347,145,158,36,119,50,25,18,7,79
"2011","Bournemouth 010D","E01015373",1328,97,17,80,265,139,129,57,163,104,47,25,22,327
"2011","Bournemouth 010E","E01015378",1367,120,28,92,276,158,107,70,154,97,42,26,16,343
"2011","Bournemouth 011A","E01015314",1061,164,44,120,298,176,125,52,92,66,17,10,7,71
"2011","Bournemouth 011B","E01015315",1430,235,52,183,389,215,176,64,133,67,40,25,15,111
"2011","Bournemouth 011C","E01015318",1217,124,31,93,311,171,133,84,171,78,30,20,10,115
"2011","Bournemouth 011D","E01015319",1046,213,29,184,283,152,82,57,99,50,20,17,3,90
"2011","Bournemouth 012A","E01015344",1296,205,58,147,377,158,196,33,106,38,35,27,8,148
"2011","Bournemouth 012B","E01015346",1317,147,22,125,234,117,145,61,120,73,79,51,28,341
"2011","Bournemouth 012C","E01015348",1400,224,42,182,315,173,188,26,100,64,50,37,13,260
"2011","Bournemouth 012D","E01015360",1436,114,19,95,264,137,129,46,92,51,40,28,12,563
"2011","Bournemouth 013A","E01015326",1545,130,24,106,306,160,176,73,211,115,72,57,15,302
"2011","Bournemouth 013B","E01015331",1831,156,19,137,393,233,175,100,239,157,77,52,25,301
"2011","Bournemouth 013C","E01015345",1524,135,27,108,266,157,162,84,153,117,49,38,11,401
"2011","Bournemouth 013D","E01015376",1450,93,16,77,230,135,116,65,135,83,36,23,13,557
"2011","Bournemouth 014A","E01015316",1150,159,39,120,281,176,140,71,151,71,30,17,13,71
"2011","Bournemouth 014B","E01015317",1131,115,26,89,262,159,133,86,169,98,39,23,16,70
"2011","Bournemouth 014C","E01015361",999,88,20,68,226,118,120,63,173,103,44,21,23,64
"2011","Bournemouth 014D","E01015362",876,50,11,39,170,82,100,65,162,99,68,45,23,80
"2011","Bournemouth 014E","E01015363",1218,131,18,113,299,182,133,88,157,84,59,43,16,85
"2011","Bournemouth 015A","E01015292",1322,93,29,64,227,145,153,96,219,165,65,44,21,159
"2011","Bournemouth 015B","E01015293",1144,54,12,42,218,131,112,79,197,155,65,27,38,133
"2011","Bournemouth 015C","E01015294",1492,95,24,71,238,179,124,139,285,189,76,46,30,167
"2011","Bournemouth 015D","E01015327",1528,110,21,89,271,150,155,105,216,124,81,48,33,316
"2011","Bournemouth 015E","E01015329",1335,147,30,117,284,146,151,75,167,123,36,27,9,206
"2011","Bournemouth 016A","E01015272",1236,171,38,133,305,173,171,59,112,68,25,15,10,152
"2011","Bournemouth 016B","E01015273",1551,101,26,75,286,157,181,104,267,159,80,41,39,216
"2011","Bournemouth 016C","E01015275",1415,126,16,110,268,149,159,84,179,122,53,34,19,275
"2011","Bournemouth 016D","E01015276",1245,103,23,80,269,147,114,88,237,122,62,43,19,103
"2011","Bournemouth 016E","E01015277",1493,82,16,66,274,169,153,123,246,201,68,38,30,177
"2011","Bournemouth 017A","E01015283",1615,151,25,126,334,164,113,125,176,153,54,33,21,345
"2011","Bournemouth 017C","E01015286",1421,211,37,174,364,201,135,80,158,100,54,31,23,118
"2011","Bournemouth 017D","E01015287",1949,161,24,137,279,132,101,64,104,69,43,24,19,996
"2011","Bournemouth 017E","E01015328",1426,135,24,111,343,185,145,82,196,114,90,69,21,136
"2011","Bournemouth 017F","E01033242",819,65,5,60,164,84,54,72,119,98,45,21,24,118
"2011","Bournemouth 017G","E01033285",930,73,11,62,214,94,60,69,141,127,32,25,7,120
"2011","Bournemouth 018A","E01015274",1311,135,32,103,326,197,146,86,174,96,37,17,20,114
"2011","Bournemouth 018B","E01015297",937,119,26,93,250,128,131,43,129,59,21,15,6,57
"2011","Bournemouth 018C","E01015364",1127,161,34,127,338,152,151,46,125,46,33,19,14,75
"2011","Bournemouth 018D","E01015365",1322,107,20,87,305,162,173,88,199,108,64,40,24,116
"2011","Bournemouth 018E","E01015366",1221,146,31,115,321,132,176,64,144,82,65,56,9,91
"2011","Bournemouth 019B","E01015279",1499,81,17,64,274,149,124,129,262,254,79,47,32,147
"2011","Bournemouth 019C","E01015280",1640,114,23,91,325,142,162,116,298,224,109,87,22,150
"2011","Bournemouth 019D","E01015281",1378,61,8,53,206,105,138,116,263,224,126,88,38,139
"2011","Bournemouth 019E","E01015282",1719,61,9,52,215,140,172,143,381,331,159,86,73,117
"2011","Bournemouth 019F","E01033241",912,101,26,75,221,105,90,58,139,89,51,28,23,58
"2011","Bournemouth 019G","E01033283",915,154,30,124,254,105,111,44,93,43,35,24,11,76
"2011","Bournemouth 020A","E01015295",1022,167,36,131,318,161,128,40,102,41,19,13,6,46
"2011","Bournemouth 020B","E01015296",1242,116,29,87,341,183,175,80,157,91,59,30,29,40
"2011","Bournemouth 020C","E01015298",1010,138,25,113,260,164,143,56,131,66,20,7,13,32
"2011","Bournemouth 020D","E01015299",1178,126,33,93,300,189,168,74,144,78,24,12,12,75
"2011","Bournemouth 020E","E01015300",1090,171,32,139,298,183,129,59,101,60,28,18,10,61
"2011","Bournemouth 021A","E01015285",2341,209,26,183,330,208,124,121,185,130,88,53,35,946
"2011","Bournemouth 021B","E01015288",1521,73,8,65,226,148,124,131,263,213,94,41,53,249
"2011","Bournemouth 021C","E01015289",1543,150,18,132,316,181,152,113,188,152,67,37,30,224
"2011","Bournemouth 021D","E01015290",1462,183,19,164,269,135,116,96,199,165,77,42,35,222
"2011","Bournemouth 021E","E01015291",1410,239,43,196,339,207,141,101,130,107,50,36,14,96
"2011","Bournemouth 023A","E01015371",1315,137,22,115,289,183,102,92,201,140,68,36,32,103
"2011","Bournemouth 023B","E01015372",1184,174,35,139,315,167,90,98,148,93,41,24,17,58
"2011","Bournemouth 023C","E01033286",863,131,25,106,261,131,81,48,84,48,13,7,6,66
"2011","Bournemouth 023D","E01033288",804,108,19,89,259,114,93,55,83,43,13,9,4,36
"2011","Bournemouth 024A","E01015367",1781,172,21,151,360,176,171,156,236,204,57,25,32,249
"2011","Bournemouth 024B","E01015368",1177,197,21,176,347,162,112,56,148,73,29,13,16,53
"2011","Bournemouth 024C","E01015369",1223,175,37,138,377,173,130,70,125,74,41,24,17,58
"2011","Bournemouth 024D","E01015370",1319,257,52,205,408,161,166,50,119,55,31,20,11,72
"2011","Bristol 001A","E01014601",1140,111,22,89,200,158,82,81,202,160,87,66,21,59
"2011","Bristol 001B","E01014602",1280,65,11,54,181,159,67,105,266,255,94,67,27,88
"2011","Bristol 001C","E01014603",1585,183,34,149,322,211,127,111,269,197,60,38,22,105
"2011","Bristol 001E","E01014605",1109,54,14,40,141,118,93,72,257,206,120,77,43,48
"2011","Bristol 001G","E01032516",1390,220,37,183,357,199,103,88,200,105,42,27,15,76
"2011","Bristol 001H","E01032517",1076,72,10,62,156,137,75,92,206,186,77,62,15,75
"2011","Bristol 002A","E01014688",1160,61,14,47,162,104,80,96,230,227,102,74,28,98
"2011","Bristol 002B","E01014689",1028,22,8,14,95,85,53,81,222,248,140,102,38,82
"2011","Bristol 002C","E01014690",1395,84,13,71,233,132,72,122,293,259,98,65,33,102
"2011","Bristol 002D","E01014691",1267,94,10,84,211,149,61,93,252,234,79,51,28,94
"2011","Bristol 002E","E01014692",1147,55,7,48,162,131,62,98,239,206,98,64,34,96
"2011","Bristol 002F","E01014693",1080,109,17,92,255,202,68,97,180,99,19,14,5,51
"2011","Bristol 002G","E01014694",1201,53,6,47,182,136,81,101,240,232,86,57,29,90
"2011","Bristol 003A","E01014497",1098,47,9,38,133,114,63,121,240,233,84,54,30,63
"2011","Bristol 003B","E01014498",1063,39,14,25,126,125,47,104,227,250,83,52,31,62
"2011","Bristol 003C","E01014638",1087,29,7,22,118,115,53,92,266,239,98,69,29,77
"2011","Bristol 003D","E01014639",989,51,6,45,90,98,47,76,228,220,108,65,43,71
"2011","Bristol 003E","E01014640",1024,38,11,27,111,107,44,98,239,224,85,68,17,78
"2011","Bristol 004A","E01014631",867,105,15,90,201,140,63,58,113,83,29,20,9,75
"2011","Bristol 004B","E01014632",1143,134,19,115,217,128,85,81,144,124,72,55,17,158
"2011","Bristol 004C","E01014633",1127,158,30,128,295,143,90,71,158,83,53,27,26,76
"2011","Bristol 004D","E01014636",1017,116,21,95,183,144,66,60,162,125,70,49,21,91
"2011","Bristol 005A","E01014630",1624,172,22,150,283,163,87,107,281,201,117,78,39,213
"2011","Bristol 005B","E01014634",1429,210,17,193,296,146,69,78,157,99,32,24,8,342
"2011","Bristol 005C","E01014659",1476,145,19,126,244,172,84,90,232,177,139,102,37,193
"2011","Bristol 005D","E01014661",1176,68,11,57,175,123,81,94,225,188,97,78,19,125
"2011","Bristol 006A","E01014616",971,294,33,261,308,117,57,25,54,31,26,18,8,59
"2011","Bristol 006B","E01014719",1007,253,38,215,320,115,103,32,78,36,18,10,8,52
"2011","Bristol 006C","E01014720",1106,184,35,149,289,145,99,55,143,100,41,34,7,50
"2011","Bristol 006D","E01014721",1035,265,42,223,308,132,73,40,100,42,33,26,7,42
"2011","Bristol 007A","E01014641",1050,166,34,132,254,155,83,67,130,89,26,16,10,80
"2011","Bristol 007B","E01014642",1020,111,23,88,229,134,76,76,143,130,43,22,21,78
"2011","Bristol 007C","E01014643",962,54,17,37,175,115,64,74,192,156,45,27,18,87
"2011","Bristol 007D","E01014644",1090,93,14,79,224,143,83,75,189,147,53,36,17,83
"2011","Bristol 008A","E01014492",1074,69,18,51,169,144,75,97,230,184,62,48,14,44
"2011","Bristol 008B","E01014493",1079,59,13,46,180,158,61,104,214,182,51,38,13,70
"2011","Bristol 008C","E01014494",1119,94,19,75,243,172,83,120,173,137,26,17,9,71
"2011","Bristol 008D","E01014495",1194,92,18,74,234,182,87,116,211,174,42,27,15,56
"2011","Bristol 008E","E01014496",1206,60,17,43,187,167,90,105,225,262,50,28,22,60
"2011","Bristol 008F","E01014499",1145,34,10,24,146,137,85,115,236,247,59,35,24,86
"2011","Bristol 009A","E01014715",1113,339,59,280,366,123,80,23,63,23,23,16,7,73
"2011","Bristol 009B","E01014716",980,274,47,227,297,132,86,35,65,16,18,10,8,57
"2011","Bristol 009C","E01014717",948,248,34,214,279,87,60,17,59,22,19,12,7,157
"2011","Bristol 009D","E01014718",1012,242,40,202,315,143,79,28,72,33,27,20,7,73
"2011","Bristol 010A","E01014510",1513,237,31,206,419,176,84,76,132,78,20,15,5,291
"2011","Bristol 010B","E01014635",1488,224,21,203,386,170,95,80,132,111,50,33,17,240
"2011","Bristol 010C","E01014637",1139,185,16,169,300,117,70,47,88,49,39,25,14,244
"2011","Bristol 010D","E01014662",1198,129,21,108,248,142,76,82,158,127,70,52,18,166
"2011","Bristol 011A","E01014615",1011,276,36,240,321,130,69,30,61,30,16,6,10,78
"2011","Bristol 011B","E01014617",975,272,36,236,320,100,85,28,58,29,11,6,5,72
"2011","Bristol 011C","E01014618",1007,294,40,254,349,111,73,22,53,19,12,7,5,74
"2011","Bristol 011D","E01014620",964,303,37,266,300,107,69,23,53,22,19,15,4,68
"2011","Bristol 012A","E01014571",1229,112,19,93,238,124,85,58,181,121,48,32,16,262
"2011","Bristol 012B","E01014577",1157,181,21,160,288,128,109,68,134,73,37,29,8,139
"2011","Bristol 012C","E01014586",1048,133,13,120,229,173,67,47,162,113,48,36,12,76
"2011","Bristol 012D","E01014587",947,99,24,75,182,127,79,65,131,101,59,47,12,104
"2011","Bristol 013A","E01014588",1735,97,18,79,236,170,113,78,165,146,92,72,20,638
"2011","Bristol 013B","E01014589",941,28,9,19,104,108,61,76,199,161,108,67,41,96
"2011","Bristol 013C","E01014590",1338,93,15,78,219,140,83,81,176,124,71,49,22,351
"2011","Bristol 013D","E01014591",1272,160,35,125,297,190,114,80,176,103,33,23,10,119
"2011","Bristol 013E","E01014592",1202,141,24,117,247,177,81,73,154,99,54,40,14,176
"2011","Bristol 014A","E01014660",1114,46,8,38,137,106,90,86,244,189,105,70,35,111
"2011","Bristol 014B","E01014663",1055,37,9,28,136,94,66,83,224,216,99,75,24,100
"2011","Bristol 014C","E01014664",1188,86,12,74,207,124,100,79,206,165,90,76,14,131
"2011","Bristol 014D","E01014665",1382,113,15,98,299,163,144,79,240,125,93,69,24,126
"2011","Bristol 015A","E01014709",850,273,49,224,253,106,94,17,32,14,12,9,3,49
"2011","Bristol 015B","E01014710",1073,272,56,216,217,72,85,12,43,13,16,12,4,343
"2011","Bristol 015C","E01014711",861,231,40,191,261,126,85,20,53,14,16,10,6,55
"2011","Bristol 015D","E01014712",838,212,33,179,231,101,78,19,74,21,32,22,10,70
"2011","Bristol 015E","E01014713",930,245,43,202,289,109,101,25,58,23,21,8,13,59
"2011","Bristol 015F","E01014714",2513,336,62,274,277,82,95,19,54,17,17,11,6,1616
"2011","Bristol 016A","E01014507",1318,275,39,236,411,115,79,40,82,53,15,6,9,248
"2011","Bristol 016B","E01014508",1421,240,26,214,326,108,118,63,93,125,119,91,28,229
"2011","Bristol 016C","E01014509",1698,394,49,345,455,149,92,71,122,64,44,30,14,307
"2011","Bristol 016D","E01014511",1063,229,21,208,335,99,75,27,86,39,22,13,9,151
"2011","Bristol 016E","E01014512",1136,268,41,227,337,93,87,35,83,54,29,23,6,150
"2011","Bristol 016F","E01014513",1140,277,42,235,373,118,103,31,72,28,28,24,4,110
"2011","Bristol 016G","E01014514",1539,288,26,262,455,186,100,64,118,80,22,15,7,226
"2011","Bristol 017A","E01014619",1121,342,41,301,313,85,99,17,55,20,36,27,9,154
"2011","Bristol 017B","E01014621",1050,330,36,294,312,92,54,17,51,27,43,27,16,124
"2011","Bristol 017C","E01014666",1270,337,39,298,402,132,97,28,75,31,28,17,11,140
"2011","Bristol 017D","E01014667",1204,344,42,302,333,121,75,34,70,26,20,9,11,181
"2011","Bristol 017E","E01014672",1600,470,56,414,423,119,98,44,81,45,55,41,14,265
"2011","Bristol 018A","E01014624",1203,62,13,49,170,155,98,111,242,195,69,48,21,101
"2011","Bristol 018D","E01014629",982,63,15,48,137,120,90,73,170,146,82,66,16,101
"2011","Bristol 018E","E01032518",1224,41,8,33,181,136,88,100,239,212,123,93,30,104
"2011","Bristol 018F","E01032519",840,70,9,61,188,123,77,71,112,85,29,23,6,85
"2011","Bristol 019A","E01014572",1442,150,22,128,320,153,115,79,176,135,102,69,33,212
"2011","Bristol 019B","E01014573",1435,136,24,112,343,184,114,83,172,126,64,51,13,213
"2011","Bristol 019C","E01014575",1146,99,17,82,210,127,103,71,168,125,118,92,26,125
"2011","Bristol 019D","E01014576",1415,109,13,96,276,252,122,88,225,174,70,42,28,99
"2011","Bristol 020A","E01014487",1713,334,36,298,416,166,96,40,109,52,41,28,13,459
"2011","Bristol 020B","E01014491",1540,317,39,278,434,142,133,54,116,57,49,28,21,238
"2011","Bristol 020C","E01014668",1246,315,42,273,368,104,86,32,73,34,22,9,13,212
"2011","Bristol 020D","E01014669",1217,377,39,338,300,81,65,36,60,35,23,13,10,240
"2011","Bristol 020E","E01014670",1220,317,36,281,308,106,72,21,80,43,25,15,10,248
"2011","Bristol 020F","E01014671",1382,249,24,225,344,107,69,50,87,50,29,19,10,397
"2011","Bristol 021A","E01014622",1108,87,9,78,202,133,113,86,192,126,75,60,15,94
"2011","Bristol 021B","E01014623",1172,83,9,74,215,166,96,85,209,146,74,53,21,98
"2011","Bristol 021C","E01014626",1416,108,19,89,237,187,112,91,236,208,100,78,22,137
"2011","Bristol 021D","E01014627",1586,118,29,89,326,242,141,113,278,193,70,55,15,105
"2011","Bristol 022A","E01014557",1402,289,24,265,305,93,68,25,53,19,25,15,10,525
"2011","Bristol 022B","E01014558",1718,298,18,280,293,112,59,32,58,43,52,42,10,771
"2011","Bristol 022C","E01014559",1680,418,40,378,404,93,80,36,69,28,34,20,14,518
"2011","Bristol 022D","E01014560",1484,378,35,343,359,117,79,33,72,29,17,11,6,400
"2011","Bristol 022E","E01014562",1678,275,20,255,269,78,54,47,41,23,28,17,11,863
"2011","Bristol 023A","E01014485",1393,165,25,140,403,136,136,88,149,117,91,64,27,108
"2011","Bristol 023B","E01014486",1777,150,12,138,383,183,169,83,246,182,183,112,71,198
"2011","Bristol 023C","E01014488",1614,272,32,240,473,142,144,67,135,107,92,70,22,182
"2011","Bristol 023D","E01014489",2032,251,16,235,522,192,155,106,198,133,131,74,57,344
"2011","Bristol 023F","E01033347",945,138,13,125,213,90,46,74,100,66,94,65,29,124
"2011","Bristol 023G","E01033348",842,56,8,48,178,80,40,43,126,93,98,69,29,128
"2011","Bristol 023H","E01033366",916,39,7,32,133,67,58,47,133,146,161,114,47,132
"2011","Bristol 025A","E01014539",1596,344,28,316,340,94,72,37,78,38,34,25,9,559
"2011","Bristol 025C","E01014561",1482,367,50,317,368,125,74,37,80,36,20,12,8,375
"2011","Bristol 025D","E01014563",1647,317,31,286,349,135,58,44,88,61,33,19,14,562
"2011","Bristol 025E","E01033342",1772,166,14,152,171,75,43,37,95,54,42,30,12,1089
"2011","Bristol 025F","E01033367",1094,125,9,116,216,90,106,49,127,114,104,61,43,163
"2011","Bristol 026A","E01014551",1644,367,37,330,320,98,52,30,54,26,25,15,10,672
"2011","Bristol 026B","E01014552",1652,423,34,389,362,96,77,20,48,25,27,16,11,574
"2011","Bristol 026C","E01014553",1536,383,50,333,364,110,77,28,66,18,23,16,7,467
"2011","Bristol 026D","E01014554",1536,406,34,372,350,112,68,44,71,31,20,11,9,434
"2011","Bristol 026E","E01014556",1403,421,45,376,399,116,105,25,48,26,16,5,11,247
"2011","Bristol 027A","E01014673",1297,109,22,87,250,194,110,125,208,167,80,52,28,54
"2011","Bristol 027B","E01014674",1164,84,20,64,187,160,108,96,222,181,53,31,22,73
"2011","Bristol 027C","E01014675",1120,72,15,57,207,177,85,81,227,151,51,30,21,69
"2011","Bristol 027D","E01014676",1092,82,24,58,186,170,115,105,197,134,48,26,22,55
"2011","Bristol 028A","E01014682",1116,85,13,72,217,175,121,77,176,142,60,34,26,63
"2011","Bristol 028B","E01014683",1245,95,16,79,260,148,83,101,200,188,95,71,24,75
"2011","Bristol 028C","E01014685",1083,43,6,37,136,142,97,74,201,201,95,68,27,94
"2011","Bristol 028D","E01014686",1172,80,16,64,208,164,90,90,242,163,54,39,15,81
"2011","Bristol 028E","E01014687",1109,60,12,48,234,149,103,82,192,160,69,48,21,60
"2011","Bristol 029A","E01014565",1222,94,16,78,240,169,84,96,195,170,88,57,31,86
"2011","Bristol 029B","E01014566",1297,108,15,93,289,179,114,89,196,180,71,48,23,71
"2011","Bristol 029C","E01014567",1480,108,17,91,339,201,107,117,266,180,70,42,28,92
"2011","Bristol 029D","E01014681",1595,127,23,104,376,208,134,90,270,203,99,62,37,88
"2011","Bristol 029E","E01014684",1340,125,21,104,301,186,106,98,191,186,72,43,29,75
"2011","Bristol 030A","E01014544",1156,303,40,263,251,86,56,31,39,23,19,12,7,348
"2011","Bristol 030B","E01014545",1357,446,51,395,359,87,80,26,55,39,16,7,9,249
"2011","Bristol 030C","E01014546",1324,336,28,308,332,106,55,28,44,24,15,6,9,384
"2011","Bristol 030D","E01014547",1435,472,43,429,420,94,109,34,48,33,16,5,11,209
"2011","Bristol 032A","E01014538",1833,237,18,219,196,79,55,21,44,32,24,17,7,1145
"2011","Bristol 032B","E01014540",2393,298,33,265,346,163,100,85,163,136,91,68,23,1011
"2011","Bristol 032C","E01014542",2182,291,20,271,252,101,59,47,83,49,42,34,8,1258
"2011","Bristol 032E","E01033344",1525,217,28,189,193,86,48,37,57,43,45,31,14,799
"2011","Bristol 032F","E01033345",1288,260,34,226,223,82,46,30,39,14,19,14,5,575
"2011","Bristol 032G","E01033350",939,264,44,220,275,106,64,38,56,26,22,11,11,88
"2011","Bristol 033A","E01014677",1169,140,38,102,264,196,112,86,186,116,25,18,7,44
"2011","Bristol 033B","E01014678",1154,89,19,70,209,202,104,100,203,147,45,25,20,55
"2011","Bristol 033C","E01014679",1155,80,18,62,225,199,104,84,212,142,47,30,17,62
"2011","Bristol 033D","E01014680",950,82,25,57,190,166,90,84,170,94,23,16,7,51
"2011","Bristol 034A","E01014548",1428,339,28,311,339,120,110,40,94,61,35,21,14,290
"2011","Bristol 034B","E01014549",1006,212,19,193,223,60,56,40,55,54,33,23,10,273
"2011","Bristol 034C","E01014550",1918,433,62,371,474,139,96,44,76,50,19,15,4,587
"2011","Bristol 034D","E01014555",1738,270,21,249,293,101,56,43,67,36,36,23,13,836
"2011","Bristol 035A","E01014528",1174,141,31,110,307,199,77,92,154,126,28,17,11,50
"2011","Bristol 035B","E01014529",1054,60,8,52,167,133,73,89,202,182,72,52,20,76
"2011","Bristol 035C","E01014530",1094,127,20,107,292,181,76,89,137,131,28,16,12,33
"2011","Bristol 035D","E01014531",1301,156,30,126,336,179,102,101,182,137,47,31,16,61
"2011","Bristol 035E","E01014532",1109,133,17,116,252,169,78,77,183,131,31,20,11,55
"2011","Bristol 035F","E01014537",1286,88,16,72,245,214,128,102,233,154,52,35,17,70
"2011","Bristol 036A","E01014695",1295,162,30,132,301,151,106,84,147,147,67,47,20,130
"2011","Bristol 036B","E01014696",1308,257,28,229,449,141,84,52,109,80,27,15,12,109
"2011","Bristol 036C","E01014698",1502,275,39,236,482,175,106,77,132,91,38,22,16,126
"2011","Bristol 036D","E01014699",1157,201,25,176,294,148,77,71,130,84,50,31,19,102
"2011","Bristol 036E","E01014700",1214,159,20,139,286,204,110,87,144,107,16,10,6,101
"2011","Bristol 036F","E01014701",1379,258,24,234,456,169,96,55,133,71,41,22,19,100
"2011","Bristol 037A","E01014730",1323,188,31,157,350,189,92,86,153,126,67,44,23,72
"2011","Bristol 037B","E01014731",1309,206,20,186,381,153,112,83,149,93,70,41,29,62
"2011","Bristol 037C","E01014732",1360,226,32,194,395,165,108,66,127,109,85,48,37,79
"2011","Bristol 037D","E01014735",1327,193,27,166,395,181,98,85,163,117,32,21,11,63
"2011","Bristol 038A","E01014523",985,60,15,45,202,152,100,89,166,119,40,20,20,57
"2011","Bristol 038B","E01014524",1062,77,20,57,161,160,121,69,187,178,39,23,16,70
"2011","Bristol 038C","E01014525",1184,122,22,100,272,217,92,84,174,133,31,21,10,59
"2011","Bristol 038D","E01014526",1063,62,14,48,153,137,82,99,235,184,59,28,31,52
"2011","Bristol 038E","E01014527",982,80,16,64,219,168,86,83,152,126,29,15,14,39
"2011","Bristol 039A","E01014500",1171,93,13,80,285,177,76,97,188,149,48,32,16,58
"2011","Bristol 039B","E01014502",1310,96,11,85,235,214,100,84,237,220,69,46,23,55
"2011","Bristol 039E","E01033359",1125,171,24,147,267,143,63,90,137,84,82,58,24,88
"2011","Bristol 039F","E01033361",1048,133,22,111,219,139,65,87,147,133,47,27,20,78
"2011","Bristol 039G","E01033362",914,167,21,146,272,130,53,57,85,47,42,27,15,61
"2011","Bristol 039H","E01033364",1263,199,39,160,403,172,80,63,131,116,35,15,20,64
"2011","Bristol 040A","E01014729",1029,64,9,55,188,120,70,70,210,136,85,65,20,86
"2011","Bristol 040B","E01014733",1381,204,22,182,428,149,100,83,159,116,42,29,13,100
"2011","Bristol 040C","E01014734",1220,219,26,193,385,155,98,65,124,76,40,23,17,58
"2011","Bristol 040D","E01014736",1434,131,18,113,270,185,102,114,237,230,78,59,19,87
"2011","Bristol 041A","E01014501",1240,75,23,52,190,171,119,105,248,196,60,39,21,76
"2011","Bristol 041B","E01014504",1196,198,30,168,319,164,95,78,130,103,32,19,13,77
"2011","Bristol 041C","E01014505",1430,231,26,205,459,196,91,63,167,113,29,13,16,81
"2011","Bristol 041D","E01014506",1144,97,25,72,222,201,95,123,176,129,17,9,8,84
"2011","Bristol 042A","E01014645",1111,89,15,74,222,173,106,83,196,127,49,31,18,66
"2011","Bristol 042B","E01014646",1144,53,13,40,178,151,113,105,227,192,40,30,10,85
"2011","Bristol 042C","E01014648",1211,172,24,148,347,186,121,62,117,80,65,44,21,61
"2011","Bristol 042D","E01014649",1198,182,34,148,331,194,109,69,120,90,32,19,13,71
"2011","Bristol 042E","E01014651",1234,186,23,163,358,173,102,52,175,87,30,24,6,71
"2011","Bristol 043A","E01014533",1146,143,30,113,292,175,115,83,147,95,46,36,10,50
"2011","Bristol 043B","E01014534",1251,147,28,119,321,210,95,77,169,117,56,36,20,59
"2011","Bristol 043C","E01014535",1410,148,18,130,317,244,144,88,209,132,43,22,21,85
"2011","Bristol 043D","E01014536",1032,59,11,48,177,141,70,91,190,182,73,50,23,49
"2011","Bristol 044A","E01014578",1184,86,18,68,180,156,69,93,220,215,79,53,26,86
"2011","Bristol 044B","E01014583",973,27,6,21,92,84,57,75,217,232,116,97,19,73
"2011","Bristol 044C","E01014585",1164,23,6,17,96,94,62,97,269,261,170,130,40,92
"2011","Bristol 044D","E01014647",1142,23,0,23,130,107,65,105,253,289,102,75,27,68
"2011","Bristol 044E","E01014650",1108,79,21,58,179,161,78,90,185,209,62,44,18,65
"2011","Bristol 045A","E01014579",976,39,10,29,123,138,59,109,203,180,56,39,17,69
"2011","Bristol 045B","E01014580",1071,20,5,15,112,122,69,94,252,221,111,87,24,70
"2011","Bristol 045C","E01014581",1047,19,5,14,103,83,64,89,234,250,141,107,34,64
"2011","Bristol 045D","E01014582",959,27,6,21,98,86,64,74,208,234,98,78,20,70
"2011","Bristol 045E","E01014584",923,30,7,23,104,93,56,83,190,194,97,71,26,76
"2011","Bristol 046A","E01014518",1228,77,12,65,218,202,124,105,215,161,47,34,13,79
"2011","Bristol 046B","E01014519",929,54,10,44,134,156,72,87,187,136,48,34,14,55
"2011","Bristol 046C","E01014520",1122,80,20,60,191,221,138,103,184,136,23,12,11,46
"2011","Bristol 046D","E01014521",897,69,18,51,152,137,105,78,142,123,36,24,12,55
"2011","Bristol 047A","E01014607",1033,55,15,40,166,205,82,116,199,141,26,11,15,43
"2011","Bristol 047B","E01014608",1185,50,17,33,154,176,99,118,227,185,79,56,23,97
"2011","Bristol 047C","E01014609",1229,61,12,49,188,189,97,122,218,213,62,43,19,79
"2011","Bristol 047D","E01014610",978,37,11,26,139,152,75,83,209,161,66,44,22,56
"2011","Bristol 047E","E01014613",1120,72,19,53,186,200,107,100,227,139,30,17,13,59
"2011","Bristol 047F","E01014614",900,66,16,50,147,163,99,98,149,105,25,22,3,48
"2011","Bristol 048A","E01014594",985,25,7,18,95,112,64,77,246,175,122,79,43,69
"2011","Bristol 048B","E01014598",1055,66,12,54,166,222,112,116,172,135,20,11,9,46
"2011","Bristol 048C","E01014599",921,50,12,38,172,167,125,88,141,107,23,11,12,48
"2011","Bristol 048D","E01014600",911,46,13,33,133,149,85,81,176,148,41,22,19,52
"2011","Bristol 049A","E01014702",1079,74,19,55,200,197,95,109,191,134,32,23,9,47
"2011","Bristol 049B","E01014703",1071,46,11,35,144,140,79,97,255,180,62,46,16,68
"2011","Bristol 049C","E01014704",1332,97,23,74,218,221,126,119,227,156,80,52,28,88
"2011","Bristol 049D","E01014705",973,60,21,39,181,161,89,100,186,135,16,9,7,45
"2011","Bristol 049E","E01014706",842,41,8,33,98,118,61,76,204,175,38,25,13,31
"2011","Bristol 049F","E01014707",1195,70,17,53,224,209,115,95,235,123,31,17,14,93
"2011","Bristol 049G","E01014708",1286,117,30,87,267,240,126,100,193,127,39,22,17,77
"2011","Bristol 050A","E01014515",1022,49,17,32,136,130,111,89,210,178,55,34,21,64
"2011","Bristol 050B","E01014516",946,26,9,17,96,116,58,92,219,182,115,77,38,42
"2011","Bristol 050C","E01014517",863,22,4,18,95,96,49,69,201,180,84,58,26,67
"2011","Bristol 050D","E01014522",1077,39,7,32,130,181,82,105,224,172,75,43,32,69
"2011","Bristol 051A","E01014593",966,18,7,11,89,100,53,70,228,196,129,93,36,83
"2011","Bristol 051B","E01014595",997,33,9,24,87,129,77,80,224,251,66,47,19,50
"2011","Bristol 051C","E01014596",1036,27,9,18,103,105,54,102,231,227,120,82,38,67
"2011","Bristol 051D","E01014597",924,23,6,17,79,119,73,84,188,198,113,78,35,47
"2011","Bristol 052A","E01014611",947,68,10,58,201,159,90,80,185,108,14,7,7,42
"2011","Bristol 052B","E01014612",1044,66,12,54,169,201,97,86,202,133,33,24,9,57
"2011","Bristol 052C","E01014722",1162,92,17,75,209,234,118,94,200,145,22,15,7,48
"2011","Bristol 052D","E01014723",1030,62,11,51,195,208,78,98,202,111,27,16,11,49
"2011","Bristol 052E","E01014725",1123,81,18,63,213,248,98,106,188,102,24,15,9,63
"2011","Bristol 053B","E01014726",1107,20,3,17,71,94,70,97,245,253,155,108,47,102
"2011","Bristol 053C","E01014727",1008,22,7,15,78,96,50,79,250,232,122,81,41,79
"2011","Bristol 053E","E01032514",1297,14,5,9,89,123,77,94,322,312,189,147,42,77
"2011","Bristol 053F","E01032515",921,34,5,29,97,115,67,77,223,192,65,47,18,51
"2011","Bristol 054A","E01033352",1101,166,13,153,294,165,41,66,127,91,49,32,17,102
"2011","Bristol 054B","E01033353",1010,94,10,84,208,105,35,55,111,93,51,25,26,258
"2011","Bristol 054C","E01033355",1023,259,40,219,253,97,38,36,68,45,52,39,13,175
"2011","Bristol 054D","E01033358",1519,38,3,35,148,83,79,59,166,156,195,146,49,595
"2011","Bristol 054E","E01033370",887,132,18,114,135,106,46,51,146,137,81,60,21,53
"2011","Bristol 055A","E01014564",1323,105,20,85,255,123,118,75,189,149,137,108,29,172
"2011","Bristol 055B","E01014653",1672,43,11,32,175,127,116,92,296,240,366,289,77,217
"2011","Bristol 055C","E01014655",1660,88,15,73,287,143,112,83,247,217,289,225,64,194
"2011","Bristol 056A","E01014654",1552,47,4,43,169,108,117,104,256,263,289,234,55,199
"2011","Bristol 056B","E01014658",1314,35,8,27,107,93,84,80,238,252,277,235,42,148
"2011","Bristol 056C","E01033356",962,45,7,38,123,103,67,60,156,194,148,110,38,66
"2011","Bristol 056D","E01033369",919,30,6,24,102,89,73,62,173,147,151,120,31,92
"2011","Bristol 057A","E01014568",1700,115,11,104,335,177,164,90,226,188,212,163,49,193
"2011","Bristol 057B","E01014569",1556,141,20,121,318,164,152,63,202,146,174,129,45,196
"2011","Bristol 057C","E01014570",1330,124,23,101,328,154,123,82,165,148,89,65,24,117
"2011","Bristol 057D","E01014574",1551,103,19,84,274,160,133,91,233,190,178,136,42,189
"2011","Cornwall 010A","E01018753",1219,144,35,109,321,123,208,94,156,96,15,11,4,62
"2011","Cornwall 010B","E01018754",1119,79,23,56,215,118,179,107,192,120,33,19,14,76
"2011","Cornwall 010C","E01018755",1119,110,36,74,289,124,200,75,144,79,27,15,12,71
"2011","Cornwall 010D","E01018756",1177,131,32,99,287,121,206,74,170,110,20,15,5,58
"2011","Cornwall 012A","E01018777",1558,167,52,115,413,143,329,95,185,123,27,14,13,76
"2011","Cornwall 012B","E01018782",1076,74,17,57,252,131,164,88,178,103,21,13,8,65
"2011","Cornwall 012C","E01018783",1167,105,27,78,263,131,200,86,168,118,27,18,9,69
"2011","Cornwall 012D","E01018784",1080,120,29,91,245,94,274,62,131,79,15,13,2,60
"2011","Cornwall 013A","E01018750",1621,125,31,94,374,203,201,162,257,156,33,20,13,110
"2011","Cornwall 013B","E01018751",1113,61,18,43,165,101,136,114,200,207,65,44,21,64
"2011","Cornwall 013C","E01018752",1485,125,39,86,285,180,177,140,262,180,42,24,18,94
"2011","Cornwall 013D","E01018779",1635,133,38,95,312,171,285,130,270,207,49,33,16,78
"2011","Cornwall 016A","E01018758",1798,114,29,85,341,204,280,146,316,240,66,45,21,91
"2011","Cornwall 016B","E01018768",1414,67,23,44,286,196,135,125,261,181,61,39,22,102
"2011","Cornwall 016C","E01018769",1287,92,28,64,256,151,170,98,242,136,56,44,12,86
"2011","Cornwall 016D","E01018778",1245,99,34,65,265,143,244,100,170,124,25,20,5,75
"2011","Cornwall 017A","E01018767",1054,31,10,21,117,92,87,103,237,212,87,67,20,88
"2011","Cornwall 017B","E01018770",863,47,14,33,136,98,81,63,194,121,48,24,24,75
"2011","Cornwall 017C","E01018771",1021,58,17,41,183,117,121,85,196,153,46,24,22,62
"2011","Cornwall 017D","E01018772",1117,124,32,92,290,156,139,78,155,81,18,5,13,76
"2011","Cornwall 022A","E01018764",1083,152,38,114,303,145,189,66,101,59,17,7,10,51
"2011","Cornwall 022B","E01018787",1137,132,38,94,278,201,151,69,122,87,20,12,8,77
"2011","Cornwall 022C","E01018795",956,126,37,89,241,151,100,61,115,80,17,7,10,65
"2011","Cornwall 022D","E01018796",902,87,24,63,245,137,69,83,132,83,14,5,9,52
"2011","Cornwall 023A","E01018757",1572,203,58,145,429,182,289,82,167,97,34,23,11,89
"2011","Cornwall 023B","E01018763",841,98,21,77,207,99,133,61,89,76,28,17,11,50
"2011","Cornwall 023C","E01018765",1130,164,51,113,293,129,213,87,103,75,29,22,7,37
"2011","Cornwall 023D","E01018785",1461,178,41,137,367,159,273,98,169,102,33,20,13,82
"2011","Cornwall 025A","E01018786",973,70,21,49,202,141,82,96,193,100,20,16,4,69
"2011","Cornwall 025B","E01018788",963,55,18,37,184,138,86,94,189,149,33,21,12,35
"2011","Cornwall 025C","E01018790",862,47,14,33,167,108,77,83,154,117,43,32,11,66
"2011","Cornwall 025D","E01018794",1058,94,22,72,207,162,69,105,203,129,23,13,10,66
"2011","Cornwall 026A","E01018789",1107,59,18,41,241,150,94,104,212,132,34,22,12,81
"2011","Cornwall 026B","E01018791",920,94,21,73,229,131,104,79,118,84,23,16,7,58
"2011","Cornwall 026C","E01018792",2027,228,65,163,567,312,171,135,277,169,34,19,15,134
"2011","Cornwall 026D","E01018793",1279,112,33,79,268,156,156,97,209,141,50,34,16,90
"2011","Cornwall 028A","E01018759",1123,84,25,59,219,128,249,90,145,126,33,26,7,49
"2011","Cornwall 028B","E01018760",912,81,14,67,200,93,209,57,125,72,24,19,5,51
"2011","Cornwall 028C","E01018761",1033,58,11,47,186,91,241,88,176,112,34,29,5,47
"2011","Cornwall 028D","E01018766",1334,140,30,110,303,129,341,57,124,137,38,25,13,65
"2011","Cornwall 028E","E01018774",1018,54,12,42,197,53,172,86,218,136,47,20,27,55
"2011","Cornwall 029A","E01018797",815,40,9,31,146,72,79,74,166,132,45,25,20,61
"2011","Cornwall 029B","E01018798",1107,82,24,58,229,167,108,92,198,149,24,21,3,58
"2011","Cornwall 029C","E01018799",819,34,11,23,159,104,52,70,184,122,39,20,19,55
"2011","Cornwall 029D","E01018800",1162,88,42,46,276,191,76,95,217,126,22,14,8,71
"2011","Cornwall 034A","E01018780",1680,161,38,123,363,185,219,145,266,204,48,26,22,89
"2011","Cornwall 034B","E01018781",1397,153,46,107,362,178,251,95,151,98,35,25,10,74
"2011","Cornwall 034E","E01033294",1767,116,34,82,401,273,139,178,317,182,46,30,16,115
"2011","Cornwall 037A","E01018762",911,71,10,61,211,71,236,59,123,84,25,17,8,31
"2011","Cornwall 037B","E01018773",1067,71,21,50,204,114,196,94,174,126,39,21,18,49
"2011","Cornwall 037C","E01018775",1010,91,20,71,227,111,211,67,128,91,24,13,11,60
"2011","Cornwall 037D","E01018776",915,61,17,44,176,85,245,80,135,84,20,8,12,29
"2011","Cornwall 032A","E01018815",1525,143,41,102,327,186,265,101,251,138,34,20,14,80
"2011","Cornwall 032B","E01018831",934,92,18,74,186,94,204,65,141,74,28,15,13,50
"2011","Cornwall 032C","E01018832",992,77,23,54,243,115,181,84,131,74,17,8,9,70
"2011","Cornwall 032D","E01018847",1135,108,22,86,248,129,212,80,173,83,25,16,9,77
"2011","Cornwall 033A","E01018833",1061,80,18,62,235,121,231,69,144,95,24,13,11,62
"2011","Cornwall 033B","E01018842",1043,101,21,80,245,124,168,66,154,97,25,16,9,63
"2011","Cornwall 033C","E01018843",974,126,32,94,224,110,192,72,110,72,18,9,9,50
"2011","Cornwall 033D","E01018844",878,81,13,68,224,86,128,64,145,88,27,19,8,35
"2011","Cornwall 040A","E01018825",1174,127,29,98,301,125,176,99,152,101,31,20,11,62
"2011","Cornwall 040B","E01018826",1516,110,27,83,356,234,229,99,245,120,38,27,11,85
"2011","Cornwall 040C","E01018851",994,136,23,113,265,105,148,61,118,69,29,20,9,63
"2011","Cornwall 040D","E01018852",1802,257,33,224,497,205,304,90,207,98,37,13,24,107
"2011","Cornwall 042A","E01018823",1055,144,23,121,324,121,85,51,142,91,16,5,11,81
"2011","Cornwall 042B","E01018824",1777,206,39,167,442,229,166,113,295,164,54,29,25,108
"2011","Cornwall 042C","E01018853",1847,201,44,157,437,244,146,119,291,202,63,39,24,144
"2011","Cornwall 042D","E01018854",968,94,13,81,188,99,81,67,171,150,45,29,16,73
"2011","Cornwall 043A","E01018819",1136,107,20,87,262,174,90,83,185,128,39,29,10,68
"2011","Cornwall 043B","E01018822",903,61,10,51,209,137,85,87,158,92,17,15,2,57
"2011","Cornwall 043C","E01018855",1779,266,49,217,397,267,133,110,230,123,41,25,16,212
"2011","Cornwall 043D","E01018856",1035,63,9,54,176,140,92,98,204,123,47,36,11,92
"2011","Cornwall 043E","E01018857",845,46,10,36,138,99,69,69,175,150,46,27,19,53
"2011","Cornwall 043F","E01018858",958,144,31,113,217,123,103,61,124,95,26,19,7,65
"2011","Cornwall 044A","E01018807",965,151,27,124,257,119,104,61,133,44,19,13,6,77
"2011","Cornwall 044B","E01018808",1051,153,27,126,262,158,96,58,133,81,20,16,4,90
"2011","Cornwall 044C","E01018809",1431,154,28,126,335,180,116,123,213,154,63,34,29,93
"2011","Cornwall 044D","E01018810",1014,137,22,115,304,145,84,55,134,62,19,9,10,74
"2011","Cornwall 047A","E01018816",1200,246,62,184,373,126,194,42,90,49,17,14,3,63
"2011","Cornwall 047B","E01018817",1493,222,45,177,429,174,234,67,151,83,26,16,10,107
"2011","Cornwall 047C","E01018818",1144,130,34,96,303,162,141,76,162,71,29,17,12,70
"2011","Cornwall 047D","E01018820",1326,141,24,117,332,136,234,72,198,108,27,15,12,78
"2011","Cornwall 047E","E01018821",907,87,15,72,208,124,149,58,142,72,11,5,6,56
"2011","Cornwall 048A","E01018845",1089,102,24,78,231,113,207,82,162,94,24,15,9,74
"2011","Cornwall 048B","E01018846",1015,120,33,87,273,112,178,57,119,88,18,12,6,50
"2011","Cornwall 048C","E01018848",1162,94,26,68,304,174,144,89,186,84,24,14,10,63
"2011","Cornwall 048D","E01018849",1347,143,42,101,300,133,317,101,162,106,39,31,8,46
"2011","Cornwall 048E","E01018850",998,116,20,96,232,96,237,69,98,64,21,9,12,65
"2011","Cornwall 056A","E01018827",1114,170,47,123,288,108,163,39,90,54,16,12,4,186
"2011","Cornwall 056B","E01018828",1071,149,36,113,272,118,172,51,126,90,20,16,4,73
"2011","Cornwall 056C","E01018829",1045,119,26,93,222,115,188,67,137,74,40,24,16,83
"2011","Cornwall 056D","E01018830",1050,163,33,130,251,112,187,59,120,67,27,19,8,64
"2011","Cornwall 060A","E01018834",1326,89,40,49,243,141,137,101,260,175,36,24,12,144
"2011","Cornwall 060B","E01018835",1332,112,36,76,231,145,131,110,204,167,45,29,16,187
"2011","Cornwall 060C","E01018836",1208,49,7,42,180,95,100,97,212,197,81,45,36,197
"2011","Cornwall 060D","E01018837",1530,132,24,108,331,162,184,113,226,170,35,21,14,177
"2011","Cornwall 062A","E01018838",1143,50,16,34,146,96,101,94,206,158,61,42,19,231
"2011","Cornwall 062B","E01018839",943,108,23,85,229,79,114,57,96,68,31,17,14,161
"2011","Cornwall 062C","E01018840",1373,73,13,60,230,68,107,84,125,103,42,27,15,541
"2011","Cornwall 062D","E01018841",1003,43,13,30,109,67,104,97,205,188,70,33,37,120
"2011","Cornwall 062E","E01018860",1347,47,17,30,161,108,128,124,273,295,96,57,39,115
"2011","Cornwall 063A","E01018803",1319,131,33,98,242,93,147,69,109,75,17,10,7,436
"2011","Cornwall 063B","E01018804",1597,112,17,95,236,74,151,91,108,77,35,18,17,713
"2011","Cornwall 063C","E01018805",1062,158,46,112,287,112,157,54,83,61,16,12,4,134
"2011","Cornwall 063D","E01018806",1208,91,17,74,234,95,87,64,121,98,24,11,13,394
"2011","Cornwall 064A","E01018811",1087,84,21,63,252,121,129,111,171,128,20,13,7,71
"2011","Cornwall 064B","E01018812",989,74,22,52,217,93,109,74,178,121,35,18,17,88
"2011","Cornwall 064C","E01018813",1064,125,36,89,274,140,118,80,156,70,17,9,8,84
"2011","Cornwall 064D","E01018814",1081,68,21,47,211,139,128,112,185,124,18,13,5,96
"2011","Cornwall 064E","E01018859",1278,88,23,65,288,162,167,99,160,127,23,17,6,164
"2011","Cornwall 045A","E01018889",976,54,13,41,210,155,125,96,154,117,13,8,5,52
"2011","Cornwall 045B","E01018890",1047,83,18,65,219,126,111,93,175,149,44,33,11,47
"2011","Cornwall 045C","E01018891",977,77,19,58,201,136,122,102,162,104,27,20,7,46
"2011","Cornwall 045D","E01018892",1004,115,34,81,243,126,157,68,135,83,18,12,6,59
"2011","Cornwall 045E","E01018893",975,51,10,41,163,123,113,92,186,148,46,38,8,53
"2011","Cornwall 046A","E01018908",1236,63,16,47,220,145,192,95,208,181,48,36,12,84
"2011","Cornwall 046B","E01018909",1159,53,13,40,195,178,112,115,223,174,36,21,15,73
"2011","Cornwall 046C","E01018910",1256,29,7,22,132,103,58,127,300,283,131,100,31,93
"2011","Cornwall 046D","E01018911",1213,60,22,38,207,144,133,106,240,213,60,46,14,50
"2011","Cornwall 049A","E01018912",1083,56,18,38,235,135,127,97,195,155,31,25,6,52
"2011","Cornwall 049B","E01018913",1342,102,29,73,277,130,145,137,247,177,46,29,17,81
"2011","Cornwall 049C","E01018914",1401,103,21,82,292,182,135,123,243,196,46,34,12,81
"2011","Cornwall 049D","E01018915",1445,89,23,66,310,198,154,133,254,189,48,34,14,70
"2011","Cornwall 050A","E01018916",992,89,27,62,198,121,126,84,136,130,40,32,8,68
"2011","Cornwall 050B","E01018917",1021,66,17,49,212,153,130,76,183,109,31,22,9,61
"2011","Cornwall 050C","E01018918",1308,85,17,68,249,153,205,122,236,139,42,20,22,77
"2011","Cornwall 050D","E01018919",1033,61,17,44,226,149,144,94,169,119,38,21,17,33
"2011","Cornwall 051A","E01018894",1338,61,13,48,258,174,197,130,241,153,42,26,16,82
"2011","Cornwall 051B","E01018895",1243,66,19,47,231,145,135,133,249,182,43,27,16,59
"2011","Cornwall 051C","E01018896",1138,64,25,39,218,163,139,93,210,135,47,33,14,69
"2011","Cornwall 051D","E01018897",1081,56,11,45,185,102,135,94,205,183,64,47,17,57
"2011","Cornwall 051E","E01018898",935,30,7,23,97,104,70,83,197,186,92,70,22,76
"2011","Cornwall 052A","E01018865",1403,50,19,31,207,148,134,137,322,258,60,31,29,87
"2011","Cornwall 052B","E01018866",1179,53,12,41,183,158,83,131,271,203,34,20,14,63
"2011","Cornwall 052C","E01018867",1378,55,14,41,242,146,114,138,285,236,69,56,13,93
"2011","Cornwall 052D","E01018868",1254,44,5,39,206,133,117,119,274,206,81,48,33,74
"2011","Cornwall 053A","E01018874",953,36,4,32,165,144,99,75,192,141,46,32,14,55
"2011","Cornwall 053B","E01018875",894,21,5,16,99,83,84,83,204,175,88,67,21,57
"2011","Cornwall 053C","E01018876",1031,72,16,56,212,127,138,59,201,141,25,16,9,56
"2011","Cornwall 053D","E01018877",1041,68,19,49,227,146,122,97,161,125,36,27,9,59
"2011","Cornwall 053E","E01018878",1006,47,13,34,176,108,93,90,190,162,64,38,26,76
"2011","Cornwall 055A","E01018869",1114,49,16,33,192,118,107,109,228,196,62,46,16,53
"2011","Cornwall 055B","E01018870",893,19,7,12,102,76,69,81,172,182,110,82,28,82
"2011","Cornwall 055C","E01018871",1239,77,17,60,246,169,136,127,224,153,33,19,14,74
"2011","Cornwall 055D","E01018872",926,53,15,38,174,123,123,76,167,119,43,29,14,48
"2011","Cornwall 055E","E01018873",901,43,15,28,161,107,91,83,156,151,54,31,23,55
"2011","Cornwall 059A","E01018863",1220,105,19,86,256,168,172,101,195,124,27,16,11,72
"2011","Cornwall 059B","E01018864",1205,105,32,73,248,148,219,99,187,117,19,9,10,63
"2011","Cornwall 059C","E01018921",1568,170,41,129,362,180,241,106,218,152,52,28,24,87
"2011","Cornwall 059D","E01018922",1785,157,39,118,393,197,377,122,223,162,31,24,7,123
"2011","Cornwall 066A","E01018879",1276,202,47,155,336,143,238,64,118,69,21,16,5,85
"2011","Cornwall 066B","E01018880",1514,153,36,117,341,152,343,112,158,134,46,28,18,75
"2011","Cornwall 066C","E01018899",2215,109,28,81,218,121,145,83,161,105,25,13,12,1248
"2011","Cornwall 066D","E01018900",1110,118,39,79,278,133,170,82,128,110,17,11,6,74
"2011","Cornwall 066E","E01018901",1226,126,31,95,264,143,192,69,138,109,24,18,6,161
"2011","Cornwall 071A","E01018882",1121,91,30,61,276,178,114,110,171,90,18,8,10,73
"2011","Cornwall 071B","E01018883",1158,85,25,60,307,124,112,131,184,112,22,12,10,81
"2011","Cornwall 071C","E01018884",1184,86,31,55,269,183,114,131,196,99,25,16,9,81
"2011","Cornwall 071D","E01018885",1085,81,17,64,248,114,128,99,181,113,56,43,13,65
"2011","Cornwall 071E","E01018886",1324,134,70,64,320,165,112,151,206,128,33,21,12,75
"2011","Cornwall 071F","E01018887",1118,50,20,30,224,119,106,132,199,155,41,25,16,92
"2011","Cornwall 071G","E01018888",1305,75,33,42,241,159,101,131,270,197,50,39,11,81
"2011","Cornwall 072A","E01018861",1081,113,38,75,219,121,201,82,167,109,18,8,10,51
"2011","Cornwall 072B","E01018862",1045,103,23,80,239,104,248,69,140,76,25,16,9,41
"2011","Cornwall 072C","E01018905",962,78,12,66,202,110,170,80,136,110,14,11,3,62
"2011","Cornwall 072D","E01018906",879,72,22,50,187,103,145,70,137,97,19,13,6,49
"2011","Cornwall 072E","E01018907",888,48,13,35,171,83,101,86,163,143,40,19,21,53
"2011","Cornwall 073A","E01018881",1359,98,24,74,285,125,303,105,176,136,40,24,16,91
"2011","Cornwall 073B","E01018902",872,84,18,66,176,78,241,48,112,57,22,12,10,54
"2011","Cornwall 073C","E01018903",1490,162,110,52,421,299,181,189,114,57,28,22,6,39
"2011","Cornwall 073D","E01018904",1470,124,34,90,352,159,260,106,201,154,35,23,12,79
"2011","Cornwall 073E","E01018920",1482,122,38,84,285,139,378,107,201,147,38,29,9,65
"2011","Cornwall 001A","E01018936",1126,61,12,49,226,132,196,87,190,121,46,30,16,67
"2011","Cornwall 001B","E01018937",1336,64,15,49,241,130,157,113,268,204,66,37,29,93
"2011","Cornwall 001C","E01018938",1135,73,16,57,216,123,217,86,183,115,44,28,16,78
"2011","Cornwall 001D","E01018959",1025,80,27,53,251,134,179,74,146,83,25,18,7,53
"2011","Cornwall 001E","E01018960",1365,71,10,61,260,136,243,118,230,185,41,25,16,81
"2011","Cornwall 001F","E01018961",1051,76,19,57,214,120,198,79,161,117,33,19,14,53
"2011","Cornwall 002A","E01018943",1565,105,28,77,315,154,409,92,243,133,46,34,12,68
"2011","Cornwall 002B","E01018951",1654,113,35,78,343,165,446,92,231,138,52,37,15,74
"2011","Cornwall 002C","E01018974",1880,114,34,80,304,180,502,134,309,192,65,51,14,80
"2011","Cornwall 003A","E01018940",1153,84,15,69,214,110,252,94,191,129,37,28,9,42
"2011","Cornwall 003B","E01018941",1136,67,14,53,159,97,261,127,186,144,46,27,19,49
"2011","Cornwall 003C","E01018942",1140,73,23,50,213,108,275,100,178,109,36,21,15,48
"2011","Cornwall 003D","E01018969",1679,132,27,105,363,138,428,112,247,133,45,29,16,81
"2011","Cornwall 004B","E01018953",899,73,12,61,147,91,246,63,141,69,21,12,9,48
"2011","Cornwall 004C","E01018968",1840,142,23,119,348,191,516,120,234,175,48,33,15,66
"2011","Cornwall 004D","E01033291",1171,98,25,73,224,131,261,91,161,112,31,20,11,62
"2011","Cornwall 004E","E01033292",935,43,11,32,165,72,127,117,174,139,51,29,22,47
"2011","Cornwall 005A","E01018946",1060,41,15,26,178,124,109,91,260,172,36,28,8,49
"2011","Cornwall 005B","E01018947",2102,126,40,86,391,215,212,207,478,261,75,53,22,137
"2011","Cornwall 005C","E01018948",1210,73,25,48,225,112,154,123,251,158,60,38,22,54
"2011","Cornwall 005D","E01018949",961,34,8,26,108,70,78,100,233,204,68,41,27,66
"2011","Cornwall 005E","E01018950",1253,65,12,53,226,117,141,105,299,201,47,29,18,52
"2011","Cornwall 006A","E01018925",1608,167,61,106,309,161,401,85,216,147,50,37,13,72
"2011","Cornwall 006B","E01018952",863,61,20,41,165,97,157,75,146,99,23,19,4,40
"2011","Cornwall 006C","E01018965",1861,137,36,101,337,196,362,118,288,187,84,73,11,152
"2011","Cornwall 006D","E01018966",855,105,28,77,171,84,178,58,92,71,20,11,9,76
"2011","Cornwall 006E","E01018967",1035,149,43,106,256,114,160,50,98,77,17,12,5,114
"2011","Cornwall 007A","E01018924",857,65,15,50,178,67,234,65,115,61,25,16,9,47
"2011","Cornwall 007B","E01018962",1538,125,28,97,316,122,457,105,189,114,38,27,11,72
"2011","Cornwall 007E","E01033289",1484,135,32,103,327,137,405,98,179,125,32,21,11,46
"2011","Cornwall 008A","E01018954",902,71,27,44,167,89,202,82,115,78,29,20,9,69
"2011","Cornwall 008B","E01018955",1142,74,15,59,228,98,269,105,155,143,22,16,6,48
"2011","Cornwall 008C","E01018956",787,65,17,48,166,70,172,68,111,78,17,14,3,40
"2011","Cornwall 008D","E01018957",948,65,26,39,197,59,193,90,158,123,15,8,7,48
"2011","Cornwall 008E","E01018958",949,60,18,42,169,64,176,113,144,130,51,35,16,42
"2011","Cornwall 009A","E01018970",1103,96,29,67,270,163,146,86,156,102,22,15,7,62
"2011","Cornwall 009B","E01018971",1311,93,17,76,293,156,195,95,196,133,54,44,10,96
"2011","Cornwall 009C","E01018972",1250,80,23,57,234,115,182,132,231,163,60,45,15,53
"2011","Cornwall 009D","E01018973",1020,59,13,46,226,111,133,67,213,129,32,19,13,50
"2011","Cornwall 011A","E01018923",903,93,24,69,215,92,178,67,124,68,18,15,3,48
"2011","Cornwall 011B","E01018926",1776,162,50,112,364,188,394,127,228,172,44,25,19,97
"2011","Cornwall 011C","E01018944",892,79,26,53,185,71,165,83,126,102,35,23,12,46
"2011","Cornwall 011D","E01018945",956,103,26,77,216,98,210,59,120,96,21,15,6,33
"2011","Cornwall 014A","E01018932",1218,52,12,40,237,127,113,125,250,155,69,39,30,90
"2011","Cornwall 014B","E01018933",1074,55,9,46,157,99,117,108,209,201,63,47,16,65
"2011","Cornwall 014C","E01018934",1468,125,37,88,325,202,170,138,232,153,26,15,11,97
"2011","Cornwall 014D","E01018935",1608,98,27,71,343,219,147,168,300,192,52,36,16,89
"2011","Cornwall 015A","E01018927",1152,54,15,39,191,140,117,127,233,197,50,34,16,43
"2011","Cornwall 015B","E01018928",1257,44,10,34,185,94,122,152,277,233,78,50,28,72
"2011","Cornwall 015C","E01018929",927,69,19,50,176,117,112,95,153,127,29,21,8,49
"2011","Cornwall 015D","E01018930",1099,23,12,11,123,93,77,109,275,239,86,55,31,74
"2011","Cornwall 015E","E01018931",851,33,13,20,141,114,101,85,166,140,30,17,13,41
"2011","Cornwall 054A","E01019008",1032,34,8,26,160,91,139,119,194,171,52,37,15,72
"2011","Cornwall 054B","E01019009",1107,47,7,40,191,95,167,108,186,172,47,29,18,94
"2011","Cornwall 054C","E01019010",994,52,17,35,218,105,169,97,152,118,21,14,7,62
"2011","Cornwall 054D","E01019011",1051,99,26,73,252,122,235,72,114,87,18,12,6,52
"2011","Cornwall 054E","E01019012",1368,89,18,71,331,111,298,133,176,137,33,18,15,60
"2011","Cornwall 057A","E01018978",1101,64,17,47,225,116,175,101,190,121,33,19,14,76
"2011","Cornwall 057B","E01018981",1479,63,18,45,267,190,208,155,279,199,34,24,10,84
"2011","Cornwall 057C","E01018982",1530,68,11,57,257,159,242,141,275,216,74,46,28,98
"2011","Cornwall 057D","E01018983",1150,59,14,45,250,162,184,96,192,104,40,31,9,63
"2011","Cornwall 057E","E01018984",1460,41,12,29,213,127,184,120,330,245,88,67,21,112
"2011","Cornwall 058A","E01018985",1702,144,32,112,394,199,318,121,214,138,42,33,9,132
"2011","Cornwall 058B","E01018986",1082,64,18,46,235,126,224,81,173,105,34,24,10,40
"2011","Cornwall 058C","E01018987",1571,154,35,119,389,180,316,101,199,123,36,24,12,73
"2011","Cornwall 061A","E01018975",1379,99,26,73,316,167,207,112,207,133,43,25,18,95
"2011","Cornwall 061B","E01018979",1053,76,23,53,194,115,181,82,191,98,43,24,19,73
"2011","Cornwall 061C","E01018980",1017,75,21,54,237,106,167,67,154,130,39,28,11,42
"2011","Cornwall 061D","E01018990",1261,111,23,88,252,111,264,100,181,138,45,33,12,59
"2011","Cornwall 061E","E01019007",1640,121,27,94,379,189,317,123,218,153,42,26,16,98
"2011","Cornwall 065A","E01018988",1161,58,18,40,221,147,204,114,208,120,41,34,7,48
"2011","Cornwall 065B","E01018989",1312,104,20,84,283,122,283,72,167,129,57,40,17,95
"2011","Cornwall 065C","E01018991",1130,51,9,42,230,122,203,106,185,131,45,24,21,57
"2011","Cornwall 065D","E01019006",1196,112,15,97,288,133,328,66,116,69,24,10,14,60
"2011","Cornwall 067A","E01018976",1499,91,21,70,322,197,233,107,281,156,44,29,15,68
"2011","Cornwall 067B","E01018977",1017,35,14,21,144,116,128,86,225,155,63,52,11,65
"2011","Cornwall 067C","E01018994",1137,83,18,65,229,115,146,87,209,164,36,27,9,68
"2011","Cornwall 067D","E01018996",1126,55,14,41,231,123,122,91,208,153,76,58,18,67
"2011","Cornwall 067E","E01018997",1001,9,1,8,102,70,75,85,262,199,93,66,27,106
"2011","Cornwall 068A","E01018995",1544,78,11,67,300,124,193,122,302,233,103,73,30,89
"2011","Cornwall 068B","E01018998",1066,63,6,57,233,115,123,99,220,123,43,25,18,47
"2011","Cornwall 068C","E01018999",1100,61,10,51,207,94,164,114,205,138,43,25,18,74
"2011","Cornwall 068D","E01019001",1234,79,19,60,316,125,216,79,187,120,46,24,22,66
"2011","Cornwall 069A","E01018992",1242,85,5,80,318,118,291,81,158,108,30,20,10,53
"2011","Cornwall 069B","E01018993",1222,84,15,69,242,117,206,108,233,118,34,19,15,80
"2011","Cornwall 069C","E01019005",1540,137,23,114,311,126,372,128,213,150,43,34,9,60
"2011","Cornwall 070A","E01019000",971,72,19,53,207,104,164,66,174,112,25,17,8,47
"2011","Cornwall 070B","E01019002",1020,96,23,73,266,102,224,57,128,80,26,21,5,41
"2011","Cornwall 070C","E01019003",1256,95,17,78,300,170,211,85,180,113,33,21,12,69
"2011","Cornwall 070D","E01019004",1165,47,13,34,225,102,191,97,221,134,63,31,32,85
"2011","Cornwall 018A","E01019048",1351,96,23,73,327,151,247,119,174,146,39,24,15,52
"2011","Cornwall 018B","E01019049",1316,58,26,32,256,146,202,125,232,178,41,29,12,78
"2011","Cornwall 018C","E01019050",1076,77,22,55,252,142,176,100,135,97,41,29,12,56
"2011","Cornwall 018D","E01019051",1143,51,14,37,196,113,124,122,208,192,61,43,18,76
"2011","Cornwall 019A","E01019060",1204,98,25,73,264,103,308,97,155,97,26,18,8,56
"2011","Cornwall 019B","E01019061",1253,74,27,47,287,171,156,115,188,142,31,21,10,89
"2011","Cornwall 019C","E01019062",1382,55,19,36,211,153,163,146,262,239,65,33,32,88
"2011","Cornwall 019D","E01019063",1478,84,22,62,296,163,233,145,257,161,43,24,19,96
"2011","Cornwall 019E","E01019064",1420,87,25,62,275,158,253,120,241,176,40,20,20,70
"2011","Cornwall 019F","E01019065",952,33,10,23,146,93,113,114,219,163,30,20,10,41
"2011","Cornwall 020A","E01019028",1494,98,20,78,271,128,226,165,255,214,51,33,18,86
"2011","Cornwall 020B","E01019029",1094,36,14,22,209,98,181,104,181,155,51,29,22,79
"2011","Cornwall 020C","E01019030",1317,109,27,82,338,161,179,102,187,127,24,8,16,90
"2011","Cornwall 020D","E01019031",1116,110,29,81,260,102,240,79,124,103,29,20,9,69
"2011","Cornwall 021A","E01019018",1177,77,20,57,266,142,157,113,176,121,37,23,14,88
"2011","Cornwall 021B","E01019019",1036,48,14,34,220,115,200,103,146,98,35,25,10,71
"2011","Cornwall 021C","E01019020",1152,35,2,33,162,83,184,112,229,188,60,28,32,99
"2011","Cornwall 021D","E01019021",1079,59,13,46,225,114,171,101,180,132,34,19,15,63
"2011","Cornwall 021E","E01019022",1243,62,20,42,215,126,194,133,209,175,47,18,29,82
"2011","Cornwall 021F","E01019023",1176,39,12,27,216,125,141,122,235,164,36,19,17,98
"2011","Cornwall 024A","E01019052",1297,68,27,41,186,123,199,150,242,211,52,35,17,66
"2011","Cornwall 024B","E01019053",1438,76,26,50,223,178,203,175,265,218,58,41,17,42
"2011","Cornwall 024C","E01019054",1366,55,19,36,213,163,177,181,251,210,41,25,16,75
"2011","Cornwall 024D","E01019055",1020,31,10,21,116,85,85,143,215,223,55,34,21,67
"2011","Cornwall 027A","E01019035",1065,117,26,91,255,107,189,60,141,80,54,42,12,62
"2011","Cornwall 027B","E01019036",1292,93,22,71,270,141,275,114,182,126,36,16,20,55
"2011","Cornwall 027C","E01019037",1066,87,23,64,221,124,154,74,166,108,43,21,22,89
"2011","Cornwall 027D","E01019074",1320,51,19,32,207,149,129,145,258,222,65,39,26,94
"2011","Cornwall 027E","E01019075",1295,73,25,48,237,162,175,156,221,164,43,27,16,64
"2011","Cornwall 027F","E01019076",1337,58,11,47,183,123,134,140,294,266,52,35,17,87
"2011","Cornwall 030A","E01019069",961,51,9,42,126,122,83,137,193,157,41,16,25,51
"2011","Cornwall 030B","E01019070",1458,47,12,35,174,164,145,176,313,285,70,43,27,84
"2011","Cornwall 030C","E01019071",1174,89,30,59,235,131,196,118,160,126,43,25,18,76
"2011","Cornwall 030D","E01019072",1081,48,13,35,170,133,103,113,210,173,55,42,13,76
"2011","Cornwall 030E","E01019073",1051,72,20,52,214,141,165,81,186,106,32,25,7,54
"2011","Cornwall 031A","E01019056",1073,23,5,18,109,80,103,117,247,233,91,64,27,70
"2011","Cornwall 031B","E01019057",1384,57,19,38,212,175,147,172,260,214,66,48,18,81
"2011","Cornwall 031C","E01019058",1326,76,22,54,261,177,142,155,229,167,45,24,21,74
"2011","Cornwall 031D","E01019059",1130,52,13,39,192,130,139,120,206,189,49,35,14,53
"2011","Cornwall 035A","E01019024",1056,76,20,56,209,122,163,111,151,120,36,29,7,68
"2011","Cornwall 035B","E01019025",973,106,33,73,239,123,206,52,95,69,28,20,8,55
"2011","Cornwall 035C","E01019026",1048,54,17,37,218,126,177,112,159,119,27,21,6,56
"2011","Cornwall 035D","E01019027",1068,109,38,71,248,100,206,70,138,116,26,22,4,55
"2011","Cornwall 036A","E01019013",1558,93,23,70,268,205,149,156,293,226,62,44,18,106
"2011","Cornwall 036B","E01019014",1058,50,14,36,184,158,110,108,221,129,36,29,7,62
"2011","Cornwall 036C","E01019015",1042,59,9,50,236,159,107,125,175,107,26,21,5,48
"2011","Cornwall 036D","E01019016",1339,87,42,45,270,206,117,150,222,163,39,20,19,85
"2011","Cornwall 036E","E01019017",1664,242,75,167,458,239,239,94,169,105,41,32,9,77
"2011","Cornwall 038A","E01019032",1081,117,25,92,251,176,118,72,145,101,46,25,21,55
"2011","Cornwall 038B","E01019034",1099,89,27,62,193,131,130,98,195,133,62,33,29,68
"2011","Cornwall 038C","E01019045",1552,106,31,75,312,235,164,139,250,179,58,42,16,109
"2011","Cornwall 038D","E01019047",780,45,12,33,160,71,92,72,145,93,35,21,14,67
"2011","Cornwall 039A","E01019033",971,39,9,30,120,107,106,90,194,149,108,86,22,58
"2011","Cornwall 039B","E01019041",1155,55,16,39,165,120,110,125,221,197,87,61,26,75
"2011","Cornwall 039C","E01019042",1266,67,21,46,193,144,126,150,250,192,60,37,23,84
"2011","Cornwall 039D","E01019043",1130,59,18,41,212,144,139,115,207,137,45,36,9,72
"2011","Cornwall 039E","E01019044",1076,46,13,33,195,145,112,113,223,153,28,23,5,61
"2011","Cornwall 039F","E01019046",983,23,4,19,122,89,84,114,227,180,64,46,18,80
"2011","Cornwall 041A","E01019038",803,63,22,41,169,76,199,68,108,68,22,11,11,30
"2011","Cornwall 041B","E01019039",982,80,15,65,216,123,234,58,128,67,24,13,11,52
"2011","Cornwall 041C","E01019040",901,67,14,53,188,88,181,65,148,98,19,9,10,47
"2011","Cornwall 041D","E01019066",891,94,30,64,216,95,192,42,105,70,22,12,10,55
"2011","Cornwall 041E","E01019067",823,74,20,54,197,111,157,54,103,68,20,12,8,39
"2011","Cornwall 041F","E01019068",1171,94,31,63,257,160,179,107,181,113,36,24,12,44
"2011","Isles of Scilly 001A","E01019077",1622,93,26,67,365,165,445,162,201,154,17,10,7,20
"2011","North Somerset 001B","E01014790",1033,176,37,139,310,133,102,72,103,68,11,5,6,58
"2011","North Somerset 001C","E01014795",1016,106,23,83,224,130,95,97,155,114,36,21,15,59
"2011","North Somerset 001D","E01014797",1286,133,29,104,321,159,122,96,209,140,31,18,13,75
"2011","North Somerset 001E","E01032675",1056,247,43,204,332,151,90,62,83,40,19,10,9,32
"2011","North Somerset 001F","E01032676",1062,201,45,156,290,175,98,63,99,83,21,13,8,32
"2011","North Somerset 001G","E01032681",806,99,12,87,221,108,74,62,119,70,14,8,6,39
"2011","North Somerset 002A","E01014789",954,186,50,136,322,131,96,46,85,38,11,5,6,39
"2011","North Somerset 002B","E01014793",1095,176,44,132,338,188,92,52,116,59,11,4,7,63
"2011","North Somerset 002C","E01014794",1200,228,58,170,342,192,122,53,132,74,12,4,8,45
"2011","North Somerset 002D","E01014798",1147,196,37,159,317,188,84,74,127,60,11,6,5,90
"2011","North Somerset 003B","E01014792",1251,127,26,101,311,188,120,118,184,129,24,12,12,50
"2011","North Somerset 003C","E01014796",1203,150,34,116,278,169,121,105,165,133,24,13,11,58
"2011","North Somerset 003D","E01032677",932,150,40,110,287,126,62,66,98,76,34,25,9,33
"2011","North Somerset 003E","E01032678",1071,201,41,160,375,162,74,52,92,53,7,4,3,55
"2011","North Somerset 003F","E01032682",732,114,16,98,202,130,53,34,90,54,15,9,6,40
"2011","North Somerset 004A","E01014766",951,248,51,197,307,103,113,23,46,23,12,4,8,76
"2011","North Somerset 004B","E01014767",957,160,43,117,244,153,108,56,109,60,13,11,2,54
"2011","North Somerset 004C","E01014786",1157,69,11,58,189,141,120,123,188,224,45,25,20,58
"2011","North Somerset 004D","E01014787",1423,187,44,143,385,185,151,101,173,131,37,23,14,73
"2011","North Somerset 005A","E01014752",1123,168,46,122,261,176,128,82,139,92,18,14,4,59
"2011","North Somerset 005B","E01014754",830,147,24,123,272,115,95,49,84,32,12,8,4,24
"2011","North Somerset 005C","E01014758",891,183,47,136,269,114,82,29,93,33,26,21,5,62
"2011","North Somerset 005D","E01014759",936,179,45,134,272,143,115,57,81,36,6,4,2,47
"2011","North Somerset 006B","E01014849",1105,244,55,189,310,146,137,41,95,57,27,17,10,48
"2011","North Somerset 006C","E01014850",1433,356,83,273,418,181,150,59,120,47,22,14,8,80
"2011","North Somerset 006D","E01014851",1730,357,75,282,481,223,176,98,180,124,32,15,17,59
"2011","North Somerset 006E","E01014852",1151,245,58,187,348,166,134,34,97,52,8,5,3,67
"2011","North Somerset 006F","E01032674",1740,382,84,298,518,265,149,90,162,92,21,11,10,61
"2011","North Somerset 006G","E01032680",1347,228,59,169,370,173,217,60,131,84,24,15,9,60
"2011","North Somerset 007A","E01014750",1173,158,39,119,304,149,104,82,188,76,56,44,12,56
"2011","North Somerset 007B","E01014751",1111,83,18,65,196,156,109,117,206,132,33,26,7,79
"2011","North Somerset 007C","E01014753",1292,95,25,70,274,163,120,98,247,174,50,33,17,71
"2011","North Somerset 007D","E01014755",899,149,38,111,268,123,114,45,89,54,34,28,6,23
"2011","North Somerset 007E","E01014760",1055,109,20,89,244,152,108,75,183,87,27,17,10,70
"2011","North Somerset 008A","E01014780",1075,86,18,68,227,147,122,86,197,134,27,18,9,49
"2011","North Somerset 008B","E01014781",1080,95,16,79,239,182,111,73,178,118,29,21,8,55
"2011","North Somerset 008C","E01014782",1007,137,26,111,244,195,78,85,132,78,14,9,5,44
"2011","North Somerset 008D","E01014783",1167,128,19,109,268,196,83,76,190,118,28,19,9,80
"2011","North Somerset 008E","E01014784",1098,121,29,92,240,204,84,78,192,102,17,7,10,60
"2011","North Somerset 008F","E01014785",1071,164,38,126,295,221,92,62,113,61,10,7,3,53
"2011","North Somerset 009A","E01014775",958,165,31,134,286,179,52,47,104,44,4,1,3,77
"2011","North Somerset 009B","E01014776",971,165,32,133,265,182,76,31,117,43,16,7,9,76
"2011","North Somerset 009C","E01014777",1078,142,20,122,261,183,93,97,142,89,14,8,6,57
"2011","North Somerset 009D","E01014778",970,190,45,145,272,170,89,36,114,32,12,6,6,55
"2011","North Somerset 009E","E01014779",867,155,31,124,231,139,71,49,111,35,11,8,3,65
"2011","North Somerset 010A","E01014756",1197,102,27,75,255,173,110,110,220,135,27,16,11,65
"2011","North Somerset 010B","E01014757",1111,100,19,81,198,198,87,112,209,125,23,10,13,59
"2011","North Somerset 010C","E01014761",1207,117,25,92,278,203,121,89,201,123,14,4,10,61
"2011","North Somerset 010D","E01014762",1056,124,22,102,236,189,89,92,164,79,18,10,8,65
"2011","North Somerset 010E","E01014763",1339,110,25,85,266,228,109,109,231,172,35,16,19,79
"2011","North Somerset 011A","E01014737",1021,224,63,161,259,189,100,40,82,36,14,8,6,77
"2011","North Somerset 011B","E01014738",1012,147,18,129,263,161,102,60,117,78,20,13,7,64
"2011","North Somerset 011C","E01014739",1064,194,40,154,278,147,159,42,88,53,20,13,7,83
"2011","North Somerset 011D","E01014740",950,192,44,148,295,125,119,46,62,34,13,11,2,64
"2011","North Somerset 012A","E01014855",1086,183,45,138,293,157,126,68,96,89,21,14,7,53
"2011","North Somerset 012B","E01014856",1098,158,43,115,296,125,150,77,132,82,14,10,4,64
"2011","North Somerset 012C","E01014857",1092,169,35,134,262,169,105,46,139,101,20,13,7,81
"2011","North Somerset 012D","E01014858",1312,177,41,136,345,159,185,90,160,120,16,9,7,60
"2011","North Somerset 012E","E01014859",1114,176,24,152,265,192,93,71,133,82,27,19,8,75
"2011","North Somerset 012F","E01014860",1080,100,26,74,192,124,110,116,200,148,23,15,8,67
"2011","North Somerset 013A","E01014847",1265,203,37,166,309,181,214,75,134,69,24,11,13,56
"2011","North Somerset 013B","E01014848",981,102,23,79,206,122,179,70,121,93,25,12,13,63
"2011","North Somerset 013C","E01014853",1116,200,35,165,277,146,118,55,129,80,30,14,16,81
"2011","North Somerset 013D","E01014854",991,167,37,130,252,143,185,41,76,55,19,6,13,53
"2011","North Somerset 014A","E01014764",1186,161,35,126,296,143,137,70,136,77,41,30,11,125
"2011","North Somerset 014B","E01014765",1347,223,55,168,355,177,163,61,139,65,39,32,7,125
"2011","North Somerset 014C","E01014773",1248,150,38,112,338,183,165,78,145,81,15,8,7,93
"2011","North Somerset 014D","E01014774",1306,143,39,104,247,147,173,104,215,146,63,50,13,68
"2011","North Somerset 015A","E01014821",886,61,8,53,188,136,82,78,168,95,24,10,14,54
"2011","North Somerset 015B","E01014822",1063,131,25,106,246,201,105,88,143,67,12,5,7,70
"2011","North Somerset 015C","E01014823",925,104,24,80,212,140,95,68,155,72,20,10,10,59
"2011","North Somerset 015D","E01014824",1094,111,25,86,251,185,98,86,182,99,29,18,11,53
"2011","North Somerset 015E","E01014825",907,91,28,63,183,143,94,68,182,84,12,7,5,50
"2011","North Somerset 015F","E01014826",1134,82,23,59,243,176,93,83,217,134,26,13,13,80
"2011","North Somerset 015G","E01014827",996,47,11,36,174,128,75,90,199,165,52,28,24,66
"2011","North Somerset 016A","E01014817",1080,84,20,64,247,159,114,93,189,120,33,14,19,41
"2011","North Somerset 016B","E01014820",922,62,15,47,188,131,94,79,166,113,40,31,9,49
"2011","North Somerset 016C","E01014835",957,38,13,25,146,102,74,91,220,174,49,37,12,63
"2011","North Somerset 016D","E01014836",1006,62,19,43,172,142,89,85,206,151,27,18,9,72
"2011","North Somerset 016E","E01014838",983,65,21,44,169,129,92,101,222,122,26,16,10,57
"2011","North Somerset 016F","E01014840",974,45,18,27,174,148,77,80,219,135,36,17,19,60
"2011","North Somerset 017A","E01014812",991,60,16,44,195,138,111,100,187,127,34,20,14,39
"2011","North Somerset 017B","E01014813",1213,77,18,59,231,162,150,109,234,132,44,26,18,74
"2011","North Somerset 017C","E01014815",968,67,19,48,203,125,113,80,164,119,35,25,10,62
"2011","North Somerset 017D","E01014816",1023,103,29,74,232,155,116,75,193,79,14,10,4,56
"2011","North Somerset 017E","E01014818",1243,163,39,124,330,226,137,65,158,85,15,12,3,64
"2011","North Somerset 017F","E01014819",1114,126,27,99,260,174,126,74,189,107,18,9,9,40
"2011","North Somerset 018A","E01014841",1346,129,31,98,310,154,179,120,207,147,50,33,17,50
"2011","North Somerset 018B","E01014842",1131,97,25,72,232,130,137,88,192,121,92,54,38,42
"2011","North Somerset 018C","E01014843",1047,115,29,86,254,128,106,62,141,102,82,73,9,57
"2011","North Somerset 018D","E01014844",950,85,16,69,188,90,92,73,181,124,64,42,22,53
"2011","North Somerset 018E","E01014845",868,81,19,62,210,141,114,51,139,71,18,11,7,43
"2011","North Somerset 018F","E01014846",1100,109,25,84,233,147,149,81,148,105,40,35,5,88
"2011","North Somerset 020A","E01014799",1232,62,17,45,207,122,122,118,253,179,90,58,32,79
"2011","North Somerset 020B","E01014800",1170,31,5,26,171,90,118,104,249,227,100,65,35,80
"2011","North Somerset 020C","E01014801",1027,40,10,30,141,102,108,99,201,153,121,81,40,62
"2011","North Somerset 020D","E01014802",1157,67,9,58,195,121,98,114,209,179,104,80,24,70
"2011","North Somerset 020E","E01014809",1253,68,15,53,209,128,122,122,282,177,68,41,27,77
"2011","North Somerset 020F","E01014811",1133,60,11,49,240,155,111,97,225,135,52,34,18,58
"2011","North Somerset 021A","E01014829",1324,47,8,39,193,115,76,122,315,250,84,66,18,122
"2011","North Somerset 021B","E01014830",1162,49,13,36,200,127,101,111,259,162,59,40,19,94
"2011","North Somerset 021C","E01014831",899,17,2,15,88,64,47,70,243,203,97,60,37,70
"2011","North Somerset 021D","E01014832",976,12,4,8,75,57,68,80,263,234,100,78,22,87
"2011","North Somerset 021E","E01014833",1001,17,4,13,109,81,65,78,279,197,95,61,34,80
"2011","North Somerset 022A","E01014804",904,123,30,93,250,98,104,47,116,76,35,24,11,55
"2011","North Somerset 022B","E01014806",1048,89,14,75,166,137,118,64,187,137,112,93,19,38
"2011","North Somerset 022C","E01014807",1239,80,18,62,234,155,136,98,228,141,81,51,30,86
"2011","North Somerset 022D","E01014808",1024,77,14,63,240,150,101,71,192,86,39,21,18,68
"2011","North Somerset 023A","E01014744",1007,120,35,85,239,144,155,57,141,99,11,6,5,41
"2011","North Somerset 023B","E01014746",1001,100,23,77,233,116,130,73,155,111,29,21,8,54
"2011","North Somerset 023C","E01014769",1639,169,40,129,368,222,209,138,250,162,42,22,20,79
"2011","North Somerset 023D","E01014770",993,102,28,74,217,163,95,86,174,110,14,10,4,32
"2011","North Somerset 023E","E01014771",1004,108,32,76,236,153,119,84,150,85,13,5,8,56
"2011","North Somerset 023F","E01014772",966,118,36,82,234,120,152,71,134,76,19,10,9,42
"2011","North Somerset 024A","E01014741",962,144,29,115,249,112,127,60,118,68,31,24,7,53
"2011","North Somerset 024B","E01014742",1144,171,39,132,274,140,134,64,113,58,14,9,5,176
"2011","North Somerset 024C","E01014745",1021,150,42,108,228,149,130,72,124,81,26,15,11,61
"2011","North Somerset 024D","E01014747",1003,185,41,144,282,108,145,43,101,67,17,9,8,55
"2011","North Somerset 024E","E01014748",816,124,31,93,196,95,99,42,90,38,13,7,6,119
"2011","North Somerset 024F","E01014749",1018,179,37,142,295,125,125,52,86,53,13,9,4,90
"2011","North Somerset 025A","E01014803",1041,136,23,113,251,122,148,63,157,73,27,17,10,64
"2011","North Somerset 025B","E01014805",1023,107,31,76,246,154,130,69,171,75,36,19,17,35
"2011","North Somerset 025C","E01014828",973,41,17,24,142,72,81,84,224,186,62,37,25,81
"2011","North Somerset 025D","E01014834",962,31,5,26,127,81,69,91,248,201,53,34,19,61
"2011","North Somerset 026A","E01014839",1114,89,23,66,229,138,85,105,225,137,34,20,14,72
"2011","North Somerset 026B","E01032666",856,108,29,79,210,110,119,44,118,74,19,14,5,54
"2011","North Somerset 026C","E01032667",757,79,20,59,185,100,70,66,128,76,17,8,9,36
"2011","North Somerset 026D","E01032668",1062,110,30,80,252,149,70,94,179,113,35,21,14,60
"2011","North Somerset 026E","E01032672",1005,77,13,64,245,156,102,100,166,90,29,19,10,40
"2011","North Somerset 026F","E01032673",887,60,12,48,173,134,88,68,177,116,33,22,11,38
"2011","North Somerset 027A","E01014810",994,51,14,37,174,131,82,101,228,150,33,24,9,44
"2011","North Somerset 027B","E01032669",1012,92,18,74,291,156,63,84,171,81,23,10,13,51
"2011","North Somerset 027C","E01032670",1097,125,26,99,262,180,79,85,183,92,30,13,17,61
"2011","North Somerset 027D","E01032671",915,94,29,65,203,137,79,79,143,83,26,3,23,71
"2011","North Somerset 027E","E01032679",941,85,15,70,193,146,79,84,173,102,24,7,17,55
"2011","Plymouth 001A","E01015025",1123,187,52,135,320,175,106,61,117,73,25,18,7,59
"2011","Plymouth 001B","E01015097",1269,124,35,89,281,186,122,105,210,157,25,15,10,59
"2011","Plymouth 001C","E01015160",1073,115,30,85,245,173,94,100,170,95,13,8,5,68
"2011","Plymouth 001D","E01015164",1406,120,37,83,327,227,90,125,232,141,60,43,17,84
"2011","Plymouth 002A","E01015027",1206,124,30,94,264,219,97,84,167,141,34,20,14,76
"2011","Plymouth 002B","E01015159",1113,41,19,22,143,136,79,101,264,232,58,43,15,59
"2011","Plymouth 002C","E01015161",1106,29,11,18,141,150,70,129,240,222,61,39,22,64
"2011","Plymouth 002D","E01015162",1041,31,8,23,144,118,79,93,235,210,62,41,21,69
"2011","Plymouth 002E","E01015166",1340,61,12,49,208,173,96,121,250,229,117,86,31,85
"2011","Plymouth 003A","E01015023",1175,47,12,35,134,124,82,133,233,252,83,54,29,87
"2011","Plymouth 003B","E01015026",1165,45,10,35,173,141,90,103,236,221,91,64,27,65
"2011","Plymouth 003C","E01015028",1013,15,8,7,108,125,91,97,229,213,82,49,33,53
"2011","Plymouth 003D","E01015163",1043,71,20,51,195,138,106,93,185,155,33,25,8,67
"2011","Plymouth 003E","E01015165",1173,106,34,72,252,201,78,98,193,132,32,22,10,81
"2011","Plymouth 004A","E01015024",1153,67,19,48,276,185,96,115,174,145,40,19,21,55
"2011","Plymouth 004B","E01015082",1178,28,6,22,137,138,93,121,250,230,110,82,28,71
"2011","Plymouth 004C","E01015083",1093,28,6,22,123,104,75,111,240,222,117,80,37,73
"2011","Plymouth 004D","E01015084",1060,40,9,31,149,105,93,109,226,201,57,37,20,80
"2011","Plymouth 005A","E01015090",1084,70,23,47,225,195,81,102,182,152,16,8,8,61
"2011","Plymouth 005B","E01015091",1214,102,29,73,216,197,88,108,215,177,35,19,16,76
"2011","Plymouth 005C","E01015092",1289,78,7,71,124,111,57,75,181,137,39,23,16,487
"2011","Plymouth 005D","E01015093",1066,37,14,23,145,140,79,106,252,226,34,21,13,47
"2011","Plymouth 005E","E01015094",1003,36,10,26,151,152,69,113,208,190,30,16,14,54
"2011","Plymouth 006A","E01015085",1136,45,11,34,159,177,108,108,224,200,61,34,27,54
"2011","Plymouth 006B","E01015087",1087,22,5,17,118,108,82,99,233,214,102,82,20,109
"2011","Plymouth 006C","E01015088",1048,19,7,12,89,88,64,79,238,216,146,113,33,109
"2011","Plymouth 006D","E01015147",923,55,15,40,173,138,82,85,166,126,39,30,9,59
"2011","Plymouth 006E","E01015148",1102,49,20,29,195,157,84,101,213,186,54,38,16,63
"2011","Plymouth 007A","E01015030",1121,25,7,18,115,119,83,100,255,233,114,83,31,77
"2011","Plymouth 007B","E01015070",1862,181,29,152,408,234,127,138,318,213,104,73,31,139
"2011","Plymouth 007C","E01015081",1083,27,4,23,123,112,75,85,285,221,71,46,25,84
"2011","Plymouth 007D","E01015086",972,45,14,31,108,126,65,83,234,184,70,48,22,57
"2011","Plymouth 007E","E01015089",1201,45,17,28,196,177,73,109,263,205,79,57,22,54
"2011","Plymouth 008A","E01015029",1270,129,49,80,283,236,78,84,205,123,52,36,16,80
"2011","Plymouth 008B","E01015064",1126,144,38,106,284,224,86,81,129,103,11,7,4,64
"2011","Plymouth 008C","E01015065",974,83,25,58,245,170,56,73,136,109,40,28,12,62
"2011","Plymouth 008D","E01015071",1088,88,34,54,228,178,81,90,182,128,39,24,15,74
"2011","Plymouth 009A","E01015076",1087,66,17,49,186,183,80,103,215,161,40,24,16,53
"2011","Plymouth 009B","E01015142",1031,60,19,41,181,153,96,98,188,157,40,23,17,58
"2011","Plymouth 009C","E01015143",1019,47,16,31,156,157,57,118,195,197,51,41,10,41
"2011","Plymouth 009D","E01015144",1071,30,14,16,119,143,96,91,226,182,97,64,33,87
"2011","Plymouth 009E","E01015146",1214,20,7,13,146,139,102,102,262,220,132,99,33,91
"2011","Plymouth 009F","E01015149",1037,22,6,16,101,107,77,102,231,205,108,73,35,84
"2011","Plymouth 009G","E01015150",1018,52,14,38,168,163,90,94,188,158,58,42,16,47
"2011","Plymouth 010A","E01015063",1068,45,15,30,166,150,77,122,208,190,43,19,24,67
"2011","Plymouth 010B","E01015068",1152,94,25,69,286,194,77,92,173,130,26,17,9,80
"2011","Plymouth 010C","E01015069",1140,44,18,26,177,159,103,105,240,186,54,32,22,72
"2011","Plymouth 010D","E01015095",1081,38,15,23,140,162,72,109,248,232,35,17,18,45
"2011","Plymouth 010E","E01015096",1065,40,13,27,136,134,76,95,240,221,50,37,13,73
"2011","Plymouth 011A","E01015074",1076,35,8,27,162,114,82,81,234,211,84,67,17,73
"2011","Plymouth 011B","E01015077",1189,72,20,52,204,187,95,118,213,167,54,38,16,79
"2011","Plymouth 011C","E01015079",1057,73,16,57,203,150,111,86,165,156,43,33,10,70
"2011","Plymouth 011D","E01015102",1267,100,17,83,333,204,101,108,194,115,49,32,17,63
"2011","Plymouth 011E","E01015104",1089,114,34,80,238,197,90,111,133,110,21,11,10,75
"2011","Plymouth 012A","E01015035",1150,89,32,57,248,219,104,96,170,121,24,10,14,79
"2011","Plymouth 012B","E01015037",950,62,18,44,195,166,80,77,166,125,40,30,10,39
"2011","Plymouth 012C","E01015058",989,27,8,19,109,97,89,96,206,194,87,63,24,84
"2011","Plymouth 012D","E01015066",1125,84,24,60,223,211,79,96,194,139,26,19,7,73
"2011","Plymouth 012E","E01015067",1132,99,31,68,260,215,95,85,147,112,28,23,5,91
"2011","Plymouth 013A","E01015072",1141,46,20,26,131,111,90,97,232,236,102,78,24,96
"2011","Plymouth 013B","E01015073",1083,29,7,22,140,124,82,99,242,220,84,63,21,63
"2011","Plymouth 013C","E01015078",843,19,7,12,78,72,48,79,186,192,94,66,28,75
"2011","Plymouth 013D","E01015080",897,17,6,11,90,61,39,60,189,220,140,102,38,81
"2011","Plymouth 013E","E01015106",922,76,19,57,176,161,86,82,138,101,44,30,14,58
"2011","Plymouth 014A","E01015039",1010,78,47,31,239,167,63,95,161,113,42,19,23,52
"2011","Plymouth 014B","E01015040",1104,31,6,25,146,120,76,91,225,241,92,65,27,82
"2011","Plymouth 014C","E01015041",1082,51,17,34,213,166,65,111,195,162,54,32,22,65
"2011","Plymouth 014D","E01015075",1015,33,10,23,136,107,73,89,233,218,67,48,19,59
"2011","Plymouth 014E","E01015145",1159,16,7,9,109,139,66,81,265,228,175,117,58,80
"2011","Plymouth 015A","E01015120",1133,109,21,88,272,207,92,92,160,105,20,16,4,76
"2011","Plymouth 015B","E01015121",1073,86,22,64,239,204,90,90,154,119,17,9,8,74
"2011","Plymouth 015C","E01015123",1114,99,18,81,275,162,122,81,170,114,37,33,4,54
"2011","Plymouth 015D","E01015124",1114,104,27,77,252,205,91,99,157,115,24,15,9,67
"2011","Plymouth 015E","E01015125",1175,100,29,71,256,207,87,101,199,114,25,15,10,86
"2011","Plymouth 016A","E01015033",1128,136,29,107,298,181,126,73,140,71,18,13,5,85
"2011","Plymouth 016B","E01015034",983,225,42,183,283,111,108,25,72,47,26,18,8,86
"2011","Plymouth 016C","E01015036",1008,154,31,123,311,170,90,44,99,58,21,14,7,61
"2011","Plymouth 016D","E01015038",1289,164,30,134,321,206,118,82,139,118,41,29,12,100
"2011","Plymouth 016E","E01015101",1047,181,29,152,310,163,156,34,81,30,21,11,10,71
"2011","Plymouth 017A","E01015098",1133,160,32,128,302,142,79,54,114,75,32,18,14,175
"2011","Plymouth 017B","E01015099",1132,164,31,133,278,177,88,60,116,84,28,12,16,137
"2011","Plymouth 017C","E01015100",1145,165,24,141,274,140,85,52,133,73,35,19,16,188
"2011","Plymouth 017D","E01015103",1110,130,22,108,329,170,111,48,122,70,34,29,5,96
"2011","Plymouth 017E","E01015105",1096,157,26,131,314,178,97,55,120,67,20,15,5,88
"2011","Plymouth 018A","E01015107",1148,80,22,58,261,203,66,107,183,135,35,18,17,78
"2011","Plymouth 018B","E01015110",1232,110,29,81,257,211,91,107,222,136,19,12,7,79
"2011","Plymouth 018C","E01015111",1260,130,38,92,303,244,69,115,207,114,17,12,5,61
"2011","Plymouth 018D","E01015119",1290,125,42,83,309,234,107,111,186,103,12,8,4,103
"2011","Plymouth 019A","E01015112",1047,84,16,68,287,182,88,70,140,102,33,21,12,61
"2011","Plymouth 019B","E01015113",1076,92,26,66,241,210,79,104,166,101,13,7,6,70
"2011","Plymouth 019C","E01015114",1089,97,31,66,257,184,90,97,168,101,18,9,9,77
"2011","Plymouth 019D","E01015118",1148,106,27,79,271,232,108,96,163,89,13,11,2,70
"2011","Plymouth 019E","E01015122",1086,97,32,65,232,216,85,82,159,112,17,12,5,86
"2011","Plymouth 020A","E01015042",1101,63,15,48,219,160,83,101,200,148,47,32,15,80
"2011","Plymouth 020B","E01015044",1219,60,16,44,248,116,111,99,198,189,109,77,32,89
"2011","Plymouth 020C","E01015167",1204,82,24,58,233,153,102,106,223,155,62,31,31,88
"2011","Plymouth 020D","E01015168",1445,57,14,43,269,204,132,129,244,193,89,49,40,128
"2011","Plymouth 020E","E01015171",1347,142,33,109,282,177,115,87,192,143,96,67,29,113
"2011","Plymouth 021A","E01015055",1054,41,9,32,116,120,88,102,239,206,67,51,16,75
"2011","Plymouth 021B","E01015056",1189,69,19,50,213,180,112,116,215,168,55,38,17,61
"2011","Plymouth 021C","E01015057",1055,35,8,27,159,123,66,98,242,156,68,49,19,108
"2011","Plymouth 021D","E01015059",1155,55,8,47,239,157,90,105,204,165,54,29,25,86
"2011","Plymouth 021E","E01015060",1123,52,12,40,209,168,74,107,196,178,52,35,17,87
"2011","Plymouth 021F","E01015176",1095,46,12,34,164,128,70,103,228,206,62,48,14,88
"2011","Plymouth 022A","E01015108",1360,97,34,63,350,237,83,129,214,145,27,11,16,78
"2011","Plymouth 022B","E01015109",1166,94,34,60,251,201,86,129,181,120,26,16,10,78
"2011","Plymouth 022C","E01015115",919,53,13,40,171,89,70,99,182,151,43,30,13,61
"2011","Plymouth 022D","E01015116",1113,108,33,75,230,209,68,114,172,127,24,17,7,61
"2011","Plymouth 022E","E01015117",1134,75,19,56,250,205,79,92,202,134,28,17,11,69
"2011","Plymouth 023A","E01015031",1280,127,13,114,275,130,87,72,122,108,40,23,17,319
"2011","Plymouth 023B","E01015032",1786,86,15,71,190,134,62,73,178,140,71,40,31,852
"2011","Plymouth 023C","E01015049",1449,92,12,80,193,107,54,53,96,86,27,19,8,741
"2011","Plymouth 023D","E01015050",1686,59,4,55,158,106,65,52,112,91,67,41,26,976
"2011","Plymouth 023E","E01015051",1780,56,11,45,134,98,41,44,94,48,43,34,9,1222
"2011","Plymouth 024A","E01015169",1614,99,26,73,271,158,120,91,180,124,62,38,24,509
"2011","Plymouth 024B","E01015170",1205,94,15,79,222,168,98,82,197,168,85,59,26,91
"2011","Plymouth 024C","E01015173",1337,169,36,133,337,167,128,94,125,102,68,46,22,147
"2011","Plymouth 024D","E01015174",1230,103,30,73,264,195,98,96,174,150,53,46,7,97
"2011","Plymouth 025A","E01015061",1137,81,15,66,228,118,53,71,193,122,48,26,22,223
"2011","Plymouth 025B","E01015062",1876,105,15,90,218,118,58,84,162,108,43,26,17,980
"2011","Plymouth 025C","E01015175",1335,112,16,96,264,157,81,89,175,130,42,31,11,285
"2011","Plymouth 025D","E01015177",1399,108,19,89,265,190,119,86,207,121,50,33,17,253
"2011","Plymouth 025E","E01015178",1777,106,19,87,317,179,91,90,153,127,62,38,24,652
"2011","Plymouth 026A","E01015043",1109,30,8,22,140,108,102,88,216,216,111,69,42,98
"2011","Plymouth 026B","E01015045",1110,33,5,28,157,128,81,98,221,240,104,73,31,48
"2011","Plymouth 026C","E01015046",1435,25,8,17,150,115,84,139,323,315,180,122,58,104
"2011","Plymouth 026D","E01015047",1058,37,4,33,143,112,86,77,220,208,96,68,28,79
"2011","Plymouth 026E","E01015048",873,27,13,14,107,95,42,66,186,194,96,62,34,60
"2011","Plymouth 027A","E01015053",1357,41,7,34,104,73,59,62,115,104,50,31,19,749
"2011","Plymouth 027B","E01015054",2141,27,6,21,86,56,41,53,90,63,57,41,16,1668
"2011","Plymouth 027C","E01015152",1418,38,6,32,149,102,86,106,245,249,169,124,45,274
"2011","Plymouth 027E","E01015156",1302,104,35,69,225,137,119,83,137,144,81,44,37,272
"2011","Plymouth 027F","E01032657",1344,125,29,96,183,106,61,69,128,84,38,23,15,550
"2011","Plymouth 027G","E01032658",1038,100,16,84,139,78,76,71,142,123,79,61,18,230
"2011","Plymouth 028A","E01015052",1730,78,5,73,195,110,57,82,174,139,78,60,18,817
"2011","Plymouth 028B","E01015179",1438,102,18,84,189,158,61,70,142,111,39,23,16,566
"2011","Plymouth 028C","E01015180",1357,45,7,38,234,152,84,142,239,235,106,80,26,120
"2011","Plymouth 028D","E01015181",1704,91,31,60,239,214,149,128,305,195,100,71,29,283
"2011","Plymouth 028E","E01015182",1395,69,21,48,236,172,108,104,234,216,116,78,38,140
"2011","Plymouth 029A","E01015151",1580,58,12,46,152,116,97,112,228,228,120,74,46,469
"2011","Plymouth 029B","E01015153",1330,72,11,61,154,97,111,101,252,239,134,91,43,170
"2011","Plymouth 029C","E01015155",1342,51,7,44,119,107,83,93,257,313,183,129,54,136
"2011","Plymouth 029D","E01015157",1747,235,52,183,368,168,156,112,204,217,124,63,61,163
"2011","Plymouth 029E","E01015158",1766,231,33,198,402,216,199,108,199,149,66,34,32,196
"2011","Plymouth 029F","E01015172",1439,149,32,117,316,163,141,103,192,117,77,51,26,181
"2011","Plymouth 030A","E01015126",900,93,25,68,223,159,93,63,133,71,16,11,5,49
"2011","Plymouth 030B","E01015127",1087,105,26,79,222,187,102,114,160,104,22,14,8,71
"2011","Plymouth 030C","E01015131",1048,127,45,82,302,177,119,55,104,76,23,11,12,65
"2011","Plymouth 030D","E01015132",1055,108,55,53,251,174,82,80,167,112,19,15,4,62
"2011","Plymouth 030E","E01015133",1115,123,36,87,281,197,95,77,146,95,21,15,6,80
"2011","Plymouth 031A","E01015135",1134,77,22,55,230,159,113,82,181,153,54,39,15,85
"2011","Plymouth 031B","E01015136",1057,79,13,66,221,163,117,94,167,114,20,19,1,82
"2011","Plymouth 031C","E01015137",1142,118,32,86,278,169,153,93,142,105,32,24,8,52
"2011","Plymouth 031D","E01015138",1149,143,38,105,273,187,124,80,159,107,20,8,12,56
"2011","Plymouth 031E","E01015139",1008,93,27,66,196,129,118,81,183,124,35,19,16,49
"2011","Plymouth 031F","E01015141",1285,156,49,107,329,208,113,71,188,118,23,14,9,79
"2011","Plymouth 032A","E01015128",1196,99,30,69,238,214,100,119,216,117,28,15,13,65
"2011","Plymouth 032B","E01015129",1105,53,19,34,245,185,96,96,214,132,28,16,12,56
"2011","Plymouth 032C","E01015130",1221,98,29,69,307,218,91,103,181,107,21,13,8,95
"2011","Plymouth 032D","E01015134",1014,86,21,65,246,183,71,81,154,75,35,24,11,83
"2011","Plymouth 032E","E01015140",989,95,25,70,284,181,69,77,128,86,20,11,9,49
"2011","Poole 001A","E01015431",1063,118,34,84,272,126,86,37,96,50,13,11,2,265
"2011","Poole 001B","E01015432",1182,154,45,109,279,223,113,92,153,87,18,9,9,63
"2011","Poole 001C","E01015433",1102,168,41,127,300,178,136,65,122,69,16,7,9,48
"2011","Poole 001D","E01015434",1147,173,42,131,322,182,108,67,124,67,17,12,5,87
"2011","Poole 002A","E01015379",958,44,8,36,116,90,90,95,218,177,55,39,16,73
"2011","Poole 002B","E01015435",1156,98,22,76,272,194,94,107,172,122,34,21,13,63
"2011","Poole 002C","E01015436",1000,100,27,73,230,167,104,74,145,97,31,20,11,52
"2011","Poole 002D","E01015437",993,99,28,71,220,176,118,72,138,72,20,11,9,78
"2011","Poole 003A","E01015395",879,134,31,103,231,132,103,41,102,53,21,12,9,62
"2011","Poole 003B","E01015396",1056,183,60,123,278,176,119,49,126,52,12,5,7,61
"2011","Poole 003C","E01015397",1073,199,51,148,290,180,109,49,104,43,16,10,6,83
"2011","Poole 003D","E01015398",998,167,36,131,267,180,92,50,103,64,11,5,6,64
"2011","Poole 003E","E01015399",996,182,38,144,282,152,123,22,95,41,21,9,12,78
"2011","Poole 003F","E01015400",1030,179,48,131,291,163,110,46,123,48,17,9,8,53
"2011","Poole 003G","E01015401",1018,154,39,115,269,170,123,57,108,56,16,9,7,65
"2011","Poole 004A","E01015412",1020,148,30,118,258,192,125,61,112,63,14,5,9,47
"2011","Poole 004B","E01015413",1092,98,19,79,234,191,93,73,184,144,26,10,16,49
"2011","Poole 004C","E01015414",1084,108,26,82,226,200,90,109,157,100,31,17,14,63
"2011","Poole 004D","E01015415",928,38,15,23,132,109,79,112,196,181,40,24,16,41
"2011","Poole 004E","E01015416",939,98,28,70,235,153,65,66,168,74,26,20,6,54
"2011","Poole 005A","E01015407",1096,67,16,51,181,204,85,103,205,152,29,22,7,70
"2011","Poole 005B","E01015408",965,67,16,51,181,150,75,115,177,120,17,11,6,63
"2011","Poole 005C","E01015409",1069,59,7,52,161,136,68,115,236,145,57,38,19,92
"2011","Poole 005D","E01015410",1182,106,16,90,221,196,99,112,222,130,26,10,16,70
"2011","Poole 005E","E01015411",1021,74,21,53,196,186,85,105,174,114,20,9,11,67
"2011","Poole 006A","E01015417",1065,56,14,42,180,128,103,120,209,184,31,20,11,54
"2011","Poole 006B","E01015418",1140,95,19,76,241,191,93,114,185,147,15,10,5,59
"2011","Poole 006C","E01015419",1280,105,24,81,312,220,124,109,208,124,28,17,11,50
"2011","Poole 006D","E01015420",1051,54,9,45,155,121,100,113,222,190,41,30,11,55
"2011","Poole 006E","E01015421",951,75,19,56,166,121,98,93,176,149,28,17,11,45
"2011","Poole 006F","E01015422",1131,132,24,108,269,217,91,86,178,90,12,6,6,56
"2011","Poole 007A","E01015380",1280,86,27,59,215,182,163,114,238,165,47,38,9,70
"2011","Poole 007B","E01015381",1148,63,15,48,184,123,116,122,218,182,54,35,19,86
"2011","Poole 007C","E01015382",1352,76,14,62,246,179,99,120,294,179,74,45,29,85
"2011","Poole 007D","E01015383",1087,64,15,49,180,182,120,91,217,136,27,10,17,70
"2011","Poole 007E","E01015384",1075,33,9,24,105,108,95,89,257,202,83,61,22,103
"2011","Poole 007F","E01015385",1227,52,11,41,189,173,144,111,228,187,53,34,19,90
"2011","Poole 008A","E01015438",1147,80,22,58,225,175,125,106,219,119,37,23,14,61
"2011","Poole 008B","E01015439",1276,81,19,62,210,163,136,111,246,190,67,39,28,72
"2011","Poole 008C","E01015441",1372,95,19,76,303,190,131,105,245,157,66,40,26,80
"2011","Poole 008D","E01015442",1329,55,16,39,201,152,137,116,269,237,74,52,22,88
"2011","Poole 008E","E01015443",1302,76,21,55,202,168,128,124,260,205,73,59,14,66
"2011","Poole 008F","E01015444",1283,85,22,63,227,183,140,128,222,162,34,21,13,102
"2011","Poole 009A","E01015386",1238,101,17,84,242,150,137,104,212,143,47,28,19,102
"2011","Poole 009B","E01015387",1119,111,28,83,267,174,125,103,156,104,21,14,7,58
"2011","Poole 009C","E01015388",1284,144,33,111,220,148,90,47,88,44,33,29,4,470
"2011","Poole 009D","E01015389",1125,149,33,116,311,144,139,82,143,72,20,12,8,65
"2011","Poole 010A","E01015390",1281,108,25,83,263,151,117,123,230,146,58,33,25,85
"2011","Poole 010B","E01015391",1117,80,26,54,231,157,132,106,198,123,35,23,12,55
"2011","Poole 010C","E01015392",1062,84,17,67,219,146,130,94,180,133,26,15,11,50
"2011","Poole 010D","E01015393",937,75,14,61,233,124,98,75,162,100,25,16,9,45
"2011","Poole 010E","E01015394",1177,106,25,81,247,189,143,97,179,99,24,19,5,93
"2011","Poole 011A","E01015440",1425,122,35,87,306,202,160,95,254,164,38,21,17,84
"2011","Poole 011B","E01015447",1124,100,27,73,249,166,144,77,179,114,33,24,9,62
"2011","Poole 011C","E01015449",1243,72,18,54,200,188,111,111,251,181,36,29,7,93
"2011","Poole 011D","E01015456",1253,139,32,107,270,176,124,96,209,138,39,32,7,62
"2011","Poole 011E","E01015457",1183,175,36,139,341,128,129,84,137,97,41,34,7,51
"2011","Poole 012A","E01015445",1401,137,28,109,323,216,148,108,206,141,24,10,14,98
"2011","Poole 012B","E01015446",1120,90,18,72,240,148,97,105,205,130,36,23,13,69
"2011","Poole 012C","E01015448",1093,71,16,55,200,164,96,101,207,166,20,9,11,68
"2011","Poole 012D","E01015450",1263,82,16,66,244,178,125,117,207,172,48,31,17,90
"2011","Poole 012E","E01015451",1036,78,19,59,251,143,116,106,156,107,18,11,7,61
"2011","Poole 013A","E01015458",1004,243,64,179,276,135,149,36,79,29,14,6,8,43
"2011","Poole 013B","E01015460",1236,158,34,124,328,140,108,96,198,92,38,21,17,78
"2011","Poole 013C","E01015461",1145,122,28,94,311,137,148,65,151,93,34,21,13,84
"2011","Poole 013D","E01015462",1215,163,32,131,366,148,134,69,155,76,38,20,18,66
"2011","Poole 013E","E01015463",1151,235,36,199,363,166,119,42,70,43,45,35,10,68
"2011","Poole 013F","E01015464",1144,297,53,244,344,152,164,23,64,27,15,9,6,58
"2011","Poole 014A","E01015427",1259,85,38,47,262,206,91,123,222,173,39,24,15,58
"2011","Poole 014B","E01015428",1564,139,33,106,325,248,193,121,246,190,45,21,24,57
"2011","Poole 014C","E01015429",1192,53,12,41,176,156,108,114,232,217,62,39,23,74
"2011","Poole 014D","E01015430",1094,32,10,22,130,115,81,107,245,205,95,61,34,84
"2011","Poole 015A","E01015465",1331,99,23,76,277,179,115,111,244,169,64,32,32,73
"2011","Poole 015B","E01015466",1192,131,30,101,282,152,126,79,181,132,53,37,16,56
"2011","Poole 015D","E01015468",1277,158,22,136,305,186,90,77,200,128,49,28,21,84
"2011","Poole 015F","E01032659",936,61,18,43,160,110,92,88,172,145,63,35,28,45
"2011","Poole 015G","E01032660",1381,131,29,102,281,156,84,93,175,104,51,29,22,306
"2011","Poole 015H","E01032661",1018,128,29,99,260,128,135,68,138,82,30,15,15,49
"2011","Poole 015I","E01032662",818,79,20,59,131,82,76,69,167,130,49,28,21,35
"2011","Poole 016A","E01015423",1523,130,38,92,286,178,164,136,250,239,57,30,27,83
"2011","Poole 016B","E01015424",1026,72,22,50,220,149,94,110,168,140,30,21,9,43
"2011","Poole 016C","E01015425",956,70,25,45,162,148,98,95,177,119,34,13,21,53
"2011","Poole 016D","E01015426",966,48,14,34,153,107,116,105,177,167,39,20,19,54
"2011","Poole 017A","E01015452",1137,214,45,169,338,133,153,53,106,57,24,16,8,59
"2011","Poole 017B","E01015453",1383,271,55,216,413,159,172,70,125,84,31,19,12,58
"2011","Poole 017C","E01015454",1319,196,43,153,357,165,161,79,171,102,24,15,9,64
"2011","Poole 017D","E01015455",1282,219,54,165,382,192,176,57,99,66,31,13,18,60
"2011","Poole 017E","E01015459",1149,244,66,178,355,162,183,33,63,38,19,14,5,52
"2011","Poole 018A","E01015402",1123,182,49,133,311,131,144,62,102,73,34,28,6,84
"2011","Poole 018B","E01015403",958,157,39,118,308,150,100,52,99,34,33,20,13,25
"2011","Poole 018C","E01015404",1065,221,62,159,306,147,173,36,80,18,28,21,7,56
"2011","Poole 018D","E01015405",1251,276,75,201,358,166,216,40,72,33,30,20,10,60
"2011","Poole 018E","E01015406",1272,210,63,147,384,144,240,49,77,64,41,22,19,63
"2011","South Gloucestershire 001A","E01014985",1083,197,33,164,296,197,61,71,122,54,12,8,4,73
"2011","South Gloucestershire 001B","E01014986",1077,137,26,111,247,141,67,94,146,111,55,44,11,79
"2011","South Gloucestershire 001C","E01014987",892,143,27,116,250,153,54,61,100,47,22,13,9,62
"2011","South Gloucestershire 001D","E01014988",996,167,27,140,277,159,79,54,129,62,8,6,2,61
"2011","South Gloucestershire 001E","E01014989",1041,132,34,98,223,154,121,63,93,91,101,90,11,63
"2011","South Gloucestershire 002A","E01014990",1094,142,22,120,285,193,78,75,155,78,21,9,12,67
"2011","South Gloucestershire 002B","E01014991",1483,110,30,80,283,193,125,154,263,224,60,45,15,71
"2011","South Gloucestershire 002C","E01014992",1141,191,37,154,292,173,74,71,141,85,34,20,14,80
"2011","South Gloucestershire 002D","E01014993",1074,181,34,147,297,179,109,51,103,63,15,8,7,76
"2011","South Gloucestershire 003A","E01014884",1609,171,30,141,346,138,222,132,205,221,90,80,10,84
"2011","South Gloucestershire 003B","E01014885",1407,230,42,188,373,198,139,84,168,111,21,10,11,83
"2011","South Gloucestershire 003C","E01014929",1506,210,44,166,350,184,266,96,162,115,47,35,12,76
"2011","South Gloucestershire 003D","E01014930",1389,268,60,208,366,191,147,58,122,82,26,15,11,129
"2011","South Gloucestershire 004A","E01014863",1022,166,45,121,273,147,100,55,123,77,14,11,3,67
"2011","South Gloucestershire 004B","E01014864",1107,217,53,164,294,162,124,63,114,54,21,14,7,58
"2011","South Gloucestershire 004C","E01014962",1297,244,54,190,330,149,236,53,101,61,28,22,6,95
"2011","South Gloucestershire 004D","E01014963",1378,278,56,222,393,160,192,64,118,57,5,2,3,111
"2011","South Gloucestershire 005A","E01014861",1396,192,44,148,352,177,192,88,154,133,37,18,19,71
"2011","South Gloucestershire 005B","E01014862",1976,360,80,280,581,280,197,113,195,96,42,24,18,112
"2011","South Gloucestershire 005C","E01014953",1517,176,45,131,309,229,177,131,237,136,34,17,17,88
"2011","South Gloucestershire 005D","E01014954",1162,88,26,62,200,179,106,139,182,193,27,11,16,48
"2011","South Gloucestershire 006A","E01015014",1118,183,44,139,288,199,110,77,127,61,15,10,5,58
"2011","South Gloucestershire 006B","E01015015",1105,168,41,127,279,181,73,68,135,105,24,15,9,72
"2011","South Gloucestershire 006C","E01015016",935,120,34,86,232,163,82,66,124,68,11,7,4,69
"2011","South Gloucestershire 006D","E01015017",1059,100,30,70,238,159,80,88,162,116,42,32,10,74
"2011","South Gloucestershire 006E","E01015018",1090,92,23,69,228,186,93,80,167,134,30,20,10,80
"2011","South Gloucestershire 007A","E01015019",1324,106,22,84,234,174,103,121,243,197,46,30,16,100
"2011","South Gloucestershire 007B","E01015020",1099,45,13,32,169,153,69,91,235,198,61,31,30,78
"2011","South Gloucestershire 007C","E01015021",1211,119,28,91,266,216,92,110,175,130,17,7,10,86
"2011","South Gloucestershire 007D","E01015022",1220,104,25,79,246,206,107,105,200,161,21,8,13,70
"2011","South Gloucestershire 008A","E01014886",1234,115,29,86,246,163,128,112,194,170,39,27,12,67
"2011","South Gloucestershire 008B","E01014887",1063,209,48,161,297,164,94,66,106,65,13,8,5,49
"2011","South Gloucestershire 008C","E01014888",1023,182,41,141,310,155,67,59,119,63,17,11,6,51
"2011","South Gloucestershire 008D","E01014889",1166,109,25,84,237,208,90,130,187,129,17,11,6,59
"2011","South Gloucestershire 009A","E01014872",1262,211,24,187,313,213,74,97,176,82,20,9,11,76
"2011","South Gloucestershire 009B","E01014874",1095,174,28,146,268,223,59,84,123,72,31,19,12,61
"2011","South Gloucestershire 009C","E01014876",1284,197,26,171,340,227,65,87,166,102,34,19,15,66
"2011","South Gloucestershire 009D","E01014877",1145,183,25,158,327,202,57,59,143,56,22,14,8,96
"2011","South Gloucestershire 009E","E01014879",1282,253,45,208,316,205,76,89,159,102,14,10,4,68
"2011","South Gloucestershire 009F","E01014881",1421,294,52,242,400,241,85,76,119,75,31,22,9,100
"2011","South Gloucestershire 010A","E01015009",967,63,16,47,160,160,76,113,191,143,13,8,5,48
"2011","South Gloucestershire 010B","E01015010",1003,57,13,44,158,163,64,108,198,174,19,12,7,62
"2011","South Gloucestershire 010C","E01015011",1139,85,22,63,186,156,121,89,209,192,39,26,13,62
"2011","South Gloucestershire 010D","E01015012",908,91,15,76,179,172,77,80,153,108,14,8,6,34
"2011","South Gloucestershire 010E","E01015013",988,44,8,36,175,155,76,109,189,164,17,8,9,59
"2011","South Gloucestershire 011A","E01014946",1172,52,8,44,183,147,92,115,245,207,51,29,22,80
"2011","South Gloucestershire 011B","E01014947",1029,103,15,88,209,165,102,105,177,89,27,20,7,52
"2011","South Gloucestershire 011C","E01014948",1211,68,16,52,174,182,82,116,252,200,78,48,30,59
"2011","South Gloucestershire 011D","E01014949",1091,73,19,54,213,182,69,97,202,156,23,11,12,76
"2011","South Gloucestershire 011E","E01014950",1067,84,14,70,206,153,76,111,214,140,26,16,10,57
"2011","South Gloucestershire 011F","E01014951",1007,58,17,41,159,162,65,106,218,155,33,23,10,51
"2011","South Gloucestershire 011G","E01014952",1270,121,18,103,248,215,103,122,193,136,32,17,15,100
"2011","South Gloucestershire 012A","E01014873",1144,220,44,176,326,191,73,63,122,59,14,8,6,76
"2011","South Gloucestershire 012B","E01014875",1379,302,28,274,315,220,59,85,176,98,59,36,23,65
"2011","South Gloucestershire 012C","E01014878",1571,315,67,248,418,278,74,105,155,93,27,12,15,106
"2011","South Gloucestershire 012D","E01014880",1326,286,42,244,346,228,71,73,123,90,25,18,7,84
"2011","South Gloucestershire 012E","E01014882",1533,253,39,214,363,237,67,123,211,116,55,37,18,108
"2011","South Gloucestershire 012F","E01014883",930,183,30,153,254,177,36,44,105,57,18,7,11,56
"2011","South Gloucestershire 013A","E01014911",970,161,41,120,251,164,111,60,95,50,6,3,3,72
"2011","South Gloucestershire 013B","E01014912",1316,200,43,157,339,208,155,96,132,93,17,10,7,76
"2011","South Gloucestershire 013C","E01014913",1175,182,36,146,334,210,105,64,123,75,10,7,3,72
"2011","South Gloucestershire 013D","E01014914",1175,121,36,85,197,160,106,100,194,173,43,35,8,81
"2011","South Gloucestershire 014A","E01014892",1212,60,15,45,172,199,88,124,244,248,30,22,8,47
"2011","South Gloucestershire 014B","E01014893",1096,59,15,44,222,179,76,113,213,165,17,5,12,52
"2011","South Gloucestershire 014C","E01014894",977,72,14,58,198,170,59,79,183,144,16,9,7,56
"2011","South Gloucestershire 014D","E01014895",1062,68,19,49,185,157,71,113,203,165,20,8,12,80
"2011","South Gloucestershire 014E","E01014896",964,60,10,50,167,172,76,101,160,141,23,11,12,64
"2011","South Gloucestershire 015A","E01014979",1162,185,26,159,278,210,72,87,144,91,15,11,4,80
"2011","South Gloucestershire 015B","E01014980",1246,229,50,179,299,221,79,82,163,75,10,2,8,88
"2011","South Gloucestershire 015C","E01014982",1148,102,21,81,238,214,72,108,203,128,24,12,12,59
"2011","South Gloucestershire 015D","E01014983",1106,87,18,69,175,197,73,115,190,158,46,25,21,65
"2011","South Gloucestershire 015E","E01014984",1054,98,18,80,168,199,86,109,171,133,24,14,10,66
"2011","South Gloucestershire 016A","E01014998",1048,135,28,107,237,208,84,73,134,96,21,13,8,60
"2011","South Gloucestershire 016B","E01014999",1108,184,39,145,291,188,111,67,107,62,37,28,9,61
"2011","South Gloucestershire 016C","E01015000",1074,129,31,98,230,157,126,81,128,109,44,33,11,70
"2011","South Gloucestershire 016D","E01015001",1111,189,35,154,272,168,89,78,129,80,21,12,9,85
"2011","South Gloucestershire 017A","E01014978",1130,242,36,206,283,186,74,53,113,70,19,11,8,90
"2011","South Gloucestershire 017B","E01014981",2097,388,57,331,506,346,143,126,222,140,50,28,22,176
"2011","South Gloucestershire 017C","E01014996",1139,254,47,207,303,179,91,53,82,35,65,51,14,77
"2011","South Gloucestershire 017E","E01033331",2010,277,73,204,278,120,43,48,78,40,17,11,6,1109
"2011","South Gloucestershire 017F","E01033333",1940,176,37,139,247,125,118,36,101,59,26,22,4,1052
"2011","South Gloucestershire 018A","E01014904",1100,63,10,53,156,176,49,95,213,161,52,31,21,135
"2011","South Gloucestershire 018B","E01014905",1272,119,23,96,225,189,97,116,176,139,27,16,11,184
"2011","South Gloucestershire 018C","E01014906",1166,102,19,83,191,162,83,87,217,150,66,46,20,108
"2011","South Gloucestershire 018D","E01014907",1153,113,13,100,201,194,64,74,158,109,48,25,23,192
"2011","South Gloucestershire 018E","E01014908",985,134,14,120,243,163,89,69,110,56,27,17,10,94
"2011","South Gloucestershire 018F","E01014909",1176,120,9,111,183,162,83,73,169,110,38,27,11,238
"2011","South Gloucestershire 018G","E01014910",1077,140,19,121,185,155,64,83,154,111,39,23,16,146
"2011","South Gloucestershire 019A","E01014867",1003,114,27,87,213,130,97,76,113,92,78,71,7,90
"2011","South Gloucestershire 019B","E01014868",1179,124,34,90,258,197,122,81,165,138,29,19,10,65
"2011","South Gloucestershire 019D","E01014994",1225,133,38,95,267,156,198,95,163,114,31,25,6,68
"2011","South Gloucestershire 019E","E01014995",1224,141,31,110,292,233,151,82,143,106,11,5,6,65
"2011","South Gloucestershire 019F","E01033338",1179,162,33,129,298,188,125,89,136,73,23,15,8,85
"2011","South Gloucestershire 019G","E01033339",1038,114,24,90,210,163,98,64,160,118,37,19,18,74
"2011","South Gloucestershire 020A","E01014901",1145,194,40,154,319,203,91,58,117,75,14,7,7,74
"2011","South Gloucestershire 020B","E01014902",893,161,39,122,218,187,68,58,89,52,8,6,2,52
"2011","South Gloucestershire 020C","E01014903",1041,167,30,137,250,197,86,76,124,56,14,10,4,71
"2011","South Gloucestershire 020D","E01014965",1028,143,33,110,254,174,92,62,135,85,19,11,8,64
"2011","South Gloucestershire 021A","E01014964",1228,226,50,176,354,211,114,69,115,62,19,8,11,58
"2011","South Gloucestershire 021B","E01014966",1138,217,54,163,335,206,82,59,137,40,11,6,5,51
"2011","South Gloucestershire 021C","E01014967",1511,288,88,200,429,251,117,85,172,78,26,17,9,65
"2011","South Gloucestershire 021D","E01014969",1116,142,29,113,292,216,68,79,158,95,15,6,9,51
"2011","South Gloucestershire 021F","E01033334",1177,299,123,176,321,168,73,75,100,59,19,9,10,63
"2011","South Gloucestershire 021G","E01033336",1192,201,41,160,326,226,87,52,128,65,15,10,5,92
"2011","South Gloucestershire 022A","E01014897",1000,144,30,114,297,179,106,56,79,48,13,8,5,78
"2011","South Gloucestershire 022B","E01014898",1133,152,27,125,296,196,110,56,134,91,21,13,8,77
"2011","South Gloucestershire 022C","E01014899",1175,147,25,122,315,179,115,65,156,86,39,31,8,73
"2011","South Gloucestershire 022D","E01014900",1115,142,21,121,265,176,122,62,128,88,53,43,10,79
"2011","South Gloucestershire 023A","E01014959",998,86,20,66,224,143,89,86,173,111,24,15,9,62
"2011","South Gloucestershire 023B","E01014960",1157,95,16,79,242,136,111,97,205,153,25,11,14,93
"2011","South Gloucestershire 023C","E01014961",1126,88,21,67,206,179,106,87,205,130,49,28,21,76
"2011","South Gloucestershire 023D","E01014968",1137,58,9,49,188,150,103,89,210,205,51,27,24,83
"2011","South Gloucestershire 024A","E01014865",1360,187,39,148,326,172,201,78,167,109,39,19,20,81
"2011","South Gloucestershire 024B","E01014869",1190,250,51,199,335,99,166,61,102,83,21,12,9,73
"2011","South Gloucestershire 024C","E01014870",1222,190,39,151,308,136,221,73,106,74,26,13,13,88
"2011","South Gloucestershire 024D","E01014871",857,98,28,70,174,139,128,63,112,81,21,10,11,41
"2011","South Gloucestershire 024E","E01014890",1508,251,57,194,389,153,250,91,156,107,33,23,10,78
"2011","South Gloucestershire 024F","E01014891",1298,168,48,120,320,142,249,79,143,111,20,16,4,66
"2011","South Gloucestershire 025A","E01014955",951,105,22,83,197,155,105,73,128,112,26,18,8,50
"2011","South Gloucestershire 025B","E01014956",1155,94,22,72,186,196,81,116,206,170,27,9,18,79
"2011","South Gloucestershire 025C","E01014957",925,63,14,49,158,166,74,100,172,117,16,13,3,59
"2011","South Gloucestershire 025D","E01014974",1057,116,21,95,251,187,102,65,145,98,35,20,15,58
"2011","South Gloucestershire 025E","E01014977",929,56,17,39,161,114,75,73,165,150,80,47,33,55
"2011","South Gloucestershire 026A","E01014922",1010,71,20,51,196,184,82,89,182,117,24,15,9,65
"2011","South Gloucestershire 026B","E01014923",1057,83,12,71,205,166,81,93,196,144,34,19,15,55
"2011","South Gloucestershire 026C","E01014924",1304,93,13,80,232,194,120,117,251,171,60,37,23,66
"2011","South Gloucestershire 026D","E01014973",1069,77,12,65,199,166,95,106,186,146,32,19,13,62
"2011","South Gloucestershire 026E","E01014975",1195,109,27,82,252,216,81,111,197,133,40,23,17,56
"2011","South Gloucestershire 026F","E01014976",1096,85,20,65,178,153,85,107,206,172,42,23,19,68
"2011","South Gloucestershire 027A","E01014925",1095,58,13,45,182,176,92,108,210,170,29,17,12,70
"2011","South Gloucestershire 027B","E01014926",1156,41,6,35,144,163,88,100,251,224,57,31,26,88
"2011","South Gloucestershire 027C","E01014927",1187,75,22,53,205,177,104,113,251,158,40,21,19,64
"2011","South Gloucestershire 027D","E01014928",1081,59,10,49,157,160,93,102,228,176,51,31,20,55
"2011","South Gloucestershire 027E","E01014958",852,35,5,30,119,137,78,81,163,146,39,29,10,54
"2011","South Gloucestershire 028A","E01014915",1110,73,20,53,204,166,111,103,194,139,48,34,14,72
"2011","South Gloucestershire 028B","E01015003",1191,124,24,100,237,211,106,105,199,124,33,22,11,52
"2011","South Gloucestershire 028C","E01015005",1456,97,19,78,315,231,151,112,228,183,56,37,19,83
"2011","South Gloucestershire 028D","E01015007",1259,66,13,53,253,204,103,103,236,146,73,51,22,75
"2011","South Gloucestershire 028E","E01015008",1190,60,12,48,209,198,86,105,238,157,51,36,15,86
"2011","South Gloucestershire 029A","E01014943",1373,139,26,113,333,255,102,94,215,131,24,12,12,80
"2011","South Gloucestershire 029B","E01014944",1361,183,47,136,304,284,114,98,179,107,19,6,13,73
"2011","South Gloucestershire 029C","E01014972",1264,162,47,115,280,209,136,91,160,123,22,20,2,81
"2011","South Gloucestershire 029D","E01015002",1171,89,22,67,220,215,84,108,218,143,30,19,11,64
"2011","South Gloucestershire 029E","E01015004",1352,115,31,84,261,246,133,116,205,159,37,20,17,80
"2011","South Gloucestershire 029F","E01015006",1171,73,15,58,216,190,100,110,213,158,38,23,15,73
"2011","South Gloucestershire 030A","E01014936",1051,92,27,65,234,149,125,73,155,98,42,22,20,83
"2011","South Gloucestershire 030B","E01014938",1153,109,24,85,276,206,102,71,158,130,39,21,18,62
"2011","South Gloucestershire 030C","E01014939",919,70,14,56,172,163,70,78,154,128,30,12,18,54
"2011","South Gloucestershire 030D","E01014940",1038,81,16,65,223,205,108,94,155,82,16,8,8,74
"2011","South Gloucestershire 030E","E01014941",1080,69,17,52,157,141,86,93,231,184,52,28,24,67
"2011","South Gloucestershire 030F","E01014942",1008,67,12,55,157,145,75,85,218,158,52,34,18,51
"2011","South Gloucestershire 030G","E01014945",1236,104,26,78,245,212,98,91,206,157,48,36,12,75
"2011","South Gloucestershire 031A","E01014916",1063,80,15,65,252,178,82,81,160,130,35,22,13,65
"2011","South Gloucestershire 031B","E01014917",1035,84,18,66,217,186,119,75,176,105,14,6,8,59
"2011","South Gloucestershire 031C","E01014918",995,102,29,73,205,184,111,71,146,100,17,11,6,59
"2011","South Gloucestershire 031D","E01014919",853,85,23,62,180,175,88,64,121,72,17,11,6,51
"2011","South Gloucestershire 031E","E01014920",1034,134,35,99,228,179,104,70,150,78,17,13,4,74
"2011","South Gloucestershire 031F","E01014921",1027,122,31,91,204,213,109,90,121,79,20,12,8,69
"2011","South Gloucestershire 032A","E01014866",1185,141,31,110,298,228,138,61,149,71,31,20,11,68
"2011","South Gloucestershire 032B","E01014931",1050,94,19,75,201,203,127,104,163,79,26,18,8,53
"2011","South Gloucestershire 032C","E01014932",1232,160,33,127,259,229,121,105,166,98,24,13,11,70
"2011","South Gloucestershire 032D","E01014933",1134,138,30,108,258,255,82,80,162,92,13,7,6,54
"2011","South Gloucestershire 032E","E01014934",897,100,23,77,192,171,81,85,131,76,7,4,3,54
"2011","South Gloucestershire 032F","E01014935",1164,114,23,91,256,265,89,89,167,91,19,13,6,74
"2011","South Gloucestershire 032G","E01014937",937,87,19,68,197,181,81,76,145,96,12,7,5,62
"2011","Swindon 001A","E01015519",1020,86,22,64,200,131,106,93,152,172,26,14,12,54
"2011","Swindon 001B","E01015520",832,118,26,92,188,127,95,54,105,79,25,16,9,41
"2011","Swindon 001C","E01015521",1090,140,36,104,255,175,106,90,137,104,17,8,9,66
"2011","Swindon 001D","E01015522",1122,117,26,91,232,208,89,92,175,119,25,13,12,65
"2011","Swindon 001E","E01015523",1121,196,51,145,272,182,146,64,101,71,26,17,9,63
"2011","Swindon 001F","E01015524",887,47,9,38,165,131,65,104,174,121,26,16,10,54
"2011","Swindon 003A","E01015543",950,55,10,45,123,136,58,105,193,172,55,30,25,53
"2011","Swindon 003B","E01015544",1123,20,2,18,121,121,76,101,255,258,105,56,49,66
"2011","Swindon 003C","E01015545",1080,20,4,16,99,105,64,104,280,222,117,74,43,69
"2011","Swindon 003D","E01015546",1110,15,5,10,90,97,55,125,277,282,105,47,58,64
"2011","Swindon 004A","E01015513",1214,136,39,97,282,192,92,132,190,119,14,7,7,57
"2011","Swindon 004B","E01015514",943,92,27,65,178,183,56,82,193,101,9,6,3,49
"2011","Swindon 004C","E01015515",1139,129,36,93,255,205,86,86,194,111,21,7,14,52
"2011","Swindon 004D","E01015516",949,79,18,61,175,149,78,92,172,109,45,25,20,50
"2011","Swindon 004E","E01015517",1041,76,16,60,186,189,82,96,226,134,16,10,6,36
"2011","Swindon 005A","E01015555",1047,88,20,68,166,166,79,116,165,162,55,39,16,50
"2011","Swindon 005B","E01015556",1184,100,37,63,214,227,95,103,212,154,18,8,10,61
"2011","Swindon 005C","E01015557",1104,99,29,70,214,186,106,96,196,119,28,16,12,60
"2011","Swindon 005D","E01015558",1043,28,5,23,122,117,68,92,240,218,64,45,19,94
"2011","Swindon 005E","E01015559",1091,77,12,65,200,148,88,100,236,141,34,16,18,67
"2011","Swindon 005F","E01015560",1153,91,29,62,235,188,105,91,200,134,43,31,12,66
"2011","Swindon 006A","E01015526",1123,102,23,79,252,188,62,103,207,117,35,16,19,57
"2011","Swindon 006B","E01015528",1224,48,11,37,165,150,74,114,260,244,92,57,35,77
"2011","Swindon 006C","E01015529",1132,67,21,46,178,139,104,109,230,193,46,29,17,66
"2011","Swindon 006D","E01015530",1184,40,7,33,166,149,82,120,253,233,60,46,14,81
"2011","Swindon 007A","E01015506",1104,48,19,29,119,133,77,117,249,217,75,54,21,69
"2011","Swindon 007B","E01015507",1080,34,7,27,116,102,79,77,235,250,104,62,42,83
"2011","Swindon 007C","E01015527",1204,71,15,56,200,137,87,102,251,199,73,49,24,84
"2011","Swindon 007D","E01015580",1161,66,15,51,162,186,98,98,234,174,60,43,17,83
"2011","Swindon 008A","E01015473",1283,197,45,152,324,194,158,80,142,88,29,19,10,71
"2011","Swindon 008B","E01015474",1233,167,50,117,299,152,179,60,146,121,35,21,14,74
"2011","Swindon 008C","E01015547",1263,231,50,181,366,129,179,53,113,80,26,14,12,86
"2011","Swindon 008D","E01015548",1151,268,65,203,318,141,163,55,79,53,19,13,6,55
"2011","Swindon 009A","E01015549",1261,106,26,80,262,232,100,117,207,144,24,14,10,69
"2011","Swindon 009B","E01015550",1363,97,19,78,263,253,95,129,253,164,48,23,25,61
"2011","Swindon 009C","E01015551",1061,103,30,73,214,180,86,85,173,132,20,13,7,68
"2011","Swindon 009D","E01015552",1510,154,32,122,329,251,127,134,223,150,41,24,17,101
"2011","Swindon 009E","E01015553",1225,161,44,117,258,224,93,108,168,106,25,17,8,82
"2011","Swindon 009F","E01015554",1009,99,18,81,196,194,78,85,163,105,44,31,13,45
"2011","Swindon 010A","E01015508",1005,48,12,36,115,101,81,94,200,210,80,57,23,76
"2011","Swindon 010B","E01015509",1230,65,9,56,179,159,107,122,254,214,65,41,24,65
"2011","Swindon 010C","E01015510",1412,76,12,64,184,148,106,140,306,276,87,61,26,89
"2011","Swindon 010D","E01015511",1183,76,8,68,188,135,82,122,226,235,61,36,25,58
"2011","Swindon 011A","E01015562",1143,155,44,111,262,211,75,80,157,76,38,17,21,89
"2011","Swindon 011B","E01015563",1191,204,47,157,340,190,83,74,128,56,23,11,12,93
"2011","Swindon 011C","E01015565",1199,145,27,118,272,212,68,88,181,102,39,22,17,92
"2011","Swindon 011D","E01015566",1246,159,25,134,311,217,85,111,157,103,25,13,12,78
"2011","Swindon 012B","E01015578",1204,64,12,52,200,198,82,133,244,182,54,29,25,47
"2011","Swindon 012C","E01015579",1173,96,17,79,229,175,86,123,221,158,37,24,13,48
"2011","Swindon 012D","E01015581",1108,98,19,79,219,152,120,96,173,136,51,34,17,63
"2011","Swindon 012E","E01015582",1408,135,14,121,291,210,93,126,231,186,59,37,22,77
"2011","Swindon 012F","E01032708",1360,183,40,143,370,205,91,96,161,156,47,26,21,51
"2011","Swindon 012G","E01032716",1111,79,13,66,210,167,72,86,199,199,41,19,22,58
"2011","Swindon 013A","E01015481",1294,113,30,83,290,224,79,130,222,130,31,15,16,75
"2011","Swindon 013B","E01015482",997,79,18,61,178,180,77,98,187,116,24,9,15,58
"2011","Swindon 013C","E01015483",1014,89,26,63,207,183,77,88,195,115,13,8,5,47
"2011","Swindon 013D","E01015484",1042,73,12,61,187,190,77,113,193,131,31,20,11,47
"2011","Swindon 013E","E01015485",1139,100,22,78,276,209,73,122,156,120,24,11,13,59
"2011","Swindon 013F","E01015486",1101,95,23,72,226,213,65,102,187,131,43,28,15,39
"2011","Swindon 014A","E01015561",1157,138,32,106,273,171,79,90,175,115,44,22,22,72
"2011","Swindon 014B","E01015564",1203,172,42,130,323,191,80,71,140,117,26,13,13,83
"2011","Swindon 014C","E01015567",1177,106,22,84,262,189,71,117,187,145,34,18,16,66
"2011","Swindon 014D","E01015568",1118,126,21,105,227,175,91,112,190,106,33,13,20,58
"2011","Swindon 015A","E01015475",1646,53,17,36,148,128,91,134,355,480,129,100,29,128
"2011","Swindon 015B","E01015476",1877,163,11,152,332,177,121,150,332,351,160,94,66,91
"2011","Swindon 015C","E01015477",1217,97,16,81,222,155,77,126,168,214,80,55,25,78
"2011","Swindon 015D","E01015480",1807,54,5,49,156,96,98,136,402,575,155,105,50,135
"2011","Swindon 016A","E01015538",1261,37,8,29,146,125,75,116,293,269,112,73,39,88
"2011","Swindon 016B","E01015572",903,26,3,23,92,79,41,87,204,224,89,51,38,61
"2011","Swindon 016C","E01015573",1469,47,10,37,184,177,83,147,315,270,121,70,51,125
"2011","Swindon 016D","E01015575",804,15,2,13,76,68,39,74,189,188,87,56,31,68
"2011","Swindon 017A","E01015479",1232,109,23,86,246,187,99,101,198,153,57,36,21,82
"2011","Swindon 017B","E01015493",1291,155,21,134,240,161,115,87,196,167,73,55,18,97
"2011","Swindon 017C","E01015574",1148,119,25,94,224,188,90,79,210,121,39,31,8,78
"2011","Swindon 017D","E01015576",1054,104,20,84,213,178,96,76,156,112,43,37,6,76
"2011","Swindon 018A","E01015499",1027,144,38,106,258,184,79,65,126,73,26,18,8,72
"2011","Swindon 018B","E01015500",1171,116,23,93,237,225,81,101,175,137,37,21,16,62
"2011","Swindon 018C","E01015504",1046,158,40,118,266,188,81,70,122,70,17,7,10,74
"2011","Swindon 018D","E01015505",1137,148,27,121,273,181,62,84,173,128,37,12,25,51
"2011","Swindon 019A","E01015494",1460,183,20,163,298,154,99,116,221,223,70,47,23,96
"2011","Swindon 019C","E01015496",1321,197,28,169,319,194,83,105,189,118,57,29,28,59
"2011","Swindon 019D","E01015497",1212,221,34,187,322,151,85,79,125,101,63,46,17,65
"2011","Swindon 019E","E01032714",1100,202,13,189,297,129,51,58,145,96,63,37,26,59
"2011","Swindon 019F","E01032715",780,122,10,112,209,96,71,50,101,70,33,18,15,28
"2011","Swindon 020A","E01015537",1227,35,8,27,128,133,67,120,276,280,92,55,37,96
"2011","Swindon 020B","E01015539",1139,33,10,23,134,131,68,126,272,211,80,53,27,84
"2011","Swindon 020C","E01015540",1282,32,5,27,128,128,63,125,305,256,152,100,52,93
"2011","Swindon 020D","E01015541",1274,36,10,26,145,120,59,128,276,260,141,100,41,109
"2011","Swindon 020E","E01015542",1028,32,9,23,118,104,69,94,237,209,79,52,27,86
"2011","Swindon 021A","E01015478",1127,148,25,123,258,164,87,98,160,109,37,23,14,66
"2011","Swindon 021B","E01015498",1373,201,35,166,338,208,107,99,173,112,29,16,13,106
"2011","Swindon 021D","E01015532",1143,230,49,181,329,147,109,52,87,51,69,44,25,69
"2011","Swindon 021E","E01032706",1208,248,31,217,338,191,62,81,107,65,58,42,16,58
"2011","Swindon 021F","E01032707",1361,331,74,257,426,168,129,40,108,55,30,24,6,74
"2011","Swindon 022A","E01015501",1068,118,17,101,248,187,69,96,150,95,28,15,13,77
"2011","Swindon 022B","E01015502",1129,73,22,51,187,157,85,111,205,163,73,51,22,75
"2011","Swindon 022C","E01015503",934,58,13,45,138,124,60,96,185,164,56,37,19,53
"2011","Swindon 022D","E01015569",1149,78,16,62,194,151,67,80,221,181,88,58,30,89
"2011","Swindon 022E","E01015570",1146,47,10,37,167,157,76,114,207,224,100,49,51,54
"2011","Swindon 022F","E01015571",1167,69,27,42,176,193,92,114,223,183,43,27,16,74
"2011","Swindon 023A","E01015487",1225,71,18,53,220,252,74,122,224,142,34,24,10,86
"2011","Swindon 023B","E01015488",1065,68,19,49,177,160,80,77,237,170,47,26,21,49
"2011","Swindon 023C","E01015489",1089,127,30,97,236,191,96,79,169,105,28,19,9,58
"2011","Swindon 023D","E01015490",993,75,16,59,187,172,90,95,172,127,32,15,17,43
"2011","Swindon 023E","E01015491",1092,60,9,51,182,174,57,104,217,188,59,35,24,51
"2011","Swindon 023F","E01015492",1016,47,12,35,163,131,73,90,222,171,43,21,22,76
"2011","Swindon 024A","E01015533",1018,168,36,132,296,161,95,47,113,51,22,15,7,65
"2011","Swindon 024B","E01015534",1367,258,42,216,419,184,110,70,135,86,40,19,21,65
"2011","Swindon 024C","E01015535",1062,196,43,153,306,182,92,43,96,63,24,15,9,60
"2011","Swindon 024D","E01015536",1694,298,71,227,447,277,140,88,174,114,55,43,12,101
"2011","Swindon 025A","E01015583",1636,267,76,191,481,197,202,84,151,108,42,23,19,104
"2011","Swindon 025B","E01015584",1002,100,26,74,226,173,73,81,177,98,24,14,10,50
"2011","Swindon 025C","E01015585",1192,170,36,134,297,184,155,59,126,91,29,14,15,81
"2011","Swindon 025D","E01015586",1037,102,26,76,227,201,89,84,168,93,14,7,7,59
"2011","Swindon 025E","E01015587",1289,141,23,118,282,179,105,91,190,159,57,37,20,85
"2011","Swindon 025F","E01015588",1331,185,50,135,355,189,140,94,159,93,39,25,14,77
"2011","Swindon 026A","E01015525",1233,160,41,119,314,200,109,106,149,121,23,12,11,51
"2011","Swindon 026B","E01032700",1127,212,54,158,341,218,76,70,117,40,8,3,5,45
"2011","Swindon 026C","E01032703",1057,183,39,144,325,186,68,74,107,62,12,3,9,40
"2011","Swindon 026D","E01032705",1042,206,47,159,298,169,80,70,93,61,21,9,12,44
"2011","Swindon 026E","E01032709",985,152,32,120,284,168,58,64,111,72,26,15,11,50
"2011","Swindon 026F","E01032713",1218,241,49,192,365,188,90,82,126,53,16,7,9,57
"2011","Swindon 027A","E01032701",926,153,35,118,245,142,44,86,135,76,22,12,10,23
"2011","Swindon 027B","E01032702",1008,194,49,145,283,140,80,76,125,39,21,11,10,50
"2011","Swindon 027C","E01032704",1041,170,40,130,299,180,54,80,126,72,20,12,8,40
"2011","Swindon 027D","E01032711",1041,145,31,114,338,167,63,73,125,62,31,17,14,37
"2011","Swindon 027E","E01032712",1038,136,27,109,294,166,58,82,135,80,33,17,16,54
"2011","Swindon 028A","E01015471",1213,237,52,185,357,192,75,86,125,64,20,9,11,57
"2011","Swindon 028B","E01015472",2000,304,67,237,543,345,143,142,213,156,52,27,25,102
"2011","Swindon 028C","E01015512",1219,244,64,180,341,195,79,72,118,79,16,6,10,75
"2011","Swindon 028D","E01015518",1089,178,36,142,271,189,71,81,141,71,23,13,10,64
"2011","Swindon 028E","E01032710",988,147,30,117,265,163,66,78,129,64,17,7,10,59
"2011","Torbay 001A","E01015262",991,35,9,26,151,93,96,80,181,205,62,46,16,88
"2011","Torbay 001B","E01015263",1049,27,4,23,136,97,77,90,225,213,114,79,35,70
"2011","Torbay 001C","E01015264",937,62,19,43,182,144,146,89,144,104,26,13,13,40
"2011","Torbay 001D","E01015265",1065,56,18,38,191,134,146,96,165,163,48,37,11,66
"2011","Torbay 001E","E01015266",1018,25,6,19,133,81,92,82,212,221,87,59,28,85
"2011","Torbay 002A","E01015236",1114,113,20,93,241,113,206,69,165,98,43,28,15,66
"2011","Torbay 002B","E01015237",959,52,11,41,162,122,125,81,163,140,38,21,17,76
"2011","Torbay 002C","E01015238",1001,59,17,42,222,126,113,76,186,122,48,36,12,49
"2011","Torbay 002D","E01015239",996,52,10,42,167,110,165,66,184,140,59,38,21,53
"2011","Torbay 003A","E01015249",1008,50,16,34,180,136,94,68,187,166,56,38,18,71
"2011","Torbay 003B","E01015250",1026,63,17,46,230,185,93,88,190,111,26,17,9,40
"2011","Torbay 003C","E01015251",886,95,22,73,222,111,111,61,113,77,21,10,11,75
"2011","Torbay 003D","E01015252",1715,117,22,95,404,227,187,128,307,198,63,30,33,84
"2011","Torbay 003E","E01015253",1202,106,23,83,345,154,112,93,177,119,25,13,12,71
"2011","Torbay 003F","E01015254",1002,70,25,45,250,139,148,57,167,94,30,23,7,47
"2011","Torbay 004A","E01015257",973,37,11,26,127,91,75,96,188,205,81,55,26,73
"2011","Torbay 004B","E01015258",1494,116,21,95,322,185,192,97,239,174,87,47,40,82
"2011","Torbay 004C","E01015259",1006,31,10,21,166,130,118,85,201,155,54,23,31,66
"2011","Torbay 004D","E01015260",1177,63,16,47,173,131,149,104,205,186,91,56,35,75
"2011","Torbay 005A","E01015240",971,70,18,52,198,94,171,81,165,121,40,20,20,31
"2011","Torbay 005B","E01015241",1009,44,10,34,201,144,131,84,173,119,36,13,23,77
"2011","Torbay 005C","E01015242",898,25,9,16,161,105,89,75,183,129,58,31,27,73
"2011","Torbay 005D","E01015243",931,57,9,48,202,139,124,59,171,103,21,11,10,55
"2011","Torbay 006A","E01015214",1056,29,6,23,190,112,135,95,221,146,64,33,31,64
"2011","Torbay 006B","E01015215",1069,53,18,35,202,149,145,90,182,131,35,27,8,82
"2011","Torbay 006C","E01015216",1063,34,12,22,200,100,132,109,198,161,63,36,27,66
"2011","Torbay 006D","E01015218",1002,43,9,34,188,116,130,94,170,115,83,58,25,63
"2011","Torbay 008A","E01015217",1132,47,10,37,161,113,112,111,245,179,103,57,46,61
"2011","Torbay 008B","E01015255",1313,55,16,39,165,110,227,133,224,230,113,58,55,56
"2011","Torbay 008C","E01015256",1452,75,16,59,237,127,179,176,278,221,101,52,49,58
"2011","Torbay 008D","E01015261",1491,81,19,62,228,162,244,122,261,223,100,57,43,70
"2011","Torbay 010A","E01015267",1167,107,22,85,264,111,213,78,181,109,82,56,26,22
"2011","Torbay 010B","E01015268",1173,143,35,108,285,132,190,67,174,95,34,18,16,53
"2011","Torbay 010C","E01015269",1162,143,33,110,302,142,181,74,141,86,54,37,17,39
"2011","Torbay 010D","E01015270",1192,127,33,94,262,145,193,66,171,119,62,45,17,47
"2011","Torbay 010E","E01015271",1000,191,39,152,283,124,177,33,86,40,24,17,7,42
"2011","Torbay 011A","E01015224",1057,58,20,38,236,168,146,94,146,105,33,22,11,71
"2011","Torbay 011B","E01015225",1018,70,22,48,212,141,139,69,166,109,47,31,16,65
"2011","Torbay 011C","E01015226",1038,92,30,62,254,157,149,73,165,71,28,23,5,49
"2011","Torbay 011D","E01015227",1097,107,29,78,252,166,167,65,146,95,23,15,8,76
"2011","Torbay 011E","E01015228",1029,46,9,37,192,124,159,61,178,147,69,49,20,53
"2011","Torbay 011F","E01015230",991,61,17,44,233,171,154,81,142,93,23,14,9,33
"2011","Torbay 012A","E01015202",1064,59,22,37,205,141,135,97,204,129,30,14,16,64
"2011","Torbay 012B","E01015203",885,86,27,59,207,145,131,51,120,76,23,13,10,46
"2011","Torbay 012C","E01015204",996,66,26,40,174,132,114,81,191,133,50,32,18,55
"2011","Torbay 012D","E01015205",1096,48,16,32,211,150,134,106,211,148,32,22,10,56
"2011","Torbay 012E","E01015206",1038,48,12,36,178,139,135,86,213,147,42,27,15,50
"2011","Torbay 013A","E01015190",1216,74,29,45,206,145,162,99,230,169,52,26,26,79
"2011","Torbay 013B","E01015191",1161,80,24,56,244,160,136,96,207,139,30,22,8,69
"2011","Torbay 013C","E01015192",1009,57,12,45,169,108,87,90,206,169,47,31,16,76
"2011","Torbay 013D","E01015193",933,43,16,27,146,108,106,71,196,153,49,34,15,61
"2011","Torbay 013E","E01015194",1041,38,13,25,146,116,123,90,230,175,64,37,27,59
"2011","Torbay 013F","E01015195",1066,56,23,33,175,110,155,82,205,173,33,21,12,77
"2011","Torbay 013G","E01015196",1019,38,6,32,117,90,114,68,227,173,102,58,44,90
"2011","Torbay 014A","E01015229",872,53,15,38,164,76,136,71,156,121,38,27,11,57
"2011","Torbay 014B","E01015231",1171,35,6,29,136,97,130,107,269,203,132,84,48,62
"2011","Torbay 014C","E01015232",1221,44,12,32,186,89,259,94,251,184,55,29,26,59
"2011","Torbay 014D","E01015233",1033,41,12,29,137,109,142,90,229,161,78,45,33,46
"2011","Torbay 014E","E01015234",922,29,12,17,129,111,95,87,187,175,51,29,22,58
"2011","Torbay 014F","E01015235",1161,78,20,58,201,118,223,85,202,132,84,57,27,38
"2011","Torbay 015A","E01015219",953,54,11,43,177,117,125,64,162,158,35,21,14,61
"2011","Torbay 015B","E01015220",1004,72,14,58,201,143,151,85,157,107,27,12,15,61
"2011","Torbay 015C","E01015221",1044,55,15,40,195,148,109,86,194,139,37,21,16,81
"2011","Torbay 015D","E01015222",1019,83,18,65,209,149,139,93,164,103,29,14,15,50
"2011","Torbay 015E","E01015223",988,70,17,53,194,148,107,86,179,112,19,11,8,73
"2011","Torbay 016A","E01015197",1008,122,31,91,239,152,132,73,125,81,24,11,13,60
"2011","Torbay 016B","E01015198",1102,87,17,70,238,159,167,90,172,108,21,10,11,60
"2011","Torbay 016C","E01015199",892,110,33,77,230,127,176,52,92,58,11,6,5,36
"2011","Torbay 016D","E01015200",690,42,15,27,117,106,80,50,142,93,11,5,6,49
"2011","Torbay 016E","E01015201",952,100,20,80,223,121,149,65,135,93,18,11,7,48
"2011","Torbay 017A","E01015183",970,48,15,33,191,116,136,94,182,122,36,28,8,45
"2011","Torbay 017B","E01015184",899,67,15,52,197,102,147,62,176,97,25,17,8,26
"2011","Torbay 017C","E01015185",945,73,28,45,181,106,145,63,156,143,34,12,22,44
"2011","Torbay 017D","E01015186",1027,66,21,45,179,98,155,81,171,165,56,34,22,56
"2011","Torbay 017E","E01015187",978,90,27,63,249,115,186,57,151,68,30,16,14,32
"2011","Torbay 017F","E01015188",1040,56,13,43,219,140,146,81,175,130,33,22,11,60
"2011","Torbay 017G","E01015189",891,55,12,43,203,93,140,63,155,100,42,21,21,40
"2011","Torbay 018A","E01015244",1045,69,12,57,237,132,136,78,172,142,27,18,9,52
"2011","Torbay 018B","E01015245",949,48,9,39,189,120,99,93,165,140,39,27,12,56
"2011","Torbay 018C","E01015246",955,72,22,50,192,128,179,77,124,108,32,20,12,43
"2011","Torbay 018D","E01015247",1224,61,20,41,231,129,161,105,247,167,51,37,14,72
"2011","Torbay 018E","E01015248",1068,48,14,34,167,101,168,92,218,153,39,21,18,82
"2011","Torbay 019E","E01015207",1151,106,30,76,270,149,173,72,163,117,31,19,12,70
"2011","Torbay 019F","E01015208",1280,170,54,116,351,162,249,57,131,78,24,17,7,58
"2011","Torbay 019A","E01015209",969,95,23,72,242,118,151,58,110,85,58,46,12,52
"2011","Torbay 019B","E01015210",1059,47,9,38,205,125,112,80,199,152,58,30,28,81
"2011","Torbay 019G","E01015211",1018,71,26,45,250,163,114,83,156,107,18,10,8,56
"2011","Torbay 019C","E01015212",1027,62,11,51,231,122,157,75,163,120,32,16,16,65
"2011","Torbay 019D","E01015213",1019,34,8,26,185,135,154,92,173,136,28,12,16,82
"2011","Wiltshire 012A","E01031841",1269,194,57,137,305,165,210,82,131,95,22,7,15,65
"2011","Wiltshire 012B","E01031868",1330,180,67,113,329,132,229,98,145,124,18,14,4,75
"2011","Wiltshire 012C","E01031873",1365,203,59,144,375,156,200,84,136,101,36,21,15,74
"2011","Wiltshire 012D","E01031874",1102,228,60,168,265,120,149,58,109,84,23,9,14,66
"2011","Wiltshire 012E","E01031884",1190,209,67,142,310,122,163,79,103,106,26,16,10,72
"2011","Wiltshire 019A","E01031861",1695,226,62,164,396,178,195,125,242,179,59,37,22,95
"2011","Wiltshire 019B","E01031862",1134,97,27,70,201,110,121,115,222,172,42,25,17,54
"2011","Wiltshire 019C","E01031863",869,172,51,121,267,82,95,53,90,53,18,10,8,39
"2011","Wiltshire 019D","E01031864",966,212,55,157,338,112,90,34,64,35,15,8,7,66
"2011","Wiltshire 019E","E01031865",1255,88,25,63,233,99,83,50,114,91,35,29,6,462
"2011","Wiltshire 024A","E01031866",1188,175,62,113,313,119,212,50,142,93,32,17,15,52
"2011","Wiltshire 024B","E01031869",1303,94,20,74,275,150,123,96,225,188,81,59,22,71
"2011","Wiltshire 024C","E01031870",1298,213,69,144,363,153,158,63,154,81,51,40,11,62
"2011","Wiltshire 024D","E01031871",1195,197,56,141,303,118,224,48,119,107,26,18,8,53
"2011","Wiltshire 025A","E01031850",1361,139,39,100,301,179,116,115,245,178,32,16,16,56
"2011","Wiltshire 025B","E01031851",1092,48,17,31,164,116,96,120,229,214,52,37,15,53
"2011","Wiltshire 025C","E01031852",1441,118,44,74,293,201,148,137,266,177,28,15,13,73
"2011","Wiltshire 025E","E01032688",911,130,36,94,275,136,63,55,112,69,16,11,5,55
"2011","Wiltshire 025F","E01032689",967,148,45,103,256,145,85,59,132,63,21,14,7,58
"2011","Wiltshire 025G","E01032692",877,103,37,66,201,143,66,81,126,106,17,8,9,34
"2011","Wiltshire 025H","E01032693",967,109,42,67,249,145,86,73,139,97,25,16,9,44
"2011","Wiltshire 026A","E01031853",1104,85,21,64,238,146,99,95,192,155,41,25,16,53
"2011","Wiltshire 026B","E01031854",1288,115,29,86,246,128,105,116,235,223,62,29,33,58
"2011","Wiltshire 026C","E01031855",1042,154,51,103,263,156,91,66,135,106,24,18,6,47
"2011","Wiltshire 026D","E01031856",1086,92,24,68,212,138,95,105,213,154,37,24,13,40
"2011","Wiltshire 028A","E01031845",1200,160,50,110,248,152,150,104,148,116,57,44,13,65
"2011","Wiltshire 028B","E01031846",1224,138,38,100,265,134,194,88,172,137,29,13,16,67
"2011","Wiltshire 028C","E01031848",1689,217,79,138,396,181,244,121,167,198,95,77,18,70
"2011","Wiltshire 028D","E01031872",1170,121,39,82,267,129,155,86,174,129,39,28,11,70
"2011","Wiltshire 028E","E01031876",1078,162,50,112,276,116,177,49,112,93,38,30,8,55
"2011","Wiltshire 029A","E01031843",1253,195,53,142,307,132,196,86,132,125,21,14,7,59
"2011","Wiltshire 029B","E01031847",1283,219,64,155,332,161,193,72,126,80,21,11,10,79
"2011","Wiltshire 029C","E01031849",1267,172,61,111,354,139,172,74,140,136,21,10,11,59
"2011","Wiltshire 029D","E01031877",1326,207,43,164,396,135,237,54,123,83,41,25,16,50
"2011","Wiltshire 034A","E01031844",1435,191,65,126,356,184,190,111,181,126,26,18,8,70
"2011","Wiltshire 034B","E01031857",1117,124,38,86,234,133,123,96,165,142,28,13,15,72
"2011","Wiltshire 034C","E01031858",1475,194,54,140,340,175,152,88,146,90,24,18,6,266
"2011","Wiltshire 034D","E01031883",1295,196,57,139,359,157,171,75,152,110,24,15,9,51
"2011","Wiltshire 038A","E01031842",1384,237,80,157,350,157,223,72,123,126,30,21,9,66
"2011","Wiltshire 038B","E01031867",1405,187,77,110,341,204,134,118,163,167,29,20,9,62
"2011","Wiltshire 038C","E01031882",1489,275,132,143,402,165,185,55,187,138,32,21,11,50
"2011","Wiltshire 041A","E01031859",1189,97,37,60,197,173,74,118,218,197,57,29,28,58
"2011","Wiltshire 041B","E01031860",1125,75,23,52,231,185,90,121,182,164,29,15,14,48
"2011","Wiltshire 041C","E01031878",1951,181,108,73,541,446,121,171,251,152,25,12,13,63
"2011","Wiltshire 041D","E01031879",1559,102,81,21,458,490,23,110,188,98,52,35,17,38
"2011","Wiltshire 041E","E01031880",3190,328,281,47,1025,948,50,413,141,159,39,29,10,87
"2011","Wiltshire 041G","E01032697",1024,48,28,20,237,137,48,109,184,156,46,32,14,59
"2011","Wiltshire 041H","E01032698",1178,77,28,49,266,134,81,121,206,174,39,20,19,80
"2011","Wiltshire 001A","E01031887",1264,234,67,167,335,160,163,63,130,88,31,21,10,60
"2011","Wiltshire 001B","E01031934",1295,224,58,166,322,200,140,76,142,99,15,9,6,77
"2011","Wiltshire 001C","E01031935",1289,197,53,144,369,180,159,73,146,78,27,17,10,60
"2011","Wiltshire 001D","E01031936",1045,113,28,85,174,133,90,88,181,172,33,24,9,61
"2011","Wiltshire 002A","E01031885",1158,220,62,158,338,134,145,57,91,91,12,6,6,70
"2011","Wiltshire 002B","E01031947",1171,98,29,69,210,103,133,90,226,182,54,30,24,75
"2011","Wiltshire 002C","E01031948",1508,273,48,225,376,178,151,91,191,137,23,15,8,88
"2011","Wiltshire 002D","E01031949",1336,254,54,200,350,136,173,79,165,91,35,22,13,53
"2011","Wiltshire 003A","E01031954",997,152,36,116,237,134,155,67,112,70,16,12,4,54
"2011","Wiltshire 003B","E01031955",1114,185,53,132,285,158,144,67,103,83,33,28,5,56
"2011","Wiltshire 003C","E01031956",863,70,19,51,152,118,122,71,155,98,32,24,8,45
"2011","Wiltshire 003D","E01031962",955,189,45,144,239,147,108,51,100,54,14,9,5,53
"2011","Wiltshire 004A","E01031886",1079,192,52,140,304,146,187,49,80,49,15,11,4,57
"2011","Wiltshire 004B","E01031892",1011,188,54,134,263,140,165,46,81,64,17,12,5,47
"2011","Wiltshire 004C","E01031893",1155,219,58,161,257,122,224,55,129,72,25,14,11,52
"2011","Wiltshire 004D","E01031894",1109,220,53,167,288,108,209,50,106,57,20,13,7,51
"2011","Wiltshire 005A","E01031957",1040,180,48,132,291,101,145,52,98,87,27,16,11,59
"2011","Wiltshire 005B","E01031958",993,171,49,122,283,126,145,46,82,58,17,10,7,65
"2011","Wiltshire 005C","E01031959",1126,194,59,135,312,150,149,53,111,90,15,12,3,52
"2011","Wiltshire 005D","E01031960",985,146,40,106,265,125,110,60,115,79,27,19,8,58
"2011","Wiltshire 006A","E01031963",1249,74,12,62,199,124,94,108,243,230,77,41,36,100
"2011","Wiltshire 006B","E01031964",1310,113,31,82,295,190,95,144,204,158,35,21,14,76
"2011","Wiltshire 006C","E01031967",1354,155,29,126,292,177,133,91,209,165,53,30,23,79
"2011","Wiltshire 006D","E01031969",1158,184,53,131,331,201,87,72,127,59,15,7,8,82
"2011","Wiltshire 007B","E01031944",842,121,49,72,203,105,112,73,97,69,18,11,7,44
"2011","Wiltshire 007D","E01031946",1540,249,189,60,510,288,30,184,125,74,24,14,10,56
"2011","Wiltshire 007E","E01031961",1005,148,33,115,243,132,170,54,117,75,18,10,8,48
"2011","Wiltshire 007F","E01031965",1064,107,27,80,256,179,78,91,166,113,18,10,8,56
"2011","Wiltshire 007G","E01031966",1126,161,43,118,317,189,102,76,134,74,12,6,6,61
"2011","Wiltshire 007H","E01031968",1218,163,46,117,298,193,138,90,160,86,20,13,7,70
"2011","Wiltshire 007I","E01032699",1694,167,62,105,450,237,150,145,237,178,50,36,14,80
"2011","Wiltshire 008A","E01031939",1604,315,91,224,410,185,201,80,163,95,50,37,13,105
"2011","Wiltshire 008B","E01031940",1601,308,77,231,447,173,238,61,143,98,34,24,10,99
"2011","Wiltshire 008C","E01031950",1029,205,58,147,300,107,189,46,65,36,16,11,5,65
"2011","Wiltshire 008D","E01031951",1078,184,71,113,288,154,143,67,85,91,20,11,9,46
"2011","Wiltshire 009A","E01031907",1814,376,82,294,507,280,109,89,168,110,31,10,21,144
"2011","Wiltshire 009B","E01031910",1085,130,29,101,220,149,93,81,171,133,37,25,12,71
"2011","Wiltshire 009C","E01031914",870,70,18,52,101,97,65,82,188,151,51,22,29,65
"2011","Wiltshire 009D","E01031915",968,147,33,114,220,148,82,86,120,85,22,7,15,58
"2011","Wiltshire 009E","E01031919",1095,187,39,148,270,160,85,45,157,84,27,18,9,80
"2011","Wiltshire 009F","E01031920",922,121,29,92,225,121,75,70,151,84,14,7,7,61
"2011","Wiltshire 010A","E01031905",1088,184,44,140,323,168,69,67,105,57,20,17,3,95
"2011","Wiltshire 010B","E01031906",1120,173,29,144,279,179,86,90,161,82,17,6,11,53
"2011","Wiltshire 010C","E01031908",1184,123,30,93,238,131,89,98,231,172,33,12,21,69
"2011","Wiltshire 010D","E01031909",950,116,27,89,223,151,75,77,138,82,22,14,8,66
"2011","Wiltshire 010E","E01031925",781,44,8,36,111,103,48,77,182,135,32,12,20,49
"2011","Wiltshire 010F","E01031926",1077,97,26,71,207,145,59,105,194,168,35,23,12,67
"2011","Wiltshire 010G","E01031927",992,125,23,102,249,173,70,84,137,69,19,8,11,66
"2011","Wiltshire 011A","E01031911",941,68,16,52,163,115,64,81,166,138,69,42,27,77
"2011","Wiltshire 011B","E01031912",1021,104,19,85,207,104,71,103,188,127,51,25,26,66
"2011","Wiltshire 011C","E01031913",998,168,39,129,242,153,87,70,134,71,24,18,6,49
"2011","Wiltshire 011D","E01031917",1073,102,28,74,222,119,89,93,188,140,48,32,16,72
"2011","Wiltshire 011E","E01031918",1680,279,57,222,387,276,117,122,222,141,54,29,25,82
"2011","Wiltshire 011F","E01031928",956,49,18,31,134,83,73,108,218,172,57,37,20,62
"2011","Wiltshire 013A","E01031891",1679,292,76,216,457,182,284,76,141,113,29,19,10,105
"2011","Wiltshire 013B","E01031904",1522,253,74,179,407,210,194,76,154,85,40,30,10,103
"2011","Wiltshire 013C","E01031937",808,110,25,85,202,95,126,45,96,72,18,8,10,44
"2011","Wiltshire 013D","E01031938",1019,151,47,104,276,143,126,77,116,76,15,7,8,39
"2011","Wiltshire 014A","E01031916",931,92,11,81,188,130,59,65,174,120,30,21,9,73
"2011","Wiltshire 014B","E01031921",1059,194,48,146,264,180,65,70,113,60,25,10,15,88
"2011","Wiltshire 014C","E01031922",1009,110,18,92,233,159,69,109,143,88,28,12,16,70
"2011","Wiltshire 014D","E01031923",1037,142,24,118,221,167,86,84,153,89,16,6,10,79
"2011","Wiltshire 014E","E01031924",1238,182,30,152,321,185,88,104,160,82,24,9,15,92
"2011","Wiltshire 015A","E01031895",1082,72,17,55,212,136,95,86,200,163,53,26,27,65
"2011","Wiltshire 015B","E01031896",826,43,13,30,120,89,62,69,185,161,53,31,22,44
"2011","Wiltshire 015C","E01031897",1549,198,48,150,393,232,140,126,207,148,27,16,11,78
"2011","Wiltshire 015D","E01031898",1247,86,25,61,205,121,95,121,209,195,42,21,21,173
"2011","Wiltshire 015F","E01032690",1222,197,51,146,309,170,90,111,160,89,28,11,17,68
"2011","Wiltshire 015G","E01032691",1087,100,29,71,215,132,91,101,176,160,39,23,16,73
"2011","Wiltshire 016A","E01031900",1600,184,48,136,372,232,161,130,252,141,43,26,17,85
"2011","Wiltshire 016B","E01031901",1055,91,33,58,206,123,99,84,175,153,60,37,23,64
"2011","Wiltshire 016C","E01031902",880,53,18,35,184,108,61,72,179,120,33,16,17,70
"2011","Wiltshire 016D","E01031903",1743,226,70,156,459,262,180,119,188,157,32,17,15,120
"2011","Wiltshire 017A","E01031888",959,192,48,144,293,90,160,38,75,45,20,14,6,46
"2011","Wiltshire 017B","E01031889",1352,180,71,109,325,187,123,96,185,149,32,15,17,75
"2011","Wiltshire 017C","E01031890",1049,162,35,127,303,126,142,71,101,70,18,12,6,56
"2011","Wiltshire 017D","E01031929",927,135,36,99,253,117,127,64,106,61,20,11,9,44
"2011","Wiltshire 017E","E01031930",1240,158,73,85,405,255,89,95,118,66,12,6,6,42
"2011","Wiltshire 018A","E01031931",1131,181,52,129,297,175,124,59,125,86,25,21,4,59
"2011","Wiltshire 018B","E01031932",1035,115,32,83,310,164,86,64,114,100,34,21,13,48
"2011","Wiltshire 018C","E01031933",1100,100,26,74,237,99,114,84,178,176,40,28,12,72
"2011","Wiltshire 018D","E01031941",1147,190,50,140,338,138,139,53,123,76,26,13,13,64
"2011","Wiltshire 018E","E01031942",1072,135,36,99,261,104,163,66,114,72,14,11,3,143
"2011","Wiltshire 018F","E01031952",1747,156,44,112,355,184,190,150,284,253,63,36,27,112
"2011","Wiltshire 018G","E01031953",2118,350,90,260,587,303,177,135,254,144,55,29,26,113
"2011","Wiltshire 045B","E01031988",1129,121,85,36,379,212,46,102,133,70,34,25,9,32
"2011","Wiltshire 045C","E01031998",2162,273,237,36,706,638,72,78,180,104,50,29,21,61
"2011","Wiltshire 045D","E01032026",1188,234,85,149,317,162,142,72,107,80,17,12,5,57
"2011","Wiltshire 045F","E01032696",2362,253,151,102,622,534,193,208,234,197,46,25,21,75
"2011","Wiltshire 046A","E01031989",1077,84,39,45,239,147,89,100,172,145,37,26,11,64
"2011","Wiltshire 046B","E01031996",997,62,19,43,151,165,98,107,165,148,34,19,15,67
"2011","Wiltshire 046C","E01031997",1102,142,50,92,273,182,90,90,151,94,20,12,8,60
"2011","Wiltshire 046D","E01031999",1145,132,43,89,248,206,114,105,149,114,18,10,8,59
"2011","Wiltshire 048A","E01031974",902,84,28,56,207,134,85,87,142,118,17,12,5,28
"2011","Wiltshire 048B","E01031975",893,42,13,29,119,99,53,107,176,191,36,19,17,70
"2011","Wiltshire 048C","E01031976",949,152,84,68,253,139,67,70,123,73,19,11,8,53
"2011","Wiltshire 048D","E01031977",2145,294,91,203,511,342,149,182,269,210,63,38,25,125
"2011","Wiltshire 048E","E01031978",1283,149,45,104,248,201,99,154,191,133,36,13,23,72
"2011","Wiltshire 048F","E01031979",1520,157,55,102,323,246,152,141,207,180,51,36,15,63
"2011","Wiltshire 049A","E01032013",1527,202,66,136,352,202,220,103,191,175,25,20,5,57
"2011","Wiltshire 049B","E01032032",1160,181,53,128,286,196,157,80,110,78,15,9,6,57
"2011","Wiltshire 049C","E01032033",1073,181,59,122,285,140,151,74,99,76,17,12,5,50
"2011","Wiltshire 049D","E01032034",988,149,39,110,281,154,121,65,89,71,11,7,4,47
"2011","Wiltshire 050A","E01032010",1488,188,55,133,379,135,345,86,153,105,36,21,15,61
"2011","Wiltshire 050B","E01032035",1058,143,48,95,259,150,181,61,131,73,22,17,5,38
"2011","Wiltshire 050C","E01032036",1069,139,37,102,244,110,216,58,134,99,20,12,8,49
"2011","Wiltshire 050D","E01032037",1027,91,17,74,186,117,153,88,170,158,33,20,13,31
"2011","Wiltshire 051A","E01031984",1148,252,55,197,345,176,79,38,112,60,11,6,5,75
"2011","Wiltshire 051B","E01031985",872,87,16,71,201,121,87,59,152,93,25,17,8,47
"2011","Wiltshire 051C","E01031986",863,78,22,56,137,117,83,101,155,128,37,24,13,27
"2011","Wiltshire 051D","E01032017",1025,158,39,119,293,183,99,50,104,56,9,4,5,73
"2011","Wiltshire 052A","E01031980",1130,107,26,81,192,159,96,88,198,173,53,31,22,64
"2011","Wiltshire 052B","E01031981",1148,38,10,28,148,119,105,106,253,213,81,57,24,85
"2011","Wiltshire 052C","E01031982",1065,68,12,56,193,139,98,103,193,154,33,19,14,84
"2011","Wiltshire 052D","E01031983",1220,56,10,46,207,127,85,110,262,225,83,42,41,65
"2011","Wiltshire 053A","E01032018",1157,177,47,130,314,176,121,63,133,82,22,15,7,69
"2011","Wiltshire 053B","E01032019",973,89,20,69,211,105,92,78,166,127,39,28,11,66
"2011","Wiltshire 053C","E01032020",1069,159,31,128,307,145,106,47,118,101,30,23,7,56
"2011","Wiltshire 053D","E01032025",1118,97,22,75,251,155,97,106,196,134,34,25,9,48
"2011","Wiltshire 054A","E01031990",1379,238,73,165,344,152,248,61,142,97,29,16,13,68
"2011","Wiltshire 054B","E01032004",1639,207,73,134,413,211,270,107,182,142,36,21,15,71
"2011","Wiltshire 054C","E01032027",1002,160,58,102,285,108,167,61,104,75,10,6,4,32
"2011","Wiltshire 054D","E01032038",931,133,61,72,205,134,120,57,124,94,29,19,10,35
"2011","Wiltshire 054E","E01032039",971,97,25,72,231,147,123,79,154,99,24,15,9,17
"2011","Wiltshire 054F","E01032040",1033,91,32,59,218,129,125,80,164,164,26,16,10,36
"2011","Wiltshire 055A","E01032001",1123,128,27,101,285,154,120,76,166,97,36,27,9,61
"2011","Wiltshire 055B","E01032002",1020,114,25,89,244,174,83,76,146,94,45,31,14,44
"2011","Wiltshire 055C","E01032003",1105,131,20,111,271,133,116,91,161,119,33,23,10,50
"2011","Wiltshire 055D","E01032024",1850,213,31,182,461,249,135,160,296,216,42,20,22,78
"2011","Wiltshire 056A","E01032014",1243,153,31,122,289,141,141,80,161,110,97,76,21,71
"2011","Wiltshire 056B","E01032015",1051,150,21,129,249,129,100,75,142,99,38,28,10,69
"2011","Wiltshire 056C","E01032016",1070,202,26,176,332,123,112,60,80,61,30,20,10,70
"2011","Wiltshire 056D","E01032021",1182,143,31,112,318,186,125,66,144,66,23,20,3,111
"2011","Wiltshire 057A","E01032000",1656,261,67,194,413,206,187,91,201,127,46,37,9,124
"2011","Wiltshire 057B","E01032011",1789,263,79,184,457,208,190,116,241,152,69,45,24,93
"2011","Wiltshire 057C","E01032012",1176,144,36,108,304,196,139,78,151,76,28,21,7,60
"2011","Wiltshire 058A","E01032008",1040,103,22,81,201,137,108,96,173,126,41,32,9,55
"2011","Wiltshire 058B","E01032009",1264,234,49,185,354,197,116,69,147,65,23,16,7,59
"2011","Wiltshire 058C","E01032022",1133,171,26,145,355,112,102,73,149,93,30,19,11,48
"2011","Wiltshire 059A","E01032005",897,128,33,95,242,134,95,42,101,69,23,15,8,63
"2011","Wiltshire 059B","E01032006",891,190,66,124,261,146,79,39,77,35,12,9,3,52
"2011","Wiltshire 059C","E01032007",976,104,25,79,232,158,94,82,108,109,29,15,14,60
"2011","Wiltshire 059D","E01032023",1235,128,19,109,227,123,84,76,225,153,73,45,28,146
"2011","Wiltshire 060A","E01031970",1136,219,56,163,315,163,126,66,113,49,15,9,6,70
"2011","Wiltshire 060B","E01031971",880,122,34,88,206,121,96,72,121,81,21,18,3,40
"2011","Wiltshire 060C","E01031972",1074,202,46,156,274,137,183,40,96,72,17,11,6,53
"2011","Wiltshire 060D","E01032041",1376,246,73,173,388,183,209,75,115,61,21,15,6,78
"2011","Wiltshire 060E","E01032042",1241,212,51,161,351,151,163,65,115,79,21,10,11,84
"2011","Wiltshire 061A","E01031991",1433,186,54,132,340,133,291,89,155,98,26,15,11,115
"2011","Wiltshire 061B","E01032029",988,111,25,86,272,114,173,55,112,79,18,10,8,54
"2011","Wiltshire 061C","E01032030",1072,85,27,58,244,114,170,82,162,125,40,22,18,50
"2011","Wiltshire 061D","E01032031",754,127,26,101,198,91,128,35,93,41,18,12,6,23
"2011","Wiltshire 062A","E01031973",1315,264,78,186,321,164,201,74,133,68,23,18,5,67
"2011","Wiltshire 062B","E01031992",1063,190,44,146,295,119,166,55,105,66,16,11,5,51
"2011","Wiltshire 062C","E01031993",1013,101,23,78,229,131,135,92,136,120,13,7,6,56
"2011","Wiltshire 062D","E01031994",946,144,33,111,231,106,113,57,115,91,28,16,12,61
"2011","Wiltshire 062E","E01031995",1118,211,63,148,277,136,154,68,145,66,22,9,13,39
"2011","Wiltshire 020A","E01032063",1365,85,19,66,242,175,116,140,280,209,42,20,22,76
"2011","Wiltshire 020B","E01032064",934,34,4,30,115,111,62,94,214,182,62,38,24,60
"2011","Wiltshire 020C","E01032065",1106,69,21,48,197,133,97,112,211,182,38,20,18,67
"2011","Wiltshire 020D","E01032073",1035,65,12,53,188,158,68,113,237,147,21,7,14,38
"2011","Wiltshire 020E","E01032074",858,61,12,49,139,136,76,88,166,133,16,8,8,43
"2011","Wiltshire 021A","E01032043",918,133,32,101,219,126,117,44,96,59,25,16,9,99
"2011","Wiltshire 021B","E01032044",951,130,38,92,269,123,130,48,94,83,23,11,12,51
"2011","Wiltshire 021C","E01032057",864,113,25,88,226,123,129,52,94,63,20,12,8,44
"2011","Wiltshire 021D","E01032070",1140,78,22,56,183,145,116,123,210,193,43,25,18,49
"2011","Wiltshire 021E","E01032071",1721,222,66,156,439,245,210,118,209,152,35,22,13,91
"2011","Wiltshire 021F","E01032072",1483,160,47,113,340,252,118,107,223,145,33,16,17,105
"2011","Wiltshire 022A","E01032062",1091,54,17,37,180,145,96,93,237,185,61,29,32,40
"2011","Wiltshire 022B","E01032066",1075,90,34,56,197,130,79,103,223,161,42,24,18,50
"2011","Wiltshire 022C","E01032067",1110,91,22,69,227,162,111,93,200,139,35,27,8,52
"2011","Wiltshire 022D","E01032068",931,76,15,61,205,106,93,87,170,108,35,25,10,51
"2011","Wiltshire 022E","E01032069",912,88,22,66,181,147,85,78,151,102,15,10,5,65
"2011","Wiltshire 023A","E01032058",988,159,32,127,266,131,142,43,90,63,25,18,7,69
"2011","Wiltshire 023B","E01032059",1273,260,71,189,366,147,187,43,107,64,29,13,16,70
"2011","Wiltshire 023C","E01032060",1035,197,45,152,317,114,143,38,82,52,22,12,10,70
"2011","Wiltshire 023D","E01032061",838,149,31,118,237,111,114,34,81,55,11,4,7,46
"2011","Wiltshire 027A","E01032045",1038,173,33,140,341,130,117,47,91,55,15,11,4,69
"2011","Wiltshire 027B","E01032046",1078,179,36,143,310,132,91,66,116,81,39,26,13,64
"2011","Wiltshire 027C","E01032047",970,156,43,113,285,130,96,51,105,60,20,11,9,67
"2011","Wiltshire 027D","E01032048",1207,115,26,89,301,135,103,81,221,158,42,26,16,51
"2011","Wiltshire 027E","E01032049",1097,165,39,126,357,152,87,51,124,73,22,13,9,66
"2011","Wiltshire 027F","E01032050",1283,268,56,212,469,121,152,44,89,50,18,9,9,72
"2011","Wiltshire 030A","E01032077",1254,195,52,143,337,183,118,76,146,102,28,22,6,69
"2011","Wiltshire 030B","E01032078",2083,268,89,179,508,276,165,144,336,225,60,31,29,101
"2011","Wiltshire 030C","E01032079",1044,94,25,69,207,152,113,80,170,144,30,21,9,54
"2011","Wiltshire 030D","E01032080",1192,219,71,148,330,177,105,71,136,51,19,12,7,84
"2011","Wiltshire 031A","E01032085",1259,145,26,119,287,168,90,115,188,138,48,34,14,80
"2011","Wiltshire 031B","E01032086",1827,114,21,93,262,200,105,155,370,408,115,71,44,98
"2011","Wiltshire 031C","E01032087",1539,86,20,66,246,206,126,148,318,280,54,42,12,75
"2011","Wiltshire 032A","E01032099",1990,333,95,238,476,354,161,133,255,122,41,21,20,115
"2011","Wiltshire 032B","E01032100",1080,112,30,82,264,159,84,83,178,128,21,12,9,51
"2011","Wiltshire 032C","E01032101",1225,102,24,78,224,145,116,94,231,183,66,40,26,64
"2011","Wiltshire 032D","E01032102",1089,105,22,83,238,181,78,71,199,128,25,12,13,64
"2011","Wiltshire 033A","E01032096",1249,36,6,30,123,115,88,86,266,281,137,82,55,117
"2011","Wiltshire 033B","E01032097",1374,121,35,86,304,221,131,92,251,134,23,16,7,97
"2011","Wiltshire 033C","E01032098",1255,100,31,69,241,199,84,98,225,155,64,39,25,89
"2011","Wiltshire 035A","E01032092",1118,129,33,96,234,177,93,112,192,109,22,9,13,50
"2011","Wiltshire 035B","E01032093",1293,88,23,65,190,163,77,114,255,217,90,54,36,99
"2011","Wiltshire 035C","E01032094",1670,97,26,71,248,188,117,167,343,293,89,56,33,128
"2011","Wiltshire 035D","E01032095",1229,97,26,71,241,170,108,115,240,175,28,17,11,55
"2011","Wiltshire 036A","E01032088",1086,81,20,61,211,188,107,83,187,143,28,14,14,58
"2011","Wiltshire 036B","E01032089",1146,85,12,73,242,121,103,96,212,176,30,17,13,81
"2011","Wiltshire 036C","E01032090",1052,65,28,37,161,140,86,91,231,182,40,24,16,56
"2011","Wiltshire 036D","E01032091",899,86,21,65,186,127,98,59,132,121,40,25,15,50
"2011","Wiltshire 037A","E01032053",1039,116,38,78,241,158,105,102,156,79,26,14,12,56
"2011","Wiltshire 037B","E01032083",1657,178,55,123,371,239,237,110,241,159,42,22,20,80
"2011","Wiltshire 037C","E01032084",1862,267,80,187,557,247,269,90,192,131,33,24,9,76
"2011","Wiltshire 039A","E01032052",991,139,43,96,235,133,179,68,99,72,22,13,9,44
"2011","Wiltshire 039B","E01032054",912,87,23,64,185,100,143,67,122,117,43,26,17,48
"2011","Wiltshire 039C","E01032055",920,168,47,121,264,137,126,43,73,46,22,16,6,41
"2011","Wiltshire 039D","E01032056",944,107,29,78,229,115,156,52,127,95,18,10,8,45
"2011","Wiltshire 039E","E01032121",1138,101,29,72,233,162,115,111,197,157,18,9,9,44
"2011","Wiltshire 040A","E01032115",1213,71,18,53,205,154,119,114,237,189,63,38,25,61
"2011","Wiltshire 040B","E01032116",1842,154,49,105,337,290,188,188,299,246,45,31,14,95
"2011","Wiltshire 040C","E01032117",1871,171,46,125,400,294,181,156,272,225,52,29,23,120
"2011","Wiltshire 040D","E01032118",1043,35,12,23,144,80,80,116,241,217,48,33,15,82
"2011","Wiltshire 040E","E01032119",1402,119,29,90,296,195,118,152,210,184,43,18,25,85
"2011","Wiltshire 040G","E01032694",1148,128,39,89,292,151,88,90,158,127,38,18,20,76
"2011","Wiltshire 040H","E01032695",1057,113,39,74,224,148,120,91,171,120,29,14,15,41
"2011","Wiltshire 042A","E01032104",958,45,22,23,169,134,84,79,177,165,43,23,20,62
"2011","Wiltshire 042B","E01032105",1040,110,35,75,227,167,113,90,138,116,35,21,14,44
"2011","Wiltshire 042C","E01032107",1004,147,124,23,317,162,41,57,98,98,39,26,13,45
"2011","Wiltshire 042D","E01032108",882,74,32,42,195,109,83,73,156,110,32,23,9,50
"2011","Wiltshire 043A","E01032110",1161,110,38,72,262,169,133,111,167,133,31,22,9,45
"2011","Wiltshire 043B","E01032111",924,71,25,46,150,108,78,103,161,179,32,21,11,42
"2011","Wiltshire 043C","E01032112",1091,98,28,70,261,167,101,77,165,134,19,8,11,69
"2011","Wiltshire 043D","E01032113",1030,52,13,39,191,141,83,94,195,176,44,23,21,54
"2011","Wiltshire 044A","E01032103",1238,118,37,81,265,142,101,125,225,159,36,19,17,67
"2011","Wiltshire 044B","E01032106",1008,107,23,84,249,159,111,84,134,96,21,16,5,47
"2011","Wiltshire 044C","E01032109",1088,82,18,64,223,148,120,98,181,146,35,22,13,55
"2011","Wiltshire 044D","E01032114",1055,62,20,42,180,121,97,89,175,145,30,22,8,156
"2011","Wiltshire 047A","E01032051",988,152,49,103,257,123,169,66,86,68,13,8,5,54
"2011","Wiltshire 047B","E01032075",982,146,59,87,233,138,135,64,117,77,21,12,9,51
"2011","Wiltshire 047C","E01032076",886,122,49,73,205,114,138,56,113,77,20,16,4,41
"2011","Wiltshire 047D","E01032081",909,136,34,102,206,105,152,72,104,60,22,16,6,52
"2011","Wiltshire 047E","E01032082",910,132,46,86,261,112,149,54,85,60,18,11,7,39
"2011","East Devon 001A","E01019902",1352,107,31,76,266,155,263,110,212,151,34,16,18,54
"2011","East Devon 001B","E01019938",1644,198,57,141,364,175,456,83,168,98,39,23,16,63
"2011","East Devon 001C","E01019967",951,110,24,86,195,104,265,51,102,60,14,11,3,50
"2011","East Devon 002A","E01019927",849,46,11,35,129,98,78,68,190,158,37,19,18,45
"2011","East Devon 002B","E01019932",1196,75,22,53,195,154,155,119,240,161,36,26,10,61
"2011","East Devon 002C","E01019933",874,52,17,35,178,111,80,94,160,126,42,31,11,31
"2011","East Devon 002D","E01019934",1271,116,29,87,291,222,154,70,211,108,27,19,8,72
"2011","East Devon 003A","E01019928",1033,56,10,46,191,150,107,82,197,156,27,18,9,67
"2011","East Devon 003B","E01019929",1044,66,14,52,216,150,107,104,194,133,25,14,11,49
"2011","East Devon 003C","E01019930",929,74,20,54,181,158,99,85,167,109,22,13,9,34
"2011","East Devon 003D","E01019931",916,121,26,95,235,136,88,58,136,67,15,4,11,60
"2011","East Devon 004A","E01019925",953,74,16,58,199,135,105,94,161,114,17,9,8,54
"2011","East Devon 004D","E01019959",811,104,22,82,166,99,194,50,97,48,14,6,8,39
"2011","East Devon 004E","E01019960",1006,156,35,121,248,130,180,43,117,64,10,8,2,58
"2011","East Devon 004F","E01019962",1772,242,51,191,456,268,238,122,200,105,29,14,15,112
"2011","East Devon 004G","E01032628",1472,206,45,161,381,169,291,70,154,101,26,18,8,74
"2011","East Devon 005A","E01019886",1875,136,33,103,340,214,376,156,308,204,53,30,23,88
"2011","East Devon 005B","E01019887",964,51,19,32,167,123,132,100,182,140,27,10,17,42
"2011","East Devon 005C","E01019888",1108,92,29,63,201,120,174,95,209,141,35,22,13,41
"2011","East Devon 005D","E01019889",1013,57,18,39,198,140,180,80,166,123,22,15,7,47
"2011","East Devon 005E","E01019966",762,88,24,64,155,90,165,42,102,73,18,12,6,29
"2011","East Devon 006A","E01019891",1072,141,29,112,243,142,206,55,123,78,22,13,9,62
"2011","East Devon 006B","E01019892",1100,125,32,93,228,168,156,86,150,112,19,12,7,56
"2011","East Devon 006C","E01019893",1300,154,46,108,335,200,196,69,151,107,16,8,8,72
"2011","East Devon 006D","E01019903",1486,216,42,174,347,203,255,77,155,121,31,16,15,81
"2011","East Devon 007A","E01019899",915,83,19,64,178,101,133,72,158,120,14,5,9,56
"2011","East Devon 007B","E01019900",1229,142,29,113,281,149,267,84,160,78,20,12,8,48
"2011","East Devon 007C","E01019935",885,117,23,94,221,102,180,62,99,54,9,7,2,41
"2011","East Devon 007D","E01019936",816,87,20,67,196,91,169,54,89,46,34,30,4,50
"2011","East Devon 007E","E01019961",1829,232,71,161,514,176,384,90,208,96,25,17,8,104
"2011","East Devon 008A","E01019939",1024,203,51,152,284,132,166,48,73,43,14,9,5,61
"2011","East Devon 008B","E01019940",1078,152,32,120,339,147,173,30,110,38,22,16,6,67
"2011","East Devon 008C","E01019942",1225,134,29,105,258,181,159,88,156,122,50,34,16,77
"2011","East Devon 008D","E01019943",1106,113,23,90,275,168,133,63,177,88,18,11,7,71
"2011","East Devon 008E","E01019944",1069,128,33,95,258,127,157,76,144,90,29,11,18,60
"2011","East Devon 009A","E01019890",1368,140,40,100,295,134,282,112,173,147,31,19,12,54
"2011","East Devon 009B","E01019901",985,121,25,96,230,111,239,50,120,57,13,12,1,44
"2011","East Devon 009C","E01019951",1505,218,56,162,423,173,288,72,156,81,21,14,7,73
"2011","East Devon 010A","E01019946",925,104,31,73,229,127,140,66,142,61,24,16,8,32
"2011","East Devon 010B","E01019947",1176,96,24,72,243,104,177,109,239,124,34,21,13,50
"2011","East Devon 010C","E01019948",811,44,14,30,134,108,119,97,161,94,15,12,3,39
"2011","East Devon 010D","E01019949",895,62,14,48,197,155,118,78,135,97,16,7,9,37
"2011","East Devon 010E","E01019950",838,57,12,45,173,99,115,71,156,109,24,17,7,34
"2011","East Devon 011A","E01019952",1143,84,18,66,261,204,158,81,192,94,16,11,5,53
"2011","East Devon 011B","E01019953",1018,110,27,83,250,138,116,57,187,96,23,15,8,41
"2011","East Devon 011C","E01019954",1019,66,30,36,201,116,130,121,182,121,37,18,19,45
"2011","East Devon 011D","E01019955",1088,97,19,78,240,141,156,82,192,104,23,15,8,53
"2011","East Devon 012A","E01019956",1050,104,23,81,262,107,190,75,168,80,16,12,4,48
"2011","East Devon 012B","E01019957",976,147,47,100,278,143,129,68,97,67,15,11,4,32
"2011","East Devon 012C","E01019958",1134,126,31,95,291,146,175,82,168,68,19,12,7,59
"2011","East Devon 013A","E01019937",1471,171,38,133,383,204,221,77,193,112,29,12,17,81
"2011","East Devon 013B","E01019945",1604,214,35,179,377,205,226,90,162,107,58,52,6,165
"2011","East Devon 013C","E01019963",1107,205,32,173,339,130,132,61,97,74,16,10,6,53
"2011","East Devon 014A","E01019898",1717,276,64,212,430,240,238,98,200,119,23,15,8,93
"2011","East Devon 014B","E01019964",1578,188,82,106,322,755,120,41,62,40,9,8,1,41
"2011","East Devon 014C","E01019965",1213,172,42,130,372,149,149,70,133,94,22,14,8,52
"2011","East Devon 015A","E01019904",942,48,14,34,181,124,105,97,181,123,38,28,10,45
"2011","East Devon 015B","E01019905",1511,183,63,120,392,239,156,87,201,85,65,55,10,103
"2011","East Devon 015C","E01019906",1050,63,15,48,231,198,117,103,165,102,16,14,2,55
"2011","East Devon 015D","E01019907",1043,72,20,52,266,178,119,82,165,94,16,11,5,51
"2011","East Devon 016A","E01019908",1283,82,22,60,281,212,116,115,220,144,25,16,9,88
"2011","East Devon 016B","E01019909",1217,113,29,84,333,189,157,85,172,95,13,9,4,60
"2011","East Devon 016C","E01019910",1190,118,31,87,308,156,145,70,180,113,30,24,6,70
"2011","East Devon 016D","E01019911",1040,85,30,55,246,178,131,78,173,95,22,13,9,32
"2011","East Devon 017A","E01019894",853,133,34,99,254,131,134,30,95,29,15,9,6,32
"2011","East Devon 017B","E01019895",916,157,40,117,250,122,133,45,105,52,12,8,4,40
"2011","East Devon 017C","E01019896",1027,165,44,121,281,138,177,45,115,48,21,14,7,37
"2011","East Devon 017D","E01019897",1058,80,16,64,243,116,158,90,183,108,30,22,8,50
"2011","East Devon 018A","E01019920",1079,80,21,59,232,147,121,86,211,122,33,19,14,47
"2011","East Devon 018B","E01019921",1105,94,33,61,271,170,122,88,178,107,15,11,4,60
"2011","East Devon 018C","E01019922",1011,48,18,30,168,113,111,93,225,153,33,23,10,67
"2011","East Devon 018D","E01019923",878,52,14,38,178,102,100,67,167,129,38,28,10,45
"2011","East Devon 018E","E01019924",1128,67,21,46,214,126,122,92,230,175,39,16,23,63
"2011","East Devon 019A","E01019916",1423,63,19,44,337,157,176,134,260,175,56,32,24,65
"2011","East Devon 019B","E01019917",1120,84,19,65,279,144,119,77,177,120,46,32,14,74
"2011","East Devon 019C","E01019918",1438,134,35,99,321,166,207,115,229,158,47,22,25,61
"2011","East Devon 019D","E01019919",1279,49,9,40,244,162,140,106,259,201,38,25,13,80
"2011","East Devon 020A","E01019912",1132,118,26,92,285,154,165,81,176,81,34,20,14,38
"2011","East Devon 020B","E01019913",898,142,33,109,271,133,134,34,90,41,20,14,6,33
"2011","East Devon 020C","E01019914",1523,79,20,59,265,183,170,138,308,228,68,48,20,84
"2011","East Devon 020D","E01019915",1088,145,24,121,279,140,138,56,148,73,48,35,13,61
"2011","Exeter 001C","E01019998",1045,180,18,162,253,165,92,46,127,79,20,18,2,83
"2011","Exeter 001D","E01019999",983,178,12,166,226,112,69,24,74,37,15,9,6,248
"2011","Exeter 001E","E01020001",1046,181,30,151,258,192,86,64,104,65,24,16,8,72
"2011","Exeter 001F","E01033233",4443,278,45,233,392,244,159,72,154,108,47,34,13,2989
"2011","Exeter 002A","E01019990",968,37,9,28,134,113,49,100,242,193,48,24,24,52
"2011","Exeter 002B","E01019991",1037,59,10,49,161,136,62,102,222,153,59,39,20,83
"2011","Exeter 002C","E01019993",917,94,23,71,207,154,80,59,134,107,15,9,6,67
"2011","Exeter 002D","E01020000",935,54,7,47,132,131,73,84,181,159,45,32,13,76
"2011","Exeter 002E","E01020007",1333,75,7,68,142,86,55,51,83,61,27,20,7,753
"2011","Exeter 003A","E01019992",1069,89,18,71,201,173,94,78,198,143,31,16,15,62
"2011","Exeter 003B","E01020002",1035,61,13,48,196,155,94,79,205,148,45,26,19,52
"2011","Exeter 003C","E01020003",1099,122,27,95,272,173,123,59,161,95,30,23,7,64
"2011","Exeter 003D","E01020004",1069,129,27,102,277,203,100,73,133,76,21,14,7,57
"2011","Exeter 003E","E01020005",1232,70,14,56,204,166,91,91,258,194,67,49,18,91
"2011","Exeter 004A","E01019997",1367,108,13,95,207,86,49,61,117,67,24,15,9,648
"2011","Exeter 004B","E01020019",1565,72,10,62,110,72,44,33,69,38,23,16,7,1104
"2011","Exeter 004C","E01020020",1579,128,3,125,174,69,59,32,102,59,37,24,13,919
"2011","Exeter 004D","E01020021",1443,159,17,142,215,84,88,57,94,96,62,37,25,588
"2011","Exeter 004E","E01020022",1511,80,3,77,134,94,38,62,119,95,65,41,24,824
"2011","Exeter 005A","E01019980",1254,93,16,77,239,185,84,124,237,165,50,34,16,77
"2011","Exeter 005B","E01019982",1266,123,16,107,268,188,97,95,223,137,37,24,13,98
"2011","Exeter 005C","E01019983",1121,78,14,64,216,178,110,108,197,149,32,20,12,53
"2011","Exeter 005D","E01019984",1058,78,19,59,219,191,107,78,178,124,23,14,9,60
"2011","Exeter 005E","E01019985",986,51,11,40,148,140,78,77,214,169,45,25,20,64
"2011","Exeter 006A","E01019987",1389,153,19,134,223,123,64,68,140,108,31,18,13,479
"2011","Exeter 006B","E01019989",848,121,14,107,251,144,45,51,103,52,11,9,2,70
"2011","Exeter 006C","E01020006",1583,122,22,100,287,222,100,97,247,153,42,26,16,313
"2011","Exeter 006D","E01020008",1551,108,9,99,199,126,55,71,108,83,37,26,11,764
"2011","Exeter 006E","E01020009",1130,207,20,187,324,132,70,49,96,65,30,17,13,157
"2011","Exeter 007A","E01019986",1061,138,30,108,280,173,101,66,148,81,15,9,6,59
"2011","Exeter 007B","E01020036",1013,90,15,75,206,152,101,75,181,120,36,20,16,52
"2011","Exeter 007C","E01020037",947,55,14,41,139,134,57,78,221,164,50,36,14,49
"2011","Exeter 007D","E01020039",1275,58,14,44,169,165,69,117,298,248,69,44,25,82
"2011","Exeter 007E","E01020040",973,74,22,52,194,158,82,78,165,136,31,16,15,55
"2011","Exeter 008A","E01019994",1296,146,24,122,232,138,56,44,146,97,31,22,9,406
"2011","Exeter 008B","E01019995",1087,77,8,69,180,133,66,61,168,138,80,45,35,184
"2011","Exeter 008C","E01020016",1861,209,25,184,301,168,110,96,247,193,96,60,36,441
"2011","Exeter 008D","E01020017",2163,169,16,153,324,166,84,87,154,137,58,28,30,984
"2011","Exeter 008E","E01020018",1666,172,22,150,320,172,93,103,182,172,77,44,33,375
"2011","Exeter 009A","E01019996",1087,149,13,136,191,112,61,43,109,68,34,22,12,320
"2011","Exeter 009B","E01020023",1592,376,57,319,442,231,120,71,133,75,38,18,20,106
"2011","Exeter 009C","E01020024",1037,315,33,282,330,107,67,36,55,39,19,13,6,69
"2011","Exeter 009D","E01020025",1215,252,18,234,302,146,77,60,135,72,33,19,14,138
"2011","Exeter 010A","E01019975",930,49,9,40,124,109,81,82,193,169,57,34,23,66
"2011","Exeter 010B","E01020029",1195,90,17,73,275,183,114,103,206,126,21,14,7,77
"2011","Exeter 010C","E01020030",1383,106,12,94,299,201,115,123,250,161,53,31,22,75
"2011","Exeter 010D","E01020031",1169,99,25,74,266,194,95,91,203,133,22,15,7,66
"2011","Exeter 010E","E01020032",1149,109,15,94,264,130,98,95,173,131,57,45,12,92
"2011","Exeter 011A","E01020026",1306,102,21,81,279,269,115,103,200,139,26,20,6,73
"2011","Exeter 011B","E01020027",1217,116,22,94,261,221,106,87,183,131,40,28,12,72
"2011","Exeter 011D","E01020035",1189,156,30,126,324,192,76,67,141,106,13,10,3,114
"2011","Exeter 011E","E01020038",1087,135,30,105,264,200,93,80,128,96,28,16,12,63
"2011","Exeter 011F","E01033232",1095,171,26,145,314,169,68,64,131,96,16,6,10,66
"2011","Exeter 011G","E01033234",1087,181,41,140,302,191,73,55,125,78,19,13,6,63
"2011","Exeter 012A","E01019973",1026,58,18,40,208,162,110,83,185,123,35,28,7,62
"2011","Exeter 012B","E01019974",1052,83,20,63,195,174,107,70,197,146,34,16,18,46
"2011","Exeter 012C","E01019976",906,83,24,59,204,153,109,70,141,85,15,11,4,46
"2011","Exeter 012D","E01019977",1054,60,15,45,194,191,110,81,167,145,42,31,11,64
"2011","Exeter 012E","E01019981",1042,60,14,46,208,144,87,94,201,159,32,18,14,57
"2011","Exeter 013A","E01019988",953,99,19,80,228,162,71,61,158,96,19,15,4,59
"2011","Exeter 013B","E01020010",1242,118,21,97,222,145,89,92,221,211,57,36,21,87
"2011","Exeter 013C","E01020013",987,102,21,81,193,152,73,61,155,132,53,40,13,66
"2011","Exeter 013D","E01020014",1126,49,10,39,133,127,61,99,259,253,77,46,31,68
"2011","Exeter 013E","E01020015",1278,38,8,30,131,124,91,118,293,294,102,70,32,87
"2011","Exeter 014A","E01019968",1090,113,23,90,251,211,91,66,159,119,22,16,6,58
"2011","Exeter 014B","E01019969",968,84,9,75,231,178,86,83,132,111,22,15,7,41
"2011","Exeter 014C","E01019970",956,101,20,81,201,181,97,73,135,80,26,24,2,62
"2011","Exeter 014D","E01019971",1286,195,23,172,313,199,76,77,159,131,53,32,21,83
"2011","Exeter 014E","E01019972",1058,90,23,67,235,145,68,110,179,129,46,31,15,56
"2011","Exeter 015A","E01020011",900,106,27,79,231,129,93,51,117,98,27,20,7,48
"2011","Exeter 015B","E01020012",1057,63,10,53,196,123,106,93,223,161,37,21,16,55
"2011","Exeter 015C","E01020033",1074,164,34,130,250,124,125,66,145,108,37,26,11,55
"2011","Exeter 015E","E01033235",830,147,21,126,264,103,93,32,100,41,8,1,7,42
"2011","Exeter 015F","E01033236",717,171,29,142,200,91,101,24,58,33,10,6,4,29
"2011","Mid Devon 001A","E01020046",1176,132,32,100,258,126,260,68,135,104,22,17,5,71
"2011","Mid Devon 001B","E01020049",988,124,25,99,218,100,267,53,97,62,20,11,9,47
"2011","Mid Devon 001C","E01020050",1530,154,29,125,342,160,362,93,193,130,44,29,15,52
"2011","Mid Devon 001D","E01020077",1177,140,30,110,266,129,295,69,123,70,21,15,6,64
"2011","Mid Devon 002A","E01020047",1488,134,37,97,310,198,226,124,217,172,36,24,12,71
"2011","Mid Devon 002B","E01020051",1318,125,40,85,298,186,156,103,217,136,27,18,9,70
"2011","Mid Devon 002C","E01020066",1993,202,53,149,453,308,228,148,286,213,41,24,17,114
"2011","Mid Devon 002D","E01020080",919,85,21,64,199,129,177,64,121,86,21,10,11,37
"2011","Mid Devon 003A","E01020063",1722,155,36,119,387,208,251,139,230,219,61,45,16,72
"2011","Mid Devon 003B","E01020074",1557,194,50,144,385,188,326,80,182,115,26,18,8,61
"2011","Mid Devon 003C","E01020075",1348,156,42,114,321,136,257,84,164,131,24,15,9,75
"2011","Mid Devon 004A","E01020052",1273,94,26,68,263,128,135,107,226,205,59,38,21,56
"2011","Mid Devon 004B","E01020053",1015,42,12,30,133,103,96,106,227,208,53,38,15,47
"2011","Mid Devon 004C","E01020065",1371,71,27,44,214,142,124,130,255,203,52,32,20,180
"2011","Mid Devon 004D","E01020067",1307,52,16,36,188,131,99,133,260,279,81,53,28,84
"2011","Mid Devon 005A","E01020048",1539,88,28,60,275,161,172,163,299,225,76,47,29,80
"2011","Mid Devon 005B","E01020078",940,36,17,19,155,102,86,99,184,173,50,41,9,55
"2011","Mid Devon 005C","E01020079",927,37,11,26,141,98,83,93,193,200,46,30,16,36
"2011","Mid Devon 005D","E01020081",900,43,6,37,160,94,120,71,191,149,21,15,6,51
"2011","Mid Devon 006A","E01020045",1180,127,32,95,297,162,212,67,130,94,24,15,9,67
"2011","Mid Devon 006B","E01020059",1511,188,53,135,370,170,309,87,177,106,35,20,15,69
"2011","Mid Devon 006C","E01020062",1120,113,33,80,252,169,134,84,160,123,18,11,7,67
"2011","Mid Devon 006D","E01020064",1258,103,29,74,260,144,152,98,209,199,29,16,13,64
"2011","Mid Devon 007A","E01020054",1518,131,32,99,315,229,160,132,270,176,37,25,12,68
"2011","Mid Devon 007B","E01020055",1349,71,17,54,245,169,116,125,260,219,75,55,20,69
"2011","Mid Devon 007C","E01020057",1263,69,19,50,197,119,128,131,262,252,47,30,17,58
"2011","Mid Devon 007D","E01020058",1405,125,32,93,293,231,135,116,240,168,27,21,6,70
"2011","Mid Devon 008A","E01020043",1382,190,32,158,325,189,168,71,221,126,29,14,15,63
"2011","Mid Devon 008B","E01020044",1150,170,30,140,301,138,233,61,111,51,17,7,10,68
"2011","Mid Devon 008C","E01020056",1517,210,51,159,369,156,358,67,139,88,54,45,9,76
"2011","Mid Devon 008D","E01020071",1333,182,38,144,329,164,191,71,203,98,27,16,11,68
"2011","Mid Devon 009A","E01020072",1234,125,35,90,287,135,317,58,122,102,34,18,16,54
"2011","Mid Devon 009B","E01020073",1204,105,25,80,248,136,258,85,183,121,20,13,7,48
"2011","Mid Devon 009C","E01020076",1279,100,23,77,280,152,243,89,174,127,43,32,11,71
"2011","Mid Devon 009D","E01020082",880,89,18,71,218,86,215,49,91,60,29,18,11,43
"2011","Mid Devon 010A","E01020068",1113,166,38,128,269,144,196,47,125,78,36,28,8,52
"2011","Mid Devon 010B","E01020069",1126,152,29,123,277,120,207,47,120,103,29,16,13,71
"2011","Mid Devon 010C","E01020070",1367,153,32,121,302,152,329,78,154,99,38,22,16,62
"2011","Mid Devon 010D","E01020083",1706,197,52,145,402,209,290,107,229,150,42,33,9,80
"2011","Mid Devon 011A","E01020041",1621,88,23,65,291,198,154,142,361,222,80,51,29,85
"2011","Mid Devon 011B","E01020042",1183,103,30,73,260,189,132,90,215,131,25,19,6,38
"2011","Mid Devon 011C","E01020060",1174,93,13,80,227,170,148,92,236,138,20,13,7,50
"2011","Mid Devon 011D","E01020061",1486,124,26,98,350,184,196,97,224,139,57,44,13,115
"2011","North Devon 001A","E01020111",1002,33,4,29,107,83,129,96,235,195,65,37,28,59
"2011","North Devon 001B","E01020112",1233,58,8,50,193,81,176,132,236,227,81,48,33,49
"2011","North Devon 001C","E01020114",910,49,11,38,144,81,159,78,168,140,36,21,15,55
"2011","North Devon 001D","E01020115",885,54,17,37,193,95,178,66,155,94,18,12,6,32
"2011","North Devon 002A","E01020099",1022,57,14,43,229,100,263,73,136,102,17,10,7,45
"2011","North Devon 002B","E01020100",805,68,12,56,157,78,203,60,106,71,17,9,8,45
"2011","North Devon 002C","E01020101",1072,50,12,38,211,97,218,91,167,156,25,10,15,57
"2011","North Devon 002D","E01020126",1237,78,23,55,230,104,387,74,176,118,27,20,7,43
"2011","North Devon 003A","E01020113",1023,48,4,44,202,66,177,88,190,142,59,36,23,51
"2011","North Devon 003B","E01020116",1211,54,15,39,223,128,187,114,219,182,33,18,15,71
"2011","North Devon 003C","E01020117",1117,76,19,57,221,115,213,92,190,126,30,16,14,54
"2011","North Devon 003D","E01020118",967,37,12,25,179,72,116,86,204,163,44,25,19,66
"2011","North Devon 004A","E01020090",1226,165,43,122,310,142,194,72,147,84,26,19,7,86
"2011","North Devon 004B","E01020108",1713,129,33,96,435,177,391,122,202,138,30,17,13,89
"2011","North Devon 004C","E01020109",1029,127,31,96,272,89,257,52,91,59,19,12,7,63
"2011","North Devon 005A","E01020089",1634,126,40,86,378,180,243,133,276,171,32,14,18,95
"2011","North Devon 005B","E01020091",938,68,18,50,208,113,153,88,136,120,9,3,6,43
"2011","North Devon 005C","E01020092",977,83,30,53,197,139,161,83,148,87,32,25,7,47
"2011","North Devon 005D","E01020093",958,66,14,52,236,89,134,86,152,130,18,9,9,47
"2011","North Devon 005E","E01020110",1930,147,76,71,570,389,138,136,230,211,38,28,10,71
"2011","North Devon 006A","E01020088",1516,162,39,123,325,148,395,78,178,133,25,17,8,72
"2011","North Devon 006B","E01020120",1335,122,38,84,330,171,221,81,194,113,36,19,17,67
"2011","North Devon 006C","E01020127",1400,166,47,119,339,135,337,81,175,71,14,11,3,82
"2011","North Devon 007A","E01020132",1293,68,24,44,292,170,147,118,237,162,30,20,10,69
"2011","North Devon 007B","E01020133",1074,120,18,102,293,164,111,81,135,95,16,8,8,59
"2011","North Devon 007C","E01020134",824,97,21,76,140,88,70,72,158,122,35,21,14,42
"2011","North Devon 007D","E01020139",1027,48,11,37,149,115,66,116,229,198,37,27,10,69
"2011","North Devon 008A","E01020094",1256,63,11,52,200,100,133,133,262,229,66,55,11,70
"2011","North Devon 008B","E01020095",1087,46,8,38,179,109,99,107,248,199,20,13,7,80
"2011","North Devon 008C","E01020140",863,46,11,35,145,101,99,86,168,146,22,16,6,50
"2011","North Devon 008D","E01020141",1245,37,15,22,182,113,99,137,300,236,67,42,25,74
"2011","North Devon 009A","E01020096",1210,81,21,60,244,127,124,123,238,184,34,20,14,55
"2011","North Devon 009B","E01020123",1042,56,15,41,184,107,120,80,214,153,48,28,20,80
"2011","North Devon 009C","E01020124",997,85,13,72,226,118,129,84,163,110,27,19,8,55
"2011","North Devon 009D","E01020125",918,72,21,51,189,149,100,85,162,113,11,9,2,37
"2011","North Devon 010A","E01020102",1233,81,22,59,284,197,95,110,208,148,32,13,19,78
"2011","North Devon 010B","E01020103",1025,36,11,25,120,82,77,80,260,231,62,40,22,77
"2011","North Devon 010C","E01020104",1017,30,10,20,128,104,67,108,239,220,58,38,20,63
"2011","North Devon 010D","E01020128",921,99,26,73,247,134,115,63,115,63,35,29,6,50
"2011","North Devon 010E","E01020129",843,51,18,33,144,97,94,70,155,142,30,21,9,60
"2011","North Devon 010F","E01020130",1138,80,20,60,261,101,109,108,199,152,45,25,20,83
"2011","North Devon 011A","E01020105",1052,58,12,46,217,126,109,99,226,122,38,19,19,57
"2011","North Devon 011B","E01020106",829,76,29,47,177,138,117,69,126,77,20,16,4,29
"2011","North Devon 011C","E01020107",1112,89,26,63,266,144,135,92,178,132,26,13,13,50
"2011","North Devon 011D","E01020119",1115,114,30,84,287,110,234,59,137,84,37,28,9,53
"2011","North Devon 012A","E01020084",1032,69,14,55,208,134,113,110,200,125,24,15,9,49
"2011","North Devon 012B","E01020085",1107,81,29,52,249,153,96,96,230,119,30,12,18,53
"2011","North Devon 012C","E01020086",1104,84,29,55,237,166,149,94,182,119,21,12,9,52
"2011","North Devon 012D","E01020121",1427,120,34,86,324,176,217,97,211,152,36,24,12,94
"2011","North Devon 012E","E01020122",1272,129,39,90,278,158,256,86,157,117,25,20,5,66
"2011","North Devon 013A","E01020097",1670,154,35,119,369,157,448,111,189,130,36,26,10,76
"2011","North Devon 013B","E01020131",1645,148,30,118,292,169,421,102,199,144,49,25,24,121
"2011","North Devon 013C","E01020135",1102,43,12,31,167,108,153,114,251,165,41,25,16,60
"2011","North Devon 013D","E01020136",1208,82,25,57,220,155,181,110,218,148,34,22,12,60
"2011","North Devon 013E","E01020137",1111,62,13,49,238,104,146,105,198,152,36,17,19,70
"2011","North Devon 014A","E01020087",1402,123,31,92,281,150,382,93,157,121,44,34,10,51
"2011","North Devon 014B","E01020098",1529,127,36,91,318,157,409,84,183,137,38,28,10,76
"2011","North Devon 014C","E01020138",1637,131,40,91,309,173,390,114,237,162,57,38,19,64
"2011","South Hams 001A","E01020144",1174,131,35,96,317,228,84,104,140,87,21,7,14,62
"2011","South Hams 001B","E01020145",1587,213,59,154,352,322,198,96,176,110,33,25,8,87
"2011","South Hams 001C","E01020146",907,87,22,65,223,150,85,71,138,89,16,8,8,48
"2011","South Hams 001D","E01020149",887,73,15,58,205,117,152,69,116,91,21,9,12,43
"2011","South Hams 002A","E01020148",841,133,34,99,198,103,149,46,94,60,17,13,4,41
"2011","South Hams 002B","E01020157",1753,255,69,186,477,156,381,86,123,86,74,57,17,115
"2011","South Hams 002C","E01020160",1379,224,58,166,371,118,233,78,140,90,27,17,10,98
"2011","South Hams 002D","E01020176",818,104,14,90,208,81,155,46,84,55,24,18,6,61
"2011","South Hams 002E","E01020177",942,85,16,69,208,94,118,73,156,105,31,20,11,72
"2011","South Hams 003A","E01020180",1333,132,21,111,341,108,198,77,219,111,55,33,22,92
"2011","South Hams 003B","E01020181",1182,113,23,90,256,122,144,85,204,140,42,31,11,76
"2011","South Hams 003C","E01020182",1095,87,15,72,248,102,150,78,183,109,64,45,19,74
"2011","South Hams 003D","E01020183",1025,151,23,128,306,81,162,50,118,57,38,26,12,62
"2011","South Hams 003E","E01020184",1213,137,31,106,350,106,188,53,161,90,40,24,16,88
"2011","South Hams 004A","E01020153",947,130,50,80,277,96,164,48,102,62,32,23,9,36
"2011","South Hams 004B","E01020156",1342,181,51,130,393,120,276,64,125,96,31,23,8,56
"2011","South Hams 004C","E01020170",1566,174,42,132,385,229,271,92,168,124,37,24,13,86
"2011","South Hams 004D","E01020188",1464,212,44,168,379,116,376,57,132,85,26,17,9,81
"2011","South Hams 005A","E01020161",1686,150,41,109,383,213,162,143,259,193,65,39,26,118
"2011","South Hams 005B","E01020162",1257,91,23,68,308,197,111,106,192,137,17,11,6,98
"2011","South Hams 005C","E01020163",1310,155,45,110,350,198,120,94,182,82,23,16,7,106
"2011","South Hams 005D","E01020164",1130,108,34,74,266,147,118,89,161,110,20,13,7,111
"2011","South Hams 005E","E01020165",1141,109,28,81,278,183,98,91,185,114,20,13,7,63
"2011","South Hams 005F","E01020166",1081,106,21,85,271,157,107,82,163,107,30,24,6,58
"2011","South Hams 005G","E01020167",989,128,30,98,301,164,68,60,112,65,15,11,4,76
"2011","South Hams 006A","E01020142",1613,180,40,140,371,167,363,93,204,138,24,17,7,73
"2011","South Hams 006B","E01020143",1696,232,59,173,449,145,396,58,164,103,36,21,15,113
"2011","South Hams 006C","E01020150",1220,185,30,155,371,109,187,59,126,91,28,20,8,64
"2011","South Hams 007A","E01020151",1169,156,45,111,286,130,252,59,145,75,20,10,10,46
"2011","South Hams 007B","E01020152",1061,119,29,90,251,87,230,86,129,102,26,16,10,31
"2011","South Hams 007C","E01020154",1211,246,206,40,210,115,117,104,174,133,44,35,9,68
"2011","South Hams 007D","E01020155",751,25,10,15,108,43,101,82,162,165,32,17,15,33
"2011","South Hams 008A","E01020147",1477,214,44,170,352,147,337,90,151,91,28,18,10,67
"2011","South Hams 008B","E01020158",1202,166,37,129,307,124,219,67,139,71,30,16,14,79
"2011","South Hams 008C","E01020159",1044,179,48,131,261,122,213,51,92,49,23,16,7,54
"2011","South Hams 008D","E01020190",1465,255,58,197,425,174,196,78,153,86,34,19,15,64
"2011","South Hams 009A","E01020171",1343,298,67,231,376,147,234,44,99,56,23,13,10,66
"2011","South Hams 009B","E01020185",966,142,33,109,275,135,132,43,110,61,23,18,5,45
"2011","South Hams 009C","E01020186",1077,180,50,130,355,146,130,52,90,58,13,7,6,53
"2011","South Hams 009D","E01020187",1223,154,34,120,317,169,149,97,142,104,34,17,17,57
"2011","South Hams 010A","E01020168",1363,112,31,81,291,153,230,89,240,151,37,27,10,60
"2011","South Hams 010B","E01020169",1669,122,35,87,350,140,322,146,275,157,57,40,17,100
"2011","South Hams 010C","E01020189",1438,89,24,65,278,120,247,108,275,178,63,49,14,80
"2011","South Hams 011A","E01020174",1118,131,47,84,252,96,288,72,131,69,22,14,8,57
"2011","South Hams 011B","E01020175",1381,155,48,107,313,144,382,61,152,92,26,19,7,56
"2011","South Hams 011C","E01020178",1331,123,34,89,318,142,342,79,159,87,29,20,9,52
"2011","South Hams 012A","E01020172",1306,153,43,110,260,119,322,108,163,107,21,12,9,53
"2011","South Hams 012B","E01020173",1113,140,49,91,251,105,285,79,138,59,22,18,4,34
"2011","South Hams 012C","E01020179",1331,165,51,114,363,148,305,81,129,81,18,11,7,41
"2011","Teignbridge 001A","E01020243",892,127,28,99,256,126,148,48,73,50,17,11,6,47
"2011","Teignbridge 001B","E01020262",948,118,23,95,239,111,202,41,100,71,27,22,5,39
"2011","Teignbridge 001C","E01020263",1041,106,31,75,206,147,198,67,147,118,19,11,8,33
"2011","Teignbridge 001D","E01020274",981,166,30,136,236,114,227,42,88,49,12,11,1,47
"2011","Teignbridge 002A","E01020240",1095,135,28,107,280,147,127,79,150,104,29,25,4,44
"2011","Teignbridge 002B","E01020241",1290,187,41,146,379,164,203,74,115,91,17,10,7,60
"2011","Teignbridge 002C","E01020242",1038,151,32,119,314,176,83,61,118,61,10,7,3,64
"2011","Teignbridge 002D","E01020244",996,86,16,70,225,144,102,91,186,74,28,18,10,60
"2011","Teignbridge 002E","E01020245",1223,164,37,127,357,145,170,78,132,93,20,15,5,64
"2011","Teignbridge 003A","E01020205",1044,206,56,150,291,121,208,33,74,42,12,8,4,57
"2011","Teignbridge 003B","E01020258",1230,121,36,85,313,94,245,90,151,106,29,21,8,81
"2011","Teignbridge 003C","E01020259",835,131,32,99,196,61,234,45,83,36,11,8,3,38
"2011","Teignbridge 003D","E01020273",991,151,23,128,279,107,190,39,99,59,21,13,8,46
"2011","Teignbridge 004A","E01020203",1078,161,37,124,296,157,130,68,128,81,18,11,7,39
"2011","Teignbridge 004B","E01020206",1065,102,22,80,299,110,146,81,151,103,27,10,17,46
"2011","Teignbridge 004C","E01020220",1003,89,20,69,209,105,111,64,157,123,74,66,8,71
"2011","Teignbridge 004D","E01020221",1307,166,39,127,336,154,180,77,169,107,46,29,17,72
"2011","Teignbridge 004E","E01020222",901,113,33,80,245,115,110,62,124,75,8,6,2,49
"2011","Teignbridge 004F","E01020223",1318,145,35,110,331,146,188,82,193,142,29,20,9,62
"2011","Teignbridge 005A","E01020229",1237,111,25,86,254,143,198,80,182,140,77,63,14,52
"2011","Teignbridge 005B","E01020230",1291,134,44,90,311,159,149,103,201,128,45,34,11,61
"2011","Teignbridge 005C","E01020231",1010,71,12,59,226,170,138,54,157,104,37,26,11,53
"2011","Teignbridge 005D","E01020232",1169,82,25,57,200,154,111,120,234,138,37,20,17,93
"2011","Teignbridge 006A","E01020228",1236,90,19,71,236,127,152,115,243,173,68,48,20,32
"2011","Teignbridge 006B","E01020233",1219,164,28,136,295,167,184,75,183,77,22,11,11,52
"2011","Teignbridge 006C","E01020234",1024,39,9,30,174,149,100,91,207,160,31,17,14,73
"2011","Teignbridge 006D","E01020235",1222,93,17,76,258,143,171,91,213,137,44,29,15,72
"2011","Teignbridge 007A","E01020202",994,106,27,79,224,123,128,75,153,116,31,27,4,38
"2011","Teignbridge 007B","E01020204",1142,78,17,61,193,107,127,138,203,185,39,26,13,72
"2011","Teignbridge 007C","E01020236",905,86,21,65,220,136,140,59,114,78,14,10,4,58
"2011","Teignbridge 007D","E01020237",1136,168,49,119,310,130,211,61,108,65,18,10,8,65
"2011","Teignbridge 008A","E01020265",1231,113,27,86,318,206,136,98,184,98,28,16,12,50
"2011","Teignbridge 008B","E01020266",1286,125,26,99,329,161,168,81,165,97,28,16,12,132
"2011","Teignbridge 008C","E01020267",1059,124,37,87,288,135,156,49,155,61,32,24,8,59
"2011","Teignbridge 008D","E01020268",988,135,34,101,265,144,144,44,108,64,42,29,13,42
"2011","Teignbridge 008E","E01020270",1184,87,16,71,281,201,130,85,195,122,26,16,10,57
"2011","Teignbridge 009A","E01020250",1161,70,25,45,250,170,125,102,230,144,17,12,5,53
"2011","Teignbridge 009B","E01020252",962,59,13,46,190,134,95,91,209,114,36,30,6,34
"2011","Teignbridge 009C","E01020253",1086,110,28,82,245,164,98,102,188,86,15,8,7,78
"2011","Teignbridge 009D","E01020254",960,30,6,24,170,105,109,92,193,163,41,21,20,57
"2011","Teignbridge 009E","E01020255",936,51,14,37,177,128,94,85,184,152,20,17,3,45
"2011","Teignbridge 009F","E01020257",886,71,17,54,200,149,100,68,143,90,11,8,3,54
"2011","Teignbridge 010A","E01020264",1044,76,16,60,206,112,157,73,162,124,80,66,14,54
"2011","Teignbridge 010B","E01020269",1302,89,21,68,243,126,223,101,273,145,53,34,19,49
"2011","Teignbridge 010C","E01020271",1079,53,13,40,192,125,148,116,216,129,35,20,15,65
"2011","Teignbridge 010D","E01020272",1320,53,13,40,207,154,153,109,286,205,69,46,23,84
"2011","Teignbridge 011A","E01020200",809,115,26,89,233,81,144,50,89,47,13,5,8,37
"2011","Teignbridge 011B","E01020201",1013,141,37,104,299,144,150,56,120,61,18,9,9,24
"2011","Teignbridge 011C","E01020251",1082,124,37,87,293,151,145,71,155,72,19,13,6,52
"2011","Teignbridge 011D","E01020260",855,124,36,88,222,116,176,45,80,48,15,9,6,29
"2011","Teignbridge 011E","E01020261",878,133,22,111,257,95,187,31,76,46,8,7,1,45
"2011","Teignbridge 012A","E01020208",868,45,18,27,151,93,68,82,199,148,38,17,21,44
"2011","Teignbridge 012B","E01020209",1060,50,16,34,219,139,91,102,220,156,36,23,13,47
"2011","Teignbridge 012C","E01020210",897,93,28,65,235,142,112,68,120,70,13,5,8,44
"2011","Teignbridge 012D","E01020219",1517,187,51,136,382,199,151,101,217,142,40,25,15,98
"2011","Teignbridge 013A","E01020191",1438,119,28,91,238,125,235,137,208,218,113,93,20,45
"2011","Teignbridge 013B","E01020194",1068,131,28,103,288,173,125,61,135,66,15,6,9,74
"2011","Teignbridge 013C","E01020207",785,67,14,53,194,110,106,53,123,64,13,7,6,55
"2011","Teignbridge 013D","E01020256",979,74,21,53,208,127,132,90,151,110,13,6,7,74
"2011","Teignbridge 014A","E01020211",1094,40,12,28,126,111,90,113,257,243,60,40,20,54
"2011","Teignbridge 014B","E01020217",1200,67,27,40,219,136,120,108,258,168,58,34,24,66
"2011","Teignbridge 014C","E01020218",1102,67,17,50,212,116,115,98,244,146,47,31,16,57
"2011","Teignbridge 014D","E01020224",928,53,15,38,197,107,89,66,181,139,34,21,13,62
"2011","Teignbridge 015A","E01020216",1147,60,22,38,185,130,87,109,219,200,77,49,28,80
"2011","Teignbridge 015B","E01020225",929,66,12,54,174,106,95,62,193,136,41,34,7,56
"2011","Teignbridge 015C","E01020226",865,124,26,98,241,97,104,44,122,58,19,12,7,56
"2011","Teignbridge 015D","E01020227",985,87,22,65,222,122,131,66,140,101,46,30,16,70
"2011","Teignbridge 016A","E01020212",871,37,8,29,131,78,78,90,189,174,44,28,16,50
"2011","Teignbridge 016B","E01020213",1060,50,14,36,174,143,137,95,204,159,41,31,10,57
"2011","Teignbridge 016C","E01020214",1091,101,26,75,247,166,111,85,191,112,27,13,14,51
"2011","Teignbridge 016D","E01020215",1007,124,37,87,232,189,111,74,134,76,14,9,5,53
"2011","Teignbridge 017A","E01020195",1264,89,27,62,266,141,228,112,172,160,25,13,12,71
"2011","Teignbridge 017B","E01020196",1219,124,22,102,313,95,191,75,175,125,46,28,18,75
"2011","Teignbridge 017C","E01020197",923,130,28,102,222,81,163,76,98,80,28,24,4,45
"2011","Teignbridge 017D","E01020198",1002,73,19,54,191,84,146,89,185,141,29,20,9,64
"2011","Teignbridge 017E","E01020199",1137,95,19,76,238,124,168,103,181,145,23,13,10,60
"2011","Teignbridge 018A","E01020246",849,107,18,89,241,108,126,61,90,58,13,5,8,45
"2011","Teignbridge 018B","E01020247",1134,86,20,66,230,160,120,81,187,137,53,38,15,80
"2011","Teignbridge 018C","E01020248",1192,100,27,73,286,185,218,75,153,93,23,13,10,59
"2011","Teignbridge 018D","E01020249",979,75,21,54,236,164,140,70,125,96,13,10,3,60
"2011","Teignbridge 019A","E01020192",1108,140,35,105,291,141,150,59,136,101,25,16,9,65
"2011","Teignbridge 019B","E01020193",1067,134,32,102,271,124,209,49,107,57,35,27,8,81
"2011","Teignbridge 019C","E01020238",847,87,17,70,225,116,90,56,124,81,18,11,7,50
"2011","Teignbridge 019D","E01020239",877,109,22,87,216,115,157,48,108,60,10,7,3,54
"2011","Torridge 001A","E01020275",990,80,14,66,191,89,161,72,182,142,40,18,22,33
"2011","Torridge 001B","E01020276",1076,86,29,57,237,143,134,82,184,127,44,35,9,39
"2011","Torridge 001C","E01020297",1079,47,11,36,194,96,130,101,254,168,57,31,26,32
"2011","Torridge 001D","E01020299",1332,117,33,84,261,181,177,126,238,158,39,29,10,35
"2011","Torridge 002A","E01020298",1404,137,38,99,356,186,209,90,173,136,73,55,18,44
"2011","Torridge 002B","E01020300",1230,118,30,88,295,166,187,97,178,104,29,23,6,56
"2011","Torridge 002C","E01020310",1562,138,38,100,358,204,233,107,241,154,67,43,24,60
"2011","Torridge 003A","E01020280",1682,72,16,56,289,167,181,157,355,282,102,57,45,77
"2011","Torridge 003B","E01020281",1403,114,25,89,322,202,143,127,245,125,27,13,14,98
"2011","Torridge 003C","E01020282",1122,44,7,37,200,109,120,101,252,177,56,33,23,63
"2011","Torridge 004A","E01020277",1373,46,15,31,195,115,143,107,346,263,81,51,30,77
"2011","Torridge 004B","E01020278",1279,77,28,49,227,119,206,121,242,158,50,34,16,79
"2011","Torridge 004C","E01020279",1722,79,24,55,282,192,173,196,374,260,81,52,29,85
"2011","Torridge 004D","E01020283",1003,40,13,27,169,114,125,104,216,156,32,19,13,47
"2011","Torridge 004E","E01020284",1431,71,18,53,287,138,132,149,310,201,58,34,24,85
"2011","Torridge 004F","E01020285",1416,31,11,20,166,125,105,146,342,340,80,51,29,81
"2011","Torridge 005A","E01020288",1232,81,24,57,230,148,265,91,191,130,26,17,9,70
"2011","Torridge 005B","E01020292",1054,64,14,50,194,84,287,71,156,122,28,18,10,48
"2011","Torridge 005C","E01020295",1168,116,40,76,242,125,269,66,159,95,22,14,8,74
"2011","Torridge 005D","E01020296",1118,98,28,70,275,104,255,71,148,77,32,21,11,58
"2011","Torridge 006A","E01020304",1220,69,20,49,227,108,167,106,249,160,59,30,29,75
"2011","Torridge 006B","E01020305",792,34,9,25,138,54,131,87,141,130,43,19,24,34
"2011","Torridge 006C","E01020306",891,33,13,20,167,108,97,94,195,125,23,13,10,49
"2011","Torridge 006D","E01020307",1133,45,20,25,161,91,159,89,238,206,65,32,33,79
"2011","Torridge 007A","E01020287",1143,86,19,67,217,103,289,78,175,104,27,14,13,64
"2011","Torridge 007B","E01020303",1199,114,26,88,254,146,257,71,161,104,37,17,20,55
"2011","Torridge 007C","E01020308",1298,127,28,99,297,161,305,95,142,99,24,15,9,48
"2011","Torridge 007D","E01020311",1535,133,33,100,314,146,377,114,221,143,44,25,19,43
"2011","Torridge 008A","E01020291",1196,54,9,45,226,106,363,67,166,113,39,26,13,62
"2011","Torridge 008B","E01020293",1639,82,20,62,300,177,363,106,294,198,52,36,16,67
"2011","Torridge 008C","E01020294",1120,42,10,32,144,128,151,113,254,170,62,39,23,56
"2011","Torridge 008D","E01020302",1283,88,23,65,232,153,324,93,199,112,27,18,9,55
"2011","Torridge 008E","E01020309",1280,99,26,73,271,148,326,68,177,95,35,23,12,61
"2011","Torridge 009A","E01020286",1202,71,18,53,206,109,340,90,187,118,29,20,9,52
"2011","Torridge 009B","E01020289",1189,107,17,90,225,130,326,77,145,89,33,22,11,57
"2011","Torridge 009C","E01020290",1237,96,26,70,224,128,313,108,178,108,31,18,13,51
"2011","Torridge 009D","E01020301",1477,108,19,89,316,148,354,82,198,139,33,19,14,99
"2011","West Devon 001A","E01020320",1272,153,30,123,289,123,319,68,138,82,50,38,12,50
"2011","West Devon 001B","E01020321",1639,98,31,67,294,164,365,117,241,200,83,57,26,77
"2011","West Devon 001C","E01020322",1497,120,32,88,269,149,399,95,212,133,38,28,10,82
"2011","West Devon 001D","E01020326",1483,130,26,104,274,164,264,124,261,153,47,28,19,66
"2011","West Devon 002A","E01020327",1299,93,20,73,253,189,128,115,236,182,43,23,20,60
"2011","West Devon 002B","E01020328",1617,110,26,84,293,196,144,147,326,268,53,27,26,80
"2011","West Devon 002C","E01020329",1159,114,21,93,233,122,179,107,191,128,30,22,8,55
"2011","West Devon 002D","E01020330",1255,74,19,55,202,155,154,115,266,183,55,28,27,51
"2011","West Devon 003A","E01020318",1035,149,39,110,253,107,247,43,114,54,20,13,7,48
"2011","West Devon 003B","E01020319",1226,167,41,126,315,100,305,76,129,63,19,12,7,52
"2011","West Devon 003C","E01020323",1650,107,26,81,282,145,271,150,237,274,109,95,14,75
"2011","West Devon 003D","E01020339",1261,157,33,124,270,114,261,101,143,103,40,33,7,72
"2011","West Devon 004A","E01020314",1167,136,42,94,244,108,313,77,128,77,33,17,16,51
"2011","West Devon 004B","E01020325",1211,134,35,99,292,123,297,69,135,76,20,11,9,65
"2011","West Devon 004C","E01020331",1146,140,31,109,247,119,290,84,116,73,27,15,12,50
"2011","West Devon 004D","E01020340",1252,113,23,90,235,106,274,97,220,120,22,13,9,65
"2011","West Devon 005A","E01020332",1356,167,38,129,339,141,175,97,190,122,50,31,19,75
"2011","West Devon 005B","E01020333",1396,180,51,129,388,192,151,78,193,79,35,21,14,100
"2011","West Devon 005C","E01020334",1393,99,22,77,294,148,156,108,247,170,79,54,25,92
"2011","West Devon 005D","E01020335",1035,128,36,92,252,113,126,71,133,93,48,38,10,71
"2011","West Devon 005E","E01020336",969,176,38,138,295,136,114,39,88,50,9,4,5,62
"2011","West Devon 005F","E01020337",935,64,20,44,180,90,110,71,181,112,27,14,13,100
"2011","West Devon 005G","E01020338",1648,164,54,110,350,221,152,129,318,172,43,20,23,99
"2011","West Devon 006A","E01020317",1059,170,36,134,293,124,181,49,110,52,30,25,5,50
"2011","West Devon 006B","E01020324",1118,146,37,109,293,101,236,63,119,75,18,11,7,67
"2011","West Devon 006C","E01020341",1184,186,44,142,336,151,201,61,97,68,20,12,8,64
"2011","West Devon 006D","E01020342",1113,99,23,76,217,132,144,118,195,120,42,27,15,46
"2011","West Devon 007A","E01020312",1188,138,30,108,295,126,198,94,161,87,27,16,11,62
"2011","West Devon 007B","E01020313",1014,78,21,57,202,100,120,85,200,142,41,29,12,46
"2011","West Devon 007C","E01020315",1036,144,38,106,276,117,154,55,116,73,30,24,6,71
"2011","West Devon 007D","E01020316",1328,310,76,234,369,163,180,50,94,55,25,18,7,82
"2011","Christchurch 001A","E01020343",1123,102,21,81,246,167,160,65,175,117,21,16,5,70
"2011","Christchurch 001B","E01020344",1084,87,27,60,223,169,106,107,189,102,23,13,10,78
"2011","Christchurch 001C","E01020345",882,93,18,75,211,136,124,59,119,73,17,11,6,50
"2011","Christchurch 001D","E01020365",1112,133,31,102,263,170,183,70,145,78,16,14,2,54
"2011","Christchurch 002A","E01020351",928,96,23,73,244,124,143,53,123,74,27,14,13,44
"2011","Christchurch 002B","E01020352",911,89,19,70,230,160,83,63,136,75,13,8,5,62
"2011","Christchurch 002C","E01020353",1118,85,15,70,220,165,127,83,200,127,32,21,11,79
"2011","Christchurch 002D","E01020359",897,86,18,68,220,130,85,75,129,83,20,11,9,69
"2011","Christchurch 002E","E01020366",1436,189,40,149,369,229,224,84,173,75,14,7,7,79
"2011","Christchurch 003A","E01020349",927,95,19,76,233,136,117,54,139,82,28,19,9,43
"2011","Christchurch 003B","E01020350",958,119,26,93,255,201,121,50,135,38,16,8,8,23
"2011","Christchurch 003C","E01020357",1523,148,34,114,366,206,201,111,195,146,49,31,18,101
"2011","Christchurch 003D","E01020358",982,130,25,105,273,174,126,54,112,51,18,12,6,44
"2011","Christchurch 004A","E01020369",856,106,38,68,208,144,96,59,124,67,7,1,6,45
"2011","Christchurch 004B","E01020370",1080,127,23,104,259,175,126,79,175,66,16,5,11,57
"2011","Christchurch 004C","E01020371",1026,135,31,104,234,190,128,75,131,64,28,15,13,41
"2011","Christchurch 004D","E01020372",826,93,21,72,204,140,79,62,140,61,12,3,9,35
"2011","Christchurch 005A","E01020346",1144,67,22,45,177,145,119,108,238,160,48,26,22,82
"2011","Christchurch 005B","E01020347",1178,48,14,34,152,133,109,125,271,200,65,42,23,75
"2011","Christchurch 005C","E01020348",1163,46,10,36,153,108,124,114,264,207,68,44,24,79
"2011","Christchurch 005D","E01020363",888,75,14,61,196,122,100,80,145,94,31,14,17,45
"2011","Christchurch 006A","E01020360",1052,89,27,62,242,165,154,80,163,67,28,13,15,64
"2011","Christchurch 006B","E01020361",1117,105,29,76,270,164,135,79,174,99,32,16,16,59
"2011","Christchurch 006C","E01020364",1148,120,30,90,272,171,123,66,199,98,36,20,16,63
"2011","Christchurch 006D","E01020367",1317,177,46,131,355,193,192,77,135,71,33,20,13,84
"2011","Christchurch 006E","E01020368",1653,163,36,127,383,214,205,124,265,160,48,20,28,91
"2011","Christchurch 007A","E01020354",1053,90,21,69,212,186,116,86,167,124,24,11,13,48
"2011","Christchurch 007B","E01020355",1229,203,59,144,363,198,145,64,128,54,25,15,10,49
"2011","Christchurch 007C","E01020356",1030,146,33,113,284,137,172,59,123,53,20,9,11,36
"2011","Christchurch 007D","E01020362",1004,100,27,73,242,146,149,81,130,85,19,9,10,52
"2011","East Dorset 001A","E01020373",917,98,21,77,223,115,124,67,128,87,20,15,5,55
"2011","East Dorset 001B","E01020374",1086,154,43,111,291,177,142,86,113,71,11,7,4,41
"2011","East Dorset 001C","E01020389",1637,157,45,112,365,178,326,99,207,148,45,38,7,112
"2011","East Dorset 001D","E01020397",1056,142,32,110,225,135,181,56,127,112,22,15,7,56
"2011","East Dorset 002A","E01020416",1087,97,26,71,263,168,119,94,172,104,15,9,6,55
"2011","East Dorset 002B","E01020417",775,98,28,70,186,106,95,64,118,72,9,7,2,27
"2011","East Dorset 002C","E01020418",942,134,28,106,239,176,116,66,98,55,19,8,11,39
"2011","East Dorset 002D","E01020419",1266,154,47,107,340,212,140,93,155,83,17,5,12,72
"2011","East Dorset 002E","E01020420",912,128,39,89,246,150,102,63,97,49,11,6,5,66
"2011","East Dorset 003A","E01020411",753,76,21,55,169,90,89,60,115,93,29,17,12,32
"2011","East Dorset 003B","E01020412",1024,74,27,47,199,111,145,97,162,133,41,26,15,62
"2011","East Dorset 003C","E01020413",1011,181,52,129,289,164,106,54,108,61,13,9,4,35
"2011","East Dorset 003D","E01020414",1318,211,65,146,338,190,141,82,155,100,13,10,3,88
"2011","East Dorset 003E","E01020415",1106,162,40,122,304,174,134,66,112,59,24,14,10,71
"2011","East Dorset 004A","E01020403",1150,171,54,117,312,148,192,43,93,42,55,50,5,94
"2011","East Dorset 004B","E01020404",1116,186,53,133,294,162,144,72,122,64,17,15,2,55
"2011","East Dorset 004C","E01020405",1112,128,41,87,266,158,163,60,168,102,22,11,11,45
"2011","East Dorset 004D","E01020406",1596,280,90,190,419,272,236,79,149,82,23,13,10,56
"2011","East Dorset 005A","E01020396",788,113,41,72,191,94,122,45,101,69,15,8,7,38
"2011","East Dorset 005B","E01020398",1719,285,73,212,477,188,318,89,148,112,23,13,10,79
"2011","East Dorset 005C","E01020409",933,128,39,89,235,135,136,56,106,63,16,9,7,58
"2011","East Dorset 005D","E01020410",946,88,11,77,232,107,151,72,126,92,16,10,6,62
"2011","East Dorset 006A","E01020421",942,115,38,77,254,133,118,43,125,67,35,30,5,52
"2011","East Dorset 006B","E01020422",990,106,34,72,218,161,99,71,175,105,27,16,11,28
"2011","East Dorset 006C","E01020423",1037,122,35,87,284,160,113,56,154,82,15,11,4,51
"2011","East Dorset 006D","E01020424",997,79,19,60,206,164,111,95,161,115,35,23,12,31
"2011","East Dorset 006E","E01020425",1123,109,28,81,243,176,133,88,192,129,19,13,6,34
"2011","East Dorset 007A","E01020377",1189,194,52,142,339,182,142,67,117,70,13,7,6,65
"2011","East Dorset 007B","E01020379",1049,144,41,103,257,148,129,56,145,87,20,14,6,63
"2011","East Dorset 007C","E01020380",790,168,34,134,241,110,92,26,72,28,6,2,4,47
"2011","East Dorset 007D","E01020381",895,172,35,137,248,158,96,26,91,41,8,6,2,55
"2011","East Dorset 008A","E01020390",871,99,32,67,192,152,119,52,136,71,18,15,3,32
"2011","East Dorset 008B","E01020391",976,137,47,90,216,194,129,41,124,66,23,14,9,46
"2011","East Dorset 008C","E01020392",938,90,22,68,198,143,127,61,153,81,49,30,19,36
"2011","East Dorset 008D","E01020393",1116,53,12,41,204,128,87,110,206,173,75,47,28,80
"2011","East Dorset 008E","E01020394",1143,112,29,83,194,166,150,86,199,144,40,30,10,52
"2011","East Dorset 009A","E01020375",981,86,21,65,200,165,117,88,159,95,20,9,11,51
"2011","East Dorset 009B","E01020376",773,62,13,49,188,111,103,50,126,70,13,8,5,50
"2011","East Dorset 009C","E01020378",1124,130,25,105,270,174,126,100,169,81,9,7,2,65
"2011","East Dorset 009D","E01020407",834,70,14,56,213,135,105,61,122,77,12,5,7,39
"2011","East Dorset 009E","E01020408",820,81,21,60,189,104,123,57,138,66,17,16,1,45
"2011","East Dorset 010A","E01020426",1183,179,44,135,356,159,129,57,130,81,23,10,13,69
"2011","East Dorset 010B","E01020427",1098,57,21,36,221,133,118,97,220,156,50,37,13,46
"2011","East Dorset 010C","E01020428",1265,149,36,113,335,158,137,92,190,127,35,22,13,42
"2011","East Dorset 010D","E01020429",1205,145,21,124,297,157,120,87,168,130,39,18,21,62
"2011","East Dorset 011A","E01020395",1143,162,53,109,280,193,175,55,124,56,36,26,10,62
"2011","East Dorset 011B","E01020399",1757,238,66,172,460,291,198,88,226,119,44,27,17,93
"2011","East Dorset 011C","E01020400",1139,130,35,95,261,207,163,67,143,72,23,14,9,73
"2011","East Dorset 011D","E01020401",993,122,37,85,261,166,143,53,104,67,20,12,8,57
"2011","East Dorset 011E","E01020402",1095,155,34,121,307,192,110,62,138,64,14,8,6,53
"2011","East Dorset 012A","E01020382",1144,141,35,106,302,185,110,82,168,72,16,9,7,68
"2011","East Dorset 012B","E01020383",1272,144,42,102,311,226,164,78,167,103,20,13,7,59
"2011","East Dorset 012C","E01020384",1263,119,35,84,277,232,112,105,179,118,22,12,10,99
"2011","East Dorset 012D","E01020385",916,130,35,95,227,131,101,55,116,73,20,13,7,63
"2011","East Dorset 012E","E01020386",870,122,28,94,242,145,92,56,90,55,25,19,6,43
"2011","East Dorset 012F","E01020387",777,121,40,81,208,133,85,36,88,57,11,8,3,38
"2011","East Dorset 012G","E01020388",1089,127,39,88,245,169,131,79,156,98,25,15,10,59
"2011","North Dorset 001A","E01020443",1824,141,48,93,327,186,207,174,326,307,56,31,25,100
"2011","North Dorset 001B","E01020447",1205,66,18,48,203,151,155,116,206,219,41,23,18,48
"2011","North Dorset 001C","E01020463",1151,119,40,79,279,147,155,90,157,105,25,14,11,74
"2011","North Dorset 001D","E01020464",1017,89,20,69,205,126,118,97,157,142,33,22,11,50
"2011","North Dorset 002A","E01020440",1432,174,51,123,354,175,310,72,146,113,29,19,10,59
"2011","North Dorset 002B","E01020450",1656,164,57,107,351,218,239,138,219,205,27,14,13,95
"2011","North Dorset 002D","E01020462",1310,144,37,107,328,141,309,51,141,100,32,20,12,64
"2011","North Dorset 002E","E01033156",1201,105,31,74,266,148,172,116,181,141,17,13,4,55
"2011","North Dorset 002F","E01033158",937,109,32,77,228,115,165,54,118,69,21,12,9,58
"2011","North Dorset 003A","E01020454",1442,90,28,62,278,137,174,114,243,288,48,28,20,70
"2011","North Dorset 003B","E01020455",1317,118,34,84,288,184,150,112,207,176,21,12,9,61
"2011","North Dorset 003C","E01020456",1307,65,22,43,217,144,157,124,244,250,33,14,19,73
"2011","North Dorset 003D","E01020457",1050,134,29,105,297,113,158,56,102,85,21,11,10,84
"2011","North Dorset 004A","E01020433",1324,129,33,96,280,160,255,99,175,130,31,20,11,65
"2011","North Dorset 004B","E01020434",1248,97,22,75,243,140,190,114,218,163,50,40,10,33
"2011","North Dorset 004C","E01020449",1428,167,56,111,320,194,235,84,167,149,48,45,3,64
"2011","North Dorset 004D","E01020458",1530,152,46,106,352,177,270,101,205,170,25,14,11,78
"2011","North Dorset 004E","E01020459",1807,136,44,92,325,200,251,127,290,312,67,48,19,99
"2011","North Dorset 005A","E01020444",1293,120,36,84,299,136,195,75,198,177,30,20,10,63
"2011","North Dorset 005B","E01020445",932,111,34,77,256,90,113,66,84,71,14,11,3,127
"2011","North Dorset 005C","E01020446",1023,131,38,93,245,140,164,53,132,82,26,19,7,50
"2011","North Dorset 005D","E01020460",1763,185,47,138,400,157,343,138,190,193,91,81,10,66
"2011","North Dorset 006A","E01020442",1488,179,54,125,348,182,292,93,161,125,39,22,17,69
"2011","North Dorset 006B","E01020452",1719,138,39,99,331,155,159,121,222,206,37,28,9,350
"2011","North Dorset 006C","E01020453",1263,184,49,135,320,166,172,88,136,111,25,12,13,61
"2011","North Dorset 006E","E01033154",1670,186,120,66,412,616,55,151,101,81,26,17,9,42
"2011","North Dorset 006F","E01033159",784,93,27,66,236,101,79,55,101,67,23,9,14,29
"2011","North Dorset 007A","E01020435",1407,101,19,82,314,204,141,132,234,195,35,27,8,51
"2011","North Dorset 007B","E01020436",1526,143,36,107,392,227,143,112,220,162,42,29,13,85
"2011","North Dorset 007C","E01020437",1357,93,28,65,306,169,117,153,234,197,34,27,7,54
"2011","North Dorset 007D","E01020438",1397,126,24,102,291,148,137,129,252,192,55,34,21,67
"2011","North Dorset 007E","E01020439",1621,146,32,114,379,172,172,113,279,224,52,33,19,84
"2011","North Dorset 008A","E01020430",1072,132,36,96,275,113,130,94,138,125,26,11,15,39
"2011","North Dorset 008B","E01020431",869,103,37,66,211,79,142,40,64,62,14,11,3,154
"2011","North Dorset 008C","E01020432",930,121,46,75,232,104,148,72,104,89,22,14,8,38
"2011","North Dorset 008D","E01020441",1382,155,38,117,338,174,266,80,158,128,26,15,11,57
"2011","North Dorset 008E","E01020448",1458,146,44,102,351,152,329,88,146,154,27,17,10,65
"2011","Purbeck 001A","E01020465",1451,143,34,109,345,188,216,91,188,169,41,18,23,70
"2011","Purbeck 001B","E01020469",1347,151,39,112,303,164,155,121,191,150,35,20,15,77
"2011","Purbeck 001C","E01020470",1353,202,47,155,393,200,176,57,152,68,15,8,7,90
"2011","Purbeck 002A","E01020471",993,52,15,37,178,145,74,99,184,143,41,24,17,77
"2011","Purbeck 002B","E01020472",998,69,22,47,179,134,96,91,190,158,26,17,9,55
"2011","Purbeck 002C","E01020473",1084,89,20,69,232,188,109,81,199,120,15,8,7,51
"2011","Purbeck 002D","E01020474",1234,114,26,88,278,220,154,117,172,99,19,8,11,61
"2011","Purbeck 002E","E01020475",1477,115,41,74,301,225,149,126,259,202,22,11,11,78
"2011","Purbeck 003A","E01020476",910,97,31,66,218,122,120,71,120,98,20,17,3,44
"2011","Purbeck 003B","E01020477",1098,108,28,80,238,156,102,94,155,150,32,15,17,63
"2011","Purbeck 003C","E01020485",1004,71,19,52,212,106,124,102,177,140,34,27,7,38
"2011","Purbeck 003D","E01020486",916,107,23,84,201,132,99,71,132,111,17,8,9,46
"2011","Purbeck 003E","E01020487",965,59,11,48,190,138,94,115,156,120,23,9,14,70
"2011","Purbeck 003F","E01020488",1059,93,30,63,190,140,113,114,181,141,37,23,14,50
"2011","Purbeck 004A","E01020489",1111,117,49,68,271,130,158,74,138,111,66,55,11,46
"2011","Purbeck 004B","E01020490",1209,157,54,103,309,141,226,92,141,86,20,14,6,37
"2011","Purbeck 004C","E01020491",1147,119,33,86,248,167,128,96,165,134,29,15,14,61
"2011","Purbeck 004D","E01020492",812,68,23,45,172,121,86,77,130,84,31,23,8,43
"2011","Purbeck 004E","E01020493",1830,148,96,52,482,337,92,196,242,189,45,18,27,99
"2011","Purbeck 005A","E01020466",1293,158,45,113,302,145,223,121,165,97,33,20,13,49
"2011","Purbeck 005B","E01020467",1279,173,54,119,320,152,220,101,137,108,23,10,13,45
"2011","Purbeck 005C","E01020468",1051,108,27,81,283,132,206,65,126,76,19,15,4,36
"2011","Purbeck 006A","E01020478",753,50,13,37,167,96,150,59,118,68,12,8,4,33
"2011","Purbeck 006B","E01020479",741,80,21,59,159,91,115,66,116,64,20,13,7,30
"2011","Purbeck 006C","E01020480",1038,115,30,85,254,148,173,77,150,69,16,14,2,36
"2011","Purbeck 006D","E01020481",1107,130,34,96,294,129,179,73,148,72,27,11,16,55
"2011","Purbeck 006E","E01020482",1178,87,22,65,243,105,200,113,218,126,32,20,12,54
"2011","Purbeck 006F","E01020483",933,47,12,35,168,95,120,86,180,134,26,14,12,77
"2011","Purbeck 006G","E01020484",1008,61,15,46,207,111,117,106,199,120,34,22,12,53
"2011","West Dorset 001A","E01020542",922,154,44,110,228,111,100,50,123,74,36,29,7,46
"2011","West Dorset 001B","E01020543",964,49,14,35,160,93,99,89,207,175,41,27,14,51
"2011","West Dorset 001C","E01020544",997,151,34,117,276,93,117,52,103,66,27,13,14,112
"2011","West Dorset 001E","E01020546",1120,78,27,51,207,68,87,42,98,82,23,12,11,435
"2011","West Dorset 001F","E01020547",826,49,12,37,141,76,81,101,166,147,23,11,12,42
"2011","West Dorset 001H","E01032642",1451,186,50,136,389,185,166,95,193,132,22,13,9,83
"2011","West Dorset 002A","E01020497",1347,145,39,106,318,174,199,112,193,115,21,16,5,70
"2011","West Dorset 002B","E01020508",1452,191,49,142,344,163,295,69,148,101,26,20,6,115
"2011","West Dorset 002C","E01020541",1444,178,46,132,368,144,280,93,167,124,31,21,10,59
"2011","West Dorset 002D","E01020550",1128,169,43,126,291,122,165,79,133,78,31,19,12,60
"2011","West Dorset 003A","E01020494",799,74,26,48,200,82,167,58,103,56,13,4,9,46
"2011","West Dorset 003B","E01020495",945,93,25,68,226,123,147,71,142,81,23,13,10,39
"2011","West Dorset 003C","E01020496",1070,85,25,60,210,120,162,82,181,140,49,35,14,41
"2011","West Dorset 003D","E01020506",1273,141,37,104,284,135,286,85,141,107,39,26,13,55
"2011","West Dorset 003E","E01020530",1374,165,40,125,319,152,306,98,157,83,32,19,13,62
"2011","West Dorset 003F","E01020534",1534,181,45,136,378,179,285,109,189,124,33,14,19,56
"2011","West Dorset 004A","E01020509",1958,318,76,242,566,216,286,94,205,109,36,24,12,128
"2011","West Dorset 004B","E01020510",1383,189,55,134,340,181,145,108,167,145,36,31,5,72
"2011","West Dorset 004C","E01020529",1646,231,64,167,476,195,288,92,167,107,23,14,9,67
"2011","West Dorset 004D","E01020539",1483,203,49,154,369,145,309,91,167,106,26,19,7,67
"2011","West Dorset 004E","E01020540",1763,224,58,166,452,199,289,115,221,154,28,18,10,81
"2011","West Dorset 005A","E01020511",1135,117,32,85,276,116,257,50,159,88,22,12,10,50
"2011","West Dorset 005B","E01020532",1140,153,47,106,340,110,239,51,128,62,19,12,7,38
"2011","West Dorset 005C","E01020533",1390,96,22,74,317,108,246,124,232,155,34,19,15,78
"2011","West Dorset 005D","E01020535",1265,165,41,124,298,103,364,54,135,75,24,15,9,47
"2011","West Dorset 006A","E01020498",1406,114,41,73,299,185,206,116,219,146,45,31,14,76
"2011","West Dorset 006B","E01020499",985,42,16,26,152,90,126,108,197,186,36,26,10,48
"2011","West Dorset 006C","E01020500",1152,98,25,73,240,111,167,106,198,135,40,25,15,57
"2011","West Dorset 006D","E01020501",975,75,17,58,228,131,136,77,170,90,29,21,8,39
"2011","West Dorset 007A","E01020507",1362,148,46,102,400,143,290,76,157,78,21,14,7,49
"2011","West Dorset 007B","E01020517",1298,136,29,107,276,148,295,76,181,112,19,13,6,55
"2011","West Dorset 007C","E01020531",1238,161,40,121,319,126,226,70,170,84,22,16,6,60
"2011","West Dorset 007D","E01020536",1499,133,40,93,309,163,325,108,223,142,31,19,12,65
"2011","West Dorset 008A","E01020502",1188,62,14,48,201,135,152,99,264,173,42,26,16,60
"2011","West Dorset 008B","E01020503",1219,86,22,64,296,100,189,101,207,130,59,46,13,51
"2011","West Dorset 008C","E01020504",1595,152,41,111,382,224,286,113,230,123,29,19,10,56
"2011","West Dorset 009C","E01020526",942,111,27,84,229,111,82,76,147,102,27,19,8,57
"2011","West Dorset 009D","E01020527",1078,92,13,79,248,117,92,94,162,150,42,26,16,81
"2011","West Dorset 009E","E01020528",1384,157,35,122,332,174,116,112,199,176,50,30,20,68
"2011","West Dorset 009F","E01032641",1148,156,39,117,332,129,92,67,159,95,33,19,14,85
"2011","West Dorset 009G","E01032643",1310,148,28,120,340,180,92,114,168,137,57,46,11,74
"2011","West Dorset 009H","E01032644",673,69,12,57,179,74,62,47,105,83,29,16,13,25
"2011","West Dorset 009I","E01032645",703,86,15,71,174,69,54,55,89,84,45,40,5,47
"2011","West Dorset 010A","E01020518",1095,91,17,74,230,131,127,88,181,158,35,21,14,54
"2011","West Dorset 010B","E01020519",1223,131,30,101,337,179,107,84,171,103,41,32,9,70
"2011","West Dorset 010C","E01020520",1034,101,26,75,280,159,73,78,161,120,20,11,9,42
"2011","West Dorset 010D","E01020523",949,107,17,90,257,136,89,65,124,76,24,18,6,71
"2011","West Dorset 010E","E01020524",1047,89,27,62,241,188,81,91,174,111,24,16,8,48
"2011","West Dorset 010F","E01020525",902,156,31,125,269,141,66,48,95,54,13,8,5,60
"2011","West Dorset 011A","E01020505",1364,207,47,160,379,198,159,79,148,101,22,15,7,71
"2011","West Dorset 011B","E01020537",1457,171,54,117,443,155,236,93,170,119,24,17,7,46
"2011","West Dorset 011C","E01020538",1356,151,42,109,287,182,154,121,237,129,40,22,18,55
"2011","West Dorset 011D","E01020549",1516,158,43,115,360,210,228,112,227,110,42,25,17,69
"2011","West Dorset 012A","E01020512",1535,172,50,122,420,185,270,110,177,103,27,18,9,71
"2011","West Dorset 012B","E01020513",1051,71,21,50,214,150,122,98,191,130,30,19,11,45
"2011","West Dorset 012C","E01020514",930,88,20,68,224,134,127,75,128,95,19,11,8,40
"2011","West Dorset 012D","E01020515",841,59,10,49,181,115,109,73,148,89,19,14,5,48
"2011","West Dorset 012E","E01020516",1095,79,20,59,223,178,99,124,191,133,28,15,13,40
"2011","Weymouth and Portland 001A","E01020551",1401,68,13,55,322,181,112,148,251,188,45,23,22,86
"2011","Weymouth and Portland 001B","E01020552",1281,29,6,23,158,133,86,141,280,258,104,56,48,92
"2011","Weymouth and Portland 001C","E01020570",1182,130,33,97,337,158,153,82,133,97,36,29,7,56
"2011","Weymouth and Portland 001D","E01020571",1514,98,21,77,335,214,117,137,271,193,65,38,27,84
"2011","Weymouth and Portland 002A","E01020557",1044,149,37,112,293,155,127,73,141,50,21,10,11,35
"2011","Weymouth and Portland 002B","E01020558",1243,181,39,142,362,172,160,76,132,84,23,13,10,53
"2011","Weymouth and Portland 002C","E01020559",1129,180,43,137,317,177,127,72,135,75,10,8,2,36
"2011","Weymouth and Portland 002D","E01020560",1449,155,35,120,383,252,139,101,193,120,23,18,5,83
"2011","Weymouth and Portland 002E","E01020561",1228,95,23,72,271,159,126,125,215,126,35,15,20,76
"2011","Weymouth and Portland 003A","E01020574",1377,92,26,66,299,182,125,133,231,174,56,38,18,85
"2011","Weymouth and Portland 003B","E01020575",1182,39,7,32,156,113,110,106,267,234,79,53,26,78
"2011","Weymouth and Portland 003C","E01020576",1236,112,27,85,268,207,137,108,209,116,31,19,12,48
"2011","Weymouth and Portland 003D","E01020579",1389,152,35,117,369,203,190,81,164,98,43,34,9,89
"2011","Weymouth and Portland 003E","E01020580",1044,127,29,98,280,157,114,77,119,80,18,12,6,72
"2011","Weymouth and Portland 004A","E01020553",1010,65,14,51,192,101,119,95,185,122,61,49,12,70
"2011","Weymouth and Portland 004B","E01020554",1429,73,18,55,273,115,191,136,277,229,80,38,42,55
"2011","Weymouth and Portland 004C","E01020555",1086,64,9,55,181,79,108,110,236,180,79,48,31,49
"2011","Weymouth and Portland 004D","E01020556",1094,95,18,77,224,115,143,87,168,109,91,69,22,62
"2011","Weymouth and Portland 004E","E01020581",1531,163,45,118,357,189,220,106,212,124,72,58,14,88
"2011","Weymouth and Portland 004F","E01020582",1136,60,7,53,195,143,119,89,230,169,80,57,23,51
"2011","Weymouth and Portland 005A","E01020572",1493,84,14,70,303,203,156,140,262,208,58,41,17,79
"2011","Weymouth and Portland 005B","E01020573",1350,80,18,62,214,176,148,125,268,173,85,60,25,81
"2011","Weymouth and Portland 005C","E01020577",1153,78,23,55,227,150,110,131,201,139,36,25,11,81
"2011","Weymouth and Portland 005D","E01020578",1447,66,19,47,258,175,159,164,270,223,50,30,20,82
"2011","Weymouth and Portland 006A","E01020583",1417,179,46,133,345,182,143,97,202,149,41,27,14,79
"2011","Weymouth and Portland 006B","E01020584",1275,110,19,91,289,183,142,108,157,157,45,28,17,84
"2011","Weymouth and Portland 006C","E01020585",1082,70,25,45,191,145,106,100,214,133,40,23,17,83
"2011","Weymouth and Portland 007A","E01020586",942,72,28,44,212,127,91,83,155,100,34,16,18,68
"2011","Weymouth and Portland 007B","E01020587",1015,73,27,46,225,161,84,101,183,111,29,19,10,48
"2011","Weymouth and Portland 007C","E01020588",969,90,20,70,243,121,128,91,146,85,14,8,6,51
"2011","Weymouth and Portland 007D","E01020589",1083,66,16,50,223,155,128,89,179,141,37,22,15,65
"2011","Weymouth and Portland 008A","E01020563",1310,70,26,44,232,150,103,108,178,204,204,195,9,61
"2011","Weymouth and Portland 008D","E01020569",1012,24,9,15,140,91,95,102,218,212,76,48,28,54
"2011","Weymouth and Portland 008E","E01033200",2068,120,24,96,338,207,265,196,338,358,137,94,43,109
"2011","Weymouth and Portland 009A","E01020562",1456,99,35,64,324,218,147,147,251,176,28,14,14,66
"2011","Weymouth and Portland 009B","E01020564",1154,49,18,31,192,144,83,132,259,174,64,36,28,57
"2011","Weymouth and Portland 009C","E01020565",1082,48,18,30,205,177,87,125,198,152,42,17,25,48
"2011","Weymouth and Portland 009D","E01020566",1578,114,41,73,356,252,165,161,259,183,27,21,6,61
"2011","Cheltenham 001A","E01022163",1186,89,12,77,205,180,96,97,228,172,40,24,16,79
"2011","Cheltenham 001B","E01022164",1053,41,13,28,127,109,72,103,218,203,68,45,23,112
"2011","Cheltenham 001C","E01022165",1154,118,25,93,293,192,113,87,173,105,25,18,7,48
"2011","Cheltenham 001D","E01022166",1023,93,19,74,220,173,90,85,168,102,25,13,12,67
"2011","Cheltenham 002A","E01022143",1069,203,52,151,327,180,101,43,92,53,13,4,9,57
"2011","Cheltenham 002B","E01022144",785,95,27,68,208,125,62,42,116,67,19,13,6,51
"2011","Cheltenham 002C","E01022145",864,96,18,78,252,145,101,51,101,53,15,8,7,50
"2011","Cheltenham 002D","E01022146",939,178,34,144,304,143,93,32,90,33,10,5,5,56
"2011","Cheltenham 003A","E01022122",905,24,7,17,140,94,62,76,202,160,87,60,27,60
"2011","Cheltenham 003B","E01022160",1481,111,24,87,281,179,114,112,278,226,87,57,30,93
"2011","Cheltenham 003C","E01022161",1082,62,18,44,216,153,87,99,223,154,35,16,19,53
"2011","Cheltenham 003D","E01022162",1156,59,18,41,213,200,105,99,248,139,37,28,9,56
"2011","Cheltenham 004A","E01022139",982,133,22,111,239,131,89,29,72,41,13,5,8,235
"2011","Cheltenham 004B","E01022151",1509,74,21,53,171,107,67,75,196,137,53,39,14,629
"2011","Cheltenham 004C","E01022152",888,31,1,30,85,50,54,46,167,124,73,56,17,258
"2011","Cheltenham 004D","E01022153",1422,102,19,83,236,115,70,73,175,116,71,49,22,464
"2011","Cheltenham 004E","E01022154",1681,111,11,100,193,125,65,87,171,116,58,35,23,755
"2011","Cheltenham 005A","E01022120",1090,42,10,32,151,139,70,99,241,184,101,47,54,63
"2011","Cheltenham 005B","E01022121",1214,65,14,51,160,145,72,90,296,194,92,54,38,100
"2011","Cheltenham 005C","E01022147",1193,53,12,41,180,119,92,111,259,187,117,55,62,75
"2011","Cheltenham 005D","E01022157",1107,63,14,49,164,130,93,86,244,166,96,54,42,65
"2011","Cheltenham 005E","E01022159",1047,46,14,32,152,105,84,88,275,179,53,25,28,65
"2011","Cheltenham 006A","E01022131",889,50,8,42,135,85,75,73,186,182,49,31,18,54
"2011","Cheltenham 006B","E01022132",1009,48,12,36,138,121,96,79,207,196,61,43,18,63
"2011","Cheltenham 006C","E01022133",1043,45,6,39,134,97,79,80,223,195,102,63,39,88
"2011","Cheltenham 006D","E01022134",1172,114,21,93,226,134,104,86,201,165,69,35,34,73
"2011","Cheltenham 007A","E01022148",1121,111,28,83,260,146,113,85,173,127,41,32,9,65
"2011","Cheltenham 007B","E01022149",1039,64,10,54,180,107,112,91,197,151,53,33,20,84
"2011","Cheltenham 007C","E01022150",1146,109,17,92,276,138,87,79,186,109,55,32,23,107
"2011","Cheltenham 007D","E01022155",1132,89,20,69,173,136,97,81,209,141,32,23,9,174
"2011","Cheltenham 007E","E01022156",1204,123,28,95,249,145,117,81,166,125,58,35,23,140
"2011","Cheltenham 007F","E01022158",1916,225,29,196,403,256,119,124,236,160,52,33,19,341
"2011","Cheltenham 008A","E01022100",1370,268,57,211,410,163,122,52,113,68,30,18,12,144
"2011","Cheltenham 008B","E01022101",1421,245,44,201,432,194,104,60,121,86,34,17,17,145
"2011","Cheltenham 008C","E01022102",1592,189,20,169,380,186,151,123,213,125,65,23,42,160
"2011","Cheltenham 008D","E01022140",846,142,23,119,247,133,70,41,81,53,20,10,10,59
"2011","Cheltenham 008E","E01022141",1168,230,46,184,377,183,115,40,84,53,20,12,8,66
"2011","Cheltenham 008F","E01022142",1242,165,39,126,327,153,117,75,131,85,40,28,12,149
"2011","Cheltenham 009A","E01022116",1091,163,36,127,278,109,57,47,84,43,26,14,12,284
"2011","Cheltenham 009B","E01022117",1437,245,46,199,409,159,144,88,128,83,40,19,21,141
"2011","Cheltenham 009C","E01022119",997,179,40,139,314,126,81,43,94,45,23,12,11,92
"2011","Cheltenham 009D","E01022124",970,178,24,154,283,149,72,39,102,47,53,28,25,47
"2011","Cheltenham 009E","E01022125",917,210,46,164,272,118,95,31,66,26,36,26,10,63
"2011","Cheltenham 009F","E01022126",1256,229,51,178,439,168,98,41,105,61,34,16,18,81
"2011","Cheltenham 009G","E01022127",1483,157,29,128,306,122,77,58,115,79,37,25,12,532
"2011","Cheltenham 010A","E01022106",1284,145,29,116,354,267,84,103,150,81,20,12,8,80
"2011","Cheltenham 010B","E01022107",1120,171,40,131,308,208,89,62,137,59,20,8,12,66
"2011","Cheltenham 010C","E01022108",1346,162,44,118,349,228,124,81,170,118,24,13,11,90
"2011","Cheltenham 010D","E01022123",1724,238,51,187,438,337,127,99,210,123,52,29,23,100
"2011","Cheltenham 011A","E01022135",1145,255,71,184,319,134,90,25,60,27,30,24,6,205
"2011","Cheltenham 011B","E01022136",1092,219,43,176,313,123,96,42,86,30,28,17,11,155
"2011","Cheltenham 011C","E01022137",1338,298,59,239,406,149,148,49,83,52,22,17,5,131
"2011","Cheltenham 011D","E01022138",1361,299,58,241,393,147,104,34,74,25,23,15,8,262
"2011","Cheltenham 011E","E01022174",959,112,18,94,264,178,106,50,98,60,16,8,8,75
"2011","Cheltenham 012A","E01022103",1764,311,72,239,570,248,153,76,166,90,33,21,12,117
"2011","Cheltenham 012B","E01022104",1179,154,43,111,361,184,98,69,113,78,29,21,8,93
"2011","Cheltenham 012C","E01022105",985,189,48,141,339,129,125,32,72,33,6,3,3,60
"2011","Cheltenham 012D","E01022109",1005,162,27,135,300,165,110,47,101,37,11,6,5,72
"2011","Cheltenham 012E","E01022110",923,136,35,101,237,132,107,36,115,73,20,8,12,67
"2011","Cheltenham 012F","E01022111",942,162,40,122,323,122,105,28,79,40,17,8,9,66
"2011","Cheltenham 012G","E01022112",887,140,31,109,270,108,96,44,95,46,21,10,11,67
"2011","Cheltenham 013A","E01022167",868,124,22,102,252,182,76,39,101,43,9,2,7,42
"2011","Cheltenham 013B","E01022168",782,87,18,69,220,127,68,60,108,55,18,12,6,39
"2011","Cheltenham 013C","E01022169",1077,96,29,67,262,211,83,83,148,93,26,13,13,75
"2011","Cheltenham 013D","E01022170",1070,133,24,109,317,207,75,63,107,65,23,13,10,80
"2011","Cheltenham 013E","E01022171",1030,188,27,161,329,177,66,51,94,36,5,2,3,84
"2011","Cheltenham 013F","E01022172",972,105,25,80,249,163,94,69,153,79,12,8,4,48
"2011","Cheltenham 013G","E01022173",962,97,20,77,197,151,91,74,161,84,52,33,19,55
"2011","Cheltenham 014A","E01022113",1094,258,51,207,344,170,103,23,69,40,17,10,7,70
"2011","Cheltenham 014B","E01022114",1034,192,54,138,315,151,124,45,90,41,11,4,7,65
"2011","Cheltenham 014C","E01022115",1230,249,50,199,411,170,121,39,79,59,33,20,13,69
"2011","Cheltenham 014D","E01022118",983,198,36,162,316,107,89,32,91,42,14,8,6,94
"2011","Cheltenham 015A","E01022128",1108,264,48,216,353,156,114,37,82,26,6,1,5,70
"2011","Cheltenham 015B","E01022129",1412,266,55,211,421,175,141,63,143,55,56,47,9,92
"2011","Cheltenham 015C","E01022130",1123,210,46,164,379,172,112,31,108,38,15,8,7,58
"2011","Cotswold 001A","E01022179",1464,224,67,157,394,147,253,77,153,118,32,19,13,66
"2011","Cotswold 001B","E01022182",1065,138,45,93,250,122,205,71,112,94,23,15,8,50
"2011","Cotswold 001C","E01022183",1022,148,44,104,230,93,210,66,126,72,29,17,12,48
"2011","Cotswold 001D","E01022184",1057,148,54,94,275,97,223,73,107,68,17,10,7,49
"2011","Cotswold 001E","E01022185",977,118,31,87,255,124,153,61,120,81,18,8,10,47
"2011","Cotswold 002A","E01022177",1414,129,32,97,301,137,277,100,207,164,28,18,10,71
"2011","Cotswold 002B","E01022178",964,149,47,102,236,98,198,51,95,71,23,17,6,43
"2011","Cotswold 002C","E01022205",1314,185,50,135,322,123,258,80,167,99,25,16,9,55
"2011","Cotswold 002D","E01022211",1244,133,37,96,268,135,159,93,200,167,37,25,12,52
"2011","Cotswold 002E","E01022212",1191,112,31,81,267,140,144,108,199,139,24,17,7,58
"2011","Cotswold 003A","E01022180",1479,100,35,65,316,176,187,133,246,200,42,23,19,79
"2011","Cotswold 003B","E01022181",1095,146,48,98,292,130,233,77,94,58,17,10,7,48
"2011","Cotswold 003C","E01022214",1538,198,57,141,404,153,273,104,172,113,23,17,6,98
"2011","Cotswold 003D","E01022222",1459,219,73,146,374,126,328,82,156,89,26,10,16,59
"2011","Cotswold 004A","E01022186",1244,222,56,166,332,121,219,77,108,91,19,11,8,55
"2011","Cotswold 004B","E01022187",1441,231,65,166,339,122,235,69,124,79,23,12,11,219
"2011","Cotswold 004C","E01022201",1341,240,69,171,375,116,231,67,128,76,21,17,4,87
"2011","Cotswold 004D","E01022216",1382,223,51,172,391,157,263,56,122,78,28,16,12,64
"2011","Cotswold 005A","E01022175",1423,205,48,157,352,153,268,90,150,97,36,25,11,72
"2011","Cotswold 005B","E01022207",1319,253,66,187,333,132,185,82,138,105,28,20,8,63
"2011","Cotswold 005C","E01022213",1305,200,45,155,321,149,187,98,144,117,31,20,11,58
"2011","Cotswold 005D","E01022215",1337,219,53,166,351,124,310,62,119,77,24,16,8,51
"2011","Cotswold 006A","E01022188",981,91,25,66,165,115,83,84,209,120,42,22,20,72
"2011","Cotswold 006B","E01022189",989,130,34,96,237,132,77,80,145,101,8,4,4,79
"2011","Cotswold 006C","E01022190",1049,62,21,41,172,121,96,110,212,139,36,16,20,101
"2011","Cotswold 006D","E01022196",1214,180,43,137,310,160,154,55,162,87,24,12,12,82
"2011","Cotswold 006E","E01022197",1380,165,43,122,358,197,148,101,201,106,13,7,6,91
"2011","Cotswold 007A","E01022194",1104,140,31,109,289,115,108,65,153,81,40,26,14,113
"2011","Cotswold 007B","E01022195",1198,121,34,87,236,93,111,62,108,64,19,16,3,384
"2011","Cotswold 007C","E01022199",1326,166,43,123,322,136,148,69,181,110,62,34,28,132
"2011","Cotswold 007D","E01022200",866,74,14,60,153,95,63,80,166,149,46,21,25,40
"2011","Cotswold 008A","E01022191",1052,107,19,88,248,159,76,67,180,94,28,15,13,93
"2011","Cotswold 008B","E01022192",978,54,12,42,123,84,78,82,205,160,48,38,10,144
"2011","Cotswold 008C","E01022193",777,117,32,85,214,112,63,39,93,40,9,5,4,90
"2011","Cotswold 008D","E01022198",993,102,28,74,193,111,73,90,195,124,21,8,13,84
"2011","Cotswold 008E","E01022225",1274,126,56,70,313,189,98,103,183,146,40,23,17,76
"2011","Cotswold 009A","E01022202",793,135,33,102,224,79,122,42,86,59,10,7,3,36
"2011","Cotswold 009B","E01022203",943,130,32,98,212,118,150,57,122,87,22,14,8,45
"2011","Cotswold 009C","E01022204",1059,99,28,71,227,132,105,107,151,148,24,16,8,66
"2011","Cotswold 009D","E01022208",1109,220,60,160,318,167,128,52,88,52,12,7,5,72
"2011","Cotswold 009E","E01022209",857,123,36,87,227,107,112,46,99,69,12,5,7,62
"2011","Cotswold 009F","E01022210",918,92,26,66,179,97,134,80,153,122,22,12,10,39
"2011","Cotswold 010A","E01022221",1389,250,74,176,380,142,189,69,153,93,22,16,6,91
"2011","Cotswold 010B","E01022223",1756,252,60,192,451,193,215,128,233,153,35,17,18,96
"2011","Cotswold 010C","E01022224",1181,196,53,143,287,162,178,55,131,76,21,16,5,75
"2011","Cotswold 011A","E01022176",1471,220,60,160,388,144,227,82,157,116,55,44,11,82
"2011","Cotswold 011B","E01022206",1440,230,71,159,368,140,267,84,141,105,39,27,12,66
"2011","Cotswold 011C","E01022217",955,117,20,97,224,124,102,72,155,90,26,17,9,45
"2011","Cotswold 011D","E01022218",925,65,18,47,159,65,101,86,206,148,37,23,14,58
"2011","Cotswold 011E","E01022219",894,153,49,104,226,112,108,48,104,80,13,7,6,50
"2011","Cotswold 011F","E01022220",1129,180,40,140,309,126,166,79,138,75,20,12,8,36
"2011","Forest of Dean 001A","E01022233",1421,183,47,136,339,163,274,88,149,107,41,30,11,77
"2011","Forest of Dean 001B","E01022235",1287,153,41,112,276,187,220,99,146,87,49,41,8,70
"2011","Forest of Dean 001C","E01022247",2089,168,49,119,318,158,207,69,121,80,13,9,4,955
"2011","Forest of Dean 001D","E01022270",1368,184,58,126,317,166,266,73,116,104,54,44,10,88
"2011","Forest of Dean 001E","E01022271",1258,187,37,150,338,138,236,65,122,70,28,17,11,74
"2011","Forest of Dean 002A","E01022261",1349,104,23,81,272,140,147,115,261,183,48,29,19,79
"2011","Forest of Dean 002B","E01022262",1370,108,16,92,281,131,148,130,256,192,51,31,20,73
"2011","Forest of Dean 002C","E01022267",1194,139,40,99,293,124,218,62,152,93,46,35,11,67
"2011","Forest of Dean 003A","E01022251",1028,61,14,47,156,112,140,89,200,167,44,24,20,59
"2011","Forest of Dean 003B","E01022252",1293,146,48,98,276,161,169,104,180,164,32,20,12,61
"2011","Forest of Dean 003C","E01022258",769,34,7,27,143,102,80,60,150,131,29,17,12,40
"2011","Forest of Dean 003D","E01022259",1238,112,28,84,252,198,140,102,192,138,25,13,12,79
"2011","Forest of Dean 003E","E01022260",1331,75,21,54,238,171,164,113,226,195,66,40,26,83
"2011","Forest of Dean 004A","E01022236",1544,79,23,56,224,188,174,147,309,253,75,40,35,95
"2011","Forest of Dean 004B","E01022237",1073,39,16,23,142,113,110,83,224,211,82,64,18,69
"2011","Forest of Dean 004C","E01022238",873,29,8,21,90,80,73,97,224,180,57,32,25,43
"2011","Forest of Dean 004D","E01022239",1209,62,14,48,204,133,148,114,228,202,52,31,21,66
"2011","Forest of Dean 004E","E01022240",1548,57,14,43,210,185,150,172,340,247,102,51,51,85
"2011","Forest of Dean 004F","E01022249",1490,145,36,109,314,200,195,108,235,168,63,41,22,62
"2011","Forest of Dean 004G","E01022250",1325,100,34,66,212,179,122,120,256,215,66,37,29,55
"2011","Forest of Dean 005A","E01022228",1283,126,37,89,297,142,223,69,174,112,75,60,15,65
"2011","Forest of Dean 005B","E01022230",1246,140,35,105,314,149,220,84,137,82,45,35,10,75
"2011","Forest of Dean 005C","E01022265",1248,144,36,108,303,134,190,69,130,103,106,93,13,69
"2011","Forest of Dean 005D","E01022266",1013,107,33,74,217,137,181,58,142,68,47,37,10,56
"2011","Forest of Dean 006A","E01022234",1146,144,46,98,280,125,183,90,135,94,33,24,9,62
"2011","Forest of Dean 006B","E01022253",1252,132,37,95,282,167,165,98,177,128,46,29,17,57
"2011","Forest of Dean 006C","E01022263",1398,197,50,147,352,153,227,68,160,114,48,32,16,79
"2011","Forest of Dean 007A","E01022229",1176,69,28,41,196,119,136,104,258,185,51,32,19,58
"2011","Forest of Dean 007B","E01022241",1134,81,26,55,202,140,127,99,210,151,60,41,19,64
"2011","Forest of Dean 007C","E01022242",1043,84,21,63,177,108,121,114,178,150,51,34,17,60
"2011","Forest of Dean 007D","E01022243",888,52,11,41,138,102,79,81,168,157,46,24,22,65
"2011","Forest of Dean 007E","E01022244",1073,71,21,50,143,122,126,120,218,165,50,33,17,58
"2011","Forest of Dean 007F","E01022245",997,56,18,38,161,99,71,116,207,191,41,27,14,55
"2011","Forest of Dean 007G","E01022246",948,71,16,55,208,151,122,88,149,105,16,9,7,38
"2011","Forest of Dean 008A","E01022231",1187,87,25,62,202,141,164,100,216,180,43,37,6,54
"2011","Forest of Dean 008B","E01022232",1111,84,26,58,195,124,168,109,206,141,35,13,22,49
"2011","Forest of Dean 008C","E01022264",1133,79,15,64,201,125,177,77,197,186,28,14,14,63
"2011","Forest of Dean 008D","E01022268",1179,98,31,67,233,140,146,98,179,183,49,26,23,53
"2011","Forest of Dean 008E","E01022269",1454,140,40,100,298,196,213,109,195,168,46,36,10,89
"2011","Forest of Dean 009A","E01022226",1087,89,23,66,248,131,87,103,196,136,41,22,19,56
"2011","Forest of Dean 009B","E01022227",1149,120,31,89,245,143,168,76,170,129,33,23,10,65
"2011","Forest of Dean 009C","E01022254",1344,54,15,39,167,136,107,128,308,282,83,58,25,79
"2011","Forest of Dean 009D","E01022255",1158,111,40,71,222,173,110,100,194,127,42,23,19,79
"2011","Forest of Dean 009E","E01022256",1097,53,16,37,168,118,118,87,234,186,74,48,26,59
"2011","Forest of Dean 009F","E01022257",1377,107,39,68,266,209,148,120,255,169,37,16,21,66
"2011","Forest of Dean 010A","E01022248",1279,189,42,147,339,160,218,60,120,77,42,26,16,74
"2011","Forest of Dean 010B","E01022272",925,67,22,45,149,106,89,99,200,127,38,19,19,50
"2011","Forest of Dean 010C","E01022273",953,75,34,41,281,220,48,55,124,76,34,22,12,40
"2011","Forest of Dean 010D","E01022274",905,187,38,149,256,93,136,44,76,45,16,12,4,52
"2011","Forest of Dean 010E","E01022275",1101,175,41,134,296,137,120,81,129,75,25,20,5,63
"2011","Gloucester 001A","E01022313",1259,139,38,101,316,252,84,94,185,93,29,18,11,67
"2011","Gloucester 001B","E01022315",1092,110,25,85,263,201,86,96,155,90,20,18,2,71
"2011","Gloucester 001C","E01022316",1186,141,31,110,303,228,76,93,165,77,23,10,13,80
"2011","Gloucester 001D","E01022317",1132,149,34,115,292,221,80,70,137,75,17,11,6,91
"2011","Gloucester 001E","E01022318",1308,139,35,104,286,202,98,70,163,82,18,13,5,250
"2011","Gloucester 002A","E01022309",1151,101,18,83,272,151,72,83,182,103,69,59,10,118
"2011","Gloucester 002B","E01022310",1311,86,12,74,266,150,103,88,222,159,62,38,24,175
"2011","Gloucester 002C","E01022311",1366,97,18,79,245,136,77,93,291,218,108,66,42,101
"2011","Gloucester 002D","E01022312",1766,177,32,145,414,191,107,111,257,131,107,88,19,271
"2011","Gloucester 002E","E01022314",1034,121,32,89,259,191,97,71,132,80,28,12,16,55
"2011","Gloucester 003A","E01022295",989,87,16,71,193,197,77,83,178,101,23,14,9,50
"2011","Gloucester 003B","E01022296",1028,76,15,61,191,143,94,92,183,129,46,27,19,74
"2011","Gloucester 003C","E01022297",930,134,35,99,265,155,75,44,112,40,17,13,4,88
"2011","Gloucester 003D","E01022298",1172,123,21,102,301,168,93,86,165,85,55,45,10,96
"2011","Gloucester 004A","E01022332",1263,58,12,46,208,149,66,116,229,211,102,72,30,124
"2011","Gloucester 004B","E01022347",1471,119,24,95,244,147,83,111,227,234,168,129,39,138
"2011","Gloucester 004C","E01022348",1954,263,65,198,521,297,128,113,234,160,75,50,25,163
"2011","Gloucester 004E","E01032932",898,58,9,49,176,98,59,69,165,137,74,58,16,62
"2011","Gloucester 004F","E01032937",963,52,13,39,143,90,54,76,157,130,74,50,24,187
"2011","Gloucester 005A","E01022288",1206,66,11,55,201,127,62,90,283,201,95,71,24,81
"2011","Gloucester 005B","E01022289",1112,38,9,29,150,102,71,83,223,194,154,120,34,97
"2011","Gloucester 005C","E01022290",935,38,6,32,132,81,73,67,226,165,77,58,19,76
"2011","Gloucester 005D","E01022291",1221,43,11,32,146,108,82,87,255,198,192,150,42,110
"2011","Gloucester 005E","E01022292",1025,37,9,28,148,91,81,66,214,130,155,115,40,103
"2011","Gloucester 006A","E01022283",1098,157,35,122,319,227,73,61,121,58,16,10,6,66
"2011","Gloucester 006B","E01022303",999,74,19,55,237,169,86,81,151,110,41,23,18,50
"2011","Gloucester 006C","E01022304",1103,96,20,76,281,202,113,84,157,100,24,14,10,46
"2011","Gloucester 006D","E01022305",1007,99,20,79,210,186,87,89,167,88,18,11,7,63
"2011","Gloucester 006E","E01022308",1016,87,14,73,225,195,91,79,169,96,24,15,9,50
"2011","Gloucester 007A","E01022278",1196,126,36,90,291,204,84,84,188,121,30,14,16,68
"2011","Gloucester 007B","E01022279",1088,92,22,70,220,201,80,89,176,128,33,18,15,69
"2011","Gloucester 007C","E01022282",2033,330,76,254,554,348,126,109,257,122,51,24,27,136
"2011","Gloucester 007D","E01022284",947,45,13,32,147,120,66,93,207,160,47,23,24,62
"2011","Gloucester 007E","E01022285",954,56,15,41,156,107,59,83,177,153,74,52,22,89
"2011","Gloucester 007F","E01022286",1160,57,12,45,165,140,80,107,242,220,78,50,28,71
"2011","Gloucester 007G","E01022287",1203,125,36,89,276,190,85,82,207,135,32,21,11,71
"2011","Gloucester 008A","E01022293",1163,51,11,40,180,111,75,86,222,211,120,76,44,107
"2011","Gloucester 008B","E01022294",1135,39,15,24,168,140,76,110,254,192,79,55,24,77
"2011","Gloucester 008C","E01022323",1221,42,7,35,132,111,78,92,292,253,116,77,39,105
"2011","Gloucester 008D","E01022328",955,47,17,30,165,108,75,74,190,157,67,44,23,72
"2011","Gloucester 008E","E01022329",1096,47,14,33,143,96,76,96,232,205,127,90,37,74
"2011","Gloucester 009A","E01022326",963,50,10,40,157,145,95,76,167,164,40,27,13,69
"2011","Gloucester 009B","E01022327",1179,104,28,76,244,161,77,102,206,142,52,41,11,91
"2011","Gloucester 009C","E01022330",1056,64,19,45,187,158,86,98,215,142,29,13,16,77
"2011","Gloucester 009D","E01022331",975,46,14,32,158,141,80,93,176,142,53,30,23,86
"2011","Gloucester 009E","E01022333",1007,23,9,14,105,93,71,95,241,216,101,56,45,62
"2011","Gloucester 009F","E01022334",1152,74,24,50,206,165,98,110,210,157,65,51,14,67
"2011","Gloucester 010A","E01022276",1211,116,32,84,300,235,94,99,169,110,23,13,10,65
"2011","Gloucester 010B","E01022277",1115,109,33,76,264,233,93,72,184,74,26,17,9,60
"2011","Gloucester 010C","E01022280",1224,160,36,124,319,229,70,82,180,85,33,25,8,66
"2011","Gloucester 010D","E01022281",1342,166,44,122,357,268,102,83,158,89,20,15,5,99
"2011","Gloucester 010E","E01022306",1058,153,31,122,295,189,73,72,139,67,9,5,4,61
"2011","Gloucester 010F","E01022307",1208,161,40,121,312,243,86,75,154,68,20,16,4,89
"2011","Gloucester 011A","E01022319",977,24,8,16,92,86,51,83,245,226,122,65,57,48
"2011","Gloucester 011B","E01022320",1123,67,22,45,191,128,96,99,202,170,105,75,30,65
"2011","Gloucester 011C","E01022321",1105,71,17,54,233,175,84,80,216,130,48,29,19,68
"2011","Gloucester 011D","E01022322",917,42,16,26,114,109,83,93,197,165,60,46,14,54
"2011","Gloucester 011E","E01022324",1065,44,10,34,146,142,75,90,226,198,84,44,40,60
"2011","Gloucester 011F","E01022325",1005,51,14,37,166,139,83,84,204,154,60,36,24,64
"2011","Gloucester 012A","E01022343",928,84,26,58,208,127,100,61,149,107,46,36,10,46
"2011","Gloucester 012B","E01022344",1101,75,30,45,155,161,88,97,245,154,36,23,13,90
"2011","Gloucester 012C","E01022345",1071,88,21,67,202,162,104,100,202,115,40,33,7,58
"2011","Gloucester 012D","E01022346",1059,30,9,21,127,127,74,102,248,192,77,48,29,82
"2011","Gloucester 013A","E01022299",1050,53,18,35,190,198,75,113,208,124,32,18,14,57
"2011","Gloucester 013B","E01022300",999,44,14,30,163,171,74,97,227,147,31,20,11,45
"2011","Gloucester 013C","E01022301",1091,47,10,37,174,160,67,107,240,183,50,24,26,63
"2011","Gloucester 013D","E01022302",1133,59,16,43,179,205,90,112,231,151,34,26,8,72
"2011","Gloucester 014A","E01022339",1236,165,38,127,328,229,91,76,154,101,23,13,10,69
"2011","Gloucester 014B","E01022340",1139,103,26,77,234,206,73,112,193,117,29,8,21,72
"2011","Gloucester 014C","E01022341",1593,141,35,106,366,260,88,137,262,163,70,57,13,106
"2011","Gloucester 014D","E01022342",1271,165,44,121,313,228,86,98,175,117,20,8,12,69
"2011","Gloucester 015A","E01022335",1107,87,26,61,226,193,68,103,191,150,24,13,11,65
"2011","Gloucester 015B","E01022336",852,56,11,45,158,147,79,76,165,107,13,5,8,51
"2011","Gloucester 015D","E01022338",1007,58,17,41,205,149,55,114,206,154,27,10,17,39
"2011","Gloucester 015E","E01032933",1060,113,27,86,247,180,71,76,159,94,41,17,24,79
"2011","Gloucester 015F","E01032934",1087,89,26,63,215,186,94,90,197,119,40,26,14,57
"2011","Gloucester 015G","E01032935",1121,160,39,121,303,165,78,91,153,84,31,21,10,56
"2011","Gloucester 015H","E01032936",1209,91,31,60,263,204,55,98,198,135,73,33,40,92
"2011","Stroud 001A","E01022378",1387,142,30,112,369,227,143,98,199,114,24,6,18,71
"2011","Stroud 001B","E01022379",1086,70,22,48,198,132,77,119,220,182,40,21,19,48
"2011","Stroud 001C","E01022380",1111,131,38,93,286,156,167,69,142,88,12,6,6,60
"2011","Stroud 001D","E01022412",2070,314,66,248,566,308,230,108,214,157,41,20,21,132
"2011","Stroud 002A","E01022354",1572,261,57,204,445,185,291,56,136,90,28,17,11,80
"2011","Stroud 002B","E01022390",788,170,43,127,227,74,130,33,68,39,12,10,2,35
"2011","Stroud 002C","E01022391",1028,242,48,194,359,93,143,32,59,33,17,10,7,50
"2011","Stroud 002D","E01022392",1121,210,50,160,314,125,209,48,76,45,21,16,5,73
"2011","Stroud 003A","E01022376",1311,164,53,111,305,149,198,88,167,126,32,23,9,82
"2011","Stroud 003B","E01022396",1241,197,48,149,315,146,166,91,147,100,17,6,11,62
"2011","Stroud 003C","E01022397",1367,178,34,144,311,161,187,110,157,160,29,10,19,74
"2011","Stroud 003D","E01022398",848,118,29,89,192,102,115,60,112,82,20,15,5,47
"2011","Stroud 004A","E01022355",1204,82,24,58,229,135,117,119,255,155,36,25,11,76
"2011","Stroud 004B","E01022356",1670,193,48,145,380,216,150,127,281,152,72,40,32,99
"2011","Stroud 004C","E01022357",1276,97,30,67,269,207,109,110,240,149,31,19,12,64
"2011","Stroud 004D","E01022358",1095,48,16,32,166,116,97,110,244,194,41,28,13,79
"2011","Stroud 004E","E01022377",1577,113,21,92,309,211,153,140,310,189,63,36,27,89
"2011","Stroud 004F","E01022389",1287,177,30,147,356,135,189,61,165,91,21,12,9,92
"2011","Stroud 005A","E01022400",1325,133,29,104,264,153,107,125,259,190,25,16,9,69
"2011","Stroud 005B","E01022401",1037,94,27,67,210,116,80,98,176,156,36,26,10,71
"2011","Stroud 005C","E01022402",1201,88,20,68,220,129,111,132,246,174,30,20,10,71
"2011","Stroud 005D","E01022403",972,45,12,33,127,69,67,107,233,212,55,34,21,57
"2011","Stroud 005E","E01022404",1065,110,22,88,277,123,94,72,140,90,23,14,9,136
"2011","Stroud 006A","E01022365",1624,156,34,122,361,169,180,120,273,183,89,50,39,93
"2011","Stroud 006B","E01022399",1602,120,21,99,322,128,179,124,297,201,124,73,51,107
"2011","Stroud 006C","E01022410",1579,177,48,129,438,152,202,118,205,126,52,32,20,109
"2011","Stroud 006D","E01022411",1627,160,41,119,385,198,185,110,222,200,63,40,23,104
"2011","Stroud 006E","E01022414",1877,176,36,140,488,161,249,119,291,190,67,37,30,136
"2011","Stroud 007A","E01022393",1055,145,37,108,261,152,123,78,129,99,19,13,6,49
"2011","Stroud 007B","E01022394",1171,125,28,97,291,125,141,96,193,127,13,5,8,60
"2011","Stroud 007C","E01022395",1135,143,32,111,289,156,142,81,149,73,21,10,11,81
"2011","Stroud 007D","E01022408",805,148,39,109,250,89,102,33,86,51,12,7,5,34
"2011","Stroud 007E","E01022409",933,127,38,89,249,111,121,58,116,70,17,7,10,64
"2011","Stroud 008A","E01022366",1226,220,58,162,378,159,175,54,96,59,8,4,4,77
"2011","Stroud 008B","E01022367",1174,203,51,152,333,129,161,71,119,58,23,11,12,77
"2011","Stroud 008C","E01022368",1035,170,37,133,279,156,136,60,99,56,18,9,9,61
"2011","Stroud 008D","E01022369",1209,112,22,90,288,178,110,102,178,138,27,12,15,76
"2011","Stroud 009A","E01022370",890,145,32,113,222,87,131,45,107,85,16,10,6,52
"2011","Stroud 009B","E01022371",789,153,30,123,186,101,112,41,88,40,11,6,5,57
"2011","Stroud 009C","E01022405",1011,83,25,58,210,132,111,75,186,130,35,18,17,49
"2011","Stroud 009D","E01022406",913,152,39,113,247,136,102,54,92,65,13,7,6,52
"2011","Stroud 009E","E01022407",1005,99,25,74,230,140,121,73,138,113,36,30,6,55
"2011","Stroud 010A","E01022350",1506,334,73,261,440,143,210,66,139,72,19,16,3,83
"2011","Stroud 010B","E01022382",1055,212,58,154,355,125,115,36,80,47,23,16,7,62
"2011","Stroud 010C","E01022383",878,94,36,58,194,74,119,61,124,123,32,16,16,57
"2011","Stroud 010D","E01022384",1028,182,49,133,281,91,156,54,103,49,58,49,9,54
"2011","Stroud 011A","E01022359",1043,134,41,93,232,149,78,99,154,99,21,14,7,77
"2011","Stroud 011B","E01022360",1042,157,40,117,239,162,116,84,135,65,29,23,6,55
"2011","Stroud 011C","E01022361",891,97,26,71,181,103,73,68,186,118,29,16,13,36
"2011","Stroud 011D","E01022362",843,101,21,80,196,104,74,59,152,91,18,11,7,48
"2011","Stroud 011E","E01022363",1305,159,41,118,297,201,116,91,199,147,20,10,10,75
"2011","Stroud 011F","E01022364",795,41,15,26,115,93,47,74,203,128,39,28,11,55
"2011","Stroud 012A","E01022351",1059,89,21,68,195,125,127,99,191,143,27,16,11,63
"2011","Stroud 012B","E01022352",981,124,23,101,229,115,110,64,150,132,22,16,6,35
"2011","Stroud 012C","E01022353",1051,108,29,79,237,131,91,93,176,140,27,15,12,48
"2011","Stroud 012D","E01022413",1388,229,69,160,348,166,226,96,125,99,20,11,9,79
"2011","Stroud 013A","E01022385",1190,194,37,157,309,89,181,75,152,86,30,17,13,74
"2011","Stroud 013B","E01022386",1188,213,63,150,315,117,150,66,125,91,27,19,8,84
"2011","Stroud 013C","E01022387",1207,136,32,104,280,135,137,91,186,139,41,26,15,62
"2011","Stroud 013D","E01022388",1237,123,34,89,277,139,139,93,209,144,36,23,13,77
"2011","Stroud 014A","E01022372",1285,199,36,163,349,171,108,79,179,103,32,19,13,65
"2011","Stroud 014B","E01022373",1253,123,20,103,239,118,124,130,226,180,42,26,16,71
"2011","Stroud 014C","E01022374",1395,133,24,109,336,183,125,122,226,153,48,30,18,69
"2011","Stroud 014D","E01022375",897,52,9,43,118,76,70,93,198,157,69,48,21,64
"2011","Stroud 015A","E01022381",1488,289,66,223,363,180,183,69,173,102,24,18,6,105
"2011","Stroud 015B","E01022415",1138,228,43,185,310,128,161,56,101,61,23,14,9,70
"2011","Stroud 015C","E01022416",1052,104,27,77,190,110,91,86,183,188,46,32,14,54
"2011","Stroud 015D","E01022417",1268,193,55,138,339,166,123,95,164,112,19,9,10,57
"2011","Stroud 015E","E01022418",1193,210,60,150,282,121,143,76,143,121,26,13,13,71
"2011","Tewkesbury 001B","E01022450",1517,90,27,63,255,214,104,155,323,257,51,31,20,68
"2011","Tewkesbury 001C","E01022451",1145,84,25,59,218,184,80,144,240,118,26,22,4,51
"2011","Tewkesbury 001D","E01022452",1092,87,19,68,190,156,98,142,201,142,23,15,8,53
"2011","Tewkesbury 001E","E01022455",1523,145,41,104,325,239,151,159,235,143,32,23,9,94
"2011","Tewkesbury 001F","E01032938",1158,140,46,94,309,181,111,72,164,84,33,17,16,64
"2011","Tewkesbury 001G","E01032939",1137,175,46,129,304,147,82,84,171,75,16,10,6,83
"2011","Tewkesbury 001H","E01032940",1014,165,40,125,328,188,57,54,105,55,17,7,10,45
"2011","Tewkesbury 002A","E01022456",977,136,25,111,247,149,70,90,141,79,20,11,9,45
"2011","Tewkesbury 002B","E01022457",1025,46,12,34,149,116,73,113,224,178,70,46,24,56
"2011","Tewkesbury 002C","E01022458",970,54,12,42,131,78,72,110,199,200,76,35,41,50
"2011","Tewkesbury 002D","E01022459",1145,96,23,73,269,138,147,94,188,125,41,14,27,47
"2011","Tewkesbury 002E","E01022460",1262,151,36,115,273,184,93,105,224,136,44,20,24,52
"2011","Tewkesbury 002F","E01022461",994,105,32,73,222,157,93,90,170,93,22,12,10,42
"2011","Tewkesbury 002G","E01022462",1259,198,53,145,309,184,173,80,140,89,38,26,12,48
"2011","Tewkesbury 003A","E01022449",1458,251,78,173,409,158,282,73,123,82,16,11,5,64
"2011","Tewkesbury 003B","E01022463",1064,146,36,110,283,118,196,56,115,82,24,15,9,44
"2011","Tewkesbury 003C","E01022464",1072,119,36,83,226,141,127,83,160,125,47,26,21,44
"2011","Tewkesbury 003D","E01022465",1118,211,68,143,311,135,175,54,101,60,8,6,2,63
"2011","Tewkesbury 003E","E01022466",1222,155,37,118,333,166,166,72,160,79,33,20,13,58
"2011","Tewkesbury 004A","E01022434",1492,291,86,205,451,217,226,52,99,72,20,12,8,64
"2011","Tewkesbury 004B","E01022441",1176,159,44,115,277,155,208,69,146,86,30,22,8,46
"2011","Tewkesbury 004C","E01022445",1040,148,44,104,232,145,219,48,110,63,15,12,3,60
"2011","Tewkesbury 004D","E01022453",1150,196,52,144,309,164,173,38,119,57,15,8,7,79
"2011","Tewkesbury 005A","E01022432",1418,145,28,117,363,236,150,98,203,128,23,12,11,72
"2011","Tewkesbury 005B","E01022433",1467,248,59,189,433,251,134,61,163,83,28,11,17,66
"2011","Tewkesbury 005C","E01022435",1598,141,33,108,318,199,139,140,332,185,45,30,15,99
"2011","Tewkesbury 005D","E01022436",1308,171,44,127,320,218,114,97,215,92,31,15,16,50
"2011","Tewkesbury 005E","E01022437",970,142,29,113,222,169,96,68,107,75,24,15,9,67
"2011","Tewkesbury 005F","E01022438",1031,175,33,142,304,196,88,66,100,39,8,7,1,55
"2011","Tewkesbury 005G","E01022439",1131,188,39,149,312,207,80,70,128,77,14,6,8,55
"2011","Tewkesbury 006A","E01022440",1202,114,28,86,262,192,133,92,195,123,41,31,10,50
"2011","Tewkesbury 006B","E01022442",1178,158,33,125,291,152,191,78,117,73,35,21,14,83
"2011","Tewkesbury 006C","E01022443",1023,164,36,128,299,185,90,70,87,56,13,8,5,59
"2011","Tewkesbury 006D","E01022444",1084,171,37,134,289,173,132,61,106,52,47,39,8,53
"2011","Tewkesbury 007A","E01022425",880,93,28,65,234,147,59,71,126,65,14,6,8,71
"2011","Tewkesbury 007B","E01022426",982,166,46,120,265,173,97,46,99,52,14,8,6,70
"2011","Tewkesbury 007C","E01022427",1024,151,53,98,303,165,94,40,115,72,24,15,9,60
"2011","Tewkesbury 007D","E01022428",1294,121,26,95,277,167,93,113,198,159,75,52,23,91
"2011","Tewkesbury 007E","E01022429",1165,110,28,82,288,205,109,92,163,109,22,11,11,67
"2011","Tewkesbury 007F","E01022430",1065,117,31,86,265,224,84,76,151,70,14,9,5,64
"2011","Tewkesbury 007G","E01022431",1563,188,55,133,425,325,112,108,174,110,20,9,11,101
"2011","Tewkesbury 007H","E01022447",1129,136,99,37,285,279,43,75,120,95,38,29,9,58
"2011","Tewkesbury 008A","E01022420",1572,197,57,140,351,207,247,80,204,163,47,38,9,76
"2011","Tewkesbury 008B","E01022448",972,82,25,57,199,161,97,73,157,108,50,32,18,45
"2011","Tewkesbury 008C","E01022454",1326,162,33,129,306,180,169,95,190,120,40,29,11,64
"2011","Tewkesbury 009A","E01022421",1242,117,31,86,231,180,97,124,221,151,53,31,22,68
"2011","Tewkesbury 009B","E01022422",1225,136,33,103,304,207,127,87,162,106,23,15,8,73
"2011","Tewkesbury 009C","E01022423",1417,128,35,93,336,221,129,123,251,143,22,14,8,64
"2011","Tewkesbury 009D","E01022424",1138,67,19,48,187,157,84,100,232,178,61,32,29,72
"2011","Tewkesbury 009E","E01022446",1271,176,43,133,357,205,104,83,171,86,36,25,11,53
"2011","Mendip 001A","E01029022",991,177,40,137,289,115,155,56,85,41,21,16,5,52
"2011","Mendip 001B","E01029023",878,129,32,97,250,92,134,42,89,52,37,32,5,53
"2011","Mendip 001C","E01029044",981,78,18,60,194,100,103,94,183,135,44,20,24,50
"2011","Mendip 001D","E01029053",1673,202,64,138,403,178,374,106,154,128,46,34,12,82
"2011","Mendip 001E","E01029057",1471,251,56,195,416,140,262,49,139,95,36,22,14,83
"2011","Mendip 002A","E01029024",1505,149,46,103,329,189,208,114,224,164,30,13,17,98
"2011","Mendip 002B","E01029025",956,44,13,31,163,91,99,93,185,183,38,29,9,60
"2011","Mendip 002C","E01029026",757,78,21,57,153,77,100,66,109,83,30,12,18,61
"2011","Mendip 002D","E01029068",1013,79,17,62,200,92,115,58,143,89,24,20,4,213
"2011","Mendip 002E","E01029069",804,111,28,83,170,97,131,49,107,77,13,6,7,49
"2011","Mendip 003A","E01029030",1450,141,37,104,368,233,141,144,223,113,18,4,14,69
"2011","Mendip 003B","E01029031",1153,90,29,61,208,162,103,126,218,154,23,14,9,69
"2011","Mendip 003C","E01029032",700,79,22,57,173,121,78,52,109,58,11,8,3,19
"2011","Mendip 003D","E01029033",1052,101,34,67,256,142,86,89,191,124,17,12,5,46
"2011","Mendip 003E","E01029034",1010,94,30,64,212,138,101,91,181,122,20,9,11,51
"2011","Mendip 004A","E01029036",1201,90,19,71,290,107,124,79,200,148,82,51,31,81
"2011","Mendip 004B","E01029041",1381,111,19,92,299,142,163,100,233,177,77,46,31,79
"2011","Mendip 004C","E01029042",1090,66,17,49,188,87,127,100,190,167,84,55,29,81
"2011","Mendip 004D","E01029043",1123,96,22,74,224,127,143,107,190,132,42,22,20,62
"2011","Mendip 004E","E01029045",1175,98,24,74,266,120,130,109,207,113,42,33,9,90
"2011","Mendip 005A","E01029052",1526,216,51,165,330,189,260,84,169,123,60,49,11,95
"2011","Mendip 005B","E01029060",1355,189,43,146,350,137,287,60,143,81,39,29,10,69
"2011","Mendip 005C","E01029061",1601,196,46,150,402,160,303,78,204,138,26,18,8,94
"2011","Mendip 005D","E01029083",909,126,26,100,248,105,89,26,91,40,9,6,3,175
"2011","Mendip 006A","E01029018",1702,213,52,161,433,171,317,113,162,152,36,22,14,105
"2011","Mendip 006B","E01029056",1707,286,61,225,487,172,288,87,155,98,34,26,8,100
"2011","Mendip 006C","E01029064",1226,107,22,85,245,151,148,100,197,177,37,25,12,64
"2011","Mendip 006D","E01029084",1082,78,15,63,233,125,117,91,185,140,34,20,14,79
"2011","Mendip 007A","E01029029",1197,79,20,59,194,122,116,115,214,196,65,48,17,96
"2011","Mendip 007B","E01029035",1107,146,30,116,271,118,122,80,157,124,30,16,14,59
"2011","Mendip 007C","E01029037",1019,85,16,69,249,96,108,60,177,132,60,42,18,52
"2011","Mendip 007D","E01029038",1006,58,13,45,144,98,92,89,252,166,47,31,16,60
"2011","Mendip 007E","E01029039",1081,79,23,56,192,127,118,116,232,134,36,23,13,47
"2011","Mendip 007F","E01029040",1182,75,19,56,220,132,141,97,264,156,41,26,15,56
"2011","Mendip 008A","E01029078",1156,114,28,86,265,139,142,92,194,117,41,28,13,52
"2011","Mendip 008B","E01029079",1137,91,20,71,211,127,123,93,219,163,43,31,12,67
"2011","Mendip 008C","E01029080",1069,115,27,88,230,122,110,70,186,135,24,21,3,77
"2011","Mendip 008D","E01029081",1108,89,22,67,246,145,119,102,184,118,29,19,10,76
"2011","Mendip 008E","E01029082",904,136,28,108,273,126,88,53,110,49,20,13,7,49
"2011","Mendip 009A","E01029062",1070,55,14,41,159,77,87,110,227,236,58,29,29,61
"2011","Mendip 009B","E01029063",1849,187,46,141,364,210,192,191,309,246,57,37,20,93
"2011","Mendip 009C","E01029065",1248,91,39,52,284,178,120,129,173,152,31,25,6,90
"2011","Mendip 009D","E01029066",1296,83,21,62,223,162,117,139,277,192,42,28,14,61
"2011","Mendip 009E","E01029067",1027,45,13,32,124,109,101,111,231,207,33,24,9,66
"2011","Mendip 010A","E01029020",1047,121,31,90,230,113,183,80,134,106,26,17,9,54
"2011","Mendip 010B","E01029021",924,109,34,75,224,118,158,57,113,85,12,6,6,48
"2011","Mendip 010C","E01029027",845,79,30,49,182,79,156,46,132,102,13,6,7,56
"2011","Mendip 010D","E01029028",824,67,21,46,170,95,116,73,133,110,25,18,7,35
"2011","Mendip 010E","E01029058",1669,184,37,147,391,149,354,116,187,144,60,42,18,84
"2011","Mendip 011A","E01029046",1005,62,12,50,223,71,163,81,162,132,65,44,21,46
"2011","Mendip 011D","E01029050",1647,105,18,87,305,146,239,138,316,234,52,37,15,112
"2011","Mendip 011E","E01029051",1192,107,20,87,298,148,193,77,184,100,26,17,9,59
"2011","Mendip 011F","E01032627",1560,119,26,93,372,153,269,93,234,183,56,41,15,81
"2011","Mendip 012A","E01029047",1081,79,16,63,209,127,126,101,197,127,36,20,16,79
"2011","Mendip 012B","E01029054",1099,103,29,74,261,134,221,52,141,107,27,15,12,53
"2011","Mendip 012C","E01029055",864,83,23,60,192,108,147,54,128,96,18,10,8,38
"2011","Mendip 012D","E01029074",1433,82,18,64,248,128,114,74,143,100,15,8,7,529
"2011","Mendip 012E","E01029076",1496,129,26,103,309,216,168,136,261,187,20,11,9,70
"2011","Mendip 013A","E01029019",1667,236,60,176,492,179,297,84,161,91,38,31,7,89
"2011","Mendip 013B","E01029059",1537,204,50,154,399,172,289,77,178,98,33,25,8,87
"2011","Mendip 013C","E01029077",1556,185,46,139,369,168,363,82,163,115,15,9,6,96
"2011","Mendip 014A","E01029070",1312,88,14,74,302,137,175,132,218,155,36,20,16,69
"2011","Mendip 014B","E01029071",1078,60,10,50,200,115,114,109,223,161,39,29,10,57
"2011","Mendip 014C","E01029072",1128,50,11,39,181,128,92,89,245,240,36,24,12,67
"2011","Mendip 014D","E01029073",827,57,20,37,187,92,82,73,143,119,24,14,10,50
"2011","Mendip 014E","E01029075",934,52,12,40,145,89,91,103,191,172,37,28,9,54
"2011","Sedgemoor 001A","E01029085",1523,230,36,194,357,144,183,107,212,127,56,38,18,107
"2011","Sedgemoor 001B","E01029126",1142,121,28,93,256,113,158,95,182,118,32,23,9,67
"2011","Sedgemoor 001C","E01029127",987,120,31,89,212,130,107,92,154,98,22,12,10,52
"2011","Sedgemoor 001D","E01029128",1396,243,36,207,378,187,187,58,128,86,31,24,7,98
"2011","Sedgemoor 001E","E01029129",1369,169,46,123,341,155,183,71,181,106,42,28,14,121
"2011","Sedgemoor 002C","E01029089",1638,196,52,144,408,189,293,92,191,130,33,21,12,106
"2011","Sedgemoor 002D","E01029113",1093,107,26,81,233,154,127,82,190,116,26,19,7,58
"2011","Sedgemoor 002E","E01029115",1148,114,26,88,258,163,121,97,200,126,16,9,7,53
"2011","Sedgemoor 002F","E01029140",2160,212,63,149,474,282,287,145,309,224,103,73,30,124
"2011","Sedgemoor 002G","E01032633",1679,100,30,70,286,190,262,157,305,234,77,58,19,68
"2011","Sedgemoor 003A","E01029086",1651,269,79,190,455,197,299,76,133,76,25,16,9,121
"2011","Sedgemoor 003B","E01029147",1248,210,53,157,310,144,253,45,118,57,25,18,7,86
"2011","Sedgemoor 003C","E01029148",1141,176,45,131,314,122,197,43,113,59,21,10,11,96
"2011","Sedgemoor 003D","E01029149",1024,127,32,95,246,112,178,57,113,82,12,8,4,97
"2011","Sedgemoor 004A","E01029114",1017,93,20,73,264,136,130,71,159,89,29,20,9,46
"2011","Sedgemoor 004B","E01029116",1127,81,23,58,206,132,132,93,214,155,78,69,9,36
"2011","Sedgemoor 004C","E01029117",1123,62,16,46,187,119,138,101,231,186,49,25,24,50
"2011","Sedgemoor 004D","E01029119",1029,59,16,43,180,124,120,77,229,154,41,27,14,45
"2011","Sedgemoor 004E","E01029120",1093,77,29,48,187,121,109,105,242,157,24,16,8,71
"2011","Sedgemoor 005A","E01029118",1266,103,23,80,261,169,125,111,251,132,39,19,20,75
"2011","Sedgemoor 005B","E01029131",1491,57,15,42,212,132,154,129,304,327,104,69,35,72
"2011","Sedgemoor 005C","E01029132",1037,25,9,16,109,51,77,103,263,264,73,46,27,72
"2011","Sedgemoor 005D","E01029133",945,56,12,44,175,125,132,82,188,124,26,18,8,37
"2011","Sedgemoor 005E","E01029134",1403,56,16,40,206,149,180,148,293,269,42,28,14,60
"2011","Sedgemoor 006A","E01029135",1220,119,28,91,254,173,204,83,175,134,30,15,15,48
"2011","Sedgemoor 006B","E01029136",1490,115,37,78,273,134,266,123,242,226,39,20,19,72
"2011","Sedgemoor 006C","E01029145",1428,128,37,91,344,198,148,106,234,180,20,10,10,70
"2011","Sedgemoor 006D","E01029152",1517,113,34,79,290,204,150,131,287,196,54,36,18,92
"2011","Sedgemoor 007A","E01029121",982,107,22,85,264,94,160,72,126,81,25,16,9,53
"2011","Sedgemoor 007B","E01029122",1045,110,25,85,249,124,150,72,160,88,13,8,5,79
"2011","Sedgemoor 007C","E01029123",776,53,11,42,124,87,87,73,153,97,28,20,8,74
"2011","Sedgemoor 007D","E01029124",1230,142,33,109,285,142,205,91,162,119,35,21,14,49
"2011","Sedgemoor 007E","E01029125",1012,143,33,110,264,88,209,47,120,70,19,14,5,52
"2011","Sedgemoor 008A","E01029093",1164,35,10,25,172,121,77,113,250,250,81,41,40,65
"2011","Sedgemoor 008B","E01029096",1064,36,8,28,126,97,104,94,254,225,66,41,25,62
"2011","Sedgemoor 008C","E01029106",1111,19,6,13,87,71,67,86,268,300,130,93,37,83
"2011","Sedgemoor 008D","E01029107",1071,18,7,11,96,80,72,97,277,294,60,43,17,77
"2011","Sedgemoor 008E","E01029109",962,16,6,10,87,99,77,66,222,251,63,44,19,81
"2011","Sedgemoor 009A","E01029094",1218,49,14,35,189,147,93,117,287,226,51,24,27,59
"2011","Sedgemoor 009B","E01029095",1210,45,11,34,155,110,113,130,276,214,96,63,33,71
"2011","Sedgemoor 009C","E01029110",1636,75,22,53,231,169,129,140,372,300,110,73,37,110
"2011","Sedgemoor 009D","E01029111",1773,76,18,58,313,193,113,150,371,331,101,68,33,125
"2011","Sedgemoor 009E","E01029112",1445,77,19,58,192,156,128,123,310,257,116,78,38,86
"2011","Sedgemoor 010A","E01029090",1110,52,17,35,169,148,115,95,231,219,26,11,15,55
"2011","Sedgemoor 010B","E01029091",1277,50,11,39,215,170,93,138,291,244,23,10,13,53
"2011","Sedgemoor 010C","E01029092",1165,67,22,45,212,178,116,110,221,156,25,14,11,80
"2011","Sedgemoor 010D","E01029108",1546,69,20,49,200,225,126,149,362,286,62,33,29,67
"2011","Sedgemoor 011A","E01029102",1127,88,20,68,213,135,116,82,209,147,56,43,13,81
"2011","Sedgemoor 011B","E01029103",1036,100,28,72,216,166,104,101,186,96,13,12,1,54
"2011","Sedgemoor 011C","E01029104",1063,107,31,76,223,157,138,98,145,86,19,6,13,90
"2011","Sedgemoor 011E","E01032631",979,68,20,48,199,150,81,83,170,146,25,18,7,57
"2011","Sedgemoor 011F","E01032632",921,93,27,66,204,155,112,77,116,90,8,6,2,66
"2011","Sedgemoor 011G","E01032634",907,121,30,91,243,153,96,48,105,61,22,17,5,58
"2011","Sedgemoor 012A","E01029130",1556,191,52,139,397,173,257,87,177,143,29,19,10,102
"2011","Sedgemoor 012B","E01029137",1193,164,43,121,269,143,188,74,142,104,37,25,12,72
"2011","Sedgemoor 012C","E01029138",1026,86,28,58,207,132,137,87,187,120,20,12,8,50
"2011","Sedgemoor 012D","E01029139",1097,126,33,93,259,115,181,76,154,102,19,15,4,65
"2011","Sedgemoor 012E","E01029150",953,137,44,93,240,89,185,72,95,71,14,11,3,50
"2011","Sedgemoor 012F","E01029151",899,102,19,83,222,115,141,56,118,80,22,12,10,43
"2011","Sedgemoor 013A","E01029097",1004,34,8,26,115,85,60,95,256,233,72,47,25,54
"2011","Sedgemoor 013B","E01029098",1059,46,11,35,167,120,110,91,183,183,91,59,32,68
"2011","Sedgemoor 013C","E01029099",904,17,4,13,103,68,85,78,212,229,51,26,25,61
"2011","Sedgemoor 013D","E01029100",938,27,6,21,100,61,81,74,224,205,91,58,33,75
"2011","Sedgemoor 013E","E01029105",971,39,12,27,124,95,86,78,221,190,74,50,24,64
"2011","Sedgemoor 014A","E01029101",822,44,10,34,131,119,44,76,173,148,38,26,12,49
"2011","Sedgemoor 014C","E01029142",1053,110,27,83,215,139,146,74,161,112,43,35,8,53
"2011","Sedgemoor 014D","E01029143",974,53,12,41,146,131,105,92,206,169,25,14,11,47
"2011","Sedgemoor 014E","E01029144",945,124,41,83,207,108,189,48,117,61,27,19,8,64
"2011","Sedgemoor 014F","E01032629",1137,127,44,83,264,147,173,97,156,108,26,16,10,39
"2011","Sedgemoor 014G","E01032630",1157,114,32,82,302,164,90,94,182,126,25,14,11,60
"2011","South Somerset 001A","E01029157",917,73,18,55,186,65,132,66,109,99,38,22,16,149
"2011","South Somerset 001B","E01029158",982,91,29,62,230,91,142,59,113,118,21,17,4,117
"2011","South Somerset 001C","E01029221",1785,220,58,162,451,177,390,95,171,125,31,21,10,125
"2011","South Somerset 002A","E01029166",1668,262,72,190,422,148,351,91,168,102,26,21,5,98
"2011","South Somerset 002B","E01029167",1089,75,14,61,180,100,153,86,211,185,50,36,14,49
"2011","South Somerset 002C","E01029168",1105,113,33,80,269,129,157,83,183,121,19,12,7,31
"2011","South Somerset 002D","E01029210",1160,160,49,111,303,131,201,59,135,94,17,9,8,60
"2011","South Somerset 002E","E01029211",1022,136,37,99,293,117,163,69,95,89,12,6,6,48
"2011","South Somerset 003A","E01029224",1209,122,30,92,310,115,235,79,173,84,21,18,3,70
"2011","South Somerset 003B","E01029225",1523,148,44,104,333,176,205,124,238,173,40,29,11,86
"2011","South Somerset 003C","E01029226",1129,99,29,70,204,122,145,98,183,187,27,19,8,64
"2011","South Somerset 004A","E01029200",1012,84,25,59,207,119,136,67,174,136,29,20,9,60
"2011","South Somerset 004B","E01029201",1019,86,27,59,190,123,139,84,178,109,45,35,10,65
"2011","South Somerset 004C","E01029222",1143,141,33,108,271,116,224,68,136,94,30,19,11,63
"2011","South Somerset 004D","E01029223",877,121,36,85,231,107,139,44,101,75,21,11,10,38
"2011","South Somerset 005A","E01029155",1314,194,49,145,345,149,266,68,137,77,26,18,8,52
"2011","South Somerset 005B","E01029227",1123,112,31,81,235,127,145,95,187,137,26,18,8,59
"2011","South Somerset 005C","E01029228",1163,88,19,69,227,141,157,102,203,180,23,15,8,42
"2011","South Somerset 005D","E01029229",1425,103,24,79,248,131,158,154,285,245,32,18,14,69
"2011","South Somerset 006A","E01029164",999,127,42,85,262,110,157,77,119,73,14,8,6,60
"2011","South Somerset 006B","E01029165",876,108,31,77,209,123,147,67,100,64,19,12,7,39
"2011","South Somerset 006C","E01029198",884,142,90,52,225,102,56,109,117,76,15,7,8,42
"2011","South Somerset 006D","E01029199",2442,241,137,104,651,514,245,324,205,144,28,16,12,90
"2011","South Somerset 007A","E01029187",719,82,14,68,130,85,124,60,112,72,22,15,7,32
"2011","South Somerset 007B","E01029188",1076,148,49,99,274,148,169,71,123,64,20,12,8,59
"2011","South Somerset 007C","E01029196",1065,101,23,78,229,121,164,77,168,130,20,11,9,55
"2011","South Somerset 007D","E01029197",928,112,25,87,246,100,174,54,108,75,12,7,5,47
"2011","South Somerset 008A","E01029154",1382,138,40,98,279,129,212,98,211,214,39,24,15,62
"2011","South Somerset 008B","E01029156",1369,144,49,95,269,157,218,105,191,174,41,26,15,70
"2011","South Somerset 008C","E01029206",1059,85,18,67,202,107,152,105,158,169,19,10,9,62
"2011","South Somerset 008D","E01029207",989,111,36,75,253,128,132,70,126,88,21,12,9,60
"2011","South Somerset 009A","E01029202",838,49,11,38,154,80,76,89,173,140,34,21,13,43
"2011","South Somerset 009B","E01029203",1173,154,47,107,299,135,207,79,135,89,15,13,2,60
"2011","South Somerset 009C","E01029204",852,127,36,91,209,94,106,79,114,63,25,17,8,35
"2011","South Somerset 009D","E01029205",1306,110,46,64,262,169,147,117,232,166,33,16,17,70
"2011","South Somerset 010A","E01029163",1653,220,66,154,390,173,295,104,195,141,42,26,16,93
"2011","South Somerset 010B","E01029216",1042,148,40,108,239,122,183,72,131,92,26,12,14,29
"2011","South Somerset 010C","E01029217",1097,156,44,112,288,123,161,77,145,80,16,9,7,51
"2011","South Somerset 010D","E01029218",1254,124,32,92,283,149,160,104,197,151,39,26,13,47
"2011","South Somerset 011A","E01029238",1118,47,14,33,160,134,67,135,222,237,49,30,19,67
"2011","South Somerset 011B","E01029252",1079,87,33,54,218,157,74,146,217,103,23,18,5,54
"2011","South Somerset 011C","E01029253",1139,82,29,53,186,168,55,157,230,179,32,17,15,50
"2011","South Somerset 011D","E01029254",976,110,28,82,187,169,86,102,173,85,17,13,4,47
"2011","South Somerset 012A","E01029160",1920,244,70,174,483,271,138,181,273,136,26,16,10,168
"2011","South Somerset 012B","E01029248",1119,54,14,40,172,141,72,114,281,161,48,35,13,76
"2011","South Somerset 012C","E01029250",962,127,31,96,218,132,91,109,135,63,33,29,4,54
"2011","South Somerset 012D","E01029251",949,85,27,58,169,154,101,94,193,98,16,8,8,39
"2011","South Somerset 013A","E01029161",1225,119,29,90,251,197,61,139,239,113,29,22,7,77
"2011","South Somerset 013B","E01029162",1120,96,24,72,211,181,88,126,218,127,32,22,10,41
"2011","South Somerset 013C","E01029247",1095,38,10,28,116,98,45,116,296,229,80,44,36,77
"2011","South Somerset 013D","E01029255",1001,67,12,55,238,148,60,104,198,110,28,14,14,48
"2011","South Somerset 014A","E01029231",1129,128,32,96,211,157,102,108,193,139,35,23,12,56
"2011","South Somerset 014B","E01029233",964,55,14,41,126,89,64,102,227,176,68,43,25,57
"2011","South Somerset 014C","E01029235",980,52,16,36,147,101,96,107,211,176,36,24,12,54
"2011","South Somerset 014D","E01029236",994,40,7,33,114,90,62,117,231,226,60,39,21,54
"2011","South Somerset 014E","E01029237",1045,40,15,25,135,112,74,120,241,196,69,40,29,58
"2011","South Somerset 015A","E01029232",1134,81,15,66,231,142,86,97,237,155,57,36,21,48
"2011","South Somerset 015B","E01029234",1411,101,20,81,238,119,91,150,298,251,101,62,39,62
"2011","South Somerset 015C","E01029239",1042,57,9,48,137,96,75,112,228,207,57,33,24,73
"2011","South Somerset 015D","E01029240",1123,78,19,59,241,113,101,140,222,152,24,15,9,52
"2011","South Somerset 016A","E01029241",1372,115,16,99,254,158,99,155,287,181,51,35,16,72
"2011","South Somerset 016B","E01029245",1645,179,46,133,362,263,134,142,276,152,40,24,16,97
"2011","South Somerset 016C","E01029246",1068,132,36,96,250,157,75,98,188,82,35,28,7,51
"2011","South Somerset 016D","E01029249",967,72,15,57,160,147,57,124,199,128,21,15,6,59
"2011","South Somerset 017A","E01029189",806,57,16,41,142,103,99,79,171,101,14,10,4,40
"2011","South Somerset 017B","E01029190",913,137,32,105,261,93,146,58,111,74,7,3,4,26
"2011","South Somerset 017C","E01029191",871,114,34,80,189,91,124,66,141,75,31,13,18,40
"2011","South Somerset 017D","E01029192",1069,119,32,87,226,112,114,95,189,118,31,22,9,65
"2011","South Somerset 017E","E01029212",765,119,32,87,196,91,108,59,85,63,7,4,3,37
"2011","South Somerset 017F","E01029213",912,123,35,88,208,116,122,68,139,80,8,4,4,48
"2011","South Somerset 017G","E01029214",855,111,30,81,203,108,134,67,109,70,18,15,3,35
"2011","South Somerset 017H","E01029215",788,72,13,59,172,87,102,66,122,104,22,12,10,41
"2011","South Somerset 018A","E01029159",1162,183,40,143,297,194,66,119,155,65,17,11,6,66
"2011","South Somerset 018B","E01029242",1141,103,26,77,215,161,85,148,235,126,14,10,4,54
"2011","South Somerset 018C","E01029243",1159,129,38,91,259,159,120,105,207,89,28,19,9,63
"2011","South Somerset 018D","E01029244",1147,163,35,128,283,205,75,117,160,88,12,6,6,44
"2011","South Somerset 019A","E01029193",1356,110,30,80,287,144,178,100,228,184,50,33,17,75
"2011","South Somerset 019B","E01029194",1761,181,44,137,423,228,190,159,294,195,30,13,17,61
"2011","South Somerset 019C","E01029195",1060,69,18,51,196,115,117,110,221,150,27,17,10,55
"2011","South Somerset 019D","E01029208",769,76,24,52,154,120,142,52,112,74,11,6,5,28
"2011","South Somerset 019E","E01029209",952,128,35,93,261,129,174,55,95,64,14,10,4,32
"2011","South Somerset 020A","E01029178",1069,184,43,141,265,140,145,72,128,62,22,16,6,51
"2011","South Somerset 020B","E01029179",812,69,19,50,176,81,67,91,160,109,25,16,9,34
"2011","South Somerset 020C","E01029180",1056,120,32,88,249,136,170,80,121,100,19,12,7,61
"2011","South Somerset 020D","E01029181",961,141,41,100,233,137,127,67,121,74,32,23,9,29
"2011","South Somerset 021A","E01029182",1082,99,28,71,236,143,133,93,176,124,20,9,11,58
"2011","South Somerset 021B","E01029183",1028,43,11,32,131,95,103,129,253,191,31,18,13,52
"2011","South Somerset 021C","E01029184",1260,125,35,90,300,204,158,99,193,119,17,10,7,45
"2011","South Somerset 021D","E01029185",1238,108,29,79,235,146,175,108,232,146,44,29,15,44
"2011","South Somerset 021E","E01029186",1015,61,18,43,166,92,98,106,244,158,47,32,15,43
"2011","South Somerset 022A","E01029169",1099,66,20,46,188,128,101,116,255,159,33,25,8,53
"2011","South Somerset 022B","E01029172",1060,97,31,66,206,150,87,91,213,138,14,7,7,64
"2011","South Somerset 022C","E01029173",891,40,9,31,137,102,74,108,192,154,30,17,13,54
"2011","South Somerset 022D","E01029176",908,61,21,40,177,131,88,105,176,111,20,13,7,39
"2011","South Somerset 022E","E01029177",798,29,10,19,94,67,68,98,203,164,48,30,18,27
"2011","South Somerset 023A","E01029170",775,36,14,22,78,71,60,111,191,146,35,20,15,47
"2011","South Somerset 023B","E01029171",1479,86,26,60,239,157,146,141,339,236,61,33,28,74
"2011","South Somerset 023C","E01029174",768,32,8,24,105,88,71,67,201,135,35,30,5,34
"2011","South Somerset 023D","E01029175",1405,60,22,38,191,109,120,152,339,271,77,49,28,86
"2011","South Somerset 024A","E01029153",1730,219,56,163,450,189,360,99,178,155,26,18,8,54
"2011","South Somerset 024B","E01029219",1054,82,23,59,212,131,208,82,142,114,25,13,12,58
"2011","South Somerset 024C","E01029220",865,66,16,50,151,115,111,72,146,151,15,7,8,38
"2011","South Somerset 024D","E01029230",1706,216,72,144,378,173,337,109,241,142,33,18,15,77
"2011","Taunton Deane 001A","E01029258",1075,134,28,106,279,170,127,64,141,71,26,18,8,63
"2011","Taunton Deane 001B","E01029259",1005,97,27,70,247,126,117,81,155,95,28,18,10,59
"2011","Taunton Deane 001C","E01029260",1558,191,61,130,476,268,122,103,177,88,26,15,11,107
"2011","Taunton Deane 001D","E01029268",1161,200,49,151,304,125,238,61,90,53,27,16,11,63
"2011","Taunton Deane 002A","E01029276",1136,109,25,84,266,141,85,57,127,72,29,24,5,250
"2011","Taunton Deane 002B","E01029278",938,160,37,123,245,111,134,49,106,49,22,13,9,62
"2011","Taunton Deane 002C","E01029290",1048,115,18,97,260,154,93,79,164,108,15,8,7,60
"2011","Taunton Deane 002D","E01029306",1096,93,29,64,263,164,96,66,185,112,44,30,14,73
"2011","Taunton Deane 002E","E01029319",1115,141,36,105,316,171,90,90,134,85,18,12,6,70
"2011","Taunton Deane 003A","E01029267",1185,148,31,117,330,133,193,46,134,83,38,22,16,80
"2011","Taunton Deane 003B","E01029320",1124,77,16,61,234,120,158,67,202,155,37,25,12,74
"2011","Taunton Deane 003C","E01029321",1685,209,50,159,384,192,383,84,183,91,61,44,17,98
"2011","Taunton Deane 004A","E01029297",910,37,9,28,128,98,65,93,217,155,60,39,21,57
"2011","Taunton Deane 004B","E01029298",1017,34,13,21,128,132,87,105,279,167,30,18,12,55
"2011","Taunton Deane 004C","E01029304",1054,26,7,19,139,145,87,98,250,190,48,35,13,71
"2011","Taunton Deane 004D","E01029305",1021,40,12,28,180,173,86,104,211,140,30,19,11,57
"2011","Taunton Deane 004E","E01029307",975,26,8,18,121,112,75,92,256,175,60,38,22,58
"2011","Taunton Deane 005A","E01029271",1273,159,38,121,329,148,232,67,151,99,28,20,8,60
"2011","Taunton Deane 005B","E01029273",832,81,21,60,186,146,90,53,139,86,21,16,5,30
"2011","Taunton Deane 005C","E01029274",1067,136,33,103,298,128,156,60,127,81,18,14,4,63
"2011","Taunton Deane 005D","E01029275",894,109,31,78,228,120,99,43,140,88,27,26,1,40
"2011","Taunton Deane 005E","E01029279",1038,138,46,92,274,108,212,56,105,80,19,12,7,46
"2011","Taunton Deane 006A","E01029282",1079,64,9,55,258,196,89,94,199,110,21,10,11,48
"2011","Taunton Deane 006B","E01029291",1172,67,19,48,179,165,89,111,262,177,71,52,19,51
"2011","Taunton Deane 006C","E01029294",1334,148,41,107,363,231,89,80,206,88,42,33,9,87
"2011","Taunton Deane 006D","E01029317",911,92,27,65,227,116,82,75,144,84,16,9,7,75
"2011","Taunton Deane 006E","E01029318",1090,129,29,100,298,166,163,57,115,71,14,10,4,77
"2011","Taunton Deane 007A","E01029285",1873,169,29,140,426,256,125,159,312,205,47,34,13,174
"2011","Taunton Deane 007B","E01029287",1202,115,21,94,276,189,96,91,193,123,43,30,13,76
"2011","Taunton Deane 007C","E01029288",1132,146,34,112,325,161,77,64,142,81,66,56,10,70
"2011","Taunton Deane 007D","E01029289",1391,148,28,120,370,169,113,97,218,132,67,46,21,77
"2011","Taunton Deane 007E","E01029299",1098,85,18,67,211,138,94,90,207,154,52,33,19,67
"2011","Taunton Deane 007F","E01029300",1174,124,17,107,272,184,87,94,213,109,36,21,15,55
"2011","Taunton Deane 008A","E01029256",975,116,32,84,257,154,99,71,126,79,25,14,11,48
"2011","Taunton Deane 008B","E01029257",1532,113,25,88,305,214,132,87,272,216,74,57,17,119
"2011","Taunton Deane 008D","E01029277",768,55,18,37,157,124,63,59,164,97,7,4,3,42
"2011","Taunton Deane 008E","E01032651",1608,100,49,51,369,556,105,109,155,110,47,35,12,57
"2011","Taunton Deane 008F","E01032652",847,50,17,33,190,117,71,80,174,108,24,17,7,33
"2011","Taunton Deane 009A","E01029280",1139,51,10,41,184,123,101,85,273,189,44,30,14,89
"2011","Taunton Deane 009B","E01029281",1262,74,21,53,201,163,106,111,272,213,53,39,14,69
"2011","Taunton Deane 009C","E01029283",1357,106,33,73,270,177,97,123,270,184,33,19,14,97
"2011","Taunton Deane 009D","E01029292",1008,25,9,16,102,77,75,107,263,214,75,51,24,70
"2011","Taunton Deane 009E","E01029293",1022,20,7,13,72,70,64,84,290,228,130,79,51,64
"2011","Taunton Deane 010A","E01029266",928,74,12,62,205,123,61,56,142,87,47,35,12,133
"2011","Taunton Deane 010B","E01029284",1289,101,22,79,237,138,83,82,222,153,39,23,16,234
"2011","Taunton Deane 010C","E01029286",1263,139,26,113,283,161,87,75,240,132,48,36,12,98
"2011","Taunton Deane 010D","E01029301",1282,168,31,137,336,185,100,69,198,95,54,41,13,77
"2011","Taunton Deane 010E","E01029303",1185,223,50,173,345,215,93,63,100,49,17,10,7,80
"2011","Taunton Deane 011A","E01029263",1032,102,10,92,259,203,77,71,160,80,11,6,5,69
"2011","Taunton Deane 011B","E01029264",881,75,22,53,237,173,70,62,122,73,14,5,9,55
"2011","Taunton Deane 011C","E01029265",1025,128,22,106,309,194,74,71,118,54,19,13,6,58
"2011","Taunton Deane 011D","E01029302",1138,173,41,132,325,189,99,62,124,63,23,15,8,80
"2011","Taunton Deane 011E","E01029308",1389,212,48,164,404,178,170,64,131,62,15,10,5,153
"2011","Taunton Deane 012A","E01029309",1420,92,25,67,243,135,112,132,323,236,60,38,22,87
"2011","Taunton Deane 012B","E01029311",1021,30,11,19,122,108,99,83,228,201,78,59,19,72
"2011","Taunton Deane 012C","E01029312",1001,71,20,51,231,133,110,89,159,121,23,9,14,64
"2011","Taunton Deane 012D","E01029313",977,62,17,45,186,112,118,78,178,138,34,22,12,71
"2011","Taunton Deane 012E","E01029316",1136,97,21,76,273,136,133,73,195,145,31,18,13,53
"2011","Taunton Deane 013A","E01029262",1744,232,65,167,475,213,306,95,181,123,26,15,11,93
"2011","Taunton Deane 013B","E01029269",1538,169,43,126,359,172,315,86,198,121,33,26,7,85
"2011","Taunton Deane 013C","E01029310",1292,114,30,84,320,153,130,87,188,139,21,17,4,140
"2011","Taunton Deane 013D","E01029314",1832,130,38,92,386,208,217,127,328,249,64,43,21,123
"2011","Taunton Deane 013E","E01029315",993,100,20,80,283,152,110,58,133,87,13,11,2,57
"2011","Taunton Deane 014A","E01029261",1542,239,53,186,394,189,288,81,154,81,31,17,14,85
"2011","Taunton Deane 014B","E01029270",1583,261,60,201,408,211,252,74,157,109,23,17,6,88
"2011","Taunton Deane 014C","E01029295",1228,127,36,91,327,214,122,88,175,81,22,12,10,72
"2011","Taunton Deane 014D","E01029296",1021,142,33,109,310,161,97,40,113,62,32,28,4,64
"2011","West Somerset 001B","E01029324",1120,45,20,25,208,106,126,129,253,162,26,20,6,65
"2011","West Somerset 001C","E01029329",1140,66,23,43,203,104,175,97,212,122,55,40,15,106
"2011","West Somerset 001D","E01029330",1423,98,20,78,316,139,228,126,253,145,51,43,8,67
"2011","West Somerset 001F","E01032636",1341,86,20,66,286,163,182,108,243,179,38,27,11,56
"2011","West Somerset 002A","E01029322",1562,51,16,35,270,116,110,180,402,340,40,19,21,53
"2011","West Somerset 002B","E01029331",966,52,17,35,220,141,149,63,175,109,25,19,6,32
"2011","West Somerset 002C","E01029333",791,50,14,36,142,70,106,68,161,121,32,20,12,41
"2011","West Somerset 002D","E01029336",1456,130,27,103,294,135,376,96,202,128,32,23,9,63
"2011","West Somerset 003A","E01029326",869,68,16,52,163,78,156,69,148,108,32,20,12,47
"2011","West Somerset 003B","E01029334",790,54,11,43,176,87,139,53,131,86,31,17,14,33
"2011","West Somerset 003C","E01029339",1089,41,10,31,187,135,114,96,243,171,39,22,17,63
"2011","West Somerset 003E","E01029341",950,50,11,39,199,96,175,68,171,115,35,21,14,41
"2011","West Somerset 003G","E01032635",1538,66,19,47,236,174,164,142,356,252,50,31,19,98
"2011","West Somerset 004A","E01029327",1524,210,48,162,367,166,396,65,148,88,24,14,10,60
"2011","West Somerset 004B","E01029335",844,98,19,79,215,87,202,55,88,51,11,10,1,37
"2011","West Somerset 004C","E01029337",1584,145,35,110,379,165,268,113,235,146,59,39,20,74
"2011","West Somerset 004D","E01029342",791,97,34,63,197,111,160,49,86,44,23,19,4,24
"2011","West Somerset 004E","E01029343",1077,70,17,53,219,147,168,97,185,119,30,19,11,42
"2011","West Somerset 005A","E01029325",1380,120,30,90,278,133,354,91,186,124,37,24,13,57
"2011","West Somerset 005B","E01029328",1324,138,40,98,283,146,290,81,188,120,38,23,15,40
"2011","West Somerset 005C","E01029338",1359,107,23,84,278,94,441,97,140,116,28,19,9,58
"2011","Isle of Anglesey 001A","W01000003",1828,76,11,65,295,188,194,175,380,280,124,76,48,116
"2011","Isle of Anglesey 001B","W01000004",939,66,11,55,191,103,126,83,134,110,58,39,19,68
"2011","Isle of Anglesey 001C","W01000018",986,83,19,64,188,98,140,111,162,101,50,29,21,53
"2011","Isle of Anglesey 001D","W01000028",1454,89,30,59,255,136,237,123,244,172,96,55,41,102
"2011","Isle of Anglesey 001E","W01000031",1165,100,22,78,215,138,203,111,170,119,50,32,18,59
"2011","Isle of Anglesey 002A","W01000010",1313,123,39,84,307,147,204,139,166,123,35,21,14,69
"2011","Isle of Anglesey 002B","W01000020",990,112,23,89,235,126,181,74,114,66,28,22,6,54
"2011","Isle of Anglesey 002C","W01000021",1692,127,33,94,314,185,288,135,254,196,89,68,21,104
"2011","Isle of Anglesey 002D","W01000032",776,68,12,56,171,84,112,77,121,77,27,21,6,39
"2011","Isle of Anglesey 003A","W01000016",915,17,5,12,114,81,73,94,219,165,88,33,55,64
"2011","Isle of Anglesey 003B","W01000017",1123,36,11,25,150,102,87,127,256,182,102,56,46,81
"2011","Isle of Anglesey 003C","W01000029",1058,26,8,18,137,91,65,107,269,199,98,46,52,66
"2011","Isle of Anglesey 003D","W01000030",1631,43,10,33,225,178,114,171,371,277,161,101,60,91
"2011","Isle of Anglesey 003E","W01000033",1084,14,3,11,118,89,58,128,258,167,164,89,75,88
"2011","Isle of Anglesey 003F","W01000036",791,22,4,18,111,62,53,79,184,131,81,45,36,68
"2011","Isle of Anglesey 003G","W01000037",849,49,16,33,165,82,71,90,171,102,70,44,26,49
"2011","Isle of Anglesey 004A","W01000022",1202,95,30,65,232,125,201,102,197,129,49,28,21,72
"2011","Isle of Anglesey 004B","W01000034",848,42,11,31,148,106,81,108,171,108,31,20,11,53
"2011","Isle of Anglesey 004C","W01000039",772,73,20,53,217,77,104,62,109,62,30,15,15,38
"2011","Isle of Anglesey 004D","W01000040",859,99,30,69,249,79,135,74,87,57,30,19,11,49
"2011","Isle of Anglesey 004E","W01000043",864,50,23,27,132,97,85,112,161,122,55,30,25,50
"2011","Isle of Anglesey 004F","W01000044",848,62,16,46,201,128,91,101,150,58,14,8,6,43
"2011","Isle of Anglesey 005A","W01000005",1384,181,42,139,264,127,206,123,196,146,62,35,27,79
"2011","Isle of Anglesey 005B","W01000013",1640,261,41,220,444,187,205,108,163,101,56,34,22,115
"2011","Isle of Anglesey 005C","W01000019",1060,125,40,85,217,133,162,77,151,95,37,26,11,63
"2011","Isle of Anglesey 005D","W01000026",904,111,20,91,212,82,116,68,126,89,39,29,10,61
"2011","Isle of Anglesey 005E","W01000035",1381,165,36,129,302,149,201,96,190,123,65,39,26,90
"2011","Isle of Anglesey 006A","W01000006",1166,78,19,59,245,150,169,107,171,136,44,33,11,66
"2011","Isle of Anglesey 006B","W01000012",1036,99,20,79,268,138,106,73,147,117,33,19,14,55
"2011","Isle of Anglesey 006C","W01000014",1490,108,32,76,316,197,110,137,262,188,64,32,32,108
"2011","Isle of Anglesey 006D","W01000041",1060,27,11,16,101,107,66,102,247,227,105,60,45,78
"2011","Isle of Anglesey 007A","W01000001",807,73,32,41,175,85,145,48,110,93,39,26,13,39
"2011","Isle of Anglesey 007B","W01000002",931,89,37,52,207,87,123,70,141,110,41,27,14,63
"2011","Isle of Anglesey 007C","W01000009",1378,84,20,64,239,170,184,131,233,187,75,50,25,75
"2011","Isle of Anglesey 007D","W01000023",1046,60,18,42,181,118,132,92,192,159,55,40,15,57
"2011","Isle of Anglesey 007E","W01000024",1068,149,98,51,220,159,73,118,143,84,59,31,28,63
"2011","Isle of Anglesey 008A","W01000008",1093,99,19,80,301,150,107,77,143,94,26,20,6,96
"2011","Isle of Anglesey 008B","W01000011",956,168,18,150,199,82,99,45,82,48,33,21,12,200
"2011","Isle of Anglesey 008C","W01000015",1114,136,21,115,325,172,92,66,148,74,28,19,9,73
"2011","Isle of Anglesey 008D","W01000042",1559,141,29,112,340,189,134,136,244,163,57,41,16,155
"2011","Isle of Anglesey 009A","W01000007",1263,142,35,107,285,153,180,91,175,97,47,26,21,93
"2011","Isle of Anglesey 009B","W01000025",1494,123,28,95,322,167,188,144,222,166,44,34,10,118
"2011","Isle of Anglesey 009C","W01000027",1363,136,33,103,324,127,149,89,206,181,51,23,28,100
"2011","Isle of Anglesey 009D","W01000038",1638,132,30,102,336,187,217,140,243,207,69,39,30,107
"2011","Gwynedd 001A","W01000062",1632,48,2,46,104,55,38,43,82,78,61,45,16,1123
"2011","Gwynedd 001B","W01000076",1089,69,7,62,138,52,58,31,81,49,42,28,14,569
"2011","Gwynedd 001C","W01000077",1128,51,11,40,114,70,60,72,105,84,46,30,16,526
"2011","Gwynedd 001D","W01000091",849,27,6,21,86,66,58,71,171,141,106,67,39,123
"2011","Gwynedd 001E","W01000092",3908,112,9,103,125,49,51,43,83,57,53,36,17,3335
"2011","Gwynedd 002A","W01000064",1313,97,24,73,219,133,88,107,215,163,56,40,16,235
"2011","Gwynedd 002B","W01000072",1285,144,25,119,255,127,86,78,159,114,52,37,15,270
"2011","Gwynedd 002C","W01000075",1145,63,6,57,146,109,61,86,154,114,57,36,21,355
"2011","Gwynedd 002D","W01000090",959,31,11,20,118,89,57,87,206,200,96,68,28,75
"2011","Gwynedd 002E","W01000102",853,154,11,143,213,91,73,47,86,58,37,29,8,94
"2011","Gwynedd 003A","W01000050",1015,123,24,99,243,99,154,66,148,83,36,22,14,63
"2011","Gwynedd 003B","W01000071",1738,158,25,133,375,182,204,140,245,215,90,52,38,129
"2011","Gwynedd 003C","W01000096",867,57,6,51,180,91,73,86,155,119,33,21,12,73
"2011","Gwynedd 003D","W01000097",850,45,5,40,174,81,99,90,150,108,51,32,19,52
"2011","Gwynedd 003E","W01000115",1616,176,28,148,459,159,185,123,204,136,59,35,24,115
"2011","Gwynedd 004A","W01000052",857,77,14,63,255,123,71,62,107,80,22,15,7,60
"2011","Gwynedd 004B","W01000053",906,89,11,78,225,95,155,69,97,91,19,14,5,66
"2011","Gwynedd 004C","W01000087",1339,93,22,71,327,185,112,117,217,157,44,31,13,87
"2011","Gwynedd 004D","W01000119",1712,231,43,188,458,196,196,89,188,136,52,40,12,166
"2011","Gwynedd 005A","W01000063",1361,81,14,67,249,131,156,138,221,219,75,50,25,91
"2011","Gwynedd 005B","W01000081",1501,133,24,109,356,148,186,149,212,163,60,43,17,94
"2011","Gwynedd 005C","W01000099",1320,126,20,106,339,151,155,107,175,113,37,19,18,117
"2011","Gwynedd 005D","W01000103",902,95,17,78,226,98,104,55,125,61,33,23,10,105
"2011","Gwynedd 006A","W01000059",1445,48,10,38,229,171,106,98,298,257,129,92,37,109
"2011","Gwynedd 006B","W01000093",1596,185,27,158,480,245,138,90,173,131,49,29,20,105
"2011","Gwynedd 006C","W01000098",1569,51,16,35,219,126,83,130,340,313,196,136,60,111
"2011","Gwynedd 006D","W01000110",1129,60,19,41,229,160,82,93,211,154,39,32,7,101
"2011","Gwynedd 007A","W01000054",800,72,25,47,196,120,85,67,113,80,18,12,6,49
"2011","Gwynedd 007B","W01000088",1393,129,29,100,369,159,175,92,230,129,32,23,9,78
"2011","Gwynedd 007C","W01000111",1118,66,15,51,226,133,94,87,225,183,46,34,12,58
"2011","Gwynedd 007D","W01000118",1194,135,25,110,309,136,159,96,144,107,34,19,15,74
"2011","Gwynedd 008A","W01000073",1245,84,23,61,317,183,165,105,161,96,42,28,14,92
"2011","Gwynedd 008B","W01000086",1620,122,35,87,309,167,270,108,245,214,78,47,31,107
"2011","Gwynedd 008C","W01000104",1297,64,12,52,232,169,145,111,236,179,86,57,29,75
"2011","Gwynedd 008D","W01000112",1375,79,18,61,253,156,143,132,232,173,106,70,36,101
"2011","Gwynedd 009A","W01000056",1372,59,20,39,197,111,171,165,263,188,112,55,57,106
"2011","Gwynedd 009B","W01000065",836,22,9,13,131,99,65,103,167,153,35,19,16,61
"2011","Gwynedd 009C","W01000113",1308,88,20,68,232,110,138,144,265,171,73,47,26,87
"2011","Gwynedd 009D","W01000114",1171,66,17,49,225,117,225,106,177,150,34,18,16,71
"2011","Gwynedd 010A","W01000066",862,63,18,45,175,81,193,58,124,86,29,19,10,53
"2011","Gwynedd 010B","W01000100",762,64,8,56,171,61,130,72,117,83,21,14,7,43
"2011","Gwynedd 010C","W01000105",1193,54,12,42,217,108,150,119,253,178,50,29,21,64
"2011","Gwynedd 010D","W01000106",1253,138,27,111,305,164,217,93,159,94,22,14,8,61
"2011","Gwynedd 010E","W01000107",931,62,14,48,197,57,162,88,150,129,31,24,7,55
"2011","Gwynedd 011A","W01000047",950,73,18,55,178,102,169,75,149,119,33,17,16,52
"2011","Gwynedd 011B","W01000061",1214,132,23,109,277,107,202,84,191,118,29,23,6,74
"2011","Gwynedd 011C","W01000078",1231,54,9,45,219,112,213,112,206,162,57,37,20,96
"2011","Gwynedd 011D","W01000089",1460,120,30,90,357,162,265,114,207,123,33,26,7,79
"2011","Gwynedd 012A","W01000070",937,65,13,52,210,91,212,54,131,94,30,24,6,50
"2011","Gwynedd 012B","W01000094",854,72,9,63,195,87,175,51,129,86,20,15,5,39
"2011","Gwynedd 012C","W01000095",927,64,19,45,168,97,141,79,158,130,41,25,16,49
"2011","Gwynedd 012D","W01000108",1564,87,19,68,308,140,195,113,303,238,96,69,27,84
"2011","Gwynedd 012E","W01000109",1326,78,23,55,229,117,174,95,250,245,67,47,20,71
"2011","Gwynedd 013A","W01000069",1092,58,17,41,198,131,232,87,190,117,39,26,13,40
"2011","Gwynedd 013B","W01000074",1515,103,32,71,334,143,266,112,227,145,51,35,16,134
"2011","Gwynedd 013C","W01000079",762,66,18,48,155,69,175,50,107,82,29,21,8,29
"2011","Gwynedd 013D","W01000101",1058,61,16,45,189,125,130,107,184,152,34,28,6,76
"2011","Gwynedd 014C","W01000080",1192,120,30,90,295,121,226,69,165,95,35,22,13,66
"2011","Gwynedd 014D","W01000084",840,77,14,63,165,61,222,51,104,81,27,17,10,52
"2011","Gwynedd 014E","W01001932",2103,132,30,102,435,167,551,127,300,182,62,50,12,147
"2011","Gwynedd 015A","W01000051",1393,73,17,56,282,107,165,132,270,228,63,32,31,73
"2011","Gwynedd 015B","W01000060",992,84,17,67,219,77,226,97,120,92,30,21,9,47
"2011","Gwynedd 015C","W01000082",800,47,10,37,141,66,186,68,140,95,16,12,4,41
"2011","Gwynedd 015D","W01000083",963,76,19,57,204,83,273,58,116,80,27,19,8,46
"2011","Gwynedd 016A","W01000048",960,41,10,31,164,82,179,79,199,121,41,27,14,54
"2011","Gwynedd 016B","W01000049",854,45,18,27,134,69,168,72,184,97,55,31,24,30
"2011","Gwynedd 016C","W01000057",1072,92,19,73,245,102,232,73,154,86,19,15,4,69
"2011","Gwynedd 016D","W01000067",902,82,12,70,171,100,159,65,136,94,52,42,10,43
"2011","Gwynedd 016E","W01000068",978,64,17,47,188,126,109,83,176,126,47,33,14,59
"2011","Gwynedd 017C","W01000085",1477,95,22,73,327,121,330,118,235,123,79,59,20,49
"2011","Gwynedd 017D","W01000116",1115,51,21,30,277,115,197,76,198,116,36,22,14,49
"2011","Gwynedd 017E","W01000117",1113,29,7,22,170,84,167,93,256,200,52,39,13,62
"2011","Gwynedd 017F","W01001933",1655,161,37,124,391,139,364,127,233,130,53,33,20,57
"2011","Conwy 001A","W01000132",1087,75,18,57,200,123,136,90,207,145,45,25,20,66
"2011","Conwy 001B","W01000146",1797,122,19,103,341,132,307,164,313,213,119,71,48,86
"2011","Conwy 001C","W01000147",1044,92,18,74,230,116,131,83,179,122,36,16,20,55
"2011","Conwy 001D","W01000169",1409,78,21,57,245,119,203,120,274,186,106,71,35,78
"2011","Conwy 001E","W01000186",1164,62,11,51,186,97,100,111,253,195,64,44,20,96
"2011","Conwy 002A","W01000133",1234,138,27,111,323,165,179,70,171,73,46,28,18,69
"2011","Conwy 002B","W01000168",1262,51,14,37,200,124,131,128,271,205,60,42,18,92
"2011","Conwy 002C","W01000187",1054,21,6,15,116,60,60,91,240,224,131,77,54,111
"2011","Conwy 002D","W01000188",1234,72,20,52,274,164,127,110,238,137,38,22,16,74
"2011","Conwy 003A","W01000154",987,78,22,56,243,139,112,79,156,81,37,30,7,62
"2011","Conwy 003B","W01000173",1078,115,20,95,298,102,156,72,138,62,22,11,11,113
"2011","Conwy 003C","W01000174",1169,118,29,89,297,158,120,90,188,86,24,13,11,88
"2011","Conwy 003D","W01000175",1079,141,32,109,281,163,141,67,150,57,24,17,7,55
"2011","Conwy 004A","W01000155",973,122,31,91,254,113,144,63,111,75,32,21,11,59
"2011","Conwy 004B","W01000156",1021,106,26,80,277,118,119,73,161,83,30,14,16,54
"2011","Conwy 004C","W01000157",1022,42,7,35,206,123,103,91,189,127,69,45,24,72
"2011","Conwy 004D","W01000158",1029,81,25,56,270,158,124,77,142,97,19,14,5,61
"2011","Conwy 005A","W01000149",1041,22,5,17,144,100,140,116,215,176,71,44,27,57
"2011","Conwy 005B","W01000150",1092,73,17,56,190,146,163,91,180,128,40,26,14,81
"2011","Conwy 005C","W01000151",1113,47,18,29,186,134,112,81,207,187,85,52,33,74
"2011","Conwy 005D","W01000152",1018,35,10,25,162,120,138,84,213,143,64,49,15,59
"2011","Conwy 005E","W01000184",1759,67,20,47,249,186,225,159,368,302,104,62,42,99
"2011","Conwy 006A","W01000135",1371,151,34,117,368,198,185,88,203,83,26,18,8,69
"2011","Conwy 006B","W01000136",1291,144,30,114,287,144,205,78,187,116,64,36,28,66
"2011","Conwy 006C","W01000165",1366,130,32,98,374,175,195,85,193,104,28,14,14,82
"2011","Conwy 006D","W01000166",1351,92,21,71,230,152,124,122,279,176,71,48,23,105
"2011","Conwy 007A","W01000139",1167,99,29,70,260,153,122,94,191,117,30,14,16,101
"2011","Conwy 007B","W01000143",1144,63,14,49,202,110,92,95,233,158,94,48,46,97
"2011","Conwy 007C","W01000144",1130,49,16,33,177,81,111,94,269,140,135,70,65,74
"2011","Conwy 007D","W01000182",1294,112,23,89,243,145,154,92,221,145,104,72,32,78
"2011","Conwy 008A","W01000138",1303,92,28,64,314,176,106,101,231,141,55,25,30,87
"2011","Conwy 008B","W01000145",890,55,14,41,207,109,62,70,171,113,50,30,20,53
"2011","Conwy 008C","W01000180",1218,178,44,134,350,137,137,57,111,49,82,67,15,117
"2011","Conwy 008D","W01000181",1146,121,19,102,261,178,128,73,156,103,32,18,14,94
"2011","Conwy 008E","W01000183",969,124,24,100,236,99,103,43,106,76,43,36,7,139
"2011","Conwy 009A","W01000126",1261,116,31,85,294,178,148,95,178,120,39,13,26,93
"2011","Conwy 009B","W01000127",948,36,15,21,171,105,83,68,219,157,58,31,27,51
"2011","Conwy 009C","W01000128",1061,68,16,52,235,148,127,86,175,109,40,27,13,73
"2011","Conwy 009D","W01000153",1159,115,33,82,304,126,137,88,170,109,37,23,14,73
"2011","Conwy 009E","W01000163",916,45,19,26,137,67,78,66,181,147,103,74,29,92
"2011","Conwy 009F","W01000164",1017,53,13,40,220,128,119,83,182,115,39,23,16,78
"2011","Conwy 010B","W01000140",1048,61,10,51,219,158,128,92,170,106,43,29,14,71
"2011","Conwy 010C","W01000141",997,90,23,67,226,144,119,75,147,118,40,29,11,38
"2011","Conwy 010D","W01000142",1082,109,28,81,327,157,106,69,137,82,28,23,5,67
"2011","Conwy 010E","W01000178",1274,48,12,36,224,139,112,91,254,208,108,62,46,90
"2011","Conwy 010F","W01000179",1122,91,14,77,274,161,113,85,195,119,31,22,9,53
"2011","Conwy 010G","W01001927",923,62,19,43,189,119,91,78,170,125,44,30,14,45
"2011","Conwy 010H","W01001928",878,21,9,12,117,76,101,72,179,178,107,67,40,27
"2011","Conwy 011C","W01000167",1360,67,14,53,213,152,137,127,285,205,87,45,42,87
"2011","Conwy 011D","W01000176",1150,31,5,26,191,109,96,121,241,191,75,41,34,95
"2011","Conwy 011E","W01000177",877,53,15,38,171,114,71,67,149,129,34,22,12,89
"2011","Conwy 011F","W01001926",1641,163,44,119,414,178,240,134,227,136,43,21,22,106
"2011","Conwy 012A","W01000124",1467,172,34,138,387,144,257,91,165,120,37,21,16,94
"2011","Conwy 012B","W01000129",791,69,16,53,173,100,93,55,123,99,23,14,9,56
"2011","Conwy 012C","W01000130",1166,107,12,95,281,149,155,83,173,123,27,14,13,68
"2011","Conwy 012D","W01000131",1051,88,18,70,242,112,100,90,186,107,36,18,18,90
"2011","Conwy 013A","W01000123",1335,90,20,70,300,156,134,103,218,157,90,73,17,87
"2011","Conwy 013B","W01000125",1101,102,26,76,268,124,142,91,176,102,41,25,16,55
"2011","Conwy 013C","W01000170",1335,120,22,98,356,151,105,92,203,140,56,35,21,112
"2011","Conwy 013D","W01000171",1163,121,23,98,254,117,140,58,183,120,66,37,29,104
"2011","Conwy 013E","W01000172",956,46,7,39,193,95,88,99,197,125,46,24,22,67
"2011","Conwy 014A","W01000122",1620,144,25,119,390,153,372,85,200,122,44,23,21,110
"2011","Conwy 014B","W01000159",1039,71,14,57,228,100,276,67,131,87,17,12,5,62
"2011","Conwy 014C","W01000162",1419,100,20,80,319,144,352,89,176,108,44,30,14,87
"2011","Conwy 014D","W01000190",1023,78,18,60,230,108,243,70,133,85,23,16,7,53
"2011","Conwy 015A","W01000121",929,62,14,48,200,59,232,85,146,66,29,22,7,50
"2011","Conwy 015B","W01000134",1428,76,22,54,267,127,190,147,259,224,54,35,19,84
"2011","Conwy 015C","W01000137",1125,118,28,90,289,106,264,61,126,70,23,17,6,68
"2011","Conwy 015D","W01000148",863,31,6,25,136,77,94,94,162,164,42,31,11,63
"2011","Conwy 015E","W01000185",922,57,18,39,209,80,146,80,149,110,32,15,17,59
"2011","Conwy 015F","W01000189",1153,107,26,81,244,90,312,68,158,90,18,11,7,66
"2011","Denbighshire 001A","W01000218",1102,46,17,29,205,148,112,107,198,137,64,38,26,85
"2011","Denbighshire 001B","W01000219",1783,87,28,59,342,225,174,171,353,251,76,47,29,104
"2011","Denbighshire 001C","W01000220",1150,52,16,36,206,161,112,105,234,196,50,38,12,34
"2011","Denbighshire 002A","W01000213",898,31,7,24,124,92,67,78,202,164,58,37,21,82
"2011","Denbighshire 002B","W01000214",824,45,11,34,144,122,86,68,134,114,51,39,12,60
"2011","Denbighshire 002C","W01000215",985,117,24,93,277,127,111,77,122,56,24,17,7,74
"2011","Denbighshire 002D","W01000216",1015,61,16,45,214,109,96,79,155,125,61,41,20,115
"2011","Denbighshire 003A","W01000212",1547,135,28,107,387,222,183,100,214,141,52,34,18,113
"2011","Denbighshire 003B","W01000221",973,35,12,23,166,137,105,93,205,152,38,21,17,42
"2011","Denbighshire 003C","W01000222",1196,58,13,45,237,172,115,112,216,186,45,25,20,55
"2011","Denbighshire 004A","W01000226",1100,38,16,22,165,122,109,105,239,200,52,42,10,70
"2011","Denbighshire 004B","W01000227",1089,84,23,61,204,150,103,66,223,122,53,35,18,84
"2011","Denbighshire 004C","W01000228",809,45,11,34,151,84,104,54,149,110,60,33,27,52
"2011","Denbighshire 004D","W01000239",1337,36,5,31,141,99,108,114,282,266,189,118,71,102
"2011","Denbighshire 004E","W01000240",1034,19,4,15,80,72,104,95,216,195,184,118,66,69
"2011","Denbighshire 004F","W01000241",901,34,9,25,132,66,96,71,183,149,104,72,32,66
"2011","Denbighshire 006A","W01000236",1299,21,9,12,142,99,90,120,304,252,159,111,48,112
"2011","Denbighshire 006B","W01000237",1145,18,8,10,99,78,61,99,274,209,167,116,51,140
"2011","Denbighshire 006C","W01000238",1239,41,11,30,218,119,125,112,243,200,80,48,32,101
"2011","Denbighshire 008A","W01000200",943,97,20,77,252,110,126,72,108,77,34,20,14,67
"2011","Denbighshire 008B","W01000201",1080,90,30,60,222,139,130,82,174,106,63,39,24,74
"2011","Denbighshire 008C","W01000217",1429,87,13,74,273,157,175,116,247,180,67,47,20,127
"2011","Denbighshire 008D","W01000248",1240,153,38,115,291,151,207,74,143,96,28,19,9,97
"2011","Denbighshire 009A","W01000191",1576,146,22,124,342,203,151,133,255,174,46,28,18,126
"2011","Denbighshire 009B","W01000223",971,67,16,51,257,123,117,75,148,77,25,16,9,82
"2011","Denbighshire 009C","W01000224",1005,57,13,44,208,121,103,94,157,141,40,24,16,84
"2011","Denbighshire 009D","W01000225",1132,82,18,64,255,140,124,83,164,157,55,37,18,72
"2011","Denbighshire 010A","W01000245",1192,140,35,105,348,142,119,89,125,115,36,20,16,78
"2011","Denbighshire 010B","W01000246",1227,79,15,64,242,142,105,114,189,186,83,63,20,87
"2011","Denbighshire 010C","W01000247",1409,171,45,126,338,154,219,81,186,107,74,69,5,79
"2011","Denbighshire 011A","W01000194",1637,96,24,72,416,169,140,97,266,182,121,98,23,150
"2011","Denbighshire 011B","W01000198",1024,26,7,19,103,82,53,75,268,237,98,65,33,82
"2011","Denbighshire 011C","W01000199",1259,85,20,65,254,140,153,91,216,149,76,57,19,95
"2011","Denbighshire 012A","W01000195",991,103,24,79,286,146,96,72,128,81,11,10,1,68
"2011","Denbighshire 012B","W01000196",1118,85,19,66,279,143,104,89,185,119,29,18,11,85
"2011","Denbighshire 012C","W01000197",1193,101,31,70,307,168,95,92,192,124,25,17,8,89
"2011","Denbighshire 012D","W01000211",1372,152,31,121,382,117,320,82,125,98,32,16,16,64
"2011","Denbighshire 013A","W01000203",1836,270,79,191,552,202,257,116,172,131,31,14,17,105
"2011","Denbighshire 013B","W01000204",1060,172,49,123,298,117,158,53,108,54,23,17,6,77
"2011","Denbighshire 013C","W01000206",1567,181,39,142,402,158,221,91,202,108,91,84,7,113
"2011","Denbighshire 014A","W01000242",1340,84,14,70,255,126,131,100,262,226,58,42,16,98
"2011","Denbighshire 014B","W01000243",1284,103,29,74,291,115,153,95,212,121,32,15,17,162
"2011","Denbighshire 014C","W01000244",1202,134,30,104,369,157,137,71,150,87,20,13,7,77
"2011","Denbighshire 015A","W01000193",996,58,19,39,163,84,143,86,208,131,42,27,15,81
"2011","Denbighshire 015B","W01000202",1203,146,26,120,298,129,252,59,123,81,23,8,15,92
"2011","Denbighshire 015C","W01000207",1677,183,52,131,387,154,362,97,207,128,39,23,16,120
"2011","Denbighshire 016A","W01000192",763,50,8,42,159,86,140,51,123,91,29,25,4,34
"2011","Denbighshire 016B","W01000205",825,67,23,44,164,73,164,68,138,90,24,17,7,37
"2011","Denbighshire 016C","W01000208",936,80,21,59,238,60,162,84,135,76,44,29,15,57
"2011","Denbighshire 016D","W01000209",1065,71,16,55,223,97,124,124,178,136,43,27,16,69
"2011","Denbighshire 016E","W01000210",994,109,23,86,250,122,154,85,131,70,21,12,9,52
"2011","Denbighshire 017E","W01000229",1153,64,14,50,205,169,103,104,227,164,67,42,25,50
"2011","Denbighshire 017F","W01000230",1433,62,15,47,268,240,153,121,270,178,46,30,16,95
"2011","Denbighshire 017A","W01000231",1014,47,13,34,179,116,96,85,209,155,42,26,16,85
"2011","Denbighshire 017B","W01000232",1163,73,21,52,266,178,111,87,190,146,45,26,19,67
"2011","Denbighshire 017C","W01000233",950,48,18,30,163,131,100,95,197,118,33,19,14,65
"2011","Denbighshire 017G","W01000234",997,35,8,27,137,105,70,89,217,172,80,53,27,92
"2011","Denbighshire 017D","W01000235",994,64,14,50,199,152,80,115,181,100,27,17,10,76
"2011","Flintshire 001A","W01000287",1338,64,16,48,215,139,156,139,250,221,59,41,18,95
"2011","Flintshire 001B","W01000298",1127,64,19,45,214,131,144,114,202,153,47,38,9,58
"2011","Flintshire 001C","W01000338",1399,143,47,96,315,165,178,109,210,140,40,24,16,99
"2011","Flintshire 002A","W01000306",1762,131,28,103,333,195,148,186,276,249,120,87,33,124
"2011","Flintshire 002B","W01000320",1354,87,36,51,212,137,113,138,260,238,58,37,21,111
"2011","Flintshire 002C","W01000340",1740,185,45,140,459,223,204,141,232,156,52,36,16,88
"2011","Flintshire 003A","W01000253",1434,61,20,41,199,157,106,178,284,266,76,50,26,107
"2011","Flintshire 003B","W01000254",1591,62,19,43,189,153,139,141,344,383,85,51,34,95
"2011","Flintshire 003C","W01000296",1088,35,8,27,125,89,81,104,271,243,76,47,29,64
"2011","Flintshire 003D","W01000297",898,60,18,42,153,120,47,93,190,131,53,38,15,51
"2011","Flintshire 003E","W01000304",1370,38,10,28,202,115,99,140,274,298,126,86,40,78
"2011","Flintshire 003F","W01000305",1330,66,18,48,208,151,96,157,281,241,60,35,25,70
"2011","Flintshire 004A","W01000288",1561,39,11,28,176,127,51,191,374,394,131,82,49,78
"2011","Flintshire 004B","W01000290",878,25,9,16,133,70,51,95,224,182,49,36,13,49
"2011","Flintshire 004C","W01000292",1036,28,12,16,120,88,58,138,242,210,66,45,21,86
"2011","Flintshire 004D","W01000293",1152,52,20,32,163,117,67,149,273,203,55,41,14,73
"2011","Flintshire 005A","W01000289",1040,68,21,47,177,125,62,136,221,146,27,14,13,78
"2011","Flintshire 005B","W01000291",1049,66,19,47,178,132,72,142,208,140,53,30,23,58
"2011","Flintshire 005C","W01000294",1475,154,48,106,288,208,102,165,263,152,33,20,13,110
"2011","Flintshire 005D","W01000295",1165,52,15,37,213,140,71,145,232,208,29,23,6,75
"2011","Flintshire 006A","W01000258",1635,141,47,94,369,207,187,166,229,195,44,31,13,97
"2011","Flintshire 006B","W01000270",997,143,39,104,255,112,162,67,109,71,20,14,6,58
"2011","Flintshire 006C","W01000271",948,113,27,86,214,107,137,83,113,91,26,15,11,64
"2011","Flintshire 006D","W01000272",1450,231,59,172,389,164,183,98,133,106,35,27,8,111
"2011","Flintshire 006E","W01000301",1351,153,41,112,349,150,200,114,170,112,26,16,10,77
"2011","Flintshire 007A","W01000273",1171,47,21,26,155,140,70,144,243,207,78,54,24,87
"2011","Flintshire 007B","W01000274",1253,44,14,30,124,140,69,153,275,271,98,54,44,79
"2011","Flintshire 007C","W01000275",965,51,13,38,177,110,65,119,196,139,38,20,18,70
"2011","Flintshire 007D","W01000278",1071,33,13,20,115,87,50,122,261,240,92,54,38,71
"2011","Flintshire 008A","W01000276",1028,67,27,40,168,131,64,126,218,142,33,20,13,79
"2011","Flintshire 008B","W01000277",1032,76,18,58,196,149,58,144,197,113,28,15,13,71
"2011","Flintshire 008C","W01000279",932,48,15,33,158,128,71,117,204,115,31,18,13,60
"2011","Flintshire 008D","W01000281",941,48,19,29,139,132,63,138,212,131,24,10,14,54
"2011","Flintshire 008E","W01000283",1659,106,28,78,297,227,117,180,317,240,72,43,29,103
"2011","Flintshire 009A","W01000332",1171,103,31,72,228,129,112,131,209,152,52,39,13,55
"2011","Flintshire 009B","W01000333",1009,35,11,24,108,76,53,120,256,219,70,40,30,72
"2011","Flintshire 009C","W01000334",1486,62,16,46,196,177,91,190,320,269,81,47,34,100
"2011","Flintshire 009D","W01000335",766,18,7,11,90,65,38,93,164,154,72,56,16,72
"2011","Flintshire 009E","W01000336",955,16,5,11,73,82,47,104,229,202,114,76,38,88
"2011","Flintshire 009F","W01000337",1582,77,22,55,232,205,111,200,326,277,60,27,33,94
"2011","Flintshire 010A","W01000252",1244,81,19,62,244,205,93,146,214,169,29,20,9,63
"2011","Flintshire 010B","W01000280",1090,92,33,59,233,160,96,115,181,120,25,10,15,68
"2011","Flintshire 010C","W01000282",1244,157,56,101,327,171,77,137,164,78,23,13,10,110
"2011","Flintshire 010D","W01000325",1163,154,43,111,313,160,90,96,149,102,21,13,8,78
"2011","Flintshire 011A","W01000311",1330,105,30,75,267,196,94,138,242,153,45,19,26,90
"2011","Flintshire 011B","W01000312",1278,59,24,35,197,155,95,159,255,220,57,42,15,81
"2011","Flintshire 011C","W01000328",1619,74,28,46,222,168,113,187,350,320,97,58,39,88
"2011","Flintshire 012A","W01000264",1208,104,32,72,270,159,101,114,181,124,43,27,16,112
"2011","Flintshire 012B","W01000265",1003,80,25,55,247,142,89,106,157,121,12,7,5,49
"2011","Flintshire 012C","W01000323",1148,195,52,143,322,139,129,92,117,77,29,18,11,48
"2011","Flintshire 012D","W01000324",1112,137,41,96,321,166,88,110,127,69,22,10,12,72
"2011","Flintshire 013A","W01000251",1100,91,20,71,227,129,77,98,209,134,40,25,15,95
"2011","Flintshire 013B","W01000268",1257,156,44,112,352,201,105,112,147,85,18,13,5,81
"2011","Flintshire 013C","W01000284",1256,194,52,142,313,184,125,112,141,73,13,9,4,101
"2011","Flintshire 013D","W01000285",1114,156,44,112,305,184,100,97,111,84,15,7,8,62
"2011","Flintshire 013E","W01000286",1629,218,51,167,442,270,111,144,218,116,20,11,9,90
"2011","Flintshire 013F","W01000302",1324,177,40,137,360,218,111,109,154,77,40,31,9,78
"2011","Flintshire 014A","W01000249",951,90,24,66,214,172,68,112,142,70,22,13,9,61
"2011","Flintshire 014B","W01000250",1165,97,28,69,278,196,84,125,155,123,32,25,7,75
"2011","Flintshire 014C","W01000261",1170,75,15,60,223,178,93,152,221,141,27,13,14,60
"2011","Flintshire 014D","W01000321",1272,135,37,98,333,184,103,133,170,109,26,11,15,79
"2011","Flintshire 014E","W01000322",1024,100,27,73,247,167,86,100,146,93,35,24,11,50
"2011","Flintshire 015A","W01000255",1688,129,33,96,349,263,145,195,266,167,64,39,25,110
"2011","Flintshire 015B","W01000256",1145,113,30,83,282,155,74,127,184,103,26,17,9,81
"2011","Flintshire 015C","W01000257",1659,127,43,84,345,295,119,238,265,145,21,13,8,104
"2011","Flintshire 015D","W01000329",976,40,11,29,151,107,59,97,206,194,50,27,23,72
"2011","Flintshire 015E","W01000330",1521,82,12,70,258,188,111,165,298,264,63,43,20,92
"2011","Flintshire 015F","W01000331",1252,88,22,66,223,162,98,134,247,169,32,21,11,99
"2011","Flintshire 016A","W01000313",1108,84,17,67,203,143,96,116,189,154,46,26,20,77
"2011","Flintshire 016B","W01000314",776,55,8,47,160,78,83,77,136,97,28,20,8,62
"2011","Flintshire 016C","W01000315",1371,123,21,102,299,195,112,117,213,186,35,16,19,91
"2011","Flintshire 016D","W01000316",944,120,29,91,262,128,62,74,140,72,21,14,7,65
"2011","Flintshire 016E","W01000317",1044,175,35,140,359,161,71,68,81,36,10,2,8,83
"2011","Flintshire 016F","W01000318",778,26,10,16,77,59,43,83,170,198,58,30,28,64
"2011","Flintshire 016G","W01000319",1113,77,22,55,247,129,80,100,200,157,54,29,25,69
"2011","Flintshire 017A","W01000259",1155,67,26,41,211,150,89,150,212,168,44,25,19,64
"2011","Flintshire 017B","W01000260",1381,86,21,65,280,208,84,209,264,149,26,13,13,75
"2011","Flintshire 017C","W01000262",1085,38,15,23,189,102,83,158,214,163,72,49,23,66
"2011","Flintshire 017D","W01000263",1090,30,12,18,168,121,64,107,212,234,83,45,38,71
"2011","Flintshire 017E","W01000266",994,60,18,42,171,148,64,124,191,145,43,30,13,48
"2011","Flintshire 017F","W01000267",1174,97,28,69,284,176,81,142,194,113,36,22,14,51
"2011","Flintshire 018A","W01000303",1255,211,49,162,354,187,129,98,117,62,18,11,7,79
"2011","Flintshire 018B","W01000326",1255,164,46,118,313,198,124,113,157,99,26,15,11,61
"2011","Flintshire 018C","W01000327",1677,160,41,119,407,236,150,186,255,140,40,17,23,103
"2011","Flintshire 019A","W01000299",1438,214,59,155,377,186,167,123,168,99,24,13,11,80
"2011","Flintshire 019B","W01000300",1345,193,43,150,349,168,169,102,151,97,42,25,17,74
"2011","Flintshire 019C","W01000309",1576,122,37,85,292,177,156,176,275,215,60,32,28,103
"2011","Flintshire 019D","W01000339",1199,126,32,94,256,145,185,91,165,112,46,28,18,73
"2011","Flintshire 020A","W01000269",1159,83,11,72,192,148,120,138,217,166,45,30,15,50
"2011","Flintshire 020B","W01000307",987,129,28,101,245,128,138,91,104,65,16,12,4,71
"2011","Flintshire 020C","W01000308",898,82,22,60,186,102,75,107,141,110,24,11,13,71
"2011","Flintshire 020D","W01000310",1392,172,46,126,328,156,187,119,185,122,36,17,19,87
"2011","Wrexham 003A","W01000374",1017,46,19,27,154,136,69,123,215,160,55,31,24,59
"2011","Wrexham 003B","W01000375",1444,145,28,117,328,215,98,149,197,175,42,20,22,95
"2011","Wrexham 003C","W01000376",1050,55,17,38,175,144,74,140,230,163,22,14,8,47
"2011","Wrexham 003D","W01000391",1100,55,21,34,198,181,68,128,235,167,29,17,12,39
"2011","Wrexham 003E","W01000392",1198,42,14,28,135,108,66,157,268,262,75,37,38,85
"2011","Wrexham 004A","W01000377",1152,80,28,52,236,108,107,97,263,138,45,27,18,78
"2011","Wrexham 004B","W01000378",937,37,7,30,137,107,62,81,214,157,82,57,25,60
"2011","Wrexham 004C","W01000379",1193,44,13,31,167,111,81,127,273,220,97,70,27,73
"2011","Wrexham 004D","W01000380",1078,94,21,73,254,160,66,96,172,100,66,58,8,70
"2011","Wrexham 005A","W01000351",1622,90,27,63,301,207,137,160,303,249,72,46,26,103
"2011","Wrexham 005B","W01000373",1295,52,19,33,167,124,71,123,291,284,94,61,33,89
"2011","Wrexham 005C","W01000400",1230,66,16,50,225,142,97,131,256,181,59,33,26,73
"2011","Wrexham 005D","W01000401",1291,72,14,58,232,161,105,119,228,209,75,43,32,90
"2011","Wrexham 006A","W01000347",1901,163,48,115,469,272,146,181,266,218,62,36,26,124
"2011","Wrexham 006B","W01000348",1008,37,14,23,146,114,60,83,235,212,58,35,23,63
"2011","Wrexham 006C","W01000362",1119,39,8,31,146,102,78,128,274,204,71,47,24,77
"2011","Wrexham 006D","W01000363",1071,60,15,45,252,143,83,122,192,134,35,25,10,50
"2011","Wrexham 006E","W01000364",1240,103,26,77,284,158,112,121,199,152,37,24,13,74
"2011","Wrexham 007A","W01000343",757,80,28,52,211,135,49,61,103,62,20,15,5,36
"2011","Wrexham 007B","W01000344",991,93,27,66,240,157,81,99,155,97,17,12,5,52
"2011","Wrexham 007C","W01000415",1096,97,27,70,220,177,71,104,216,119,28,19,9,64
"2011","Wrexham 007D","W01000416",987,88,32,56,243,170,59,111,161,68,19,13,6,68
"2011","Wrexham 008A","W01000368",1461,152,39,113,394,235,110,129,211,127,35,21,14,68
"2011","Wrexham 008B","W01000371",944,64,20,44,182,111,66,75,155,97,34,27,7,160
"2011","Wrexham 008C","W01000372",1195,67,5,62,162,101,47,82,168,157,65,40,25,346
"2011","Wrexham 008D","W01000387",930,89,18,71,226,169,71,87,134,77,15,11,4,62
"2011","Wrexham 008E","W01000388",783,85,28,57,180,99,73,50,123,83,23,15,8,67
"2011","Wrexham 008F","W01000422",1546,95,24,71,285,207,113,159,305,197,59,35,24,126
"2011","Wrexham 009A","W01000341",1129,60,17,43,213,131,59,99,226,179,64,37,27,98
"2011","Wrexham 009B","W01000342",1092,37,12,25,168,123,70,111,235,200,61,41,20,87
"2011","Wrexham 009C","W01000393",1401,121,36,85,278,159,96,137,247,187,68,56,12,108
"2011","Wrexham 010A","W01000352",689,27,6,21,101,53,57,75,134,153,32,22,10,57
"2011","Wrexham 010B","W01000353",954,17,4,13,90,60,64,81,260,201,97,63,34,84
"2011","Wrexham 010C","W01000413",881,13,5,8,63,42,16,84,219,223,156,94,62,65
"2011","Wrexham 010D","W01000414",853,27,8,19,87,58,37,86,225,191,78,51,27,64
"2011","Wrexham 010E","W01000425",1579,21,5,16,126,81,49,137,399,401,244,183,61,121
"2011","Wrexham 011A","W01000349",1407,119,29,90,300,202,86,124,252,188,54,29,25,82
"2011","Wrexham 011B","W01000350",1306,74,10,64,174,104,54,113,239,186,61,44,17,301
"2011","Wrexham 011C","W01000365",1656,177,43,134,406,198,93,99,268,148,47,34,13,220
"2011","Wrexham 011D","W01000402",2134,148,27,121,349,188,127,163,403,302,118,81,37,336
"2011","Wrexham 012A","W01000381",840,44,18,26,137,114,45,74,168,135,45,30,15,78
"2011","Wrexham 012B","W01000382",837,43,8,35,151,71,51,59,168,168,64,30,34,62
"2011","Wrexham 012D","W01000423",1569,84,18,66,241,152,90,176,346,260,114,60,54,106
"2011","Wrexham 012E","W01000424",993,28,6,22,157,123,60,120,257,177,35,23,12,36
"2011","Wrexham 012F","W01001929",1041,33,5,28,114,76,48,115,283,227,55,30,25,90
"2011","Wrexham 012G","W01001931",1088,39,7,32,102,86,44,108,240,239,95,65,30,135
"2011","Wrexham 013A","W01000398",999,84,22,62,188,129,94,94,157,142,43,29,14,68
"2011","Wrexham 013B","W01000399",869,114,28,86,237,127,90,70,98,61,14,7,7,58
"2011","Wrexham 013C","W01000406",1557,58,26,32,181,160,103,159,337,335,121,86,35,103
"2011","Wrexham 013D","W01000408",854,71,17,54,144,99,78,77,173,118,34,19,15,60
"2011","Wrexham 014A","W01000366",1045,39,11,28,170,113,65,121,226,206,46,27,19,59
"2011","Wrexham 014B","W01000367",961,77,18,59,200,116,71,107,157,120,23,13,10,90
"2011","Wrexham 014C","W01000385",1288,80,21,59,274,219,78,173,229,141,28,19,9,66
"2011","Wrexham 014D","W01000410",1176,77,16,61,239,146,114,105,219,144,57,42,15,75
"2011","Wrexham 015A","W01000386",1111,48,13,35,144,138,62,135,229,216,68,52,16,71
"2011","Wrexham 015B","W01000405",1560,63,17,46,244,176,110,143,330,253,130,83,47,111
"2011","Wrexham 015C","W01000411",1119,37,9,28,163,97,85,117,254,216,78,53,25,72
"2011","Wrexham 015D","W01000412",1206,70,25,45,246,156,134,107,205,169,43,27,16,76
"2011","Wrexham 016A","W01000394",986,156,53,103,227,119,173,69,98,62,19,10,9,63
"2011","Wrexham 016B","W01000395",801,63,17,46,171,102,76,91,134,85,30,18,12,49
"2011","Wrexham 016C","W01000407",1021,125,23,102,277,123,98,90,133,88,20,18,2,67
"2011","Wrexham 016D","W01000419",1108,67,18,49,182,114,84,113,219,174,67,48,19,88
"2011","Wrexham 016E","W01000420",1022,69,16,53,219,111,84,107,169,135,58,34,24,70
"2011","Wrexham 017A","W01000354",1305,63,18,45,234,146,108,158,250,203,45,29,16,98
"2011","Wrexham 017B","W01000355",1156,52,15,37,145,109,92,124,276,210,85,54,31,63
"2011","Wrexham 017C","W01000356",1236,25,5,20,122,81,81,120,319,316,94,66,28,78
"2011","Wrexham 017D","W01000389",1481,122,25,97,334,196,142,145,218,173,49,24,25,102
"2011","Wrexham 017E","W01000409",1329,25,6,19,111,89,83,134,342,289,153,100,53,103
"2011","Wrexham 018A","W01000345",1199,152,53,99,316,164,161,77,153,79,33,18,15,64
"2011","Wrexham 018B","W01000346",1182,123,37,86,271,139,252,63,133,97,23,17,6,81
"2011","Wrexham 018C","W01000403",974,109,31,78,227,86,196,55,110,82,34,20,14,75
"2011","Wrexham 018D","W01000404",1414,157,31,126,349,160,225,92,176,130,41,25,16,84
"2011","Wrexham 019C","W01000359",908,56,23,33,204,133,83,79,175,79,34,17,17,65
"2011","Wrexham 019D","W01000360",860,33,13,20,119,81,52,84,197,179,51,31,20,64
"2011","Wrexham 019E","W01000361",1465,87,35,52,263,170,144,153,297,194,69,42,27,88
"2011","Wrexham 019F","W01001930",1601,111,23,88,350,155,318,138,211,163,61,44,17,94
"2011","Wrexham 020F","W01000369",888,97,17,80,221,122,79,65,136,100,21,14,7,47
"2011","Wrexham 020G","W01000370",1005,127,38,89,272,131,115,83,115,76,26,17,9,60
"2011","Wrexham 020A","W01000383",1802,207,56,151,434,248,247,137,211,148,54,28,26,116
"2011","Wrexham 020B","W01000384",780,112,33,79,198,88,116,60,85,66,17,10,7,38
"2011","Wrexham 020C","W01000390",1272,111,32,79,288,164,122,119,209,124,38,22,16,97
"2011","Wrexham 020H","W01000396",915,178,39,139,236,145,80,56,94,45,18,13,5,63
"2011","Wrexham 020I","W01000397",774,144,39,105,240,127,67,29,71,38,8,5,3,50
"2011","Wrexham 020D","W01000417",1188,232,57,175,370,141,126,73,101,49,20,13,7,76
"2011","Wrexham 020E","W01000418",1189,209,66,143,287,131,159,76,126,104,31,17,14,66
"2011","Powys 001A","W01000461",1080,66,12,54,204,83,204,86,208,125,52,34,18,52
"2011","Powys 001D","W01000470",1333,101,32,69,285,150,263,105,187,138,31,26,5,73
"2011","Powys 001E","W01000475",1771,155,34,121,412,155,477,93,224,112,45,32,13,98
"2011","Powys 001F","W01001906",1456,120,29,91,300,135,358,104,174,144,32,22,10,89
"2011","Powys 001G","W01001907",1029,97,20,77,238,77,291,57,103,76,22,17,5,68
"2011","Powys 002A","W01000444",1641,165,43,122,351,170,325,121,235,152,34,21,13,88
"2011","Powys 002B","W01000457",1575,151,36,115,374,188,284,116,212,149,28,17,11,73
"2011","Powys 002C","W01000458",1291,107,26,81,291,147,222,98,214,119,35,24,11,58
"2011","Powys 003A","W01000498",1080,40,15,25,122,79,116,95,302,213,60,38,22,53
"2011","Powys 003B","W01000499",906,31,13,18,130,76,68,88,224,178,62,48,14,49
"2011","Powys 003C","W01000500",1142,66,19,47,190,126,132,113,236,161,45,37,8,73
"2011","Powys 003D","W01000501",1577,95,21,74,305,138,198,153,307,232,75,56,19,74
"2011","Powys 004A","W01000442",1503,107,19,88,372,151,367,101,191,117,34,22,12,63
"2011","Powys 004B","W01000452",1429,124,26,98,300,120,332,98,218,114,30,24,6,93
"2011","Powys 004C","W01000473",1579,125,29,96,316,158,196,166,265,210,57,38,19,86
"2011","Powys 005A","W01000428",988,90,20,70,188,94,253,73,125,98,15,11,4,52
"2011","Powys 005B","W01000441",1008,107,34,73,238,97,222,53,137,84,21,11,10,49
"2011","Powys 005C","W01000476",945,97,14,83,220,95,131,82,138,96,26,19,7,60
"2011","Powys 005D","W01000497",1011,93,23,70,204,123,177,89,159,89,23,10,13,54
"2011","Powys 006A","W01000433",1725,101,19,82,335,189,356,146,272,191,40,24,16,95
"2011","Powys 006B","W01000460",1312,119,31,88,262,114,329,87,171,114,31,17,14,85
"2011","Powys 006C","W01000488",1635,143,36,107,336,180,390,114,219,137,31,19,12,85
"2011","Powys 007A","W01000434",1212,108,28,80,256,109,292,74,186,91,36,27,9,60
"2011","Powys 007B","W01000439",1463,104,36,68,346,182,312,101,186,122,26,17,9,84
"2011","Powys 007C","W01000447",1465,102,21,81,310,129,368,113,188,143,28,21,7,84
"2011","Powys 008A","W01000480",1517,72,17,55,210,176,174,141,305,272,76,41,35,91
"2011","Powys 008B","W01000481",1671,158,42,116,368,226,192,117,296,193,37,27,10,84
"2011","Powys 008C","W01000482",1334,129,33,96,312,155,150,81,209,184,36,23,13,78
"2011","Powys 009A","W01000478",1200,44,16,28,151,126,97,108,297,205,81,42,39,91
"2011","Powys 009B","W01000479",1009,30,4,26,122,101,81,111,250,183,61,38,23,70
"2011","Powys 009C","W01000483",1303,34,11,23,145,105,88,124,337,282,99,71,28,89
"2011","Powys 010A","W01000429",1717,142,38,104,350,148,492,95,228,126,41,27,14,95
"2011","Powys 010B","W01000453",1053,92,30,62,209,118,274,76,133,77,20,12,8,54
"2011","Powys 010C","W01000466",958,52,14,38,172,74,107,100,230,136,31,20,11,56
"2011","Powys 010D","W01000467",1105,72,13,59,225,117,186,83,185,150,33,20,13,54
"2011","Powys 011A","W01000427",1038,63,25,38,186,76,351,51,157,63,48,33,15,43
"2011","Powys 011B","W01000448",1007,53,13,40,154,100,172,95,190,151,46,30,16,46
"2011","Powys 011C","W01000449",1165,72,14,58,231,138,193,110,171,158,27,16,11,65
"2011","Powys 011D","W01000464",934,83,18,65,191,92,299,53,99,54,16,10,6,47
"2011","Powys 011E","W01000484",1186,99,26,73,257,86,358,63,138,80,27,14,13,78
"2011","Powys 011F","W01000485",1124,101,23,78,224,106,236,72,166,128,34,23,11,57
"2011","Powys 011G","W01000486",787,45,12,33,141,65,135,68,157,92,36,20,16,48
"2011","Powys 012A","W01000438",904,63,11,52,146,98,168,54,163,132,46,34,12,34
"2011","Powys 012B","W01000451",808,49,12,37,178,100,191,53,108,57,30,22,8,42
"2011","Powys 012C","W01000472",835,58,19,39,193,132,169,66,106,52,19,8,11,40
"2011","Powys 012D","W01000477",1116,101,20,81,235,113,333,55,137,70,20,18,2,52
"2011","Powys 012E","W01000487",1419,97,21,76,253,158,249,115,241,194,54,36,18,58
"2011","Powys 013A","W01000454",880,46,12,34,143,91,108,80,162,125,75,52,23,50
"2011","Powys 013B","W01000455",1481,60,18,42,269,186,146,128,311,211,87,62,25,83
"2011","Powys 013C","W01000456",1391,119,26,93,303,195,173,91,220,148,80,46,34,62
"2011","Powys 014A","W01000431",960,33,12,21,200,101,141,78,163,120,58,34,24,66
"2011","Powys 014B","W01000432",842,64,17,47,197,115,143,62,117,66,14,10,4,64
"2011","Powys 014C","W01000450",990,94,18,76,220,103,307,41,117,49,10,5,5,49
"2011","Powys 014D","W01000459",873,56,7,49,180,92,242,56,115,66,23,19,4,43
"2011","Powys 014E","W01000471",1398,94,21,73,269,137,372,91,198,130,49,31,18,58
"2011","Powys 015A","W01000430",930,73,10,63,199,96,216,72,112,73,29,23,6,60
"2011","Powys 015B","W01000443",1698,169,50,119,403,161,459,107,171,112,34,24,10,82
"2011","Powys 015C","W01000445",1153,93,20,73,257,104,275,92,133,104,34,21,13,61
"2011","Powys 015D","W01000446",1136,81,16,65,239,94,257,91,185,109,35,17,18,45
"2011","Powys 015E","W01000494",1234,93,25,68,283,139,213,88,199,107,40,25,15,72
"2011","Powys 017A","W01000489",1254,56,18,38,229,135,152,108,208,160,37,26,11,169
"2011","Powys 017D","W01000492",1175,108,30,78,291,121,150,99,191,116,34,23,11,65
"2011","Powys 017E","W01000493",1057,116,45,71,324,154,84,52,146,65,40,28,12,76
"2011","Powys 017F","W01001901",1331,119,39,80,334,192,108,91,201,153,47,27,20,86
"2011","Powys 017G","W01001902",1003,45,12,33,149,97,77,100,228,170,59,32,27,78
"2011","Powys 018E","W01000465",746,120,24,96,221,95,103,37,64,41,21,14,7,44
"2011","Powys 018F","W01001903",1530,196,47,149,418,169,183,104,182,139,56,33,23,83
"2011","Powys 018G","W01001904",1266,188,50,138,334,124,232,85,114,86,37,28,9,66
"2011","Powys 018H","W01001905",1538,169,45,124,426,143,332,81,140,111,35,23,12,101
"2011","Powys 020A","W01000440",1014,106,35,71,248,114,258,62,95,57,16,12,4,58
"2011","Powys 020B","W01000474",1297,105,30,75,273,127,348,89,167,108,22,14,8,58
"2011","Powys 020C","W01000503",786,100,27,73,205,73,227,25,58,34,13,9,4,51
"2011","Powys 020D","W01001897",1390,158,30,128,352,169,307,69,145,87,35,27,8,68
"2011","Powys 021A","W01000426",1042,75,17,58,217,139,105,93,148,176,23,12,11,66
"2011","Powys 021B","W01000496",1526,120,34,86,311,182,192,121,222,233,57,35,22,88
"2011","Powys 021C","W01000502",1490,114,39,75,321,223,110,149,196,237,61,41,20,79
"2011","Powys 021D","W01000504",847,17,7,10,95,80,60,98,171,195,64,43,21,67
"2011","Powys 021E","W01000505",1023,54,13,41,202,127,118,97,152,160,60,37,23,53
"2011","Powys 021F","W01001899",1442,78,17,61,255,176,121,143,254,251,68,45,23,96
"2011","Ceredigion 001C","W01000523",1421,175,25,150,374,144,271,72,169,94,35,22,13,87
"2011","Ceredigion 001D","W01000548",1304,144,22,122,343,158,153,92,168,110,41,31,10,95
"2011","Ceredigion 001E","W01000549",1303,151,20,131,342,175,141,88,171,93,32,17,15,110
"2011","Ceredigion 001F","W01001937",1551,180,25,155,366,143,243,107,203,151,50,29,21,108
"2011","Ceredigion 002A","W01000512",1812,159,17,142,207,81,48,40,78,38,27,18,9,1134
"2011","Ceredigion 002B","W01000513",2306,98,9,89,178,95,69,65,126,90,51,30,21,1534
"2011","Ceredigion 002D","W01000517",1296,62,2,60,128,49,42,42,72,53,33,20,13,815
"2011","Ceredigion 002F","W01001934",3532,196,10,186,289,112,104,70,155,113,54,39,15,2439
"2011","Ceredigion 003A","W01000515",1040,50,8,42,162,96,102,102,222,144,54,36,18,108
"2011","Ceredigion 003B","W01000516",1208,69,13,56,199,122,111,100,250,168,49,37,12,140
"2011","Ceredigion 003C","W01000518",956,95,9,86,155,83,69,52,113,78,19,12,7,292
"2011","Ceredigion 003E","W01001935",862,82,4,78,176,81,55,49,101,57,26,19,7,235
"2011","Ceredigion 003F","W01001936",2008,141,10,131,197,75,66,37,83,55,40,30,10,1314
"2011","Ceredigion 005A","W01000506",985,96,23,73,237,110,160,86,114,102,29,24,5,51
"2011","Ceredigion 005B","W01000524",1454,112,26,86,286,156,306,113,222,140,36,26,10,83
"2011","Ceredigion 005C","W01000538",1182,109,10,99,248,130,281,80,142,85,34,21,13,73
"2011","Ceredigion 005D","W01000539",950,67,17,50,183,84,255,65,109,78,34,26,8,75
"2011","Ceredigion 005E","W01000540",813,81,17,64,189,101,129,48,115,80,24,16,8,46
"2011","Ceredigion 007A","W01000529",1161,92,16,76,207,118,257,93,175,107,52,34,18,60
"2011","Ceredigion 007B","W01000532",1449,113,24,89,306,130,416,84,172,117,30,20,10,81
"2011","Ceredigion 007C","W01000544",776,74,17,57,157,73,176,56,90,97,18,14,4,35
"2011","Ceredigion 007D","W01000545",1534,140,32,108,356,140,385,102,163,104,52,41,11,92
"2011","Ceredigion 008A","W01000527",1219,67,6,61,105,62,92,39,96,64,35,18,17,659
"2011","Ceredigion 008B","W01000528",1013,67,9,58,159,77,128,79,172,191,54,36,18,86
"2011","Ceredigion 008C","W01000535",1481,121,28,93,257,150,379,86,205,155,52,37,15,76
"2011","Ceredigion 008D","W01000537",1113,102,14,88,221,86,290,82,151,97,23,13,10,61
"2011","Ceredigion 008E","W01000541",1390,105,22,83,264,123,310,89,205,145,47,32,15,102
"2011","Ceredigion 009A","W01000507",848,73,20,53,177,91,188,61,109,73,30,17,13,46
"2011","Ceredigion 009B","W01000508",856,61,10,51,155,84,127,69,148,101,51,36,15,60
"2011","Ceredigion 009C","W01000509",1224,81,20,61,257,136,155,83,236,143,50,35,15,83
"2011","Ceredigion 009D","W01000510",835,36,11,25,150,71,114,62,155,134,68,54,14,45
"2011","Ceredigion 009E","W01000511",866,32,12,20,118,67,148,77,161,117,79,49,30,67
"2011","Ceredigion 009F","W01000546",822,71,17,54,178,66,192,52,121,69,28,20,8,45
"2011","Ceredigion 009G","W01000547",857,65,12,53,176,75,235,53,121,72,23,19,4,37
"2011","Ceredigion 010A","W01000519",1225,99,21,78,270,104,320,74,162,104,37,25,12,55
"2011","Ceredigion 010B","W01000522",987,78,19,59,159,85,281,76,125,80,35,25,10,68
"2011","Ceredigion 010C","W01000531",1309,81,15,66,289,112,262,91,211,131,44,26,18,88
"2011","Ceredigion 010D","W01000533",1022,69,14,55,221,110,135,65,174,122,40,26,14,86
"2011","Ceredigion 010E","W01000551",973,71,19,52,194,77,247,67,139,78,29,17,12,71
"2011","Ceredigion 011A","W01000525",820,146,16,130,203,117,67,34,64,42,7,6,1,140
"2011","Ceredigion 011B","W01000534",1111,138,18,120,257,133,205,84,129,74,34,23,11,57
"2011","Ceredigion 011E","W01000536",1069,85,16,69,205,102,275,76,152,89,32,18,14,53
"2011","Ceredigion 011F","W01000542",1644,119,23,96,342,184,401,117,205,130,57,42,15,89
"2011","Ceredigion 011C","W01000543",1493,164,22,142,308,177,312,106,195,113,46,26,20,72
"2011","Ceredigion 011G","W01000550",842,51,6,45,171,79,162,65,140,96,31,19,12,47
"2011","Ceredigion 011D","W01000552",1483,153,17,136,343,169,311,88,184,98,42,27,15,95
"2011","Pembrokeshire 001A","W01000558",1479,105,25,80,284,144,345,99,229,151,48,33,15,74
"2011","Pembrokeshire 001B","W01000559",1072,61,21,40,205,100,339,65,135,75,35,21,14,57
"2011","Pembrokeshire 001C","W01000560",917,59,8,51,178,66,293,59,106,88,18,12,6,50
"2011","Pembrokeshire 001D","W01000561",919,50,9,41,172,97,203,74,124,116,24,14,10,59
"2011","Pembrokeshire 001E","W01000613",1609,122,21,101,374,132,417,89,199,126,61,44,17,89
"2011","Pembrokeshire 002A","W01000562",1263,85,18,67,268,116,366,78,153,90,41,29,12,66
"2011","Pembrokeshire 002B","W01000565",1281,69,11,58,275,134,188,98,231,150,61,40,21,75
"2011","Pembrokeshire 002C","W01000566",1095,43,8,35,220,108,135,83,223,153,73,43,30,57
"2011","Pembrokeshire 002D","W01000567",1430,94,23,71,242,115,216,115,296,210,68,42,26,74
"2011","Pembrokeshire 002E","W01000597",798,72,14,58,169,62,194,60,99,74,30,25,5,38
"2011","Pembrokeshire 002F","W01000617",1065,79,14,65,206,94,237,74,155,130,35,26,9,55
"2011","Pembrokeshire 003A","W01000579",1671,120,23,97,357,175,341,107,236,181,65,46,19,89
"2011","Pembrokeshire 003B","W01000581",1114,76,18,58,245,96,278,56,161,116,25,18,7,61
"2011","Pembrokeshire 003C","W01000612",1339,86,22,64,316,104,267,122,190,104,76,66,10,74
"2011","Pembrokeshire 003D","W01000618",1431,128,51,77,417,176,257,98,151,109,33,21,12,62
"2011","Pembrokeshire 004A","W01000582",1234,88,12,76,295,130,305,67,149,101,29,26,3,70
"2011","Pembrokeshire 004B","W01000583",1027,75,13,62,192,96,226,83,143,108,33,23,10,71
"2011","Pembrokeshire 004C","W01000611",1218,137,31,106,290,157,217,80,133,94,34,24,10,76
"2011","Pembrokeshire 004D","W01000623",1418,147,27,120,321,147,305,78,202,91,38,24,14,89
"2011","Pembrokeshire 005A","W01000568",1767,114,19,95,332,198,148,184,317,241,124,69,55,109
"2011","Pembrokeshire 005B","W01000569",896,57,14,43,216,111,75,82,169,104,32,22,10,50
"2011","Pembrokeshire 005C","W01000570",974,24,3,21,114,83,67,91,235,187,109,66,43,64
"2011","Pembrokeshire 005D","W01000572",1315,114,12,102,258,152,129,105,244,160,58,44,14,95
"2011","Pembrokeshire 006A","W01000571",1548,113,23,90,293,191,139,161,259,208,88,66,22,96
"2011","Pembrokeshire 006B","W01000573",1790,126,37,89,412,249,147,148,356,203,58,32,26,91
"2011","Pembrokeshire 006C","W01000586",1582,80,17,63,277,188,133,143,331,239,93,74,19,98
"2011","Pembrokeshire 007A","W01000577",1167,109,30,79,270,111,252,80,147,84,25,19,6,89
"2011","Pembrokeshire 007B","W01000585",1040,104,24,80,222,70,258,83,135,60,38,29,9,70
"2011","Pembrokeshire 007C","W01000595",1343,74,12,62,287,127,180,117,232,189,63,36,27,74
"2011","Pembrokeshire 007D","W01000596",1097,109,21,88,258,109,197,89,156,87,26,21,5,66
"2011","Pembrokeshire 008A","W01000555",1071,96,12,84,248,99,245,60,143,81,40,36,4,59
"2011","Pembrokeshire 008B","W01000556",846,63,14,49,200,106,158,57,121,82,18,15,3,41
"2011","Pembrokeshire 008C","W01000575",1755,88,24,64,325,186,244,169,343,237,71,50,21,92
"2011","Pembrokeshire 008D","W01000614",1049,91,24,67,207,113,179,102,155,104,38,23,15,60
"2011","Pembrokeshire 008E","W01000622",1099,115,21,94,288,116,236,79,109,75,31,23,8,50
"2011","Pembrokeshire 009A","W01000554",1353,128,32,96,358,150,200,119,154,118,59,45,14,67
"2011","Pembrokeshire 009B","W01000580",1698,113,23,90,466,193,206,146,241,167,44,25,19,122
"2011","Pembrokeshire 009C","W01000598",1627,90,26,64,297,203,146,160,337,240,70,49,21,84
"2011","Pembrokeshire 009D","W01000599",1560,70,25,45,258,176,164,166,298,255,77,55,22,96
"2011","Pembrokeshire 010A","W01000587",1475,71,19,52,278,124,128,153,298,258,87,54,33,78
"2011","Pembrokeshire 010B","W01000588",1510,55,13,42,213,155,83,164,328,301,111,59,52,100
"2011","Pembrokeshire 010C","W01000593",1960,90,20,70,386,250,149,244,371,275,88,65,23,107
"2011","Pembrokeshire 011A","W01000553",935,78,19,59,213,95,207,65,116,82,32,21,11,47
"2011","Pembrokeshire 011B","W01000563",883,55,9,46,162,97,186,68,131,84,43,38,5,57
"2011","Pembrokeshire 011C","W01000564",848,52,12,40,167,85,121,84,157,99,31,21,10,52
"2011","Pembrokeshire 011D","W01000576",1581,102,25,77,282,158,262,148,291,166,72,53,19,100
"2011","Pembrokeshire 011E","W01000615",1076,83,21,62,262,108,181,82,161,101,33,21,12,65
"2011","Pembrokeshire 011F","W01000616",790,50,9,41,148,62,155,82,129,95,30,20,10,39
"2011","Pembrokeshire 012A","W01000589",786,17,4,13,128,71,53,85,177,160,46,19,27,49
"2011","Pembrokeshire 012B","W01000590",784,33,7,26,145,73,85,96,159,109,46,33,13,38
"2011","Pembrokeshire 012C","W01000591",875,31,13,18,142,106,60,106,192,126,42,29,13,70
"2011","Pembrokeshire 012D","W01000592",900,21,5,16,105,50,60,93,214,205,90,66,24,62
"2011","Pembrokeshire 012E","W01000594",1594,43,10,33,214,143,139,155,329,316,155,106,49,100
"2011","Pembrokeshire 013A","W01000600",1198,47,9,38,179,108,107,110,276,197,99,67,32,75
"2011","Pembrokeshire 013B","W01000601",1056,26,6,20,102,89,61,114,259,213,125,102,23,67
"2011","Pembrokeshire 013C","W01000602",923,45,9,36,154,110,87,104,198,122,53,33,20,50
"2011","Pembrokeshire 013D","W01000603",1370,63,18,45,232,131,116,152,284,202,97,71,26,93
"2011","Pembrokeshire 013E","W01000604",1098,37,10,27,161,110,90,147,239,173,68,47,21,73
"2011","Pembrokeshire 013F","W01000605",1345,59,13,46,199,182,99,155,271,210,57,38,19,113
"2011","Pembrokeshire 014A","W01000557",1107,72,17,55,244,129,173,113,167,114,27,16,11,68
"2011","Pembrokeshire 014B","W01000578",1235,124,31,93,263,162,199,119,170,102,42,29,13,54
"2011","Pembrokeshire 014C","W01000584",1506,121,26,95,326,151,277,138,224,130,49,29,20,90
"2011","Pembrokeshire 014D","W01000609",1750,134,23,111,409,242,186,190,277,195,45,35,10,72
"2011","Pembrokeshire 015A","W01000574",1418,89,25,64,320,168,246,141,186,122,56,36,20,90
"2011","Pembrokeshire 015B","W01000606",1119,24,5,19,120,86,98,112,257,206,148,107,41,68
"2011","Pembrokeshire 015C","W01000607",1397,44,19,25,208,136,112,169,285,249,120,97,23,74
"2011","Pembrokeshire 015D","W01000608",1037,45,15,30,159,113,105,131,203,133,89,64,25,59
"2011","Pembrokeshire 016A","W01000610",1204,101,33,68,276,118,214,96,185,106,41,30,11,67
"2011","Pembrokeshire 016B","W01000619",1491,100,33,67,318,146,223,148,252,175,38,25,13,91
"2011","Pembrokeshire 016C","W01000620",755,46,15,31,176,52,120,87,108,95,36,17,19,35
"2011","Pembrokeshire 016D","W01000621",1086,69,21,48,191,99,160,109,197,158,48,36,12,55
"2011","Carmarthenshire 001A","W01000685",1163,68,13,55,182,131,244,89,191,155,44,27,17,59
"2011","Carmarthenshire 001B","W01000686",933,65,18,47,164,103,237,64,137,84,30,21,9,49
"2011","Carmarthenshire 001C","W01000701",1083,81,18,63,210,119,220,74,175,115,42,29,13,47
"2011","Carmarthenshire 001D","W01000702",881,40,16,24,115,76,126,66,178,170,58,39,19,52
"2011","Carmarthenshire 002A","W01000647",1133,101,19,82,199,88,343,57,134,97,41,23,18,73
"2011","Carmarthenshire 002B","W01000650",1228,107,25,82,218,97,367,67,177,94,43,31,12,58
"2011","Carmarthenshire 002C","W01000678",1006,76,13,63,198,81,193,74,137,101,54,45,9,92
"2011","Carmarthenshire 002D","W01000679",910,38,8,30,182,63,144,83,172,114,33,21,12,81
"2011","Carmarthenshire 003A","W01000646",1580,111,22,89,297,158,377,92,226,139,89,66,23,91
"2011","Carmarthenshire 003B","W01000688",1309,90,14,76,218,123,269,81,213,157,76,52,24,82
"2011","Carmarthenshire 003C","W01000689",1209,82,12,70,253,139,278,77,160,108,41,32,9,71
"2011","Carmarthenshire 003D","W01000728",1580,105,18,87,304,144,501,80,208,113,40,26,14,85
"2011","Carmarthenshire 004A","W01000676",1089,141,37,104,267,115,212,52,113,86,26,21,5,77
"2011","Carmarthenshire 004B","W01000677",968,76,18,58,197,102,117,64,174,138,51,35,16,49
"2011","Carmarthenshire 004C","W01000687",1433,139,39,100,281,124,401,66,168,116,68,54,14,70
"2011","Carmarthenshire 004D","W01000709",1686,160,29,131,377,170,388,91,204,129,69,46,23,98
"2011","Carmarthenshire 005A","W01000624",1685,185,42,143,422,216,309,101,177,138,39,24,15,98
"2011","Carmarthenshire 005B","W01000682",988,108,28,80,270,117,205,45,100,66,24,18,6,53
"2011","Carmarthenshire 005C","W01000683",839,77,12,65,164,74,269,40,95,62,20,19,1,38
"2011","Carmarthenshire 005D","W01000684",1353,121,24,97,316,165,287,72,142,127,49,29,20,74
"2011","Carmarthenshire 006A","W01000643",1151,70,11,59,238,148,75,64,209,171,57,28,29,119
"2011","Carmarthenshire 006B","W01000644",1439,89,18,71,265,115,96,62,135,75,53,45,8,549
"2011","Carmarthenshire 006C","W01000645",1162,79,16,63,281,125,104,63,167,132,44,29,15,167
"2011","Carmarthenshire 006D","W01000648",1114,91,24,67,237,121,301,68,135,75,27,22,5,59
"2011","Carmarthenshire 006E","W01000649",1150,98,22,76,286,149,236,64,144,88,21,16,5,64
"2011","Carmarthenshire 007A","W01000637",996,52,16,36,178,120,78,82,181,157,57,42,15,91
"2011","Carmarthenshire 007B","W01000638",820,31,4,27,114,88,62,83,154,172,57,39,18,59
"2011","Carmarthenshire 007C","W01000639",985,81,16,65,212,109,71,53,172,136,47,34,13,104
"2011","Carmarthenshire 007D","W01000640",864,131,19,112,247,119,89,48,89,67,21,15,6,53
"2011","Carmarthenshire 008A","W01000641",1519,86,16,70,251,151,136,131,270,251,98,61,37,145
"2011","Carmarthenshire 008B","W01000642",1196,109,21,88,330,186,110,60,168,101,45,31,14,87
"2011","Carmarthenshire 008C","W01000693",740,35,8,27,165,100,66,46,139,127,21,15,6,41
"2011","Carmarthenshire 008D","W01000694",995,107,22,85,231,136,149,56,134,96,21,11,10,65
"2011","Carmarthenshire 010A","W01000656",1530,79,29,50,281,166,139,160,274,242,98,64,34,91
"2011","Carmarthenshire 010B","W01000657",798,43,15,28,116,83,96,61,178,119,40,28,12,62
"2011","Carmarthenshire 010C","W01000658",917,40,11,29,177,120,81,92,147,148,48,24,24,64
"2011","Carmarthenshire 010D","W01000718",1032,36,8,28,168,140,88,85,180,186,65,41,24,84
"2011","Carmarthenshire 010E","W01000719",1087,57,13,44,230,144,118,106,163,155,38,24,14,76
"2011","Carmarthenshire 011A","W01000680",1437,161,42,119,402,191,132,102,184,143,35,23,12,87
"2011","Carmarthenshire 011B","W01000681",1404,66,8,58,225,153,163,103,293,235,94,65,29,72
"2011","Carmarthenshire 011C","W01000724",1349,86,20,66,283,174,136,114,230,183,66,50,16,77
"2011","Carmarthenshire 011D","W01000725",1568,101,29,72,311,208,159,127,279,227,70,48,22,86
"2011","Carmarthenshire 012A","W01000675",1473,140,31,109,339,177,286,111,167,132,31,22,9,90
"2011","Carmarthenshire 012B","W01000695",1140,58,6,52,221,141,131,107,165,184,60,47,13,73
"2011","Carmarthenshire 012C","W01000696",1133,68,22,46,243,127,191,91,162,132,43,35,8,76
"2011","Carmarthenshire 012D","W01000722",952,101,30,71,227,113,201,46,113,83,19,11,8,49
"2011","Carmarthenshire 012E","W01000723",1022,108,23,85,278,120,159,62,128,69,35,26,9,63
"2011","Carmarthenshire 013A","W01000625",841,31,11,20,114,94,64,65,170,176,66,45,21,61
"2011","Carmarthenshire 013B","W01000626",1012,60,16,44,192,120,70,77,204,174,45,28,17,70
"2011","Carmarthenshire 013C","W01000627",1524,97,22,75,378,208,128,125,232,191,82,56,26,83
"2011","Carmarthenshire 013D","W01000714",1044,64,20,44,186,107,76,94,210,175,62,37,25,70
"2011","Carmarthenshire 013E","W01000715",959,66,18,48,241,151,80,78,143,99,27,18,9,74
"2011","Carmarthenshire 015A","W01000697",1328,64,16,48,238,122,112,145,233,256,74,44,30,84
"2011","Carmarthenshire 015B","W01000698",1343,67,23,44,203,191,121,125,235,258,79,51,28,64
"2011","Carmarthenshire 015C","W01000699",1161,119,35,84,280,146,190,81,137,105,39,31,8,64
"2011","Carmarthenshire 015D","W01000712",1113,86,19,67,251,137,103,109,169,162,37,25,12,59
"2011","Carmarthenshire 015E","W01000713",1025,65,21,44,193,115,92,96,164,185,40,29,11,75
"2011","Carmarthenshire 016A","W01000662",1616,116,27,89,324,211,165,148,247,236,55,37,18,114
"2011","Carmarthenshire 016B","W01000663",1673,131,29,102,385,232,146,135,250,227,56,33,23,111
"2011","Carmarthenshire 016C","W01000664",1324,101,21,80,288,165,150,96,198,178,61,43,18,87
"2011","Carmarthenshire 016D","W01000716",999,60,17,43,216,131,129,82,147,141,36,27,9,57
"2011","Carmarthenshire 016E","W01000717",1030,54,14,40,186,99,87,88,205,182,58,35,23,71
"2011","Carmarthenshire 017A","W01000665",1365,181,37,144,391,173,144,81,156,113,41,30,11,85
"2011","Carmarthenshire 017B","W01000666",1038,63,13,50,229,140,90,105,177,142,45,38,7,47
"2011","Carmarthenshire 017C","W01000731",1820,110,27,83,379,270,185,163,279,238,71,45,26,125
"2011","Carmarthenshire 018A","W01000670",1163,52,12,40,181,129,110,107,251,204,57,34,23,72
"2011","Carmarthenshire 018B","W01000671",1350,101,15,86,282,188,139,101,218,162,55,37,18,104
"2011","Carmarthenshire 018C","W01000729",930,30,11,19,102,94,70,101,206,187,75,57,18,65
"2011","Carmarthenshire 018D","W01000730",966,57,10,47,183,117,110,95,159,140,42,32,10,63
"2011","Carmarthenshire 019A","W01000690",1261,108,26,82,307,197,96,106,200,145,39,33,6,63
"2011","Carmarthenshire 019B","W01000691",1164,84,22,62,265,176,95,92,185,126,54,35,19,87
"2011","Carmarthenshire 019C","W01000692",1139,82,18,64,245,175,89,99,178,126,52,29,23,93
"2011","Carmarthenshire 019D","W01000726",1165,140,44,96,318,166,125,75,147,85,18,13,5,91
"2011","Carmarthenshire 019E","W01000727",768,58,11,47,167,97,57,75,157,105,21,13,8,31
"2011","Carmarthenshire 020A","W01000651",1164,63,25,38,228,154,81,110,229,170,47,35,12,82
"2011","Carmarthenshire 020B","W01000652",1314,64,12,52,208,119,85,116,283,224,118,69,49,97
"2011","Carmarthenshire 020C","W01000655",1423,52,14,38,227,126,91,122,321,259,118,94,24,107
"2011","Carmarthenshire 021A","W01000632",1036,58,6,52,187,125,96,84,208,146,62,38,24,70
"2011","Carmarthenshire 021B","W01000633",990,32,7,25,147,94,113,105,229,148,63,36,27,59
"2011","Carmarthenshire 021C","W01000634",987,73,11,62,208,134,82,86,192,124,37,20,17,51
"2011","Carmarthenshire 021D","W01000710",1601,163,43,120,424,240,166,129,214,141,41,22,19,83
"2011","Carmarthenshire 021E","W01000711",1441,63,17,46,239,148,123,149,280,248,95,67,28,96
"2011","Carmarthenshire 022A","W01000703",1283,78,18,60,230,178,94,103,248,191,89,65,24,72
"2011","Carmarthenshire 022B","W01000704",1153,100,21,79,296,153,90,78,187,131,44,34,10,74
"2011","Carmarthenshire 022C","W01000705",1322,58,13,45,204,147,84,107,302,211,113,86,27,96
"2011","Carmarthenshire 023A","W01000653",1046,95,24,71,264,142,90,75,125,114,67,49,18,74
"2011","Carmarthenshire 023B","W01000654",1229,67,12,55,219,158,95,93,254,164,76,53,23,103
"2011","Carmarthenshire 023C","W01000667",988,78,21,57,200,146,79,76,191,122,39,34,5,57
"2011","Carmarthenshire 023F","W01001925",1686,138,41,97,401,185,167,118,287,184,92,62,30,114
"2011","Carmarthenshire 024A","W01000628",1162,66,17,49,241,154,99,105,229,146,42,29,13,80
"2011","Carmarthenshire 024B","W01000629",1241,59,16,43,211,154,77,98,297,216,56,40,16,73
"2011","Carmarthenshire 024C","W01000630",1186,63,17,46,196,180,87,98,239,170,68,52,16,85
"2011","Carmarthenshire 024D","W01000631",1247,39,9,30,143,88,60,121,316,271,139,101,38,70
"2011","Carmarthenshire 025A","W01000635",1666,157,42,115,419,258,145,131,248,173,42,29,13,93
"2011","Carmarthenshire 025B","W01000636",1341,71,15,56,247,158,81,118,284,200,85,59,26,97
"2011","Carmarthenshire 025C","W01000706",1182,46,19,27,205,147,77,124,255,179,75,51,24,74
"2011","Carmarthenshire 025D","W01000707",1007,32,12,20,136,91,68,78,233,188,114,88,26,67
"2011","Carmarthenshire 025E","W01000708",972,22,4,18,134,69,66,87,227,187,122,78,44,58
"2011","Carmarthenshire 026A","W01000659",1078,26,5,21,127,93,67,89,266,215,123,73,50,72
"2011","Carmarthenshire 026B","W01000660",1135,41,10,31,145,112,74,99,266,237,92,58,34,69
"2011","Carmarthenshire 026D","W01000732",1037,44,8,36,144,115,57,105,232,211,62,46,16,67
"2011","Carmarthenshire 026E","W01000733",927,24,9,15,103,63,65,72,230,189,131,94,37,50
"2011","Carmarthenshire 026F","W01000734",1033,39,13,26,113,79,51,95,271,198,100,66,34,87
"2011","Carmarthenshire 026G","W01001923",979,90,19,71,212,97,83,81,173,128,62,45,17,53
"2011","Carmarthenshire 026H","W01001924",935,27,4,23,124,81,71,62,229,184,105,68,37,52
"2011","Carmarthenshire 027E","W01000672",1219,65,15,50,217,108,291,104,183,133,41,31,10,77
"2011","Carmarthenshire 027F","W01000673",879,62,10,52,171,89,154,67,131,119,37,19,18,49
"2011","Carmarthenshire 027A","W01000674",1570,121,28,93,281,135,459,72,210,124,69,56,13,99
"2011","Carmarthenshire 027G","W01000700",1506,150,37,113,359,199,303,70,190,104,41,26,15,90
"2011","Carmarthenshire 027B","W01000720",1224,95,19,76,262,131,177,90,209,127,74,61,13,59
"2011","Carmarthenshire 027C","W01000721",952,58,2,56,173,114,149,72,168,113,35,26,9,70
"2011","Carmarthenshire 027D","W01000735",1639,108,22,86,323,172,248,137,276,189,71,55,16,115
"2011","Swansea 001A","W01000845",1458,135,26,109,384,229,81,131,188,162,40,24,16,108
"2011","Swansea 001B","W01000846",1249,93,17,76,275,177,100,108,197,159,64,43,21,76
"2011","Swansea 001C","W01000847",906,49,18,31,188,123,69,77,169,135,36,26,10,60
"2011","Swansea 001D","W01000848",836,43,11,32,140,105,44,82,162,149,58,39,19,53
"2011","Swansea 002A","W01000750",1118,56,13,43,224,159,68,104,205,164,68,50,18,70
"2011","Swansea 002B","W01000751",1066,92,24,68,270,201,98,103,141,91,21,14,7,49
"2011","Swansea 002C","W01000752",1076,42,14,28,149,160,80,110,194,200,79,57,22,62
"2011","Swansea 002D","W01000753",1015,44,16,28,185,150,70,101,179,148,57,38,19,81
"2011","Swansea 002E","W01000754",1170,58,14,44,253,162,105,106,197,154,54,38,16,81
"2011","Swansea 002F","W01000803",1381,127,19,108,302,202,194,113,182,151,38,20,18,72
"2011","Swansea 003A","W01000806",1109,56,14,42,240,196,63,103,204,136,31,22,9,80
"2011","Swansea 003B","W01000807",1161,91,33,58,303,248,53,92,151,105,24,14,10,94
"2011","Swansea 003C","W01000808",1089,68,18,50,241,191,70,91,177,136,43,29,14,72
"2011","Swansea 003D","W01000810",940,13,2,11,113,105,45,77,205,236,83,61,22,63
"2011","Swansea 003E","W01000815",1236,149,33,116,331,225,84,97,148,91,31,21,10,80
"2011","Swansea 003F","W01000816",1295,151,22,129,376,233,95,81,138,101,33,21,12,87
"2011","Swansea 004A","W01000791",1123,100,27,73,323,226,59,79,157,76,18,13,5,85
"2011","Swansea 004B","W01000792",1234,145,38,107,348,243,109,79,130,75,24,12,12,81
"2011","Swansea 004C","W01000793",1389,194,39,155,409,246,110,89,143,87,28,19,9,83
"2011","Swansea 004D","W01000837",1207,203,40,163,339,228,95,68,120,55,31,24,7,68
"2011","Swansea 004E","W01000838",892,50,9,41,148,97,38,78,182,181,61,49,12,57
"2011","Swansea 005A","W01000773",1910,108,28,80,394,295,122,171,345,292,84,50,34,99
"2011","Swansea 005B","W01000774",1153,73,17,56,220,168,97,96,206,158,71,50,21,64
"2011","Swansea 005C","W01000841",1092,73,25,48,191,146,77,80,236,160,47,33,14,82
"2011","Swansea 005D","W01000842",1048,66,16,50,191,165,100,95,193,134,41,27,14,63
"2011","Swansea 005E","W01000843",1025,68,19,49,239,170,57,87,160,147,23,18,5,74
"2011","Swansea 005F","W01000844",890,45,13,32,138,119,47,80,168,139,90,72,18,64
"2011","Swansea 006A","W01000795",1204,130,24,106,315,221,83,102,150,104,30,20,10,69
"2011","Swansea 006B","W01000796",2007,228,38,190,533,375,126,160,238,166,56,39,17,125
"2011","Swansea 006C","W01000800",1130,115,26,89,329,192,100,93,126,79,20,14,6,76
"2011","Swansea 006D","W01000801",1109,34,12,22,157,145,65,93,239,197,97,73,24,82
"2011","Swansea 007A","W01000784",959,59,7,52,207,167,71,93,166,106,30,16,14,60
"2011","Swansea 007B","W01000785",994,92,18,74,238,192,61,96,156,71,17,7,10,71
"2011","Swansea 007C","W01000786",1044,67,21,46,248,178,80,98,176,105,17,11,6,75
"2011","Swansea 007D","W01000802",1739,130,29,101,411,236,120,137,287,232,76,47,29,110
"2011","Swansea 007E","W01000877",1139,76,20,56,268,180,81,87,197,137,33,23,10,80
"2011","Swansea 007F","W01000878",898,60,16,44,172,154,63,69,153,128,28,21,7,71
"2011","Swansea 008A","W01000809",1158,59,12,47,239,183,65,99,218,160,60,35,25,75
"2011","Swansea 008B","W01000811",1167,42,10,32,168,170,62,102,242,207,98,73,25,76
"2011","Swansea 008C","W01000812",1068,36,12,24,148,133,81,96,212,205,91,71,20,66
"2011","Swansea 008D","W01000813",1179,82,16,66,271,190,92,91,208,121,38,31,7,86
"2011","Swansea 008E","W01000814",1102,29,14,15,146,140,65,103,238,202,110,77,33,69
"2011","Swansea 009A","W01000817",1256,47,10,37,126,142,69,123,249,266,136,109,27,98
"2011","Swansea 009B","W01000818",1105,32,5,27,165,168,67,101,214,224,74,48,26,60
"2011","Swansea 009C","W01000819",1098,90,16,74,275,217,64,95,154,110,22,17,5,71
"2011","Swansea 009D","W01000820",1047,42,10,32,202,198,82,97,193,128,43,29,14,62
"2011","Swansea 009E","W01000821",1099,60,14,46,192,163,106,103,199,159,54,40,14,63
"2011","Swansea 009F","W01000822",931,61,15,46,192,174,67,81,159,121,33,23,10,43
"2011","Swansea 010A","W01000794",1637,137,18,119,366,287,120,155,251,156,60,45,15,105
"2011","Swansea 010B","W01000797",1125,76,14,62,227,197,73,111,201,125,41,28,13,74
"2011","Swansea 010C","W01000798",1098,53,14,39,176,187,95,121,213,138,42,31,11,73
"2011","Swansea 010D","W01000799",1341,45,12,33,194,173,73,126,301,232,98,70,28,99
"2011","Swansea 011A","W01000830",1123,20,2,18,74,81,41,99,263,267,174,133,41,104
"2011","Swansea 011B","W01000832",1165,22,6,16,109,110,67,91,282,260,156,104,52,68
"2011","Swansea 011C","W01000833",1164,17,3,14,100,81,48,107,293,276,151,117,34,91
"2011","Swansea 011D","W01000834",1039,18,4,14,118,108,71,82,211,231,108,83,25,92
"2011","Swansea 011E","W01000836",1593,86,12,74,223,152,95,146,341,245,200,161,39,105
"2011","Swansea 012A","W01000759",1107,75,18,57,261,193,98,73,191,134,30,20,10,52
"2011","Swansea 012B","W01000777",1322,130,32,98,390,239,91,101,175,98,22,19,3,76
"2011","Swansea 012C","W01000778",1390,124,24,100,401,241,97,95,196,99,45,38,7,92
"2011","Swansea 012D","W01000779",1091,92,28,64,272,157,96,80,138,110,50,31,19,96
"2011","Swansea 013A","W01000760",1239,49,14,35,212,189,99,116,235,194,57,47,10,88
"2011","Swansea 013B","W01000761",1138,55,19,36,199,167,78,82,205,173,84,55,29,95
"2011","Swansea 013C","W01000762",1123,31,7,24,110,124,60,95,238,272,93,62,31,100
"2011","Swansea 013D","W01000831",1272,34,8,26,138,124,69,132,316,257,135,101,34,67
"2011","Swansea 013E","W01000835",954,27,8,19,99,97,73,79,221,216,74,60,14,68
"2011","Swansea 014A","W01000738",1266,23,5,18,117,120,86,99,293,291,164,127,37,73
"2011","Swansea 014B","W01000739",1424,74,4,70,239,181,82,148,256,227,109,85,24,108
"2011","Swansea 014C","W01000740",1197,52,17,35,170,173,105,146,275,176,46,35,11,54
"2011","Swansea 014D","W01000741",1113,30,11,19,137,138,60,109,256,233,78,52,26,72
"2011","Swansea 015A","W01000763",1094,48,15,33,160,177,68,120,233,161,49,38,11,78
"2011","Swansea 015B","W01000764",1211,41,8,33,207,184,66,140,257,182,53,39,14,81
"2011","Swansea 015C","W01000765",1226,57,13,44,219,179,89,115,247,174,67,42,25,79
"2011","Swansea 015D","W01000766",1119,46,12,34,204,188,83,101,217,147,32,21,11,101
"2011","Swansea 015E","W01000767",1087,28,6,22,151,127,81,97,238,211,80,61,19,74
"2011","Swansea 016A","W01000742",1163,23,4,19,115,99,66,91,289,231,164,116,48,85
"2011","Swansea 016B","W01000744",1193,52,11,41,164,134,59,89,252,204,102,79,23,137
"2011","Swansea 016C","W01000787",1160,44,11,33,209,164,88,119,242,150,71,51,20,73
"2011","Swansea 016D","W01000788",1096,29,5,24,149,168,61,107,213,220,74,55,19,75
"2011","Swansea 016E","W01000789",1067,24,8,16,140,153,78,102,231,199,57,43,14,83
"2011","Swansea 016F","W01000790",1270,32,10,22,147,139,67,170,234,249,141,117,24,91
"2011","Swansea 017A","W01000755",1417,78,15,63,269,211,105,122,261,197,69,51,18,105
"2011","Swansea 017B","W01000756",1168,39,4,35,179,129,89,92,261,198,102,77,25,79
"2011","Swansea 017C","W01000757",1074,55,14,41,250,168,82,96,198,118,44,32,12,63
"2011","Swansea 017D","W01000758",1395,123,29,94,328,207,84,103,230,137,71,54,17,112
"2011","Swansea 018A","W01000772",1149,166,32,134,357,151,108,57,120,60,22,12,10,108
"2011","Swansea 018B","W01000828",1248,140,40,100,299,180,169,91,154,106,30,18,12,79
"2011","Swansea 018C","W01000829",1397,107,28,79,328,181,131,124,213,159,52,40,12,102
"2011","Swansea 019A","W01000862",1099,22,2,20,83,90,54,67,246,255,189,137,52,93
"2011","Swansea 019B","W01000863",1085,16,3,13,99,110,49,90,213,246,162,131,31,100
"2011","Swansea 019C","W01000864",1117,24,2,22,87,85,35,97,257,275,170,139,31,87
"2011","Swansea 019D","W01000865",953,22,9,13,115,106,51,80,226,178,79,59,20,96
"2011","Swansea 019E","W01000866",827,16,4,12,73,75,50,65,189,177,111,88,23,71
"2011","Swansea 019F","W01000867",941,19,3,16,106,90,50,83,168,211,117,93,24,97
"2011","Swansea 020A","W01000768",1037,103,25,78,245,163,93,92,136,97,34,26,8,74
"2011","Swansea 020B","W01000769",1035,102,20,82,284,187,80,66,143,63,20,14,6,90
"2011","Swansea 020C","W01000770",1155,105,32,73,316,209,95,95,144,75,20,14,6,96
"2011","Swansea 020D","W01000771",958,125,23,102,234,172,94,55,106,68,44,31,13,60
"2011","Swansea 021A","W01000849",1328,45,8,37,133,148,75,125,313,277,100,86,14,112
"2011","Swansea 021B","W01000850",1793,135,14,121,332,219,119,122,315,233,124,80,44,194
"2011","Swansea 021C","W01000851",1178,67,15,52,184,163,71,106,243,170,67,47,20,107
"2011","Swansea 021D","W01000852",1105,49,8,41,155,160,77,109,232,164,58,40,18,101
"2011","Swansea 022A","W01000853",1067,134,21,113,302,161,80,57,121,66,30,17,13,116
"2011","Swansea 022B","W01000854",1033,156,25,131,299,153,71,54,109,60,55,47,8,76
"2011","Swansea 022C","W01000855",1080,179,26,153,327,147,87,59,103,61,22,13,9,95
"2011","Swansea 022D","W01000856",1201,89,16,73,216,135,89,87,198,172,107,73,34,108
"2011","Swansea 022E","W01000857",1178,154,21,133,268,142,83,73,141,108,61,39,22,148
"2011","Swansea 023B","W01000781",1149,180,36,144,340,184,95,65,109,61,17,12,5,98
"2011","Swansea 023C","W01000782",751,75,21,54,192,137,62,61,107,47,16,12,4,54
"2011","Swansea 023E","W01001956",2488,176,38,138,364,216,108,76,135,79,36,25,11,1298
"2011","Swansea 024A","W01000747",1637,77,15,62,175,112,72,81,118,103,93,83,10,806
"2011","Swansea 024B","W01000868",1062,112,16,96,254,133,70,49,92,60,10,8,2,282
"2011","Swansea 024C","W01000869",1288,137,18,119,269,115,77,57,133,71,70,50,20,359
"2011","Swansea 024D","W01000870",1357,148,19,129,215,116,59,41,107,53,45,37,8,573
"2011","Swansea 024E","W01000872",1019,196,15,181,285,133,72,42,83,45,22,13,9,141
"2011","Swansea 024F","W01000874",1786,131,11,120,214,105,61,59,79,41,37,25,12,1059
"2011","Swansea 025B","W01000745",1970,82,17,65,199,136,99,119,225,203,182,131,51,725
"2011","Swansea 025C","W01000746",1487,81,14,67,229,136,68,89,173,140,91,53,38,480
"2011","Swansea 025E","W01001938",1070,153,21,132,202,104,54,46,76,52,37,21,16,346
"2011","Swansea 025F","W01001955",1355,53,3,50,162,115,72,99,187,209,164,118,46,294
"2011","Swansea 025G","W01001957",870,43,6,37,112,68,71,55,102,131,103,94,9,185
"2011","Swansea 025H","W01001958",1143,168,30,138,223,107,63,37,66,69,50,36,14,360
"2011","Swansea 026A","W01000749",1378,70,11,59,151,133,95,83,216,156,79,59,20,395
"2011","Swansea 026B","W01000871",1574,57,8,49,179,129,69,69,140,108,92,63,29,731
"2011","Swansea 026C","W01000873",1633,61,8,53,151,86,49,40,82,67,60,47,13,1037
"2011","Swansea 026D","W01000875",1819,71,8,63,197,115,68,49,110,88,60,46,14,1061
"2011","Swansea 026E","W01000876",1842,71,6,65,156,88,40,42,70,38,43,33,10,1294
"2011","Swansea 027A","W01000858",1280,244,38,206,339,143,93,47,116,50,37,29,8,211
"2011","Swansea 027B","W01000859",994,186,32,154,278,144,80,36,87,43,39,32,7,101
"2011","Swansea 027C","W01000860",1078,248,37,211,323,138,88,37,63,28,24,18,6,129
"2011","Swansea 027D","W01000861",1513,111,17,94,164,82,54,22,53,37,31,20,11,959
"2011","Swansea 028A","W01000736",1163,246,52,194,345,160,129,55,92,45,12,3,9,79
"2011","Swansea 028B","W01000737",1038,173,39,134,298,118,124,59,116,48,20,10,10,82
"2011","Swansea 028C","W01000804",986,190,33,157,315,140,86,50,80,42,25,18,7,58
"2011","Swansea 028D","W01000805",833,165,37,128,305,106,73,24,64,19,14,7,7,63
"2011","Swansea 029A","W01000879",1264,198,36,162,389,198,120,63,118,44,34,21,13,100
"2011","Swansea 029B","W01000880",1097,148,22,126,351,137,112,65,103,54,41,30,11,86
"2011","Swansea 029C","W01000881",939,75,13,62,197,95,90,77,142,132,67,48,19,64
"2011","Swansea 029D","W01000882",1189,83,16,67,228,186,82,95,228,146,63,46,17,78
"2011","Swansea 030A","W01000775",1320,199,43,156,364,119,275,74,120,57,31,22,9,81
"2011","Swansea 030B","W01000776",1325,254,55,199,361,144,238,62,100,57,34,30,4,75
"2011","Swansea 030C","W01000839",682,90,18,72,210,93,76,54,74,37,9,7,2,39
"2011","Swansea 030D","W01000840",1166,232,38,194,365,140,145,54,95,48,20,13,7,67
"2011","Swansea 031A","W01000823",1160,216,54,162,366,160,129,42,111,37,19,11,8,80
"2011","Swansea 031B","W01000824",1103,290,66,224,332,126,126,44,74,29,21,9,12,61
"2011","Swansea 031C","W01000825",1089,186,29,157,310,146,107,60,81,70,19,12,7,110
"2011","Swansea 031D","W01000826",953,186,34,152,287,125,106,59,81,30,24,12,12,55
"2011","Swansea 031E","W01000827",995,210,30,180,306,97,101,48,81,37,19,13,6,96
"2011","Neath Port Talbot 002A","W01000918",1433,84,22,62,250,199,124,151,238,240,60,47,13,87
"2011","Neath Port Talbot 002B","W01000944",885,27,7,20,119,95,63,99,180,217,47,28,19,38
"2011","Neath Port Talbot 002C","W01000965",1566,64,24,40,217,171,130,186,291,297,124,100,24,86
"2011","Neath Port Talbot 003A","W01000893",1487,60,26,34,221,151,92,134,294,333,96,68,28,106
"2011","Neath Port Talbot 003B","W01000925",1080,45,13,32,159,102,81,84,230,222,84,53,31,73
"2011","Neath Port Talbot 003C","W01000926",1382,72,17,55,278,169,136,114,256,244,51,33,18,62
"2011","Neath Port Talbot 004A","W01000888",1742,146,39,107,414,251,124,134,245,223,82,54,28,123
"2011","Neath Port Talbot 004B","W01000946",1151,90,22,68,230,130,109,106,184,133,64,37,27,105
"2011","Neath Port Talbot 004C","W01000947",1463,100,26,74,263,200,79,105,269,259,105,75,30,83
"2011","Neath Port Talbot 004D","W01000948",1352,92,26,66,297,188,128,103,207,187,63,51,12,87
"2011","Neath Port Talbot 004E","W01000955",933,94,24,70,233,125,71,82,125,110,31,23,8,62
"2011","Neath Port Talbot 004F","W01000956",892,88,26,62,234,161,69,91,104,96,15,7,8,34
"2011","Neath Port Talbot 004G","W01000971",1069,72,18,54,203,143,97,92,171,156,52,39,13,83
"2011","Neath Port Talbot 005A","W01000887",1741,130,37,93,351,258,132,160,270,245,82,59,23,113
"2011","Neath Port Talbot 005B","W01000953",1279,51,23,28,195,133,107,102,295,244,81,60,21,71
"2011","Neath Port Talbot 005C","W01000954",1048,64,21,43,192,133,81,87,222,166,55,34,21,48
"2011","Neath Port Talbot 005D","W01000970",863,38,8,30,154,112,73,78,145,138,52,39,13,73
"2011","Neath Port Talbot 006A","W01000902",796,74,25,49,203,132,78,66,91,69,30,24,6,53
"2011","Neath Port Talbot 006B","W01000903",824,97,23,74,262,134,57,67,83,57,17,8,9,50
"2011","Neath Port Talbot 006C","W01000904",1133,148,40,108,363,199,68,89,115,75,19,14,5,57
"2011","Neath Port Talbot 006D","W01000905",1120,98,20,78,259,178,68,99,151,115,72,52,20,80
"2011","Neath Port Talbot 006E","W01000908",1222,113,40,73,304,201,74,116,188,114,34,21,13,78
"2011","Neath Port Talbot 007A","W01000906",798,95,15,80,186,115,62,60,114,82,32,26,6,52
"2011","Neath Port Talbot 007B","W01000907",1235,62,15,47,249,148,82,96,223,187,95,75,20,93
"2011","Neath Port Talbot 007C","W01000922",1239,51,15,36,226,158,74,125,219,213,94,74,20,79
"2011","Neath Port Talbot 007D","W01000923",1120,72,16,56,255,161,91,95,205,140,34,22,12,67
"2011","Neath Port Talbot 008A","W01000934",968,28,8,20,113,111,52,86,218,230,81,67,14,49
"2011","Neath Port Talbot 008B","W01000935",1214,51,18,33,160,142,94,119,237,218,104,77,27,89
"2011","Neath Port Talbot 008C","W01000938",975,69,10,59,252,128,93,86,144,110,24,18,6,69
"2011","Neath Port Talbot 008D","W01000939",915,41,9,32,147,94,62,88,165,151,110,83,27,57
"2011","Neath Port Talbot 008E","W01000940",931,32,12,20,147,110,39,95,203,173,79,56,23,53
"2011","Neath Port Talbot 009A","W01000909",873,44,10,34,126,134,48,114,167,156,37,30,7,47
"2011","Neath Port Talbot 009B","W01000910",1172,97,33,64,298,195,59,126,176,131,18,12,6,72
"2011","Neath Port Talbot 009C","W01000911",984,60,16,44,238,184,59,106,161,82,23,15,8,71
"2011","Neath Port Talbot 009D","W01000969",984,81,22,59,242,152,70,95,130,118,15,12,3,81
"2011","Neath Port Talbot 010A","W01000912",853,48,9,39,148,129,48,89,162,123,47,30,17,59
"2011","Neath Port Talbot 010B","W01000913",867,41,9,32,163,120,83,86,152,128,44,30,14,50
"2011","Neath Port Talbot 010C","W01000914",1157,32,8,24,157,128,65,124,283,223,84,65,19,61
"2011","Neath Port Talbot 010D","W01000915",898,36,11,25,146,133,69,79,197,138,38,27,11,62
"2011","Neath Port Talbot 010E","W01000916",879,59,16,43,169,141,70,90,157,116,34,26,8,43
"2011","Neath Port Talbot 010F","W01000917",1994,138,39,99,487,302,151,206,305,212,55,42,13,138
"2011","Neath Port Talbot 011A","W01000920",935,35,15,20,124,101,85,95,161,210,58,39,19,66
"2011","Neath Port Talbot 011B","W01000921",1133,19,6,13,60,76,50,85,250,349,182,132,50,62
"2011","Neath Port Talbot 011C","W01000924",804,19,9,10,78,66,44,94,177,206,78,65,13,42
"2011","Neath Port Talbot 011D","W01000930",1017,17,6,11,95,70,45,115,219,260,115,94,21,81
"2011","Neath Port Talbot 012A","W01000936",1108,42,9,33,162,126,51,93,250,214,92,61,31,78
"2011","Neath Port Talbot 012B","W01000941",1108,59,15,44,166,114,72,101,234,188,86,66,20,88
"2011","Neath Port Talbot 012C","W01000942",1329,49,15,34,173,156,80,108,270,283,104,81,23,106
"2011","Neath Port Talbot 012D","W01000943",1123,96,25,71,281,177,90,100,168,116,20,14,6,75
"2011","Neath Port Talbot 013A","W01000894",983,52,16,36,168,132,84,112,182,161,41,31,10,51
"2011","Neath Port Talbot 013B","W01000895",1163,35,2,33,142,144,101,147,223,238,80,49,31,53
"2011","Neath Port Talbot 013C","W01000896",1178,16,8,8,132,82,68,118,273,249,164,130,34,76
"2011","Neath Port Talbot 013D","W01000897",963,44,18,26,156,130,56,91,189,170,58,44,14,69
"2011","Neath Port Talbot 013E","W01000937",1537,50,16,34,227,205,98,151,286,287,147,108,39,86
"2011","Neath Port Talbot 014A","W01000898",1100,65,12,53,202,134,102,119,204,158,42,33,9,74
"2011","Neath Port Talbot 014B","W01000899",1270,89,26,63,296,208,64,127,201,156,38,28,10,91
"2011","Neath Port Talbot 014C","W01000900",1277,53,13,40,204,131,64,127,267,265,83,62,21,83
"2011","Neath Port Talbot 014D","W01000901",1250,72,16,56,220,146,62,134,237,231,65,46,19,83
"2011","Neath Port Talbot 014E","W01000945",844,53,9,44,139,93,79,75,165,169,32,19,13,39
"2011","Neath Port Talbot 015A","W01000889",1367,121,30,91,328,205,104,135,182,162,46,28,18,84
"2011","Neath Port Talbot 015B","W01000890",1241,124,32,92,352,201,74,135,138,109,27,19,8,81
"2011","Neath Port Talbot 015C","W01000891",1059,43,10,33,166,139,67,105,212,207,64,41,23,56
"2011","Neath Port Talbot 015D","W01000892",1353,107,24,83,338,194,83,141,200,171,47,29,18,72
"2011","Neath Port Talbot 016A","W01000883",1149,57,24,33,208,177,53,169,221,178,20,12,8,66
"2011","Neath Port Talbot 016B","W01000958",1151,29,8,21,99,79,46,133,272,272,149,126,23,72
"2011","Neath Port Talbot 016C","W01000961",1112,31,8,23,142,122,47,118,255,268,80,60,20,49
"2011","Neath Port Talbot 016D","W01000962",1103,17,3,14,83,78,58,112,240,265,170,135,35,80
"2011","Neath Port Talbot 016E","W01000963",1196,22,8,14,129,93,56,117,245,313,129,98,31,92
"2011","Neath Port Talbot 016F","W01000964",1217,27,9,18,128,114,64,140,251,292,110,75,35,91
"2011","Neath Port Talbot 017A","W01000884",926,16,5,11,106,110,30,111,205,213,77,55,22,58
"2011","Neath Port Talbot 017B","W01000885",980,36,7,29,125,100,42,99,225,194,96,71,25,63
"2011","Neath Port Talbot 017C","W01000886",1122,31,7,24,145,110,45,121,228,247,131,91,40,64
"2011","Neath Port Talbot 017D","W01000957",1226,35,17,18,136,119,71,139,262,282,117,91,26,65
"2011","Neath Port Talbot 017E","W01000959",1357,68,13,55,254,176,107,164,212,207,62,38,24,107
"2011","Neath Port Talbot 017F","W01000960",1268,54,10,44,198,160,72,133,238,242,88,60,28,83
"2011","Neath Port Talbot 018A","W01000949",1019,69,19,50,228,142,102,128,144,115,38,25,13,53
"2011","Neath Port Talbot 018B","W01000950",1178,45,11,34,206,157,69,152,229,194,57,36,21,69
"2011","Neath Port Talbot 018C","W01000951",1183,48,8,40,208,137,85,137,198,192,87,67,20,91
"2011","Neath Port Talbot 018D","W01000952",863,54,15,39,156,106,58,97,155,125,50,39,11,62
"2011","Neath Port Talbot 018E","W01000966",1081,41,9,32,178,137,70,121,206,195,73,48,25,60
"2011","Neath Port Talbot 019A","W01000932",779,49,21,28,127,112,53,92,131,129,44,33,11,42
"2011","Neath Port Talbot 019B","W01000933",1449,173,51,122,428,202,139,107,160,110,40,28,12,90
"2011","Neath Port Talbot 019C","W01000967",1102,33,10,23,141,126,53,122,237,230,94,72,22,66
"2011","Neath Port Talbot 019D","W01000968",1444,84,23,61,253,188,74,169,264,265,76,56,20,71
"2011","Neath Port Talbot 020A","W01000919",880,70,15,55,136,110,70,99,136,158,42,26,16,59
"2011","Neath Port Talbot 020B","W01000927",1233,66,19,47,212,180,95,124,192,242,47,37,10,75
"2011","Neath Port Talbot 020C","W01000928",1185,50,16,34,209,151,121,106,202,198,81,57,24,67
"2011","Neath Port Talbot 020D","W01000929",953,41,16,25,149,129,68,94,192,163,56,37,19,61
"2011","Neath Port Talbot 020E","W01000931",966,42,11,31,147,124,84,87,184,186,54,33,21,58
"2011","Neath Port Talbot 020F","W01000973",1070,45,9,36,144,115,78,111,218,244,58,40,18,57
"2011","Neath Port Talbot 020G","W01001900",1135,56,12,44,185,132,112,97,213,212,68,43,25,60
"2011","Bridgend 001A","W01000991",819,12,3,9,64,34,37,76,206,231,112,97,15,47
"2011","Bridgend 001B","W01000992",1098,19,10,9,84,76,70,109,221,326,134,93,41,59
"2011","Bridgend 001C","W01000993",1091,23,7,16,122,64,67,109,253,297,103,74,29,53
"2011","Bridgend 001D","W01000994",1030,22,8,14,119,92,72,97,220,241,97,60,37,70
"2011","Bridgend 001E","W01000995",1080,34,9,25,173,109,65,113,245,222,61,37,24,58
"2011","Bridgend 002A","W01001014",1214,51,16,35,170,111,72,127,281,240,81,52,29,81
"2011","Bridgend 002B","W01001015",1089,38,10,28,136,101,79,124,253,197,72,48,24,89
"2011","Bridgend 002C","W01001017",1077,89,32,57,238,139,99,88,186,134,34,26,8,70
"2011","Bridgend 002D","W01001018",1048,62,21,41,157,87,67,113,205,207,86,56,30,64
"2011","Bridgend 002E","W01001020",1096,52,14,38,161,114,52,115,221,229,97,63,34,55
"2011","Bridgend 003A","W01000976",802,28,17,11,96,79,86,74,175,166,58,43,15,40
"2011","Bridgend 003B","W01000977",1057,51,12,39,159,117,82,96,188,232,75,46,29,57
"2011","Bridgend 003C","W01001024",870,36,11,25,129,74,71,79,170,211,49,30,19,51
"2011","Bridgend 003D","W01001025",916,33,15,18,134,95,71,95,192,197,50,33,17,49
"2011","Bridgend 003E","W01001033",1261,59,18,41,198,153,96,132,278,211,60,38,22,74
"2011","Bridgend 003F","W01001034",1044,42,16,26,153,112,71,87,214,218,77,35,42,70
"2011","Bridgend 004A","W01000975",1593,42,18,24,148,127,95,144,321,426,192,148,44,98
"2011","Bridgend 004B","W01000978",1309,42,17,25,161,149,80,130,286,285,75,47,28,101
"2011","Bridgend 004C","W01001009",946,41,10,31,152,97,80,89,195,191,46,31,15,55
"2011","Bridgend 004D","W01001042",979,34,9,25,152,115,62,94,200,190,74,45,29,58
"2011","Bridgend 004E","W01001043",875,19,6,13,145,118,60,87,193,167,53,27,26,33
"2011","Bridgend 005A","W01001012",1164,109,35,74,277,151,82,119,168,136,37,25,12,85
"2011","Bridgend 005B","W01001013",1083,84,23,61,203,134,76,107,179,195,49,30,19,56
"2011","Bridgend 005C","W01001016",1252,58,20,38,204,153,77,153,274,234,50,32,18,49
"2011","Bridgend 005D","W01001019",1107,68,26,42,166,101,83,86,237,220,77,47,30,69
"2011","Bridgend 006A","W01000974",1572,88,25,63,355,200,134,161,273,202,66,37,29,93
"2011","Bridgend 006B","W01001057",1113,41,6,35,209,126,93,99,229,185,74,56,18,57
"2011","Bridgend 006C","W01001058",1420,124,34,90,327,189,113,127,229,163,55,33,22,93
"2011","Bridgend 007A","W01000986",1011,59,18,41,231,135,88,104,166,136,33,14,19,59
"2011","Bridgend 007B","W01000987",1651,89,21,68,259,178,109,157,302,331,124,89,35,102
"2011","Bridgend 007C","W01001055",895,24,11,13,106,80,47,109,183,202,88,68,20,56
"2011","Bridgend 007D","W01001056",966,57,17,40,163,111,55,112,182,172,54,41,13,60
"2011","Bridgend 008A","W01000996",1132,50,15,35,204,129,101,101,219,203,48,40,8,77
"2011","Bridgend 008B","W01001048",1069,80,30,50,237,166,63,127,191,120,25,12,13,60
"2011","Bridgend 008C","W01001049",952,22,5,17,93,89,48,103,225,230,87,61,26,55
"2011","Bridgend 008D","W01001050",1159,46,19,27,164,112,86,137,253,205,77,52,25,79
"2011","Bridgend 008E","W01001051",1305,36,8,28,225,146,117,144,261,199,92,59,33,85
"2011","Bridgend 008F","W01001052",975,36,10,26,135,78,58,106,209,217,81,54,27,55
"2011","Bridgend 009A","W01001004",803,44,8,36,119,82,63,76,154,170,42,30,12,53
"2011","Bridgend 009B","W01001005",1248,107,33,74,330,186,97,114,178,129,35,21,14,72
"2011","Bridgend 009C","W01001006",1801,193,52,141,398,298,127,156,298,192,32,27,5,107
"2011","Bridgend 009D","W01001007",1296,92,26,66,250,159,109,112,231,199,59,31,28,85
"2011","Bridgend 009E","W01001039",1264,94,33,61,247,160,127,115,200,188,48,28,20,85
"2011","Bridgend 009F","W01001040",1122,100,24,76,262,131,107,104,165,155,32,21,11,66
"2011","Bridgend 010A","W01000999",1019,49,11,38,146,83,79,113,207,210,67,47,20,65
"2011","Bridgend 010B","W01001000",1292,78,20,58,276,165,105,128,228,171,58,34,24,83
"2011","Bridgend 010C","W01001001",1037,54,14,40,183,148,66,108,226,166,38,28,10,48
"2011","Bridgend 010D","W01001002",1795,108,26,82,265,168,127,168,350,308,201,126,75,100
"2011","Bridgend 011A","W01000998",2281,141,35,106,343,177,237,222,269,418,388,350,38,86
"2011","Bridgend 011B","W01001008",1604,185,49,136,456,256,135,101,230,105,35,20,15,101
"2011","Bridgend 011C","W01001038",1528,112,22,90,356,207,113,138,263,165,61,45,16,113
"2011","Bridgend 012A","W01000997",1135,60,16,44,228,144,82,140,212,165,36,19,17,68
"2011","Bridgend 012B","W01001010",924,38,11,27,173,115,57,93,202,122,60,44,16,64
"2011","Bridgend 012C","W01001011",1024,58,21,37,191,131,80,108,202,145,35,17,18,74
"2011","Bridgend 012D","W01001026",1402,72,17,55,201,153,102,124,288,257,109,72,37,96
"2011","Bridgend 013A","W01000989",1030,156,32,124,268,114,110,64,129,85,37,30,7,67
"2011","Bridgend 013B","W01001037",1176,132,34,98,345,184,102,73,139,78,36,31,5,87
"2011","Bridgend 013C","W01001041",1822,227,47,180,566,244,140,128,207,115,73,56,17,122
"2011","Bridgend 014A","W01001021",1217,44,10,34,212,156,105,119,234,212,71,50,21,64
"2011","Bridgend 014B","W01001022",983,33,13,20,166,104,56,94,207,180,95,57,38,48
"2011","Bridgend 014C","W01001023",1292,71,16,55,218,162,87,104,244,202,105,69,36,99
"2011","Bridgend 014D","W01001028",1421,157,33,124,348,182,113,107,221,146,49,24,25,98
"2011","Bridgend 014E","W01001035",1206,57,17,40,210,108,83,120,217,237,102,76,26,72
"2011","Bridgend 015A","W01000979",1270,75,20,55,277,181,71,108,237,155,60,27,33,106
"2011","Bridgend 015B","W01000983",1171,103,24,79,297,173,80,111,172,125,30,17,13,80
"2011","Bridgend 015C","W01000985",1093,163,45,118,304,167,69,95,103,61,23,9,14,108
"2011","Bridgend 015D","W01001003",988,113,34,79,283,140,96,76,111,84,30,21,9,55
"2011","Bridgend 016A","W01000980",1094,53,17,36,214,150,71,113,203,146,65,40,25,79
"2011","Bridgend 016B","W01000981",825,34,11,23,110,77,39,68,168,146,105,77,28,78
"2011","Bridgend 016C","W01000982",1152,129,26,103,293,161,78,75,183,114,42,31,11,77
"2011","Bridgend 016D","W01000984",1634,148,30,118,416,259,107,139,265,143,62,39,23,95
"2011","Bridgend 017B","W01000990",1093,65,20,45,173,111,79,115,227,203,58,44,14,62
"2011","Bridgend 017C","W01001027",1079,93,26,67,275,178,82,91,155,111,39,31,8,55
"2011","Bridgend 017D","W01001036",1162,216,41,175,334,143,105,61,108,73,29,19,10,93
"2011","Bridgend 017E","W01001918",1085,198,55,143,368,145,57,56,118,59,17,9,8,67
"2011","Bridgend 017F","W01001919",1020,146,29,117,320,172,58,76,106,64,11,4,7,67
"2011","Bridgend 017G","W01001920",893,139,31,108,265,142,64,64,89,35,29,19,10,66
"2011","Bridgend 017H","W01001921",1085,151,40,111,290,168,50,68,155,90,40,24,16,73
"2011","Bridgend 018A","W01001031",1062,149,49,100,307,148,100,83,131,58,29,22,7,57
"2011","Bridgend 018B","W01001032",1213,123,33,90,323,185,104,95,183,100,36,28,8,64
"2011","Bridgend 018C","W01001046",1245,103,25,78,247,131,159,102,190,142,94,57,37,77
"2011","Bridgend 018D","W01001047",1189,136,32,104,293,162,124,89,139,115,54,45,9,77
"2011","Bridgend 018E","W01001053",736,111,30,81,208,97,60,58,98,50,22,17,5,32
"2011","Bridgend 018F","W01001054",809,124,32,92,249,91,73,63,76,44,30,17,13,59
"2011","Bridgend 019A","W01001029",1279,165,46,119,358,162,131,99,160,103,38,23,15,63
"2011","Bridgend 019B","W01001030",1299,156,42,114,348,155,155,102,148,103,46,33,13,86
"2011","Bridgend 019C","W01001044",1192,68,15,53,207,122,103,122,233,203,64,47,17,70
"2011","Bridgend 019D","W01001045",1295,67,16,51,251,121,131,142,243,185,79,49,30,76
"2011","The Vale of Glamorgan 001A","W01001105",1926,392,97,295,544,202,251,121,159,88,40,23,17,129
"2011","The Vale of Glamorgan 001B","W01001127",885,182,47,135,279,91,118,49,63,40,18,10,8,45
"2011","The Vale of Glamorgan 001C","W01001128",1096,166,48,118,325,118,133,70,123,69,21,14,7,71
"2011","The Vale of Glamorgan 002A","W01001082",1057,202,50,152,294,135,122,55,96,61,31,14,17,61
"2011","The Vale of Glamorgan 002B","W01001083",1161,259,51,208,360,138,134,62,77,56,13,8,5,62
"2011","The Vale of Glamorgan 002C","W01001084",1134,213,47,166,351,126,132,57,103,61,28,17,11,63
"2011","The Vale of Glamorgan 002D","W01001085",1107,270,47,223,337,109,132,50,74,40,22,14,8,73
"2011","The Vale of Glamorgan 003A","W01001113",1677,377,63,314,495,176,241,55,121,66,40,32,8,106
"2011","The Vale of Glamorgan 003B","W01001119",1270,249,53,196,340,131,197,54,94,74,32,17,15,99
"2011","The Vale of Glamorgan 003C","W01001135",1072,233,52,181,302,106,162,28,97,42,22,14,8,80
"2011","The Vale of Glamorgan 003D","W01001136",854,122,23,99,238,139,81,60,90,59,15,10,5,50
"2011","The Vale of Glamorgan 004A","W01001075",864,101,23,78,268,130,71,51,104,38,37,29,8,64
"2011","The Vale of Glamorgan 004B","W01001076",1089,90,17,73,264,148,97,78,177,123,51,32,19,61
"2011","The Vale of Glamorgan 004C","W01001077",1049,90,25,65,228,153,79,92,182,124,34,21,13,67
"2011","The Vale of Glamorgan 004D","W01001078",900,100,14,86,244,133,69,61,119,73,26,20,6,75
"2011","The Vale of Glamorgan 004E","W01001104",1491,160,33,127,423,227,115,105,210,109,44,29,15,98
"2011","The Vale of Glamorgan 004F","W01001129",951,62,9,53,184,121,91,77,165,113,54,34,20,84
"2011","The Vale of Glamorgan 005A","W01001116",1348,328,51,277,416,160,119,37,95,38,58,41,17,97
"2011","The Vale of Glamorgan 005B","W01001123",1201,209,28,181,363,166,117,60,119,69,34,15,19,64
"2011","The Vale of Glamorgan 005C","W01001124",1118,165,22,143,266,133,106,76,158,92,46,27,19,76
"2011","The Vale of Glamorgan 005D","W01001125",1013,159,16,143,288,126,84,44,143,65,37,29,8,67
"2011","The Vale of Glamorgan 005E","W01001126",1611,333,61,272,513,208,152,76,144,68,38,20,18,79
"2011","The Vale of Glamorgan 005F","W01001130",904,206,25,181,268,90,81,34,84,45,30,17,13,66
"2011","The Vale of Glamorgan 006A","W01001086",1086,233,45,188,330,155,122,41,95,40,16,11,5,54
"2011","The Vale of Glamorgan 006B","W01001087",1107,134,28,106,306,204,87,73,114,71,27,11,16,91
"2011","The Vale of Glamorgan 006C","W01001088",1274,109,22,87,289,170,104,102,227,119,54,42,12,100
"2011","The Vale of Glamorgan 006D","W01001089",1069,123,25,98,298,182,98,70,146,71,20,11,9,61
"2011","The Vale of Glamorgan 006E","W01001090",1092,157,43,114,312,189,98,62,117,58,17,11,6,82
"2011","The Vale of Glamorgan 007A","W01001081",1070,26,4,22,137,125,70,93,238,190,113,70,43,78
"2011","The Vale of Glamorgan 007B","W01001092",1218,60,16,44,202,158,100,102,238,173,79,49,30,106
"2011","The Vale of Glamorgan 007C","W01001094",962,31,10,21,145,99,62,88,221,150,90,59,31,76
"2011","The Vale of Glamorgan 007D","W01001095",1040,28,10,18,106,111,55,94,232,196,141,93,48,77
"2011","The Vale of Glamorgan 007E","W01001096",996,51,11,40,172,158,64,106,197,132,57,34,23,59
"2011","The Vale of Glamorgan 007F","W01001097",1135,26,5,21,137,128,83,77,223,198,149,99,50,114
"2011","The Vale of Glamorgan 008A","W01001114",1095,257,51,206,356,163,90,33,88,26,21,11,10,61
"2011","The Vale of Glamorgan 008B","W01001115",1425,247,53,194,388,172,138,66,165,73,63,46,17,113
"2011","The Vale of Glamorgan 008C","W01001131",1236,130,30,100,279,163,81,70,198,169,69,44,25,77
"2011","The Vale of Glamorgan 008D","W01001132",1011,115,31,84,282,167,92,70,111,70,21,11,10,83
"2011","The Vale of Glamorgan 008E","W01001133",1475,260,59,201,440,190,163,75,145,65,25,16,9,112
"2011","The Vale of Glamorgan 008F","W01001134",870,126,32,94,260,139,84,48,110,49,15,9,6,39
"2011","The Vale of Glamorgan 009A","W01001067",1004,29,9,20,140,136,49,95,209,188,105,76,29,53
"2011","The Vale of Glamorgan 009B","W01001068",1321,67,17,50,238,202,88,155,215,181,88,52,36,87
"2011","The Vale of Glamorgan 009C","W01001070",861,25,5,20,120,105,50,76,187,144,113,62,51,41
"2011","The Vale of Glamorgan 009D","W01001071",1158,59,16,43,214,151,81,109,234,166,68,40,28,76
"2011","The Vale of Glamorgan 009E","W01001072",2007,190,42,148,556,337,176,177,253,125,53,31,22,140
"2011","The Vale of Glamorgan 010A","W01001091",1279,98,32,66,320,233,109,120,202,88,30,19,11,79
"2011","The Vale of Glamorgan 010B","W01001098",838,83,19,64,229,166,80,61,93,57,19,11,8,50
"2011","The Vale of Glamorgan 010C","W01001100",1100,135,44,91,271,198,95,82,140,73,20,12,8,86
"2011","The Vale of Glamorgan 010D","W01001103",945,81,20,61,233,183,65,80,142,61,29,19,10,71
"2011","The Vale of Glamorgan 011A","W01001106",1096,88,29,59,296,151,84,112,162,87,34,23,11,82
"2011","The Vale of Glamorgan 011B","W01001107",1113,131,32,99,275,132,108,96,163,112,41,27,14,55
"2011","The Vale of Glamorgan 011C","W01001109",1060,80,27,53,260,113,86,102,170,141,40,28,12,68
"2011","The Vale of Glamorgan 011D","W01001110",1250,135,34,101,279,101,129,54,84,49,23,15,8,396
"2011","The Vale of Glamorgan 011E","W01001111",1078,65,19,46,184,146,60,101,201,177,71,44,27,73
"2011","The Vale of Glamorgan 011F","W01001112",1059,110,27,83,310,173,54,86,171,69,22,9,13,64
"2011","The Vale of Glamorgan 012A","W01001063",1271,51,6,45,233,169,120,131,236,176,86,48,38,69
"2011","The Vale of Glamorgan 012B","W01001065",1111,50,13,37,213,144,88,110,212,129,66,44,22,99
"2011","The Vale of Glamorgan 012C","W01001069",1063,39,7,32,181,155,93,95,210,154,88,46,42,48
"2011","The Vale of Glamorgan 012E","W01001079",1146,42,10,32,200,176,54,119,195,197,94,57,37,69
"2011","The Vale of Glamorgan 012F","W01001080",1150,39,9,30,176,166,70,107,247,165,102,71,31,78
"2011","The Vale of Glamorgan 012G","W01001910",1236,55,13,42,196,158,102,117,249,162,121,66,55,76
"2011","The Vale of Glamorgan 012H","W01001911",844,25,5,20,138,109,56,85,174,149,49,22,27,59
"2011","The Vale of Glamorgan 013A","W01001062",965,88,20,68,268,142,81,69,128,66,44,26,18,79
"2011","The Vale of Glamorgan 013B","W01001064",974,30,7,23,163,131,54,94,183,148,100,67,33,71
"2011","The Vale of Glamorgan 013C","W01001093",1244,46,9,37,191,191,75,128,218,189,124,76,48,82
"2011","The Vale of Glamorgan 013D","W01001099",932,56,17,39,157,136,55,77,199,123,67,35,32,62
"2011","The Vale of Glamorgan 013E","W01001101",1078,58,22,36,223,182,92,93,181,115,63,33,30,71
"2011","The Vale of Glamorgan 013F","W01001102",1080,68,17,51,241,152,88,106,196,101,55,34,21,73
"2011","The Vale of Glamorgan 014A","W01001108",1256,127,51,76,317,218,106,106,174,109,39,18,21,60
"2011","The Vale of Glamorgan 014B","W01001117",1049,96,31,65,257,146,96,114,143,86,50,33,17,61
"2011","The Vale of Glamorgan 014C","W01001118",1743,158,49,109,408,263,157,163,249,156,64,41,23,125
"2011","The Vale of Glamorgan 014D","W01001120",1052,123,24,99,243,170,93,114,142,79,20,9,11,68
"2011","The Vale of Glamorgan 014E","W01001121",1093,72,17,55,212,120,91,117,205,151,53,34,19,72
"2011","The Vale of Glamorgan 014F","W01001122",2214,299,209,90,449,538,129,157,253,168,84,48,36,137
"2011","The Vale of Glamorgan 015A","W01001059",973,128,22,106,280,130,90,59,112,78,39,30,9,57
"2011","The Vale of Glamorgan 015B","W01001060",1038,144,30,114,305,153,101,81,125,54,20,10,10,55
"2011","The Vale of Glamorgan 015C","W01001061",1565,114,34,80,345,222,146,115,268,156,104,62,42,95
"2011","The Vale of Glamorgan 015D","W01001066",1125,70,17,53,259,147,94,106,186,136,58,38,20,69
"2011","The Vale of Glamorgan 015E","W01001073",1506,84,22,62,260,204,98,129,278,228,155,96,59,70
"2011","Cardiff 001A","W01001777",1029,259,48,211,327,135,104,26,43,23,28,19,9,84
"2011","Cardiff 001B","W01001778",1369,339,70,269,429,178,118,46,67,43,32,23,9,117
"2011","Cardiff 001C","W01001794",1073,152,36,116,319,215,65,53,111,43,35,20,15,80
"2011","Cardiff 001D","W01001799",811,218,38,180,234,117,62,16,44,15,37,28,9,68
"2011","Cardiff 002A","W01001793",1073,199,27,172,322,184,70,44,99,40,24,14,10,91
"2011","Cardiff 002B","W01001795",1157,245,44,201,361,192,80,40,91,45,26,11,15,77
"2011","Cardiff 002C","W01001796",1131,199,38,161,300,212,92,58,99,61,37,22,15,73
"2011","Cardiff 002D","W01001798",1092,149,22,127,295,216,70,73,117,73,28,12,16,71
"2011","Cardiff 003A","W01001841",1507,269,43,226,407,229,117,74,142,73,63,42,21,133
"2011","Cardiff 003B","W01001842",1307,268,38,230,392,214,84,74,111,56,23,17,6,85
"2011","Cardiff 003C","W01001843",1599,359,69,290,478,195,128,85,137,70,55,38,17,92
"2011","Cardiff 003D","W01001844",1511,212,34,178,414,251,97,101,154,93,62,41,21,127
"2011","Cardiff 004A","W01001849",1083,196,36,160,344,173,86,46,91,40,23,12,11,84
"2011","Cardiff 004B","W01001852",1264,252,48,204,391,197,110,55,110,44,23,9,14,82
"2011","Cardiff 004C","W01001853",996,161,30,131,300,207,68,49,89,35,20,9,11,67
"2011","Cardiff 004D","W01001854",997,144,27,117,286,211,76,58,106,49,20,13,7,47
"2011","Cardiff 005A","W01001791",1097,169,31,138,303,166,96,59,113,75,48,34,14,68
"2011","Cardiff 005B","W01001792",1194,87,15,72,234,192,76,92,180,157,92,63,29,84
"2011","Cardiff 005C","W01001797",1023,159,28,131,279,173,80,65,124,53,24,16,8,66
"2011","Cardiff 005D","W01001800",1036,67,7,60,193,164,76,65,196,121,71,51,20,83
"2011","Cardiff 005F","W01001949",978,183,30,153,293,156,33,51,107,55,31,21,10,69
"2011","Cardiff 005G","W01001953",1081,121,27,94,263,191,51,68,153,88,57,40,17,89
"2011","Cardiff 006A","W01001820",873,162,33,129,264,107,68,51,80,57,22,10,12,62
"2011","Cardiff 006C","W01001846",1215,243,46,197,358,177,101,60,97,52,23,16,7,104
"2011","Cardiff 006D","W01001847",1136,269,59,210,356,186,91,53,80,30,15,13,2,56
"2011","Cardiff 006E","W01001948",1187,325,49,276,399,149,66,30,75,40,18,10,8,85
"2011","Cardiff 006F","W01001954",1076,311,43,268,320,128,71,24,73,32,26,19,7,91
"2011","Cardiff 007A","W01001802",1137,55,16,39,173,194,83,105,230,154,54,28,26,89
"2011","Cardiff 007B","W01001807",1027,27,9,18,107,104,48,75,238,190,150,108,42,88
"2011","Cardiff 007C","W01001808",1060,34,12,22,123,107,55,73,229,212,158,115,43,69
"2011","Cardiff 007D","W01001840",1356,163,29,134,294,248,107,75,179,139,70,52,18,81
"2011","Cardiff 008A","W01001730",1055,305,52,253,284,129,111,30,64,26,23,15,8,83
"2011","Cardiff 008B","W01001731",986,218,41,177,294,141,91,33,67,27,32,28,4,83
"2011","Cardiff 008C","W01001736",976,252,34,218,292,155,66,29,55,24,32,19,13,71
"2011","Cardiff 008D","W01001815",1013,99,23,76,230,170,67,70,149,86,56,42,14,86
"2011","Cardiff 009A","W01001811",967,22,7,15,115,100,43,99,201,177,140,95,45,70
"2011","Cardiff 009B","W01001816",1831,163,28,135,424,247,97,154,281,208,139,83,56,118
"2011","Cardiff 009C","W01001817",1062,71,21,50,198,179,75,78,209,124,44,30,14,84
"2011","Cardiff 009D","W01001818",1119,107,22,85,242,149,102,86,187,108,77,53,24,61
"2011","Cardiff 010A","W01001888",1235,210,36,174,348,173,88,61,124,95,43,30,13,93
"2011","Cardiff 010B","W01001893",1405,177,30,147,327,192,121,108,190,125,65,41,24,100
"2011","Cardiff 010C","W01001894",1128,180,32,148,320,195,81,66,101,89,31,18,13,65
"2011","Cardiff 010D","W01001895",1157,154,28,126,241,168,60,51,149,138,112,73,39,84
"2011","Cardiff 011A","W01001877",1315,124,25,99,306,228,107,107,206,117,39,28,11,81
"2011","Cardiff 011B","W01001878",1114,91,18,73,249,199,60,72,171,110,71,54,17,91
"2011","Cardiff 011C","W01001882",1315,161,27,134,350,199,106,90,152,100,56,30,26,101
"2011","Cardiff 011D","W01001885",1405,148,23,125,323,207,95,91,182,142,108,85,23,109
"2011","Cardiff 012A","W01001773",1761,346,38,308,462,253,137,93,161,85,70,57,13,154
"2011","Cardiff 012B","W01001848",1004,154,31,123,301,187,73,67,95,52,20,12,8,55
"2011","Cardiff 012C","W01001850",1325,258,51,207,441,212,116,59,95,38,10,6,4,96
"2011","Cardiff 012D","W01001851",1019,167,26,141,302,179,86,39,101,56,27,19,8,62
"2011","Cardiff 013A","W01001879",1279,73,17,56,201,183,71,81,246,190,129,94,35,105
"2011","Cardiff 013B","W01001880",996,44,11,33,151,107,39,60,194,146,160,115,45,95
"2011","Cardiff 013C","W01001881",1070,56,20,36,175,110,68,83,206,185,119,80,39,68
"2011","Cardiff 013D","W01001884",882,24,7,17,62,79,42,59,229,155,150,95,55,82
"2011","Cardiff 014A","W01001727",862,170,44,126,269,114,89,38,67,34,17,12,5,64
"2011","Cardiff 014B","W01001728",1113,250,51,199,382,166,91,40,67,28,9,7,2,80
"2011","Cardiff 014C","W01001729",1605,279,48,231,472,230,146,85,164,70,37,25,12,122
"2011","Cardiff 014D","W01001819",1723,330,50,280,536,236,164,64,136,100,36,24,12,121
"2011","Cardiff 015A","W01001803",1082,43,13,30,132,146,61,120,232,174,91,65,26,83
"2011","Cardiff 015B","W01001804",1071,38,10,28,165,130,53,113,220,184,84,61,23,84
"2011","Cardiff 015C","W01001805",1059,36,8,28,163,157,68,97,186,157,86,60,26,109
"2011","Cardiff 015D","W01001806",1182,79,12,67,231,211,90,106,187,136,51,35,16,91
"2011","Cardiff 016A","W01001866",1020,58,19,39,184,133,69,85,173,164,97,82,15,57
"2011","Cardiff 016B","W01001867",950,26,7,19,91,105,61,74,201,176,148,120,28,68
"2011","Cardiff 016C","W01001883",1132,43,14,29,113,124,51,113,267,217,130,88,42,74
"2011","Cardiff 016D","W01001886",854,25,8,17,87,101,44,80,195,149,99,68,31,74
"2011","Cardiff 017A","W01001809",1005,63,13,50,195,162,80,79,179,125,48,25,23,74
"2011","Cardiff 017B","W01001810",1160,41,11,30,163,140,79,96,222,205,112,72,40,102
"2011","Cardiff 017C","W01001812",933,29,8,21,146,145,48,85,186,167,51,39,12,76
"2011","Cardiff 017D","W01001813",1094,35,15,20,147,139,73,80,248,169,128,89,39,75
"2011","Cardiff 017E","W01001814",1079,74,12,62,193,199,70,102,200,125,46,22,24,70
"2011","Cardiff 018A","W01001769",1147,277,47,230,361,170,76,51,86,31,20,9,11,75
"2011","Cardiff 018B","W01001770",841,201,18,183,236,98,67,37,64,43,22,16,6,73
"2011","Cardiff 018C","W01001771",1184,224,34,190,356,188,79,60,93,58,43,32,11,83
"2011","Cardiff 018D","W01001774",991,195,29,166,315,146,79,51,75,44,31,24,7,55
"2011","Cardiff 019A","W01001732",1104,234,38,196,345,165,77,46,85,37,20,17,3,95
"2011","Cardiff 019B","W01001733",1679,202,27,175,265,143,90,27,84,45,52,35,17,771
"2011","Cardiff 019C","W01001734",1050,235,37,198,304,142,91,31,57,27,35,28,7,128
"2011","Cardiff 019D","W01001735",1105,248,43,205,298,161,101,39,66,37,47,35,12,108
"2011","Cardiff 020A","W01001887",1124,288,41,247,361,134,71,39,77,34,20,14,6,100
"2011","Cardiff 020B","W01001889",1092,128,25,103,258,200,89,70,144,90,56,38,18,57
"2011","Cardiff 020C","W01001891",1152,174,38,136,303,181,88,73,128,88,49,31,18,68
"2011","Cardiff 020D","W01001892",991,132,22,110,269,182,74,69,106,54,20,12,8,85
"2011","Cardiff 020E","W01001896",1098,198,33,165,350,157,78,53,95,59,17,10,7,91
"2011","Cardiff 021A","W01001772",995,141,24,117,283,178,82,55,103,56,36,27,9,61
"2011","Cardiff 021B","W01001775",1210,155,24,131,321,190,108,73,129,90,65,46,19,79
"2011","Cardiff 021C","W01001776",977,161,26,135,285,172,68,40,76,46,34,26,8,95
"2011","Cardiff 021D","W01001890",1258,144,31,113,253,180,93,57,125,82,29,17,12,295
"2011","Cardiff 022A","W01001863",1128,86,20,66,233,178,92,113,172,117,52,36,16,85
"2011","Cardiff 022B","W01001864",1102,96,23,73,233,213,117,97,159,92,26,16,10,69
"2011","Cardiff 022C","W01001865",989,85,12,73,232,151,90,75,148,97,27,18,9,84
"2011","Cardiff 022D","W01001868",1040,39,8,31,149,154,61,71,226,149,95,66,29,96
"2011","Cardiff 023A","W01001785",787,34,11,23,105,106,59,63,140,122,90,64,26,68
"2011","Cardiff 023B","W01001786",1126,104,17,87,266,179,79,80,172,112,57,42,15,77
"2011","Cardiff 023C","W01001787",1085,69,14,55,192,139,69,64,178,186,85,59,26,103
"2011","Cardiff 023D","W01001788",1018,50,15,35,134,143,58,77,196,183,85,56,29,92
"2011","Cardiff 023E","W01001789",1146,171,24,147,303,173,94,61,133,78,47,33,14,86
"2011","Cardiff 023F","W01001790",850,55,13,42,157,115,61,63,136,137,61,45,16,65
"2011","Cardiff 024A","W01001821",1422,187,22,165,219,70,76,33,65,29,38,24,14,705
"2011","Cardiff 024B","W01001826",962,159,26,133,261,148,80,48,102,55,21,19,2,88
"2011","Cardiff 024C","W01001827",1106,261,36,225,326,141,96,38,79,22,34,24,10,109
"2011","Cardiff 024D","W01001828",1128,184,29,155,294,188,96,80,115,63,29,21,8,79
"2011","Cardiff 025A","W01001755",1217,206,9,197,240,123,54,44,85,43,31,16,15,391
"2011","Cardiff 025B","W01001756",3410,94,7,87,190,145,58,78,191,122,127,100,27,2405
"2011","Cardiff 025C","W01001757",1155,139,11,128,253,133,48,53,132,58,63,42,21,276
"2011","Cardiff 025D","W01001758",1812,155,14,141,293,158,64,46,111,74,50,36,14,861
"2011","Cardiff 026A","W01001779",1084,254,37,217,363,147,86,45,62,28,26,16,10,73
"2011","Cardiff 026B","W01001780",1395,203,38,165,339,148,85,57,74,58,27,13,14,404
"2011","Cardiff 026C","W01001781",1245,298,42,256,375,131,105,48,93,48,50,34,16,97
"2011","Cardiff 026D","W01001782",1068,179,28,151,347,162,121,41,74,52,27,19,8,65
"2011","Cardiff 026E","W01001783",956,164,34,130,276,152,80,54,86,35,28,27,1,81
"2011","Cardiff 026F","W01001784",1031,125,20,105,265,201,96,61,109,52,25,11,14,97
"2011","Cardiff 027A","W01001747",1246,152,27,125,327,190,79,87,161,117,56,36,20,77
"2011","Cardiff 027B","W01001748",1083,42,7,35,178,144,89,106,217,171,68,43,25,68
"2011","Cardiff 027C","W01001749",1064,51,17,34,186,152,82,96,186,173,84,60,24,54
"2011","Cardiff 027D","W01001751",1189,45,15,30,172,136,71,100,250,210,130,91,39,75
"2011","Cardiff 028A","W01001718",1516,69,5,64,169,104,60,45,85,73,54,39,15,857
"2011","Cardiff 028B","W01001719",1823,154,10,144,201,108,41,30,84,50,33,29,4,1122
"2011","Cardiff 028C","W01001720",1781,67,7,60,120,92,36,50,72,59,32,20,12,1253
"2011","Cardiff 028D","W01001722",1452,67,6,61,126,79,28,32,78,52,36,24,12,954
"2011","Cardiff 028E","W01001726",1531,95,11,84,154,101,49,36,85,45,64,52,12,902
"2011","Cardiff 029A","W01001822",1242,230,34,196,323,191,97,63,116,66,48,32,16,108
"2011","Cardiff 029B","W01001823",996,242,31,211,310,80,74,33,80,28,27,15,12,122
"2011","Cardiff 029C","W01001824",1270,225,26,199,303,159,79,40,112,66,81,61,20,205
"2011","Cardiff 029D","W01001825",1337,229,37,192,346,190,92,56,162,80,84,66,18,98
"2011","Cardiff 030A","W01001831",1359,151,14,137,263,146,46,66,113,83,71,54,17,420
"2011","Cardiff 030B","W01001836",1299,193,25,168,239,118,67,52,88,60,85,73,12,397
"2011","Cardiff 030C","W01001837",1355,66,11,55,151,91,48,58,100,83,67,53,14,691
"2011","Cardiff 030D","W01001838",1512,138,18,120,287,143,77,67,103,83,62,47,15,552
"2011","Cardiff 030E","W01001839",1383,109,8,101,226,135,63,56,91,61,68,58,10,574
"2011","Cardiff 031A","W01001750",1156,61,10,51,183,156,95,90,222,202,76,56,20,71
"2011","Cardiff 031B","W01001752",1216,92,20,72,272,189,107,94,209,125,39,25,14,89
"2011","Cardiff 031C","W01001753",1160,33,11,22,164,150,53,92,241,219,113,83,30,95
"2011","Cardiff 031D","W01001754",1223,91,19,72,281,211,111,100,169,129,59,41,18,72
"2011","Cardiff 032A","W01001721",2682,64,13,51,117,80,34,20,95,62,40,28,12,2170
"2011","Cardiff 032C","W01001724",1917,36,4,32,75,69,18,14,64,35,44,33,11,1562
"2011","Cardiff 032D","W01001725",2129,36,1,35,76,39,14,30,70,38,38,28,10,1788
"2011","Cardiff 032E","W01001922",1921,20,2,18,53,46,11,22,49,30,37,31,6,1653
"2011","Cardiff 032F","W01001939",926,161,20,141,163,64,37,18,40,26,53,46,7,364
"2011","Cardiff 032G","W01001941",1015,153,9,144,209,85,41,41,33,24,35,26,9,394
"2011","Cardiff 033A","W01001829",1585,111,4,107,209,121,60,70,138,84,102,74,28,690
"2011","Cardiff 033B","W01001830",1470,135,15,120,291,167,62,72,170,108,143,108,35,322
"2011","Cardiff 033C","W01001832",1714,71,3,68,151,108,33,63,117,66,80,56,24,1025
"2011","Cardiff 033D","W01001833",1285,157,18,139,318,154,88,63,146,102,98,72,26,159
"2011","Cardiff 033E","W01001834",1365,130,22,108,242,163,59,79,136,94,64,41,23,398
"2011","Cardiff 033F","W01001835",1370,135,12,123,239,144,62,80,150,116,124,71,53,320
"2011","Cardiff 034A","W01001858",1368,323,27,296,459,143,101,63,79,55,56,44,12,89
"2011","Cardiff 034B","W01001859",1170,284,29,255,402,104,69,40,77,55,51,34,17,88
"2011","Cardiff 034C","W01001860",1380,292,29,263,441,126,113,58,125,73,49,37,12,103
"2011","Cardiff 034D","W01001861",1344,333,34,299,419,118,77,56,98,57,56,46,10,130
"2011","Cardiff 035A","W01001714",1074,185,32,153,324,149,94,41,107,58,37,27,10,79
"2011","Cardiff 035B","W01001715",1248,224,36,188,401,153,98,67,114,65,51,30,21,75
"2011","Cardiff 035C","W01001716",930,123,25,98,297,116,70,49,122,50,22,15,7,81
"2011","Cardiff 035D","W01001717",1247,171,16,155,358,163,89,80,111,108,78,63,15,89
"2011","Cardiff 036A","W01001694",1497,94,13,81,223,176,63,107,230,205,206,160,46,193
"2011","Cardiff 036B","W01001695",2887,91,4,87,198,140,124,127,232,304,334,282,52,1337
"2011","Cardiff 036C","W01001696",1172,71,7,64,175,123,52,86,209,187,137,101,36,132
"2011","Cardiff 036D","W01001697",1317,125,19,106,279,152,87,70,199,166,119,100,19,120
"2011","Cardiff 036E","W01001698",1623,114,6,108,297,187,87,109,238,148,210,157,53,233
"2011","Cardiff 037A","W01001870",1024,98,15,83,194,150,73,80,155,124,79,55,24,71
"2011","Cardiff 037B","W01001871",1079,23,3,20,111,109,63,92,228,203,173,141,32,77
"2011","Cardiff 037C","W01001875",1949,219,34,185,378,263,112,124,281,232,163,127,36,177
"2011","Cardiff 037D","W01001876",1067,37,9,28,130,114,55,86,204,221,147,105,42,73
"2011","Cardiff 038A","W01001869",1102,100,17,83,236,158,66,74,178,145,76,56,20,69
"2011","Cardiff 038B","W01001872",1150,74,9,65,232,142,56,93,181,160,110,87,23,102
"2011","Cardiff 038C","W01001873",1301,94,17,77,245,145,74,86,195,193,156,114,42,113
"2011","Cardiff 038D","W01001874",1044,59,14,45,151,115,52,82,194,159,153,109,44,79
"2011","Cardiff 039A","W01001737",1081,20,5,15,108,81,56,80,256,193,210,156,54,77
"2011","Cardiff 039B","W01001738",870,12,1,11,63,78,45,66,208,185,150,111,39,63
"2011","Cardiff 039C","W01001739",911,15,5,10,87,83,39,71,207,176,172,139,33,61
"2011","Cardiff 039D","W01001740",1075,18,7,11,105,118,64,102,234,185,165,127,38,84
"2011","Cardiff 039E","W01001741",1022,23,6,17,96,87,46,61,230,201,187,143,44,91
"2011","Cardiff 040A","W01001709",1394,131,17,114,319,179,129,77,205,143,99,76,23,112
"2011","Cardiff 040B","W01001710",1224,172,23,149,288,183,76,81,153,116,72,59,13,83
"2011","Cardiff 040C","W01001711",1125,69,12,57,183,159,85,82,206,169,100,78,22,72
"2011","Cardiff 040D","W01001712",1154,189,26,163,380,144,81,56,115,66,60,46,14,63
"2011","Cardiff 040E","W01001713",1333,153,22,131,353,175,108,89,148,130,73,58,15,104
"2011","Cardiff 041A","W01001704",1029,24,8,16,91,117,69,71,214,197,148,123,25,98
"2011","Cardiff 041B","W01001706",922,39,14,25,156,142,61,87,180,120,60,43,17,77
"2011","Cardiff 041C","W01001707",1379,45,12,33,154,160,91,124,314,243,150,120,30,98
"2011","Cardiff 041D","W01001746",1061,24,12,12,122,128,63,84,245,195,125,91,34,75
"2011","Cardiff 042A","W01001855",1292,97,12,85,181,115,81,84,208,171,216,188,28,139
"2011","Cardiff 042B","W01001856",1459,94,9,85,182,121,103,97,206,156,261,226,35,239
"2011","Cardiff 042C","W01001857",1326,87,8,79,202,144,74,91,206,185,218,180,38,119
"2011","Cardiff 042D","W01001862",1333,114,9,105,207,113,93,76,163,148,185,158,27,234
"2011","Cardiff 043A","W01001742",983,22,5,17,106,86,45,86,240,213,130,86,44,55
"2011","Cardiff 043B","W01001743",1078,101,22,79,249,198,79,94,169,100,29,20,9,59
"2011","Cardiff 043C","W01001744",1074,18,7,11,109,105,70,84,252,215,137,98,39,84
"2011","Cardiff 043D","W01001745",971,88,13,75,213,161,96,76,147,97,29,19,10,64
"2011","Cardiff 044A","W01001764",1475,81,6,75,145,120,87,80,191,146,186,156,30,439
"2011","Cardiff 044B","W01001765",979,73,9,64,169,109,76,52,141,116,156,135,21,87
"2011","Cardiff 044C","W01001766",1152,77,10,67,215,91,91,82,168,167,138,104,34,123
"2011","Cardiff 044D","W01001767",1207,70,7,63,221,132,84,86,196,181,147,121,26,90
"2011","Cardiff 044E","W01001768",1102,58,5,53,141,88,100,59,152,130,226,200,26,148
"2011","Cardiff 045A","W01001702",1336,71,18,53,242,174,106,112,257,168,107,80,27,99
"2011","Cardiff 045B","W01001703",907,33,6,27,107,110,44,75,192,184,104,87,17,58
"2011","Cardiff 045C","W01001705",1240,42,17,25,163,176,79,108,264,233,96,72,24,79
"2011","Cardiff 045D","W01001708",1114,26,10,16,127,127,71,115,236,198,157,111,46,57
"2011","Cardiff 046A","W01001759",1200,109,17,92,247,168,89,106,169,142,80,60,20,90
"2011","Cardiff 046B","W01001760",1218,87,15,72,198,151,105,109,183,135,136,113,23,114
"2011","Cardiff 046C","W01001761",1249,72,6,66,215,116,115,77,189,153,197,167,30,115
"2011","Cardiff 046D","W01001762",1254,67,10,57,195,106,78,85,205,194,210,162,48,114
"2011","Cardiff 048A","W01001940",1040,250,24,226,332,137,52,65,69,33,31,16,15,71
"2011","Cardiff 048B","W01001943",978,226,24,202,312,142,46,38,66,29,28,17,11,91
"2011","Cardiff 048C","W01001944",931,232,20,212,266,148,39,40,58,23,31,18,13,94
"2011","Cardiff 048D","W01001945",1239,268,43,225,422,160,58,84,88,34,24,16,8,101
"2011","Cardiff 048E","W01001947",1349,271,30,241,451,189,50,66,106,63,50,43,7,103
"2011","Cardiff 049A","W01001699",1568,134,16,118,254,144,86,107,218,147,299,244,55,179
"2011","Cardiff 049B","W01001942",1052,115,19,96,214,106,67,73,130,117,127,92,35,103
"2011","Cardiff 049C","W01001946",1063,116,18,98,233,142,52,62,154,116,133,100,33,55
"2011","Cardiff 049D","W01001950",962,237,31,206,327,109,46,54,63,38,26,19,7,62
"2011","Cardiff 049E","W01001951",907,202,24,178,263,96,54,42,67,42,49,39,10,92
"2011","Cardiff 049F","W01001952",1027,148,15,133,271,145,29,46,80,51,114,90,24,143
"2011","Rhondda Cynon Taf 001A","W01001186",1286,109,26,83,310,140,86,121,192,165,71,42,29,92
"2011","Rhondda Cynon Taf 001B","W01001187",1034,56,20,36,214,116,81,103,172,156,52,37,15,84
"2011","Rhondda Cynon Taf 001C","W01001188",783,39,17,22,123,81,59,82,145,142,62,43,19,50
"2011","Rhondda Cynon Taf 001D","W01001221",1027,33,14,19,113,58,68,105,222,232,122,102,20,74
"2011","Rhondda Cynon Taf 001E","W01001222",1135,20,8,12,85,67,65,71,209,308,177,136,41,133
"2011","Rhondda Cynon Taf 001F","W01001233",1298,79,20,59,245,138,133,123,209,219,69,54,15,83
"2011","Rhondda Cynon Taf 002A","W01001148",1198,55,13,42,227,141,103,98,207,204,70,42,28,93
"2011","Rhondda Cynon Taf 002B","W01001152",1176,115,37,78,261,133,105,90,195,157,55,34,21,65
"2011","Rhondda Cynon Taf 002C","W01001153",1069,32,6,26,174,135,90,91,220,163,78,54,24,86
"2011","Rhondda Cynon Taf 002D","W01001155",1103,49,9,40,199,134,95,92,212,167,69,43,26,86
"2011","Rhondda Cynon Taf 003A","W01001149",1039,71,18,53,197,124,71,103,190,126,47,33,14,110
"2011","Rhondda Cynon Taf 003B","W01001150",1228,52,17,35,193,150,77,126,257,213,99,67,32,61
"2011","Rhondda Cynon Taf 003C","W01001151",1214,107,29,78,327,175,83,114,174,122,35,19,16,77
"2011","Rhondda Cynon Taf 003D","W01001154",1053,43,12,31,164,137,74,101,214,169,67,37,30,84
"2011","Rhondda Cynon Taf 003E","W01001156",1175,125,32,93,345,191,72,89,148,77,19,10,9,109
"2011","Rhondda Cynon Taf 004A","W01001147",1284,113,25,88,315,158,130,82,187,148,63,48,15,88
"2011","Rhondda Cynon Taf 004B","W01001168",1035,45,11,34,203,131,91,90,174,153,71,62,9,77
"2011","Rhondda Cynon Taf 004C","W01001169",1250,58,23,35,204,116,83,96,248,239,137,105,32,69
"2011","Rhondda Cynon Taf 004D","W01001170",935,82,28,54,242,142,72,85,148,83,25,16,9,56
"2011","Rhondda Cynon Taf 005A","W01001137",1765,82,22,60,276,222,135,162,336,294,143,102,41,115
"2011","Rhondda Cynon Taf 005B","W01001138",999,26,11,15,133,96,60,94,216,200,86,65,21,88
"2011","Rhondda Cynon Taf 005C","W01001139",1081,39,12,27,159,139,81,96,204,224,73,47,26,66
"2011","Rhondda Cynon Taf 005D","W01001140",1065,49,14,35,165,124,82,94,204,203,77,47,30,67
"2011","Rhondda Cynon Taf 005E","W01001141",1150,30,8,22,160,134,69,82,238,241,106,68,38,90
"2011","Rhondda Cynon Taf 005F","W01001142",1125,22,11,11,123,110,89,101,216,266,124,82,42,74
"2011","Rhondda Cynon Taf 006A","W01001204",967,64,25,39,189,112,96,89,163,149,48,26,22,57
"2011","Rhondda Cynon Taf 006B","W01001205",1162,56,18,38,203,134,102,119,208,210,60,37,23,70
"2011","Rhondda Cynon Taf 006C","W01001206",1037,37,9,28,135,102,84,105,237,202,52,39,13,83
"2011","Rhondda Cynon Taf 006D","W01001207",1024,41,14,27,123,114,59,58,174,172,147,113,34,136
"2011","Rhondda Cynon Taf 006E","W01001208",1142,53,14,39,157,133,73,110,235,243,58,36,22,80
"2011","Rhondda Cynon Taf 007A","W01001265",1105,49,9,40,156,125,118,93,194,196,81,55,26,93
"2011","Rhondda Cynon Taf 007B","W01001266",931,27,7,20,94,93,74,77,169,209,120,83,37,68
"2011","Rhondda Cynon Taf 007C","W01001267",1035,37,9,28,121,104,76,89,188,242,112,71,41,66
"2011","Rhondda Cynon Taf 007D","W01001268",1020,24,11,13,131,87,64,102,226,249,85,62,23,52
"2011","Rhondda Cynon Taf 008A","W01001209",977,19,5,14,73,63,52,76,236,246,145,110,35,67
"2011","Rhondda Cynon Taf 008B","W01001210",1064,31,13,18,109,82,79,115,238,271,80,59,21,59
"2011","Rhondda Cynon Taf 008C","W01001211",1153,35,9,26,122,143,71,88,244,281,84,64,20,85
"2011","Rhondda Cynon Taf 008D","W01001212",989,28,15,13,89,97,65,103,220,221,94,67,27,72
"2011","Rhondda Cynon Taf 009A","W01001175",1025,30,14,16,157,158,59,105,207,176,65,48,17,68
"2011","Rhondda Cynon Taf 009B","W01001177",949,35,17,18,146,115,80,69,185,193,81,52,29,45
"2011","Rhondda Cynon Taf 009C","W01001202",1305,21,8,13,139,117,89,104,263,335,155,122,33,82
"2011","Rhondda Cynon Taf 009D","W01001203",998,19,7,12,88,81,63,82,208,233,162,127,35,62
"2011","Rhondda Cynon Taf 010A","W01001269",1001,60,18,42,209,141,96,83,166,134,54,44,10,58
"2011","Rhondda Cynon Taf 010B","W01001270",1045,73,23,50,187,137,71,88,191,153,73,49,24,72
"2011","Rhondda Cynon Taf 010C","W01001271",1180,35,16,19,152,133,97,124,224,241,99,68,31,75
"2011","Rhondda Cynon Taf 010D","W01001272",1098,59,13,46,195,112,72,98,175,220,83,64,19,84
"2011","Rhondda Cynon Taf 010E","W01001273",1215,65,24,41,204,189,78,95,219,204,74,55,19,87
"2011","Rhondda Cynon Taf 011A","W01001213",940,39,16,23,162,141,67,86,166,155,60,42,18,64
"2011","Rhondda Cynon Taf 011B","W01001214",958,84,25,59,259,148,66,64,141,112,31,23,8,53
"2011","Rhondda Cynon Taf 011C","W01001215",760,43,17,26,88,93,66,66,143,143,71,45,26,47
"2011","Rhondda Cynon Taf 011D","W01001216",1133,50,16,34,164,127,97,101,234,189,76,54,22,95
"2011","Rhondda Cynon Taf 012A","W01001143",1164,95,37,58,185,138,96,111,216,178,70,44,26,75
"2011","Rhondda Cynon Taf 012B","W01001144",1143,28,13,15,78,81,76,131,252,285,114,89,25,98
"2011","Rhondda Cynon Taf 012C","W01001145",1275,52,19,33,165,152,89,109,257,272,97,69,28,82
"2011","Rhondda Cynon Taf 012D","W01001146",1051,76,18,58,208,149,83,98,188,138,50,35,15,61
"2011","Rhondda Cynon Taf 013A","W01001176",1081,33,9,24,144,121,71,110,221,211,58,43,15,112
"2011","Rhondda Cynon Taf 013B","W01001274",934,12,0,12,83,84,45,76,173,197,177,133,44,87
"2011","Rhondda Cynon Taf 013C","W01001275",1271,37,12,25,147,122,88,136,293,255,111,75,36,82
"2011","Rhondda Cynon Taf 013D","W01001276",1045,37,13,24,144,78,76,87,210,194,124,98,26,95
"2011","Rhondda Cynon Taf 014A","W01001200",734,28,10,18,88,80,50,80,148,163,48,34,14,49
"2011","Rhondda Cynon Taf 014B","W01001201",897,26,6,20,124,74,62,70,202,188,76,59,17,75
"2011","Rhondda Cynon Taf 014C","W01001260",775,15,8,7,75,80,51,74,162,184,76,58,18,58
"2011","Rhondda Cynon Taf 014D","W01001285",1057,51,21,30,158,131,96,97,174,204,76,54,22,70
"2011","Rhondda Cynon Taf 014E","W01001286",1093,48,11,37,143,134,83,77,235,218,73,54,19,82
"2011","Rhondda Cynon Taf 014F","W01001287",1110,54,19,35,143,114,97,83,186,260,88,58,30,85
"2011","Rhondda Cynon Taf 014G","W01001288",1073,45,10,35,122,105,65,82,209,235,103,77,26,107
"2011","Rhondda Cynon Taf 015A","W01001180",1064,10,0,10,105,75,72,105,227,235,162,119,43,73
"2011","Rhondda Cynon Taf 015B","W01001181",1076,47,19,28,166,98,90,94,228,197,80,56,24,76
"2011","Rhondda Cynon Taf 015C","W01001282",1429,47,6,41,209,172,118,139,273,268,107,79,28,96
"2011","Rhondda Cynon Taf 015D","W01001283",1109,65,20,45,217,156,106,96,185,154,70,51,19,60
"2011","Rhondda Cynon Taf 015E","W01001284",863,77,24,53,244,140,52,62,103,83,17,9,8,85
"2011","Rhondda Cynon Taf 016A","W01001166",987,29,5,24,106,83,95,91,208,211,102,71,31,62
"2011","Rhondda Cynon Taf 016B","W01001167",1042,28,12,16,138,106,86,108,250,205,67,47,20,54
"2011","Rhondda Cynon Taf 016C","W01001247",1231,39,12,27,178,156,87,124,223,250,81,60,21,93
"2011","Rhondda Cynon Taf 016D","W01001248",1494,92,28,64,260,193,118,109,247,220,84,61,23,171
"2011","Rhondda Cynon Taf 017A","W01001171",944,48,16,32,146,146,57,94,175,167,55,37,18,56
"2011","Rhondda Cynon Taf 017B","W01001229",1085,56,18,38,200,145,83,111,198,152,71,43,28,69
"2011","Rhondda Cynon Taf 017C","W01001230",1096,72,19,53,233,160,100,90,161,159,47,36,11,74
"2011","Rhondda Cynon Taf 017D","W01001231",1125,33,12,21,153,137,74,112,252,197,71,52,19,96
"2011","Rhondda Cynon Taf 017E","W01001280",1192,28,10,18,119,110,77,112,255,239,101,69,32,151
"2011","Rhondda Cynon Taf 017F","W01001281",1230,35,10,25,183,166,95,115,250,245,63,44,19,78
"2011","Rhondda Cynon Taf 018A","W01001217",855,36,14,22,124,81,85,66,161,152,91,65,26,59
"2011","Rhondda Cynon Taf 018B","W01001218",1139,52,18,34,165,147,95,127,209,194,64,42,22,86
"2011","Rhondda Cynon Taf 018C","W01001219",964,14,6,8,105,87,61,79,206,219,100,78,22,93
"2011","Rhondda Cynon Taf 018D","W01001220",1083,35,10,25,146,127,97,97,209,222,80,58,22,70
"2011","Rhondda Cynon Taf 018E","W01001259",1182,36,10,26,185,140,99,107,231,210,91,66,25,83
"2011","Rhondda Cynon Taf 018F","W01001261",963,31,9,22,120,114,67,90,174,166,56,38,18,145
"2011","Rhondda Cynon Taf 019A","W01001164",1112,66,19,47,206,154,97,121,183,161,54,37,17,70
"2011","Rhondda Cynon Taf 019B","W01001165",982,41,14,27,187,156,91,85,174,133,51,39,12,64
"2011","Rhondda Cynon Taf 019C","W01001256",865,49,11,38,166,128,69,77,156,124,38,25,13,58
"2011","Rhondda Cynon Taf 019D","W01001257",927,108,23,85,253,126,91,50,117,80,40,25,15,62
"2011","Rhondda Cynon Taf 019E","W01001258",911,62,12,50,160,138,67,64,173,131,46,27,19,70
"2011","Rhondda Cynon Taf 020A","W01001172",1078,48,12,36,179,146,74,90,201,190,61,38,23,89
"2011","Rhondda Cynon Taf 020B","W01001173",1034,21,7,14,96,66,70,85,234,274,117,87,30,71
"2011","Rhondda Cynon Taf 020C","W01001174",998,29,6,23,103,78,68,84,195,236,128,99,29,77
"2011","Rhondda Cynon Taf 020D","W01001232",1065,45,16,29,201,105,76,85,169,165,106,77,29,113
"2011","Rhondda Cynon Taf 021A","W01001182",1081,62,19,43,207,160,63,86,196,150,45,29,16,112
"2011","Rhondda Cynon Taf 021B","W01001183",791,43,6,37,124,73,41,56,111,109,65,47,18,169
"2011","Rhondda Cynon Taf 021C","W01001227",1004,100,23,77,283,157,70,81,137,71,33,22,11,72
"2011","Rhondda Cynon Taf 021D","W01001228",1139,119,18,101,286,191,93,85,146,85,43,24,19,91
"2011","Rhondda Cynon Taf 021E","W01001234",1114,70,17,53,233,166,96,88,184,164,48,31,17,65
"2011","Rhondda Cynon Taf 021F","W01001235",1139,49,12,37,170,149,77,106,220,203,70,49,21,95
"2011","Rhondda Cynon Taf 021G","W01001236",1050,86,20,66,254,158,73,100,167,119,26,18,8,67
"2011","Rhondda Cynon Taf 022A","W01001185",1196,33,8,25,155,140,94,110,250,235,87,53,34,92
"2011","Rhondda Cynon Taf 022B","W01001237",1049,37,19,18,111,106,75,92,200,246,88,62,26,94
"2011","Rhondda Cynon Taf 022C","W01001238",1169,29,10,19,117,92,66,74,227,261,172,116,56,131
"2011","Rhondda Cynon Taf 022D","W01001262",1110,51,6,45,120,101,61,51,102,98,58,38,20,468
"2011","Rhondda Cynon Taf 022E","W01001263",1492,36,1,35,88,68,42,47,100,119,45,31,14,947
"2011","Rhondda Cynon Taf 022F","W01001264",1914,44,4,40,96,61,49,38,73,104,44,27,17,1405
"2011","Rhondda Cynon Taf 023A","W01001178",1261,77,12,65,163,113,106,121,246,281,67,49,18,87
"2011","Rhondda Cynon Taf 023B","W01001179",1284,29,7,22,109,102,79,96,267,352,170,135,35,80
"2011","Rhondda Cynon Taf 023C","W01001253",1079,41,16,25,152,130,95,88,217,212,77,48,29,67
"2011","Rhondda Cynon Taf 023E","W01001255",1158,49,15,34,141,96,82,106,237,256,129,100,29,62
"2011","Rhondda Cynon Taf 023F","W01001914",1260,141,40,101,356,208,105,90,140,81,31,26,5,108
"2011","Rhondda Cynon Taf 023G","W01001917",1100,47,9,38,152,119,107,113,223,185,87,60,27,67
"2011","Rhondda Cynon Taf 024A","W01001249",1044,35,6,29,151,122,87,117,230,189,58,42,16,55
"2011","Rhondda Cynon Taf 024B","W01001250",1067,45,13,32,184,119,91,111,219,188,41,28,13,69
"2011","Rhondda Cynon Taf 024C","W01001251",1095,35,9,26,147,91,58,103,226,238,129,86,43,68
"2011","Rhondda Cynon Taf 024D","W01001252",1189,88,35,53,234,196,80,132,181,166,34,25,9,78
"2011","Rhondda Cynon Taf 025A","W01001162",1219,64,18,46,197,160,85,115,209,224,84,54,30,81
"2011","Rhondda Cynon Taf 025B","W01001244",1011,97,28,69,280,160,70,93,132,99,25,14,11,55
"2011","Rhondda Cynon Taf 025C","W01001245",1014,141,42,99,291,176,76,63,117,61,38,30,8,51
"2011","Rhondda Cynon Taf 025D","W01001246",1015,68,16,52,246,185,63,90,153,110,40,26,14,60
"2011","Rhondda Cynon Taf 026A","W01001184",1428,89,21,68,265,161,138,129,235,253,48,25,23,110
"2011","Rhondda Cynon Taf 026B","W01001239",995,37,16,21,131,113,59,80,198,210,98,65,33,69
"2011","Rhondda Cynon Taf 026C","W01001240",1468,146,34,112,340,217,126,124,195,160,59,34,25,101
"2011","Rhondda Cynon Taf 026D","W01001241",1305,116,19,97,312,181,104,97,179,140,70,50,20,106
"2011","Rhondda Cynon Taf 027B","W01001196",1209,160,39,121,330,206,107,90,121,66,31,20,11,98
"2011","Rhondda Cynon Taf 027C","W01001197",937,159,33,126,289,133,115,51,68,40,26,18,8,56
"2011","Rhondda Cynon Taf 027D","W01001198",1192,118,28,90,319,184,107,101,161,102,22,13,9,78
"2011","Rhondda Cynon Taf 027E","W01001199",1290,134,30,104,322,204,132,107,160,114,44,31,13,73
"2011","Rhondda Cynon Taf 027F","W01001915",1215,178,52,126,342,210,85,114,103,74,21,13,8,88
"2011","Rhondda Cynon Taf 027G","W01001916",1103,158,44,114,369,171,77,56,107,64,19,15,4,82
"2011","Rhondda Cynon Taf 028A","W01001157",1080,69,17,52,219,167,96,126,191,121,29,17,12,62
"2011","Rhondda Cynon Taf 028B","W01001158",1158,54,16,38,221,162,99,88,190,192,88,62,26,64
"2011","Rhondda Cynon Taf 028C","W01001159",972,112,36,76,265,147,74,86,105,67,29,18,11,87
"2011","Rhondda Cynon Taf 028D","W01001277",933,78,22,56,210,151,61,88,139,107,36,23,13,63
"2011","Rhondda Cynon Taf 028E","W01001278",780,31,5,26,115,89,63,92,150,137,51,37,14,52
"2011","Rhondda Cynon Taf 028F","W01001279",840,22,9,13,88,61,43,87,201,204,77,59,18,57
"2011","Rhondda Cynon Taf 029A","W01001160",1227,94,33,61,254,179,116,118,204,173,24,14,10,65
"2011","Rhondda Cynon Taf 029B","W01001161",1643,127,32,95,308,237,128,138,308,228,57,39,18,112
"2011","Rhondda Cynon Taf 029C","W01001189",1200,69,11,58,186,152,95,95,241,216,78,43,35,68
"2011","Rhondda Cynon Taf 029D","W01001190",1882,219,58,161,495,259,174,148,233,173,47,29,18,134
"2011","Rhondda Cynon Taf 030A","W01001193",927,112,29,83,254,131,63,77,126,75,24,15,9,65
"2011","Rhondda Cynon Taf 030B","W01001194",1630,225,44,181,514,255,118,109,187,90,24,17,7,108
"2011","Rhondda Cynon Taf 030C","W01001195",1147,128,28,100,272,121,109,81,169,115,62,42,20,90
"2011","Rhondda Cynon Taf 030D","W01001242",966,131,22,109,230,150,97,64,111,69,30,12,18,84
"2011","Rhondda Cynon Taf 030E","W01001243",981,66,16,50,190,119,76,74,171,143,91,69,22,51
"2011","Rhondda Cynon Taf 031A","W01001191",1869,196,44,152,500,234,171,145,259,199,71,47,24,94
"2011","Rhondda Cynon Taf 031B","W01001192",1024,51,15,36,133,102,64,91,194,243,97,67,30,49
"2011","Rhondda Cynon Taf 031C","W01001223",1175,159,52,107,352,158,128,75,126,83,25,11,14,69
"2011","Rhondda Cynon Taf 031D","W01001224",1487,333,71,262,543,190,91,62,97,60,21,13,8,90
"2011","Rhondda Cynon Taf 031E","W01001225",1177,211,53,158,365,169,115,84,101,57,19,11,8,56
"2011","Rhondda Cynon Taf 031F","W01001226",1215,160,32,128,289,145,98,99,161,145,46,31,15,72
"2011","Merthyr Tydfil 002A","W01001295",1139,34,11,23,145,131,57,106,243,244,100,70,30,79
"2011","Merthyr Tydfil 002B","W01001296",1325,67,24,43,246,171,94,141,223,216,71,51,20,96
"2011","Merthyr Tydfil 002C","W01001297",1420,62,22,40,219,148,85,125,290,279,121,67,54,91
"2011","Merthyr Tydfil 002D","W01001298",1314,47,14,33,168,135,87,133,268,287,96,69,27,93
"2011","Merthyr Tydfil 002E","W01001310",1208,64,18,46,246,168,74,100,225,197,57,34,23,77
"2011","Merthyr Tydfil 002F","W01001311",850,15,3,12,136,113,49,105,185,145,47,26,21,55
"2011","Merthyr Tydfil 003A","W01001291",1351,89,25,64,314,160,116,108,218,151,87,52,35,108
"2011","Merthyr Tydfil 003B","W01001294",1288,116,31,85,379,212,133,96,143,98,28,23,5,83
"2011","Merthyr Tydfil 003C","W01001305",966,77,15,62,195,129,62,73,134,146,50,34,16,100
"2011","Merthyr Tydfil 003D","W01001306",1179,100,20,80,259,181,79,104,154,175,49,31,18,78
"2011","Merthyr Tydfil 003E","W01001324",1494,145,46,99,327,198,119,127,214,212,76,51,25,76
"2011","Merthyr Tydfil 004A","W01001292",1228,32,7,25,145,92,75,96,268,274,171,123,48,75
"2011","Merthyr Tydfil 004B","W01001293",1222,64,19,45,186,174,85,79,234,217,88,61,27,95
"2011","Merthyr Tydfil 004C","W01001307",1089,42,13,29,169,131,75,85,204,232,90,56,34,61
"2011","Merthyr Tydfil 004D","W01001315",1274,45,7,38,188,134,89,106,245,258,112,61,51,97
"2011","Merthyr Tydfil 005A","W01001314",1573,64,19,45,322,207,120,135,279,280,80,44,36,86
"2011","Merthyr Tydfil 005B","W01001316",2164,150,41,109,493,359,150,207,299,259,85,61,24,162
"2011","Merthyr Tydfil 005C","W01001317",1227,39,21,18,182,166,85,99,241,248,76,46,30,91
"2011","Merthyr Tydfil 005D","W01001318",1118,43,13,30,204,168,84,90,232,172,48,30,18,77
"2011","Merthyr Tydfil 006A","W01001289",1069,40,6,34,128,111,93,145,213,201,78,45,33,60
"2011","Merthyr Tydfil 006B","W01001302",851,33,7,26,99,89,60,66,177,192,78,48,30,57
"2011","Merthyr Tydfil 006C","W01001303",882,12,3,9,88,67,47,73,179,223,122,83,39,71
"2011","Merthyr Tydfil 006D","W01001304",1108,46,12,34,175,138,81,136,205,208,57,38,19,62
"2011","Merthyr Tydfil 006E","W01001312",1061,52,15,37,142,132,65,91,196,214,87,66,21,82
"2011","Merthyr Tydfil 006F","W01001313",1173,56,15,41,182,165,75,114,234,188,66,48,18,93
"2011","Merthyr Tydfil 007A","W01001290",1414,68,23,45,200,144,87,140,286,262,112,70,42,115
"2011","Merthyr Tydfil 007B","W01001319",1262,125,33,92,343,203,107,93,159,100,34,18,16,98
"2011","Merthyr Tydfil 007C","W01001320",1151,107,28,79,202,139,73,94,214,155,81,58,23,86
"2011","Merthyr Tydfil 007D","W01001321",1123,48,17,31,144,130,80,107,244,182,97,71,26,91
"2011","Merthyr Tydfil 007E","W01001322",1211,65,20,45,204,143,92,107,230,221,78,52,26,71
"2011","Merthyr Tydfil 008A","W01001299",1145,22,4,18,120,65,44,90,243,267,212,151,61,82
"2011","Merthyr Tydfil 008B","W01001300",1238,40,10,30,144,93,62,95,240,292,181,130,51,91
"2011","Merthyr Tydfil 008C","W01001301",1320,32,7,25,139,98,65,125,274,324,160,117,43,103
"2011","Merthyr Tydfil 008D","W01001308",901,18,6,12,68,47,47,68,163,241,166,136,30,83
"2011","Merthyr Tydfil 008E","W01001309",911,18,6,12,121,79,49,73,192,211,91,58,33,77
"2011","Merthyr Tydfil 008F","W01001898",1128,67,26,41,191,116,102,92,185,224,83,54,29,68
"2011","Caerphilly 001A","W01001374",1088,30,15,15,134,105,60,105,221,245,98,63,35,90
"2011","Caerphilly 001B","W01001375",1131,47,16,31,153,106,78,110,221,243,91,62,29,82
"2011","Caerphilly 001C","W01001376",1071,25,12,13,109,102,50,103,226,268,132,97,35,56
"2011","Caerphilly 001D","W01001406",1483,60,26,34,192,143,69,139,284,370,119,76,43,107
"2011","Caerphilly 001E","W01001428",929,11,5,6,58,57,23,76,191,282,176,130,46,55
"2011","Caerphilly 001F","W01001429",869,26,6,20,142,106,82,96,165,144,64,47,17,44
"2011","Caerphilly 002A","W01001360",995,49,13,36,161,135,93,93,190,176,38,27,11,60
"2011","Caerphilly 002B","W01001361",926,14,6,8,59,58,46,78,190,305,108,76,32,68
"2011","Caerphilly 002C","W01001384",1215,45,17,28,154,147,88,143,216,261,89,51,38,72
"2011","Caerphilly 002D","W01001385",1119,37,16,21,146,122,81,132,194,241,90,44,46,76
"2011","Caerphilly 002E","W01001386",1217,21,10,11,82,92,63,117,255,338,172,114,58,77
"2011","Caerphilly 003A","W01001325",1112,36,15,21,131,105,94,115,191,245,124,88,36,71
"2011","Caerphilly 003B","W01001326",1534,47,10,37,161,138,133,158,297,368,138,85,53,94
"2011","Caerphilly 003C","W01001362",1518,72,19,53,217,191,96,156,283,309,109,82,27,85
"2011","Caerphilly 004A","W01001336",1092,47,9,38,143,144,83,113,184,232,86,54,32,60
"2011","Caerphilly 004B","W01001337",1167,54,15,39,156,176,70,124,195,198,90,49,41,104
"2011","Caerphilly 004C","W01001338",1292,45,17,28,196,168,76,123,258,251,96,64,32,79
"2011","Caerphilly 004D","W01001339",1003,26,5,21,127,90,52,75,180,214,183,133,50,56
"2011","Caerphilly 005A","W01001334",1064,26,15,11,115,87,75,93,218,245,128,79,49,77
"2011","Caerphilly 005B","W01001335",977,66,21,45,175,109,101,102,162,141,54,35,19,67
"2011","Caerphilly 005C","W01001347",1046,77,23,54,233,140,96,88,147,142,48,37,11,75
"2011","Caerphilly 005D","W01001351",1174,110,34,76,320,154,104,90,160,127,35,27,8,74
"2011","Caerphilly 006A","W01001356",926,48,21,27,151,129,63,102,170,164,26,14,12,73
"2011","Caerphilly 006B","W01001357",1238,96,38,58,265,158,83,115,220,173,44,29,15,84
"2011","Caerphilly 006C","W01001358",1110,41,19,22,140,83,61,106,262,262,79,45,34,76
"2011","Caerphilly 006D","W01001359",1159,64,22,42,190,168,95,118,206,206,45,24,21,67
"2011","Caerphilly 006E","W01001390",1323,130,56,74,320,191,104,116,170,146,44,32,12,102
"2011","Caerphilly 006F","W01001391",1198,75,19,56,158,141,74,127,264,220,64,41,23,75
"2011","Caerphilly 007A","W01001352",1373,41,18,23,139,137,90,115,307,324,114,79,35,106
"2011","Caerphilly 007B","W01001353",1201,51,21,30,210,128,75,129,222,238,77,58,19,71
"2011","Caerphilly 007C","W01001387",920,45,12,33,153,91,63,96,158,181,78,50,28,55
"2011","Caerphilly 007D","W01001388",1331,68,31,37,212,149,74,125,255,233,111,69,42,104
"2011","Caerphilly 007E","W01001389",825,49,16,33,161,102,60,82,130,133,56,40,16,52
"2011","Caerphilly 008A","W01001414",1193,62,15,47,180,143,76,98,193,221,134,87,47,86
"2011","Caerphilly 008B","W01001415",1315,80,23,57,236,162,96,111,227,224,72,52,20,107
"2011","Caerphilly 008C","W01001416",1112,77,18,59,205,182,98,76,166,184,50,41,9,74
"2011","Caerphilly 008D","W01001417",1150,89,16,73,243,210,97,97,185,123,24,13,11,82
"2011","Caerphilly 008E","W01001418",1088,34,9,25,166,146,83,101,191,203,105,73,32,59
"2011","Caerphilly 009A","W01001348",1255,49,22,27,145,135,75,105,267,256,114,78,36,109
"2011","Caerphilly 009B","W01001349",1409,154,51,103,378,209,91,109,192,109,48,37,11,119
"2011","Caerphilly 009C","W01001350",1317,82,30,52,243,173,93,124,239,230,49,31,18,84
"2011","Caerphilly 009D","W01001392",1332,108,32,76,305,187,99,129,219,186,31,19,12,68
"2011","Caerphilly 010A","W01001380",1324,98,33,65,244,197,97,152,211,182,68,39,29,75
"2011","Caerphilly 010B","W01001381",1103,35,11,24,96,83,44,125,265,268,112,62,50,75
"2011","Caerphilly 010C","W01001382",1188,93,27,66,214,162,99,121,218,174,48,33,15,59
"2011","Caerphilly 010D","W01001383",1057,58,17,41,180,127,73,108,209,198,40,30,10,64
"2011","Caerphilly 011A","W01001401",1416,84,27,57,200,173,80,133,280,299,78,49,29,89
"2011","Caerphilly 011B","W01001402",1173,58,15,43,135,121,54,112,251,282,94,62,32,66
"2011","Caerphilly 011C","W01001403",1174,89,22,67,243,162,87,101,190,185,45,29,16,72
"2011","Caerphilly 011D","W01001404",1107,104,38,66,254,201,82,113,163,112,27,14,13,51
"2011","Caerphilly 011E","W01001405",1300,91,35,56,220,143,90,120,207,233,109,67,42,87
"2011","Caerphilly 012A","W01001363",1106,58,15,43,170,132,99,98,181,206,66,44,22,96
"2011","Caerphilly 012B","W01001364",1321,47,10,37,151,117,84,116,250,291,152,108,44,113
"2011","Caerphilly 012C","W01001365",1531,114,37,77,272,215,98,126,234,251,107,80,27,114
"2011","Caerphilly 012D","W01001369",1676,116,35,81,343,227,167,130,253,276,83,59,24,81
"2011","Caerphilly 013A","W01001377",1176,95,23,72,223,186,132,103,188,127,47,29,18,75
"2011","Caerphilly 013B","W01001378",1123,65,12,53,184,135,104,106,166,204,88,67,21,71
"2011","Caerphilly 013C","W01001379",1100,82,25,57,227,187,80,99,168,164,32,21,11,61
"2011","Caerphilly 013D","W01001432",1621,161,36,125,408,274,102,104,235,180,72,55,17,85
"2011","Caerphilly 013E","W01001433",1007,80,14,66,196,150,86,82,168,140,42,23,19,63
"2011","Caerphilly 013F","W01001434",1037,129,41,88,295,173,78,60,114,79,29,16,13,80
"2011","Caerphilly 014A","W01001327",1663,131,38,93,361,263,117,146,261,235,50,29,21,99
"2011","Caerphilly 014B","W01001328",1129,56,16,40,178,141,73,112,247,220,49,28,21,53
"2011","Caerphilly 014C","W01001329",1119,57,18,39,175,147,67,116,256,179,49,37,12,73
"2011","Caerphilly 014D","W01001354",1220,66,26,40,225,172,77,132,223,201,48,25,23,76
"2011","Caerphilly 015A","W01001355",1175,43,17,26,196,156,63,121,224,242,72,43,29,58
"2011","Caerphilly 015B","W01001430",1723,93,30,63,253,227,138,189,342,269,110,67,43,102
"2011","Caerphilly 015C","W01001431",1193,73,21,52,205,157,99,104,197,196,64,48,16,98
"2011","Caerphilly 016A","W01001407",1129,76,23,53,230,203,69,102,228,120,36,17,19,65
"2011","Caerphilly 016B","W01001408",1053,39,17,22,124,129,56,104,259,186,81,51,30,75
"2011","Caerphilly 016C","W01001409",1238,90,30,60,238,178,76,112,240,183,45,17,28,76
"2011","Caerphilly 016D","W01001410",1419,73,20,53,219,183,77,141,315,238,82,46,36,91
"2011","Caerphilly 017A","W01001411",1269,77,15,62,239,170,84,113,222,209,78,53,25,77
"2011","Caerphilly 017B","W01001412",1291,68,23,45,244,201,103,129,237,183,64,34,30,62
"2011","Caerphilly 017C","W01001413",1346,59,22,37,186,167,93,122,314,229,75,52,23,101
"2011","Caerphilly 018A","W01001330",1056,49,10,39,169,150,76,100,214,177,61,43,18,60
"2011","Caerphilly 018B","W01001331",1308,59,16,43,185,180,108,110,238,238,96,47,49,94
"2011","Caerphilly 018C","W01001332",1392,44,12,32,167,181,91,116,276,283,134,75,59,100
"2011","Caerphilly 018D","W01001333",1159,42,15,27,159,137,73,99,234,222,115,74,41,78
"2011","Caerphilly 019A","W01001366",1298,82,16,66,297,228,83,133,214,157,53,32,21,51
"2011","Caerphilly 019B","W01001367",1135,57,16,41,178,201,75,105,199,177,65,36,29,78
"2011","Caerphilly 019C","W01001368",1135,67,16,51,173,149,83,95,177,196,117,81,36,78
"2011","Caerphilly 019D","W01001393",971,55,21,34,140,135,59,91,171,193,68,49,19,59
"2011","Caerphilly 019E","W01001397",1312,106,23,83,273,208,99,106,176,172,74,54,20,98
"2011","Caerphilly 019F","W01001400",997,40,14,26,137,114,55,92,186,168,125,97,28,80
"2011","Caerphilly 020A","W01001340",1361,142,42,100,342,201,138,126,176,117,38,24,14,81
"2011","Caerphilly 020B","W01001341",1312,36,12,24,147,149,86,136,240,326,103,62,41,89
"2011","Caerphilly 020C","W01001344",1265,67,22,45,255,202,117,112,187,175,60,42,18,90
"2011","Caerphilly 020D","W01001346",1081,64,20,44,162,162,89,103,197,183,49,28,21,72
"2011","Caerphilly 021A","W01001342",859,108,28,80,234,131,59,55,116,78,27,14,13,51
"2011","Caerphilly 021B","W01001343",880,110,22,88,238,118,90,65,98,71,36,18,18,54
"2011","Caerphilly 021C","W01001345",1027,43,11,32,120,99,60,77,216,169,164,104,60,79
"2011","Caerphilly 021D","W01001419",1178,173,35,138,251,147,118,67,137,122,84,58,26,79
"2011","Caerphilly 022A","W01001371",1084,55,17,38,143,160,64,92,205,184,128,86,42,53
"2011","Caerphilly 022B","W01001372",1436,99,23,76,313,261,98,138,234,149,65,39,26,79
"2011","Caerphilly 022C","W01001373",1266,74,17,57,242,196,99,121,209,187,51,34,17,87
"2011","Caerphilly 022D","W01001420",998,85,22,63,221,161,84,84,157,108,36,26,10,62
"2011","Caerphilly 022E","W01001421",1087,17,3,14,84,102,47,92,226,242,198,145,53,79
"2011","Caerphilly 022F","W01001422",1111,52,17,35,147,178,62,109,182,191,123,92,31,67
"2011","Caerphilly 023A","W01001370",1247,70,11,59,240,203,93,107,213,175,67,45,22,79
"2011","Caerphilly 023B","W01001394",1047,115,23,92,291,209,76,78,123,67,26,14,12,62
"2011","Caerphilly 023C","W01001395",1045,59,15,44,173,147,75,93,168,173,92,71,21,65
"2011","Caerphilly 023D","W01001396",1148,46,3,43,174,150,62,94,210,210,115,78,37,87
"2011","Caerphilly 023E","W01001399",965,74,23,51,206,149,76,84,156,111,37,21,16,72
"2011","Caerphilly 024A","W01001398",1812,264,51,213,559,309,106,135,166,117,56,34,22,100
"2011","Caerphilly 024B","W01001423",1074,98,31,67,256,206,95,98,144,101,26,19,7,50
"2011","Caerphilly 024C","W01001424",1060,74,11,63,219,159,83,82,192,114,71,44,27,66
"2011","Caerphilly 024D","W01001425",1180,152,35,117,293,192,83,100,144,91,34,17,17,91
"2011","Caerphilly 024E","W01001426",1030,133,30,103,297,172,94,76,113,56,31,27,4,58
"2011","Caerphilly 024F","W01001427",1330,203,51,152,424,255,78,78,115,67,23,12,11,87
"2011","Blaenau Gwent 001A","W01001440",1013,45,21,24,186,122,58,115,193,162,75,37,38,57
"2011","Blaenau Gwent 001B","W01001441",892,15,8,7,99,76,47,83,226,181,97,60,37,68
"2011","Blaenau Gwent 001C","W01001442",928,68,18,50,207,134,58,72,159,125,40,28,12,65
"2011","Blaenau Gwent 001D","W01001470",1114,69,26,43,209,153,79,112,204,170,56,31,25,62
"2011","Blaenau Gwent 001E","W01001471",1277,25,12,13,114,118,73,130,314,284,151,95,56,68
"2011","Blaenau Gwent 002A","W01001446",910,70,26,44,194,107,55,86,141,139,41,32,9,77
"2011","Blaenau Gwent 002B","W01001447",1115,36,14,22,138,88,63,90,260,242,128,85,43,70
"2011","Blaenau Gwent 002C","W01001448",924,42,18,24,159,85,98,99,174,160,64,44,20,43
"2011","Blaenau Gwent 002D","W01001449",1068,44,20,24,179,99,63,117,193,249,75,42,33,49
"2011","Blaenau Gwent 003A","W01001472",1080,62,17,45,218,134,79,117,178,155,63,40,23,74
"2011","Blaenau Gwent 003B","W01001473",998,13,4,9,77,48,59,99,229,249,161,119,42,63
"2011","Blaenau Gwent 003C","W01001474",1193,61,22,39,172,120,100,117,212,237,106,77,29,68
"2011","Blaenau Gwent 003D","W01001475",918,38,11,27,147,97,70,98,185,171,48,32,16,64
"2011","Blaenau Gwent 003E","W01001480",1098,22,12,10,122,82,53,106,249,235,153,115,38,76
"2011","Blaenau Gwent 004A","W01001438",1052,39,11,28,160,149,50,99,200,207,65,38,27,83
"2011","Blaenau Gwent 004B","W01001439",1307,81,22,59,250,169,81,129,262,184,52,32,20,99
"2011","Blaenau Gwent 004C","W01001456",995,20,12,8,126,90,49,118,236,199,90,58,32,67
"2011","Blaenau Gwent 004D","W01001457",1287,16,8,8,137,100,43,123,287,297,192,121,71,92
"2011","Blaenau Gwent 004E","W01001458",1160,45,12,33,221,143,65,98,258,184,46,23,23,100
"2011","Blaenau Gwent 005A","W01001443",1052,32,12,20,154,80,76,96,235,198,122,89,33,59
"2011","Blaenau Gwent 005B","W01001444",1438,52,20,32,202,136,102,145,292,302,112,73,39,95
"2011","Blaenau Gwent 005C","W01001445",1103,49,23,26,170,103,80,112,232,210,84,55,29,63
"2011","Blaenau Gwent 005D","W01001467",1388,67,24,43,196,139,95,102,268,298,143,92,51,80
"2011","Blaenau Gwent 005E","W01001468",1043,37,9,28,145,109,60,91,224,232,91,59,32,54
"2011","Blaenau Gwent 005F","W01001469",950,33,11,22,105,79,59,71,181,216,141,98,43,65
"2011","Blaenau Gwent 006A","W01001462",1103,53,20,33,208,119,71,110,200,186,72,50,22,84
"2011","Blaenau Gwent 006B","W01001463",1426,57,19,38,264,169,94,140,286,252,82,49,33,82
"2011","Blaenau Gwent 006C","W01001478",1125,53,17,36,206,129,81,133,204,199,68,40,28,52
"2011","Blaenau Gwent 006D","W01001479",1088,17,5,12,102,72,53,91,248,247,190,130,60,68
"2011","Blaenau Gwent 006E","W01001481",1166,52,17,35,149,110,78,125,227,239,117,80,37,69
"2011","Blaenau Gwent 007A","W01001450",983,37,9,28,139,81,74,107,214,205,62,43,19,64
"2011","Blaenau Gwent 007B","W01001451",1040,31,14,17,96,94,70,127,248,227,94,54,40,53
"2011","Blaenau Gwent 007C","W01001452",1203,75,22,53,266,142,72,122,204,195,49,21,28,78
"2011","Blaenau Gwent 007D","W01001459",801,19,8,11,79,57,48,71,208,142,114,74,40,63
"2011","Blaenau Gwent 007E","W01001460",1306,72,14,58,263,161,94,125,247,182,97,54,43,65
"2011","Blaenau Gwent 007F","W01001461",1071,38,15,23,157,110,68,100,224,187,125,90,35,62
"2011","Blaenau Gwent 008A","W01001435",1102,47,14,33,163,127,69,92,244,216,71,40,31,73
"2011","Blaenau Gwent 008B","W01001436",1031,55,10,45,126,102,51,100,237,210,98,64,34,52
"2011","Blaenau Gwent 008C","W01001437",1159,58,27,31,192,148,62,121,198,225,73,38,35,82
"2011","Blaenau Gwent 008D","W01001453",1128,35,6,29,128,93,60,107,240,267,134,100,34,64
"2011","Blaenau Gwent 008E","W01001454",1061,37,10,27,138,117,69,101,226,218,81,56,25,74
"2011","Blaenau Gwent 008F","W01001455",1244,46,19,27,161,146,77,131,277,243,93,54,39,70
"2011","Blaenau Gwent 009A","W01001464",1119,34,9,25,91,84,69,104,294,269,110,63,47,64
"2011","Blaenau Gwent 009B","W01001465",1184,52,24,28,138,111,72,108,251,283,103,71,32,66
"2011","Blaenau Gwent 009C","W01001466",1308,37,8,29,152,107,80,139,300,309,102,56,46,82
"2011","Blaenau Gwent 009D","W01001476",785,39,17,22,82,50,69,65,158,171,98,65,33,53
"2011","Blaenau Gwent 009E","W01001477",1073,55,16,39,163,140,73,109,218,183,57,36,21,75
"2011","Torfaen 001A","W01001487",1129,69,18,51,187,140,84,124,207,164,79,57,22,75
"2011","Torfaen 001B","W01001488",1126,45,20,25,137,84,64,103,238,254,132,96,36,69
"2011","Torfaen 001C","W01001489",1159,60,13,47,158,133,84,113,242,220,91,59,32,58
"2011","Torfaen 001D","W01001490",947,53,15,38,182,120,63,99,196,150,40,18,22,44
"2011","Torfaen 002A","W01001482",893,36,11,25,119,62,60,93,195,195,75,53,22,58
"2011","Torfaen 002B","W01001483",946,38,7,31,115,92,64,87,197,206,83,51,32,64
"2011","Torfaen 002C","W01001484",1286,95,25,70,232,185,113,140,177,197,69,45,24,78
"2011","Torfaen 002D","W01001485",849,35,11,24,116,90,70,89,178,164,55,41,14,52
"2011","Torfaen 002E","W01001486",1123,74,16,58,195,131,96,103,208,173,77,51,26,66
"2011","Torfaen 003A","W01001525",1100,48,13,35,146,74,64,115,217,264,88,72,16,84
"2011","Torfaen 003B","W01001529",1547,69,21,48,254,162,102,154,297,302,129,79,50,78
"2011","Torfaen 003C","W01001530",1307,28,10,18,110,88,48,108,305,367,171,122,49,82
"2011","Torfaen 003D","W01001531",1264,35,11,24,199,117,86,138,276,262,93,64,29,58
"2011","Torfaen 004A","W01001491",1309,59,15,44,220,142,86,141,269,224,98,64,34,70
"2011","Torfaen 004B","W01001496",1075,36,11,25,136,116,71,103,210,237,85,65,20,81
"2011","Torfaen 004C","W01001523",1137,61,24,37,155,150,88,101,226,216,66,53,13,74
"2011","Torfaen 004D","W01001524",1364,75,22,53,283,178,106,126,218,209,97,68,29,72
"2011","Torfaen 004E","W01001540",976,60,21,39,197,121,77,83,191,149,37,25,12,61
"2011","Torfaen 004F","W01001541",855,49,19,30,139,94,89,73,167,151,44,37,7,49
"2011","Torfaen 005A","W01001510",1081,73,27,46,287,158,65,80,180,112,41,26,15,85
"2011","Torfaen 005B","W01001511",1147,82,24,58,237,162,72,102,218,158,47,31,16,69
"2011","Torfaen 005C","W01001512",1053,118,27,91,253,207,63,90,148,111,16,9,7,47
"2011","Torfaen 005D","W01001513",1157,151,44,107,314,199,87,98,136,67,21,12,9,84
"2011","Torfaen 006A","W01001514",886,75,17,58,223,138,62,76,143,87,38,29,9,44
"2011","Torfaen 006B","W01001515",1078,70,19,51,220,174,65,108,191,137,33,20,13,80
"2011","Torfaen 006C","W01001516",1081,38,16,22,132,122,49,124,256,222,74,48,26,64
"2011","Torfaen 006D","W01001517",1440,115,32,83,349,237,96,143,223,170,31,19,12,76
"2011","Torfaen 006E","W01001518",809,73,16,57,203,127,64,86,109,79,27,16,11,41
"2011","Torfaen 007A","W01001519",1004,12,3,9,95,107,57,99,230,253,95,61,34,56
"2011","Torfaen 007B","W01001520",1304,87,22,65,291,178,90,121,236,161,57,38,19,83
"2011","Torfaen 007C","W01001521",1059,60,17,43,173,155,44,102,220,175,54,30,24,76
"2011","Torfaen 007D","W01001522",1170,55,16,39,169,131,100,122,256,189,69,50,19,79
"2011","Torfaen 007E","W01001537",945,68,16,52,219,142,84,89,159,101,30,11,19,53
"2011","Torfaen 008A","W01001493",1411,75,22,53,259,195,81,132,300,224,64,36,28,81
"2011","Torfaen 008B","W01001494",1050,98,26,72,255,159,68,94,168,110,32,20,12,66
"2011","Torfaen 008C","W01001495",1214,105,33,72,270,198,92,112,184,140,40,30,10,73
"2011","Torfaen 008D","W01001507",1392,122,32,90,305,221,85,121,216,170,65,35,30,87
"2011","Torfaen 009A","W01001501",977,24,8,16,110,109,60,111,235,186,73,43,30,69
"2011","Torfaen 009B","W01001503",944,33,10,23,104,116,40,94,245,172,77,57,20,63
"2011","Torfaen 009C","W01001536",838,20,8,12,88,75,58,75,176,166,92,54,38,88
"2011","Torfaen 009D","W01001538",926,28,8,20,111,91,56,105,210,195,66,44,22,64
"2011","Torfaen 009E","W01001539",1023,32,12,20,128,106,59,118,269,195,59,35,24,57
"2011","Torfaen 010A","W01001506",1032,45,16,29,137,106,81,77,223,227,78,52,26,58
"2011","Torfaen 010B","W01001526",968,32,9,23,111,113,32,86,221,225,86,56,30,62
"2011","Torfaen 010C","W01001527",876,34,10,24,128,113,64,94,194,167,44,32,12,38
"2011","Torfaen 010D","W01001528",804,31,15,16,117,101,52,70,176,157,48,28,20,52
"2011","Torfaen 010E","W01001532",1202,51,17,34,159,121,66,111,277,234,107,71,36,76
"2011","Torfaen 011A","W01001497",1053,47,14,33,160,144,54,104,234,162,71,44,27,77
"2011","Torfaen 011B","W01001498",849,37,16,21,123,88,51,72,178,171,60,42,18,69
"2011","Torfaen 011C","W01001499",951,65,20,45,185,150,61,93,164,111,39,24,15,83
"2011","Torfaen 011D","W01001500",1027,115,34,81,255,176,81,71,142,85,25,14,11,77
"2011","Torfaen 011E","W01001502",995,93,23,70,226,157,73,77,169,100,18,10,8,82
"2011","Torfaen 012A","W01001492",1752,164,42,122,362,268,106,137,300,209,71,38,33,135
"2011","Torfaen 012B","W01001533",1237,161,45,116,376,176,105,86,128,95,20,12,8,90
"2011","Torfaen 012C","W01001534",1106,76,28,48,217,157,71,113,204,153,38,22,16,77
"2011","Torfaen 012D","W01001535",1040,105,21,84,246,157,81,68,179,117,26,14,12,61
"2011","Torfaen 013A","W01001504",1424,91,17,74,238,180,99,112,289,230,79,58,21,106
"2011","Torfaen 013B","W01001505",1494,168,46,122,383,203,138,99,190,147,58,39,19,108
"2011","Torfaen 013C","W01001508",833,100,21,79,214,121,57,67,104,70,33,25,8,67
"2011","Torfaen 013D","W01001509",1083,177,53,124,335,140,91,46,128,51,21,8,13,94
"2011","Monmouthshire 001A","W01001545",969,204,31,173,287,123,93,41,83,48,40,32,8,50
"2011","Monmouthshire 001B","W01001548",1580,165,33,132,415,142,383,95,155,96,43,30,13,86
"2011","Monmouthshire 001C","W01001557",1355,136,27,109,301,139,132,99,246,150,75,54,21,77
"2011","Monmouthshire 001D","W01001571",951,111,28,83,229,116,132,67,136,79,26,19,7,55
"2011","Monmouthshire 001E","W01001579",1035,163,41,122,310,128,121,56,114,68,36,18,18,39
"2011","Monmouthshire 002A","W01001546",1093,82,16,66,192,85,81,94,223,165,80,53,27,91
"2011","Monmouthshire 002C","W01001558",1076,82,15,67,203,108,73,79,219,183,59,45,14,70
"2011","Monmouthshire 002E","W01001580",1264,136,31,105,334,141,136,77,197,124,58,45,13,61
"2011","Monmouthshire 002F","W01001909",1917,84,31,53,353,222,158,166,399,325,108,74,34,102
"2011","Monmouthshire 003A","W01001561",1033,148,42,106,329,126,118,65,111,49,43,35,8,44
"2011","Monmouthshire 003B","W01001562",1085,109,19,90,259,125,121,63,149,125,64,36,28,70
"2011","Monmouthshire 003C","W01001563",719,63,17,46,188,95,53,52,120,88,19,9,10,41
"2011","Monmouthshire 003D","W01001564",1623,209,58,151,434,195,187,98,202,116,74,50,24,108
"2011","Monmouthshire 003E","W01001569",1048,151,35,116,246,121,109,79,124,106,56,40,16,56
"2011","Monmouthshire 004A","W01001552",1116,244,65,179,346,122,111,58,96,47,20,10,10,72
"2011","Monmouthshire 004B","W01001553",1963,237,76,161,475,184,201,144,295,202,81,51,30,144
"2011","Monmouthshire 004C","W01001554",1080,145,40,105,255,85,115,44,132,78,33,17,16,193
"2011","Monmouthshire 004D","W01001576",799,59,11,48,138,81,101,56,157,121,37,24,13,49
"2011","Monmouthshire 004E","W01001577",828,45,11,34,119,55,82,71,178,163,55,43,12,60
"2011","Monmouthshire 004F","W01001599",1491,114,29,85,312,133,193,127,270,218,54,36,18,70
"2011","Monmouthshire 005A","W01001566",984,141,27,114,253,88,190,46,95,61,58,51,7,52
"2011","Monmouthshire 005B","W01001567",755,114,23,91,167,80,149,42,73,63,24,13,11,43
"2011","Monmouthshire 005C","W01001568",1298,171,45,126,326,111,350,66,113,67,28,20,8,66
"2011","Monmouthshire 005D","W01001575",940,130,40,90,236,80,238,45,85,60,18,11,7,48
"2011","Monmouthshire 005E","W01001581",1391,187,43,144,357,160,249,80,163,89,22,13,9,84
"2011","Monmouthshire 006A","W01001555",866,136,28,108,252,117,124,41,70,46,8,5,3,72
"2011","Monmouthshire 006B","W01001556",871,109,33,76,188,116,78,76,116,107,38,24,14,43
"2011","Monmouthshire 006C","W01001560",1018,173,43,130,251,126,179,59,72,58,21,16,5,79
"2011","Monmouthshire 006D","W01001565",1387,233,61,172,340,148,297,40,91,58,57,43,14,123
"2011","Monmouthshire 006E","W01001596",969,111,27,84,212,78,116,83,136,146,56,45,11,31
"2011","Monmouthshire 006F","W01001597",1099,233,58,175,291,140,116,50,99,63,24,14,10,83
"2011","Monmouthshire 007A","W01001549",1117,232,50,182,298,107,209,39,93,41,20,17,3,78
"2011","Monmouthshire 007B","W01001583",1199,257,44,213,331,114,186,55,79,84,27,19,8,66
"2011","Monmouthshire 007C","W01001585",899,175,38,137,271,121,54,49,100,62,14,9,5,53
"2011","Monmouthshire 007D","W01001586",1726,375,98,277,529,223,131,79,157,96,34,22,12,102
"2011","Monmouthshire 007E","W01001594",1016,193,34,159,256,94,175,45,98,54,42,27,15,59
"2011","Monmouthshire 007F","W01001595",985,211,44,167,306,82,148,40,73,42,13,6,7,70
"2011","Monmouthshire 008A","W01001559",946,81,17,64,177,121,73,73,160,166,41,23,18,54
"2011","Monmouthshire 008B","W01001584",1376,84,22,62,243,153,114,154,214,262,48,31,17,104
"2011","Monmouthshire 008C","W01001587",1361,162,30,132,321,136,131,105,208,189,48,19,29,61
"2011","Monmouthshire 008D","W01001592",1176,73,23,50,200,111,76,82,248,223,79,46,33,84
"2011","Monmouthshire 008E","W01001593",1291,89,28,61,256,159,89,129,214,236,48,32,16,71
"2011","Monmouthshire 009A","W01001542",1316,216,49,167,318,143,177,97,125,128,20,11,9,92
"2011","Monmouthshire 009B","W01001543",1084,165,45,120,273,153,81,78,127,91,25,13,12,91
"2011","Monmouthshire 009C","W01001578",1622,197,48,149,372,193,165,146,228,177,42,28,14,102
"2011","Monmouthshire 009D","W01001590",1655,340,88,252,500,209,209,73,102,83,27,19,8,112
"2011","Monmouthshire 010C","W01001551",793,33,8,25,106,77,48,85,145,207,48,26,22,44
"2011","Monmouthshire 010D","W01001588",1272,95,29,66,227,207,104,137,210,175,27,17,10,90
"2011","Monmouthshire 010E","W01001589",1132,102,32,70,199,149,85,116,178,192,58,36,22,53
"2011","Monmouthshire 010F","W01001598",1195,58,20,38,156,139,66,137,233,259,73,37,36,74
"2011","Monmouthshire 010G","W01001908",1552,84,36,48,232,209,109,187,275,296,82,48,34,78
"2011","Monmouthshire 011A","W01001572",1101,159,43,116,328,157,98,73,100,86,26,21,5,74
"2011","Monmouthshire 011B","W01001573",1134,176,56,120,306,151,119,69,115,92,24,18,6,82
"2011","Monmouthshire 011C","W01001574",1128,151,44,107,281,187,74,88,128,115,26,12,14,78
"2011","Monmouthshire 011D","W01001582",1290,133,33,100,283,177,93,112,175,176,46,23,23,95
"2011","Monmouthshire 011E","W01001591",1138,177,44,133,348,186,72,65,106,87,14,10,4,83
"2011","Newport 001A","W01001623",1054,159,34,125,294,148,109,55,85,68,35,27,8,101
"2011","Newport 001B","W01001624",901,132,28,104,286,142,59,59,92,52,8,2,6,71
"2011","Newport 001C","W01001625",963,147,43,104,255,125,130,56,72,59,28,15,13,91
"2011","Newport 001D","W01001626",1060,119,37,82,272,159,74,76,121,93,58,44,14,88
"2011","Newport 001E","W01001627",1196,158,36,122,341,178,85,85,148,76,18,11,7,107
"2011","Newport 001F","W01001628",755,78,22,56,162,91,35,64,101,92,42,30,12,90
"2011","Newport 002A","W01001651",1115,104,26,78,257,206,76,91,171,103,22,12,10,85
"2011","Newport 002B","W01001652",1213,37,9,28,139,121,54,109,243,247,179,126,53,84
"2011","Newport 002C","W01001653",1058,83,25,58,256,187,53,115,172,116,22,9,13,54
"2011","Newport 002D","W01001654",1165,78,19,59,264,158,91,121,198,147,33,21,12,75
"2011","Newport 002E","W01001655",1210,96,24,72,252,225,76,127,211,117,44,23,21,62
"2011","Newport 003A","W01001617",933,19,2,17,67,106,44,78,233,231,104,68,36,51
"2011","Newport 003B","W01001618",834,25,8,17,90,71,41,87,205,175,87,66,21,53
"2011","Newport 003C","W01001619",1035,12,4,8,98,98,48,92,249,255,121,83,38,62
"2011","Newport 003D","W01001620",845,14,4,10,74,99,55,84,174,186,80,54,26,79
"2011","Newport 003E","W01001621",1040,30,10,20,99,109,52,107,239,224,113,82,31,67
"2011","Newport 003F","W01001622",953,32,11,21,134,121,57,92,228,169,66,43,23,54
"2011","Newport 004A","W01001639",1377,237,70,167,405,189,118,74,140,86,31,24,7,97
"2011","Newport 004B","W01001640",848,150,37,113,242,112,120,34,71,48,23,17,6,48
"2011","Newport 004C","W01001641",1040,191,50,141,301,127,125,37,81,53,57,49,8,68
"2011","Newport 004D","W01001649",1091,107,25,82,222,126,165,80,134,149,40,27,13,68
"2011","Newport 004E","W01001650",1104,57,14,43,168,142,79,120,183,226,65,42,23,64
"2011","Newport 005A","W01001614",1014,56,16,40,135,136,64,72,218,190,83,47,36,60
"2011","Newport 005B","W01001615",1030,56,20,36,192,157,73,99,155,157,62,39,23,79
"2011","Newport 005C","W01001616",1057,88,27,61,250,182,65,89,157,122,39,29,10,65
"2011","Newport 005D","W01001678",1210,73,25,48,241,138,72,117,238,149,97,69,28,85
"2011","Newport 006A","W01001601",1066,52,10,42,192,118,68,75,197,144,112,83,29,108
"2011","Newport 006B","W01001681",969,36,6,30,123,99,63,88,207,181,95,54,41,77
"2011","Newport 006C","W01001682",925,42,14,28,143,140,54,86,184,159,53,31,22,64
"2011","Newport 006D","W01001683",806,32,11,21,150,149,47,60,144,125,42,24,18,57
"2011","Newport 006E","W01001684",1096,59,22,37,232,169,70,109,193,136,60,40,20,68
"2011","Newport 007A","W01001675",1132,67,20,47,209,162,81,79,178,141,62,44,18,153
"2011","Newport 007B","W01001676",1217,44,11,33,193,160,76,110,225,185,92,65,27,132
"2011","Newport 007C","W01001677",1063,62,19,43,217,170,56,107,201,155,36,21,15,59
"2011","Newport 007D","W01001679",837,73,24,49,162,140,66,84,129,96,21,12,9,66
"2011","Newport 007E","W01001680",915,67,13,54,193,120,71,65,139,98,52,26,26,110
"2011","Newport 008A","W01001606",923,78,16,62,169,138,74,90,158,107,45,27,18,64
"2011","Newport 008B","W01001608",1109,76,16,60,264,187,93,89,146,128,45,28,17,81
"2011","Newport 008C","W01001663",1036,49,10,39,131,133,60,93,202,197,88,66,22,83
"2011","Newport 008D","W01001665",1131,81,28,53,210,157,88,98,181,168,75,58,17,73
"2011","Newport 009A","W01001669",1045,191,50,141,321,193,72,39,93,39,13,7,6,84
"2011","Newport 009B","W01001670",1649,288,71,217,507,279,118,95,133,68,37,21,16,124
"2011","Newport 009C","W01001672",1183,153,36,117,267,214,76,92,151,107,50,28,22,73
"2011","Newport 009D","W01001673",1094,166,39,127,377,174,70,73,98,54,17,8,9,65
"2011","Newport 009E","W01001674",1033,89,25,64,220,148,89,79,151,119,51,33,18,87
"2011","Newport 010A","W01001664",957,15,5,10,97,90,50,87,201,239,111,79,32,67
"2011","Newport 010B","W01001666",956,29,13,16,100,75,33,89,232,231,103,76,27,64
"2011","Newport 010C","W01001667",906,18,6,12,62,92,39,74,222,218,124,95,29,57
"2011","Newport 010D","W01001668",772,19,7,12,77,72,30,73,187,174,97,63,34,43
"2011","Newport 011A","W01001611",937,43,8,35,143,138,63,80,165,149,68,47,21,88
"2011","Newport 011B","W01001612",1165,66,11,55,223,173,78,104,195,136,91,66,25,99
"2011","Newport 011C","W01001613",1120,61,16,45,211,163,87,110,199,141,57,37,20,91
"2011","Newport 011D","W01001691",1073,63,12,51,186,137,86,86,171,149,89,58,31,106
"2011","Newport 011E","W01001692",1500,53,10,43,198,162,100,131,226,230,177,132,45,223
"2011","Newport 012A","W01001600",1092,221,56,165,322,187,96,53,95,53,23,10,13,42
"2011","Newport 012B","W01001602",1085,216,46,170,342,154,80,42,102,63,27,22,5,59
"2011","Newport 012C","W01001603",1026,131,30,101,242,149,96,65,117,77,80,56,24,69
"2011","Newport 012D","W01001604",996,171,31,140,297,141,93,58,86,42,43,26,17,65
"2011","Newport 013A","W01001642",1242,36,10,26,190,175,51,102,216,264,139,102,37,69
"2011","Newport 013B","W01001643",1002,29,5,24,124,123,51,85,184,200,121,79,42,85
"2011","Newport 013C","W01001644",1982,94,20,74,319,319,103,174,374,336,135,85,50,128
"2011","Newport 013D","W01001690",1627,70,16,54,218,189,101,122,311,291,191,125,66,134
"2011","Newport 013E","W01001693",1374,47,7,40,148,140,135,101,185,207,250,206,44,161
"2011","Newport 014A","W01001605",1019,105,25,80,215,125,83,60,142,83,116,89,27,90
"2011","Newport 014B","W01001685",1285,84,13,71,233,146,80,105,208,176,103,62,41,150
"2011","Newport 014C","W01001686",998,145,21,124,222,139,82,61,121,94,49,35,14,85
"2011","Newport 014D","W01001687",1406,93,12,81,216,145,84,113,191,190,170,109,61,204
"2011","Newport 015A","W01001607",945,25,5,20,101,86,59,76,168,186,157,122,35,87
"2011","Newport 015B","W01001609",978,19,7,12,78,98,36,75,235,223,125,95,30,89
"2011","Newport 015C","W01001610",941,51,16,35,136,96,51,98,185,176,77,51,26,71
"2011","Newport 015D","W01001645",961,27,9,18,128,123,51,105,217,163,66,45,21,81
"2011","Newport 015E","W01001646",1620,24,3,21,105,117,57,87,202,224,154,111,43,650
"2011","Newport 015F","W01001647",1109,70,13,57,207,183,107,115,177,143,41,30,11,66
"2011","Newport 015G","W01001648",1074,58,16,42,179,169,73,89,223,156,56,39,17,71
"2011","Newport 016A","W01001635",991,163,39,124,294,160,92,50,83,63,23,13,10,63
"2011","Newport 016B","W01001637",1161,151,47,104,296,178,80,83,136,97,35,20,15,105
"2011","Newport 016C","W01001638",868,124,33,91,245,151,69,62,90,53,16,8,8,58
"2011","Newport 016D","W01001671",1273,114,23,91,295,182,85,113,190,173,58,35,23,63
"2011","Newport 017A","W01001629",966,92,24,68,215,159,74,79,144,93,47,36,11,63
"2011","Newport 017B","W01001630",1001,47,16,31,168,133,59,91,181,172,75,47,28,75
"2011","Newport 017C","W01001631",1040,77,15,62,208,214,50,102,170,119,35,20,15,65
"2011","Newport 017D","W01001632",964,31,5,26,171,150,62,74,194,168,44,28,16,70
"2011","Newport 018A","W01001659",1210,36,8,28,121,91,71,89,218,223,236,185,51,125
"2011","Newport 018B","W01001660",1107,46,15,31,146,102,80,86,205,191,154,121,33,97
"2011","Newport 018C","W01001661",2000,64,13,51,181,141,80,122,238,193,252,206,46,729
"2011","Newport 018D","W01001662",937,20,5,15,75,68,66,56,171,193,203,158,45,85
"2011","Newport 019A","W01001633",1032,26,4,22,125,112,41,95,217,226,119,71,48,71
"2011","Newport 019B","W01001634",1082,38,6,32,183,141,71,84,225,187,79,55,24,74
"2011","Newport 019C","W01001688",1937,189,43,146,437,296,88,156,314,210,119,97,22,128
"2011","Newport 019D","W01001689",1103,27,8,19,112,86,42,95,249,257,145,103,42,90
"2011","Newport 020A","W01001636",1341,259,54,205,341,226,104,90,120,71,25,12,13,105
"2011","Newport 020C","W01001657",1099,209,52,157,321,173,117,62,88,31,14,7,7,84
"2011","Newport 020D","W01001658",1317,203,47,156,359,195,151,64,111,89,45,35,10,100
"2011","Newport 020E","W01001912",1132,133,26,107,293,153,131,88,147,106,35,22,13,46
"2011","Newport 020F","W01001913",1102,181,38,143,314,154,91,78,122,70,26,13,13,66
